agent_name,layout,event_update_level,num_attention_switches,num_attention_switches_margins,num_attention_switches_middle,inform_loss,reading_speed,total_steps,attention_switches_time_steps_list
Olaf,L0,short,138,69,69,5,0.31,200,"[1, 3, 4, 5, 6, 7, 8, 9, 11, 12, 13, 14, 15, 16, 17, 18, 19, 20, 22, 23, 24, 25, 26, 27, 28, 32, 33, 34, 35, 37, 38, 39, 40, 45, 47, 48, 49, 50, 51, 52, 54, 55, 56, 57, 58, 59, 60, 65, 66, 67, 69, 70, 71, 73, 75, 76, 79, 82, 83, 84, 86, 87, 89, 90, 92, 95, 96, 97, 98, 99, 100, 101, 102, 103, 104, 105, 108, 109, 110, 111, 112, 113, 114, 115, 116, 117, 118, 119, 122, 124, 125, 126, 127, 129, 130, 131, 132, 134, 135, 136, 137, 138, 140, 141, 142, 145, 146, 148, 149, 152, 153, 154, 156, 157, 158, 159, 162, 166, 172, 173, 174, 176, 177, 179, 180, 182, 183, 184, 185, 186, 188, 190, 192, 193, 195, 196, 197, 198]"
Olaf,L0,short,132,69,63,7,0.34,200,"[0, 4, 5, 6, 8, 9, 10, 11, 12, 15, 16, 18, 19, 21, 23, 24, 25, 26, 27, 28, 29, 30, 33, 34, 35, 36, 37, 38, 39, 40, 41, 43, 44, 45, 47, 48, 49, 50, 53, 54, 56, 57, 58, 59, 62, 63, 64, 65, 67, 68, 69, 70, 72, 74, 75, 76, 77, 80, 81, 82, 83, 84, 85, 88, 89, 91, 92, 96, 99, 100, 102, 103, 104, 105, 106, 107, 109, 110, 112, 115, 117, 118, 120, 121, 122, 123, 124, 127, 130, 132, 134, 135, 136, 139, 140, 141, 142, 143, 144, 145, 147, 148, 149, 150, 152, 153, 154, 156, 158, 161, 162, 164, 165, 168, 169, 171, 172, 173, 174, 175, 176, 180, 181, 183, 185, 187, 189, 192, 193, 194, 195, 198]"
Olaf,L0,short,125,58,67,13,0.375,200,"[0, 3, 4, 5, 6, 7, 8, 9, 12, 13, 16, 20, 21, 22, 23, 26, 27, 28, 31, 32, 34, 37, 40, 41, 43, 44, 46, 47, 48, 50, 54, 56, 57, 58, 60, 62, 63, 64, 65, 67, 68, 71, 73, 74, 75, 76, 77, 78, 79, 80, 81, 82, 83, 86, 88, 89, 90, 91, 92, 93, 94, 95, 96, 97, 99, 101, 102, 105, 106, 108, 110, 112, 114, 116, 118, 119, 120, 122, 123, 126, 129, 130, 131, 132, 134, 136, 137, 138, 139, 141, 142, 143, 144, 145, 146, 147, 149, 150, 154, 155, 158, 160, 163, 165, 169, 170, 171, 172, 173, 174, 175, 177, 178, 180, 183, 186, 187, 189, 191, 192, 193, 195, 196, 197, 199]"
Olaf,L0,short,140,83,57,9,0.3,200,"[0, 1, 2, 4, 5, 7, 8, 10, 11, 13, 15, 20, 21, 22, 23, 24, 25, 26, 27, 28, 29, 31, 32, 33, 34, 36, 38, 39, 40, 41, 42, 45, 47, 48, 49, 50, 53, 54, 55, 56, 58, 59, 60, 62, 64, 65, 66, 68, 69, 70, 71, 72, 73, 74, 76, 77, 78, 79, 81, 82, 84, 85, 86, 87, 88, 90, 91, 92, 93, 94, 95, 97, 98, 99, 100, 103, 104, 105, 106, 107, 108, 109, 110, 111, 112, 113, 114, 116, 122, 123, 124, 125, 126, 129, 130, 132, 133, 134, 135, 136, 137, 138, 141, 143, 145, 148, 149, 150, 151, 152, 156, 157, 158, 159, 161, 162, 163, 166, 167, 169, 170, 171, 172, 173, 175, 176, 178, 181, 183, 185, 186, 187, 188, 189, 190, 191, 193, 194, 196, 197]"
Olaf,L0,short,121,68,53,17,0.395,200,"[1, 2, 3, 8, 9, 12, 15, 16, 18, 19, 20, 21, 23, 24, 26, 27, 28, 29, 30, 31, 32, 33, 35, 36, 38, 39, 41, 42, 44, 45, 47, 51, 53, 54, 57, 59, 60, 61, 64, 65, 67, 70, 71, 74, 77, 78, 79, 80, 81, 82, 83, 84, 86, 87, 90, 91, 94, 95, 97, 100, 101, 102, 104, 105, 108, 109, 110, 111, 112, 114, 116, 117, 118, 122, 124, 125, 126, 127, 128, 130, 133, 135, 137, 139, 140, 141, 142, 143, 145, 146, 147, 148, 150, 151, 153, 154, 157, 160, 161, 162, 163, 168, 170, 172, 173, 174, 175, 177, 179, 180, 182, 184, 185, 187, 188, 189, 190, 194, 197, 198, 199]"
Olaf,L0,short,132,73,59,12,0.34,200,"[0, 6, 7, 8, 10, 11, 12, 14, 15, 16, 17, 18, 19, 20, 21, 23, 26, 31, 32, 33, 35, 36, 37, 38, 39, 40, 41, 42, 44, 47, 50, 52, 53, 58, 60, 63, 64, 65, 66, 68, 69, 70, 71, 72, 74, 75, 76, 78, 81, 82, 83, 84, 88, 89, 90, 92, 93, 94, 95, 96, 97, 99, 101, 102, 104, 107, 108, 110, 112, 113, 114, 115, 116, 117, 119, 120, 121, 122, 123, 124, 125, 126, 128, 129, 130, 132, 133, 134, 135, 138, 140, 141, 142, 144, 145, 146, 147, 148, 149, 150, 152, 153, 154, 156, 157, 158, 159, 160, 161, 162, 164, 166, 167, 169, 170, 172, 173, 174, 179, 180, 181, 182, 183, 184, 186, 187, 189, 192, 195, 197, 198, 199]"
Olaf,L0,short,149,67,82,6,0.255,200,"[0, 2, 3, 4, 5, 6, 7, 8, 10, 12, 13, 14, 15, 16, 17, 18, 21, 23, 25, 27, 28, 29, 30, 32, 33, 34, 36, 39, 40, 43, 45, 46, 48, 49, 50, 51, 52, 53, 54, 55, 58, 59, 60, 64, 66, 67, 68, 69, 70, 71, 72, 73, 74, 75, 77, 78, 80, 81, 83, 84, 86, 87, 88, 89, 90, 91, 92, 94, 95, 96, 97, 98, 99, 100, 101, 103, 104, 105, 106, 107, 108, 109, 111, 112, 115, 116, 117, 119, 120, 121, 122, 124, 125, 126, 128, 129, 130, 131, 132, 133, 135, 136, 137, 138, 139, 140, 142, 144, 145, 146, 147, 148, 150, 152, 153, 154, 157, 160, 161, 162, 163, 164, 167, 169, 170, 171, 172, 173, 174, 175, 177, 178, 179, 180, 181, 183, 184, 185, 186, 187, 188, 189, 190, 192, 193, 194, 195, 198, 199]"
Olaf,L0,short,132,84,48,8,0.34,200,"[0, 2, 3, 4, 5, 6, 10, 11, 12, 13, 14, 15, 17, 18, 20, 22, 23, 24, 27, 28, 31, 32, 33, 34, 36, 38, 40, 41, 43, 44, 45, 48, 49, 52, 53, 54, 56, 57, 58, 59, 62, 63, 64, 65, 67, 69, 70, 71, 74, 75, 76, 78, 79, 80, 82, 83, 84, 86, 87, 91, 92, 94, 95, 96, 98, 100, 102, 103, 104, 105, 106, 107, 108, 109, 111, 112, 113, 116, 118, 119, 121, 122, 123, 125, 128, 134, 135, 136, 139, 140, 141, 143, 144, 145, 146, 147, 149, 150, 152, 153, 154, 155, 156, 157, 158, 159, 163, 164, 165, 166, 167, 168, 172, 173, 174, 175, 176, 179, 180, 181, 183, 184, 185, 187, 188, 190, 191, 192, 193, 197, 198, 199]"
Olaf,L0,short,137,65,72,11,0.315,200,"[0, 2, 4, 5, 6, 7, 8, 10, 12, 13, 14, 15, 17, 18, 19, 21, 22, 24, 27, 28, 30, 31, 32, 34, 35, 36, 37, 38, 39, 40, 41, 42, 44, 45, 46, 48, 49, 50, 51, 52, 53, 54, 56, 57, 59, 60, 62, 63, 67, 68, 71, 72, 73, 74, 76, 77, 78, 79, 80, 81, 82, 84, 85, 87, 89, 90, 92, 94, 95, 96, 97, 98, 101, 103, 104, 105, 106, 107, 109, 110, 111, 112, 113, 117, 118, 120, 124, 125, 127, 128, 131, 132, 133, 134, 135, 136, 137, 138, 139, 141, 142, 144, 146, 147, 149, 152, 154, 156, 158, 159, 160, 161, 163, 164, 165, 168, 173, 174, 175, 176, 177, 178, 179, 180, 181, 182, 183, 184, 185, 186, 188, 191, 192, 193, 195, 196, 199]"
Olaf,L0,short,137,82,55,9,0.315,200,"[0, 1, 2, 4, 5, 7, 9, 10, 11, 12, 13, 15, 17, 19, 20, 22, 24, 25, 26, 27, 28, 29, 30, 31, 32, 33, 34, 35, 36, 37, 38, 40, 43, 44, 45, 46, 48, 49, 50, 51, 52, 53, 54, 56, 57, 61, 63, 68, 70, 71, 73, 74, 75, 76, 77, 80, 81, 82, 83, 85, 88, 89, 90, 91, 92, 93, 94, 95, 96, 97, 98, 101, 103, 104, 106, 109, 110, 113, 114, 115, 116, 118, 119, 120, 121, 122, 124, 125, 127, 129, 131, 132, 133, 134, 136, 137, 138, 139, 140, 141, 142, 143, 145, 146, 147, 148, 150, 152, 153, 154, 155, 156, 157, 158, 160, 162, 163, 165, 167, 168, 169, 171, 174, 175, 177, 179, 183, 185, 187, 189, 192, 193, 195, 196, 197, 198, 199]"
Olaf,L0,short,130,73,57,11,0.35,200,"[0, 1, 2, 3, 6, 9, 10, 11, 12, 13, 14, 15, 16, 17, 19, 23, 24, 25, 27, 28, 30, 35, 38, 41, 42, 43, 44, 45, 48, 50, 51, 52, 53, 54, 55, 57, 58, 60, 61, 62, 63, 65, 66, 67, 68, 69, 71, 73, 74, 75, 78, 79, 80, 82, 83, 84, 85, 86, 87, 88, 89, 91, 93, 94, 96, 97, 98, 101, 103, 105, 107, 110, 111, 113, 114, 115, 119, 120, 121, 123, 124, 125, 126, 127, 129, 132, 133, 134, 136, 138, 140, 143, 145, 146, 147, 148, 149, 150, 151, 153, 154, 155, 156, 157, 158, 159, 160, 161, 163, 165, 168, 169, 170, 171, 172, 173, 174, 175, 177, 178, 179, 182, 184, 185, 186, 187, 191, 192, 197, 199]"
Olaf,L0,short,121,56,65,14,0.395,200,"[0, 3, 4, 6, 8, 9, 13, 14, 15, 16, 17, 18, 20, 22, 23, 25, 26, 27, 28, 29, 30, 32, 34, 35, 36, 37, 38, 39, 40, 41, 42, 43, 44, 46, 51, 53, 54, 59, 62, 64, 65, 67, 68, 69, 71, 75, 77, 78, 82, 84, 85, 86, 91, 93, 94, 95, 96, 97, 98, 100, 101, 104, 107, 108, 110, 111, 112, 114, 115, 117, 119, 120, 122, 123, 124, 125, 126, 127, 129, 130, 131, 132, 135, 136, 139, 140, 141, 142, 143, 144, 146, 147, 149, 150, 152, 154, 156, 157, 158, 159, 161, 162, 164, 165, 166, 167, 169, 170, 173, 174, 175, 180, 182, 183, 184, 186, 188, 190, 194, 196, 197]"
Olaf,L0,short,139,44,95,3,0.305,200,"[3, 7, 8, 10, 11, 12, 15, 17, 18, 19, 20, 22, 24, 25, 26, 27, 28, 30, 32, 34, 35, 36, 38, 39, 41, 42, 43, 45, 46, 49, 50, 51, 52, 54, 55, 57, 58, 59, 60, 61, 62, 63, 64, 66, 69, 70, 71, 72, 73, 74, 75, 76, 78, 80, 81, 82, 83, 84, 85, 87, 89, 91, 92, 94, 98, 99, 101, 102, 104, 105, 108, 109, 110, 111, 112, 113, 114, 115, 116, 117, 118, 120, 121, 122, 125, 126, 127, 129, 130, 131, 133, 135, 137, 139, 140, 141, 142, 143, 144, 145, 146, 147, 148, 149, 150, 152, 153, 154, 155, 156, 157, 161, 162, 163, 164, 165, 166, 169, 172, 173, 174, 175, 177, 179, 180, 183, 184, 185, 186, 187, 189, 190, 191, 193, 194, 195, 196, 198, 199]"
Olaf,L0,short,134,68,66,8,0.33,200,"[0, 1, 2, 3, 4, 5, 6, 7, 9, 10, 12, 13, 15, 16, 17, 18, 19, 20, 21, 23, 24, 25, 26, 28, 29, 30, 31, 33, 34, 38, 39, 41, 42, 44, 45, 46, 47, 48, 49, 50, 51, 54, 55, 56, 58, 59, 60, 62, 64, 65, 66, 67, 68, 69, 70, 73, 74, 76, 77, 80, 81, 83, 84, 85, 88, 89, 91, 92, 93, 94, 96, 97, 102, 103, 104, 105, 107, 109, 111, 112, 113, 114, 116, 117, 121, 122, 124, 125, 126, 128, 129, 130, 131, 132, 135, 138, 139, 141, 146, 147, 150, 151, 152, 153, 154, 155, 159, 160, 161, 163, 164, 167, 168, 169, 170, 171, 172, 173, 174, 175, 177, 180, 182, 184, 185, 186, 188, 190, 191, 192, 193, 194, 196, 198]"
Olaf,L0,short,133,67,66,15,0.335,200,"[2, 5, 7, 8, 10, 11, 12, 13, 14, 17, 18, 20, 21, 24, 25, 28, 29, 30, 31, 33, 34, 35, 36, 37, 38, 39, 40, 44, 45, 46, 47, 48, 50, 51, 52, 55, 57, 58, 61, 62, 63, 64, 65, 66, 67, 68, 69, 71, 72, 73, 76, 77, 78, 79, 80, 83, 84, 85, 87, 89, 90, 91, 93, 94, 95, 96, 98, 102, 103, 105, 106, 107, 110, 111, 112, 114, 115, 116, 118, 119, 120, 121, 122, 124, 125, 126, 127, 128, 129, 130, 131, 133, 134, 135, 136, 140, 142, 145, 147, 149, 151, 153, 154, 155, 160, 163, 166, 167, 168, 169, 170, 172, 173, 174, 176, 178, 179, 180, 182, 183, 184, 185, 186, 187, 188, 190, 191, 193, 195, 196, 197, 198, 199]"
Olaf,L0,short,136,63,73,9,0.32,200,"[1, 4, 5, 6, 7, 9, 10, 11, 12, 13, 14, 17, 20, 22, 25, 27, 28, 29, 30, 33, 34, 35, 38, 40, 41, 43, 45, 48, 49, 51, 52, 53, 55, 56, 57, 58, 59, 60, 63, 67, 68, 69, 71, 73, 74, 75, 76, 78, 79, 83, 85, 86, 87, 88, 89, 91, 92, 94, 95, 96, 98, 99, 100, 102, 103, 104, 106, 107, 108, 110, 112, 113, 115, 116, 117, 118, 119, 120, 122, 123, 124, 125, 127, 128, 129, 131, 132, 134, 135, 136, 137, 138, 139, 141, 143, 146, 147, 148, 149, 151, 152, 153, 154, 155, 156, 157, 158, 160, 163, 164, 165, 166, 167, 171, 173, 174, 175, 176, 177, 178, 179, 182, 183, 184, 185, 186, 187, 188, 189, 191, 192, 195, 196, 197, 198, 199]"
Olaf,L0,short,129,67,62,6,0.355,200,"[0, 1, 3, 4, 5, 6, 7, 8, 10, 11, 12, 15, 16, 19, 20, 21, 22, 23, 27, 29, 32, 33, 34, 35, 36, 38, 39, 40, 41, 42, 45, 46, 47, 48, 51, 52, 54, 55, 57, 61, 62, 63, 64, 65, 66, 68, 72, 74, 77, 78, 80, 82, 83, 85, 86, 90, 91, 92, 93, 95, 96, 97, 98, 99, 100, 101, 102, 103, 104, 105, 106, 107, 108, 109, 110, 111, 112, 113, 115, 117, 118, 119, 120, 121, 123, 126, 127, 134, 135, 137, 138, 139, 140, 144, 146, 147, 148, 150, 151, 152, 154, 155, 156, 161, 163, 164, 165, 166, 167, 170, 171, 172, 174, 175, 176, 179, 180, 181, 182, 183, 187, 191, 192, 194, 195, 196, 197, 198, 199]"
Olaf,L0,short,144,50,94,8,0.28,200,"[0, 3, 4, 5, 6, 8, 9, 10, 13, 15, 16, 17, 18, 24, 26, 29, 30, 31, 32, 34, 35, 36, 37, 38, 39, 40, 42, 43, 44, 45, 46, 47, 50, 51, 52, 53, 55, 56, 58, 59, 61, 63, 64, 66, 67, 68, 70, 71, 73, 74, 75, 76, 77, 78, 79, 80, 82, 84, 85, 86, 88, 89, 91, 93, 95, 96, 97, 98, 99, 100, 101, 102, 103, 104, 105, 106, 109, 110, 112, 113, 114, 115, 116, 117, 118, 119, 120, 121, 122, 124, 125, 126, 127, 128, 129, 130, 131, 132, 133, 134, 135, 136, 137, 138, 139, 140, 142, 143, 144, 147, 150, 151, 152, 153, 154, 155, 156, 159, 161, 162, 164, 165, 166, 167, 168, 169, 171, 173, 174, 175, 176, 177, 178, 179, 181, 182, 183, 186, 189, 191, 193, 194, 198, 199]"
Olaf,L0,short,131,83,48,17,0.345,200,"[0, 2, 4, 5, 6, 10, 11, 12, 13, 14, 15, 16, 17, 18, 19, 20, 21, 22, 24, 26, 27, 28, 29, 30, 31, 32, 33, 34, 35, 37, 38, 40, 41, 42, 43, 44, 46, 47, 49, 51, 53, 55, 56, 58, 59, 60, 61, 62, 64, 66, 67, 71, 72, 74, 75, 76, 79, 80, 82, 83, 84, 86, 88, 91, 93, 94, 95, 97, 98, 99, 102, 103, 104, 105, 106, 107, 109, 110, 113, 117, 119, 121, 123, 124, 125, 126, 133, 134, 135, 136, 137, 138, 140, 141, 146, 147, 148, 149, 150, 151, 154, 157, 158, 159, 160, 161, 167, 168, 169, 170, 171, 172, 173, 174, 175, 176, 177, 178, 180, 181, 182, 183, 184, 186, 187, 188, 190, 192, 193, 194, 199]"
Olaf,L0,short,126,71,55,12,0.37,200,"[0, 1, 2, 4, 6, 7, 8, 9, 10, 11, 12, 18, 20, 23, 26, 27, 29, 30, 31, 33, 36, 38, 40, 44, 46, 47, 48, 49, 51, 52, 53, 54, 55, 56, 57, 58, 59, 60, 63, 64, 68, 69, 70, 72, 74, 75, 77, 79, 80, 86, 87, 88, 89, 90, 92, 93, 94, 96, 97, 99, 100, 102, 103, 107, 108, 109, 110, 111, 112, 118, 122, 123, 124, 125, 126, 127, 129, 131, 132, 133, 134, 136, 137, 138, 139, 140, 141, 142, 143, 145, 146, 148, 149, 150, 151, 153, 154, 157, 158, 159, 161, 162, 163, 165, 166, 167, 168, 171, 172, 175, 176, 177, 178, 185, 186, 187, 188, 189, 190, 191, 192, 193, 194, 195, 197, 198]"
Olaf,L0,short,137,71,66,8,0.315,200,"[0, 1, 3, 5, 6, 8, 9, 10, 12, 13, 15, 16, 18, 21, 22, 23, 24, 26, 27, 28, 29, 30, 31, 33, 37, 38, 39, 40, 43, 44, 45, 47, 48, 49, 50, 51, 52, 53, 54, 55, 56, 58, 59, 60, 61, 62, 63, 66, 68, 69, 73, 75, 76, 78, 79, 80, 82, 83, 84, 85, 86, 87, 88, 89, 90, 91, 93, 94, 95, 97, 99, 100, 101, 103, 105, 106, 107, 108, 109, 110, 111, 112, 113, 114, 117, 120, 121, 122, 123, 124, 125, 126, 127, 128, 129, 130, 131, 132, 136, 139, 140, 143, 144, 145, 147, 148, 152, 153, 155, 156, 157, 158, 159, 161, 163, 167, 168, 169, 170, 171, 172, 173, 174, 176, 177, 178, 180, 181, 185, 188, 189, 192, 193, 194, 195, 196, 197]"
Olaf,L0,short,132,75,57,14,0.34,200,"[0, 1, 2, 3, 5, 6, 7, 8, 9, 11, 12, 14, 15, 16, 17, 19, 21, 22, 24, 25, 26, 28, 30, 32, 34, 35, 36, 37, 39, 41, 42, 43, 45, 46, 47, 48, 51, 52, 54, 56, 57, 59, 61, 63, 65, 66, 67, 68, 69, 71, 72, 73, 74, 77, 78, 81, 82, 83, 84, 85, 86, 90, 92, 93, 94, 96, 98, 99, 100, 102, 106, 107, 108, 109, 113, 114, 115, 116, 117, 119, 120, 121, 122, 123, 126, 127, 128, 129, 131, 133, 134, 135, 136, 137, 138, 139, 140, 142, 144, 146, 148, 149, 150, 151, 153, 157, 158, 159, 161, 163, 164, 165, 168, 170, 172, 173, 175, 176, 177, 179, 180, 182, 184, 187, 188, 189, 190, 191, 193, 195, 197, 198]"
Olaf,L0,short,136,82,54,7,0.32,200,"[0, 1, 2, 4, 5, 6, 7, 9, 10, 11, 12, 13, 16, 18, 19, 22, 23, 24, 25, 26, 27, 28, 29, 30, 32, 33, 34, 35, 36, 37, 38, 39, 40, 41, 42, 43, 44, 45, 46, 47, 49, 50, 51, 52, 54, 56, 58, 59, 60, 61, 62, 63, 64, 65, 66, 68, 69, 71, 72, 73, 74, 77, 78, 79, 82, 83, 85, 91, 93, 94, 96, 99, 100, 101, 102, 104, 105, 106, 108, 112, 113, 114, 115, 116, 120, 123, 124, 125, 127, 128, 129, 133, 135, 136, 138, 139, 140, 141, 142, 143, 145, 146, 147, 148, 149, 150, 151, 153, 154, 157, 159, 161, 162, 163, 164, 165, 166, 170, 173, 174, 175, 177, 180, 181, 182, 183, 184, 187, 188, 189, 191, 193, 194, 195, 197, 199]"
Olaf,L0,short,138,66,72,12,0.31,200,"[0, 2, 3, 5, 7, 10, 11, 12, 13, 14, 16, 17, 18, 19, 20, 21, 22, 23, 24, 25, 26, 27, 28, 29, 31, 34, 40, 41, 44, 45, 46, 47, 48, 49, 50, 53, 54, 55, 57, 59, 60, 61, 62, 67, 68, 69, 72, 73, 75, 76, 78, 80, 81, 82, 84, 85, 86, 87, 88, 89, 91, 92, 93, 96, 97, 98, 99, 100, 102, 103, 104, 105, 107, 109, 111, 112, 114, 115, 116, 117, 118, 119, 120, 121, 122, 125, 127, 128, 129, 130, 131, 132, 133, 134, 136, 138, 139, 140, 141, 142, 143, 145, 146, 147, 148, 149, 151, 152, 153, 156, 157, 158, 159, 161, 162, 164, 165, 167, 168, 169, 172, 173, 174, 176, 177, 178, 181, 182, 184, 185, 186, 188, 191, 192, 193, 194, 195, 196]"
Olaf,L0,short,129,66,63,12,0.355,200,"[0, 1, 3, 4, 5, 6, 7, 10, 12, 15, 19, 21, 22, 23, 24, 26, 27, 28, 29, 36, 38, 39, 41, 42, 44, 45, 46, 47, 48, 50, 55, 56, 57, 59, 61, 62, 64, 65, 66, 69, 70, 71, 72, 74, 75, 78, 80, 81, 83, 86, 87, 88, 89, 90, 92, 93, 95, 96, 97, 100, 101, 102, 103, 104, 105, 107, 109, 110, 112, 113, 114, 116, 118, 120, 122, 123, 124, 125, 126, 128, 129, 130, 132, 133, 134, 135, 136, 139, 141, 142, 143, 144, 145, 146, 147, 149, 151, 152, 154, 155, 157, 159, 161, 163, 166, 167, 169, 171, 172, 173, 174, 175, 177, 178, 179, 181, 182, 183, 184, 185, 186, 187, 188, 190, 194, 195, 197, 198, 199]"
Olaf,L0,short,127,78,49,12,0.365,200,"[0, 3, 4, 9, 10, 11, 12, 14, 15, 17, 18, 19, 21, 22, 24, 25, 26, 28, 29, 34, 35, 38, 39, 40, 41, 42, 43, 44, 46, 47, 49, 52, 56, 57, 61, 62, 64, 67, 68, 70, 72, 74, 77, 78, 80, 82, 83, 84, 85, 86, 88, 89, 91, 93, 94, 95, 96, 97, 98, 99, 100, 101, 102, 103, 104, 105, 107, 108, 109, 110, 111, 112, 114, 116, 118, 119, 120, 121, 126, 127, 128, 129, 130, 131, 132, 133, 134, 137, 138, 143, 144, 146, 148, 149, 151, 152, 153, 154, 155, 159, 161, 163, 164, 165, 167, 168, 169, 170, 173, 174, 175, 178, 179, 183, 185, 186, 187, 188, 190, 191, 192, 194, 195, 196, 197, 198, 199]"
Olaf,L0,short,139,71,68,7,0.305,200,"[0, 1, 2, 3, 6, 8, 9, 11, 12, 14, 15, 17, 18, 20, 22, 23, 24, 26, 27, 28, 30, 31, 32, 33, 35, 36, 37, 38, 39, 45, 46, 50, 51, 52, 53, 55, 56, 58, 59, 60, 61, 64, 65, 66, 69, 70, 71, 72, 73, 75, 76, 77, 78, 79, 80, 81, 82, 83, 84, 86, 88, 89, 90, 92, 93, 94, 96, 97, 101, 103, 104, 105, 106, 107, 108, 109, 110, 112, 115, 116, 118, 119, 120, 122, 125, 126, 127, 128, 129, 130, 131, 135, 136, 137, 139, 140, 141, 142, 143, 145, 146, 147, 149, 150, 152, 153, 154, 155, 156, 157, 158, 159, 160, 161, 162, 164, 165, 167, 169, 170, 172, 173, 174, 176, 177, 180, 181, 182, 183, 184, 185, 187, 190, 192, 193, 194, 195, 196, 199]"
Olaf,L0,short,130,60,70,11,0.35,200,"[0, 2, 3, 7, 8, 9, 11, 13, 14, 15, 16, 17, 21, 22, 23, 25, 26, 28, 29, 32, 34, 35, 36, 37, 38, 39, 40, 42, 43, 44, 45, 46, 48, 49, 50, 51, 53, 54, 55, 56, 58, 60, 61, 62, 68, 70, 71, 73, 74, 75, 76, 77, 78, 79, 82, 83, 84, 86, 87, 88, 90, 94, 95, 97, 99, 100, 103, 105, 106, 107, 110, 111, 113, 114, 115, 119, 120, 121, 122, 124, 126, 128, 129, 130, 131, 132, 134, 135, 136, 137, 139, 141, 142, 143, 147, 148, 149, 150, 153, 154, 155, 156, 157, 158, 159, 160, 161, 164, 165, 167, 168, 171, 172, 175, 177, 178, 179, 180, 181, 182, 183, 185, 186, 188, 191, 192, 194, 195, 197, 199]"
Olaf,L0,short,131,68,63,9,0.345,200,"[1, 2, 6, 7, 9, 13, 14, 15, 16, 17, 19, 20, 21, 23, 25, 26, 27, 29, 30, 32, 34, 35, 38, 39, 40, 41, 42, 43, 44, 45, 46, 48, 49, 50, 52, 54, 58, 59, 60, 62, 63, 64, 65, 66, 68, 69, 70, 71, 73, 75, 79, 80, 82, 83, 84, 86, 90, 93, 94, 95, 96, 97, 98, 99, 100, 101, 102, 103, 104, 105, 106, 107, 108, 109, 110, 111, 114, 115, 117, 118, 120, 123, 124, 125, 126, 128, 129, 130, 133, 135, 137, 138, 139, 141, 142, 143, 146, 147, 148, 149, 151, 152, 156, 157, 158, 160, 162, 163, 164, 166, 168, 169, 170, 171, 172, 174, 176, 178, 179, 182, 183, 184, 185, 186, 187, 188, 189, 190, 191, 193, 199]"
Olaf,L0,short,135,57,78,15,0.325,200,"[1, 3, 4, 5, 7, 10, 16, 17, 18, 22, 23, 24, 26, 28, 29, 31, 33, 35, 36, 37, 38, 39, 40, 43, 48, 50, 51, 53, 55, 56, 57, 58, 59, 60, 61, 64, 65, 66, 67, 68, 69, 73, 74, 75, 76, 77, 78, 79, 80, 81, 83, 85, 86, 87, 88, 90, 91, 92, 94, 95, 96, 99, 100, 101, 102, 103, 104, 105, 106, 109, 111, 112, 113, 114, 115, 118, 119, 120, 124, 127, 128, 130, 132, 133, 135, 136, 137, 138, 139, 140, 141, 142, 143, 145, 147, 148, 151, 152, 153, 154, 157, 158, 161, 162, 163, 164, 167, 168, 169, 170, 171, 174, 175, 176, 177, 178, 179, 180, 181, 182, 183, 184, 185, 186, 187, 188, 189, 191, 192, 193, 194, 195, 196, 198, 199]"
Olaf,L0,short,130,65,65,8,0.35,200,"[1, 3, 5, 6, 7, 10, 11, 13, 14, 15, 17, 18, 19, 20, 21, 23, 24, 25, 26, 27, 29, 31, 35, 36, 37, 39, 41, 43, 44, 45, 46, 50, 51, 52, 54, 55, 57, 58, 60, 61, 62, 63, 64, 65, 66, 67, 68, 69, 70, 71, 74, 78, 79, 81, 82, 83, 84, 86, 87, 88, 89, 92, 93, 95, 97, 98, 99, 101, 102, 103, 105, 106, 108, 110, 111, 112, 113, 117, 119, 120, 121, 122, 128, 129, 132, 133, 136, 138, 139, 141, 142, 143, 145, 148, 149, 150, 151, 152, 153, 154, 155, 157, 158, 159, 160, 161, 162, 163, 167, 168, 170, 171, 172, 173, 176, 177, 178, 179, 180, 181, 183, 184, 185, 187, 188, 189, 191, 193, 194, 197]"
Olaf,L0,short,141,83,58,11,0.295,200,"[0, 1, 4, 5, 6, 7, 8, 9, 10, 11, 13, 15, 17, 19, 21, 23, 24, 25, 26, 28, 29, 31, 32, 34, 37, 38, 39, 40, 41, 43, 44, 47, 48, 49, 50, 51, 53, 55, 56, 57, 58, 59, 60, 63, 64, 65, 66, 67, 68, 69, 70, 71, 72, 73, 75, 77, 78, 80, 82, 83, 85, 86, 88, 89, 90, 91, 92, 93, 96, 97, 98, 101, 102, 103, 104, 105, 107, 108, 109, 111, 113, 114, 115, 116, 118, 119, 120, 121, 124, 125, 126, 127, 129, 130, 131, 132, 133, 134, 135, 136, 139, 142, 143, 144, 145, 146, 147, 148, 149, 150, 151, 153, 155, 156, 159, 162, 163, 164, 165, 169, 171, 172, 174, 175, 176, 177, 178, 179, 180, 181, 183, 184, 186, 189, 191, 192, 193, 194, 197, 198, 199]"
Olaf,L0,short,127,51,76,10,0.365,200,"[3, 4, 5, 6, 11, 12, 13, 14, 15, 16, 17, 18, 21, 22, 23, 24, 26, 28, 29, 30, 31, 33, 34, 37, 38, 39, 42, 43, 45, 47, 49, 51, 52, 53, 56, 58, 59, 60, 61, 62, 64, 65, 67, 68, 69, 71, 72, 74, 77, 80, 81, 83, 84, 88, 89, 90, 91, 92, 94, 96, 97, 98, 99, 100, 102, 103, 104, 105, 107, 109, 110, 112, 115, 118, 119, 121, 123, 124, 127, 132, 133, 135, 136, 137, 139, 144, 145, 146, 147, 149, 150, 152, 154, 155, 157, 158, 159, 160, 162, 163, 165, 166, 168, 170, 171, 172, 173, 174, 175, 177, 178, 181, 182, 183, 185, 186, 187, 188, 189, 191, 192, 193, 194, 195, 197, 198, 199]"
Olaf,L0,short,132,69,63,6,0.34,200,"[1, 2, 3, 4, 5, 7, 8, 9, 10, 17, 18, 22, 23, 24, 25, 26, 27, 28, 30, 31, 33, 34, 35, 36, 37, 39, 41, 42, 45, 46, 48, 49, 50, 51, 52, 54, 56, 57, 58, 59, 61, 62, 64, 65, 66, 67, 68, 69, 70, 71, 74, 75, 76, 79, 80, 83, 84, 86, 87, 88, 93, 95, 97, 98, 99, 101, 102, 103, 105, 108, 109, 110, 111, 112, 113, 114, 115, 116, 117, 118, 119, 123, 124, 125, 127, 128, 129, 131, 132, 135, 136, 137, 140, 141, 142, 144, 145, 146, 147, 148, 149, 150, 152, 155, 156, 161, 162, 163, 165, 166, 169, 171, 172, 173, 175, 176, 177, 178, 180, 182, 183, 185, 187, 189, 191, 192, 194, 195, 196, 197, 198, 199]"
Olaf,L0,short,140,65,75,5,0.3,200,"[0, 1, 2, 3, 4, 6, 7, 8, 12, 13, 15, 18, 19, 20, 21, 25, 27, 28, 33, 34, 35, 36, 37, 38, 41, 42, 43, 44, 45, 46, 49, 50, 54, 56, 57, 58, 59, 60, 61, 63, 64, 65, 67, 68, 70, 71, 73, 74, 75, 77, 78, 80, 83, 86, 87, 88, 90, 91, 92, 93, 97, 98, 99, 100, 101, 102, 103, 104, 106, 108, 109, 110, 111, 112, 113, 115, 118, 119, 120, 121, 122, 123, 124, 128, 129, 130, 131, 132, 133, 135, 136, 139, 140, 141, 143, 144, 145, 146, 148, 151, 152, 153, 154, 156, 158, 159, 160, 161, 162, 163, 164, 166, 167, 168, 169, 170, 171, 172, 173, 174, 176, 180, 181, 182, 183, 184, 185, 186, 187, 188, 189, 191, 192, 193, 194, 195, 196, 197, 198, 199]"
Olaf,L0,short,139,78,61,7,0.305,200,"[1, 2, 3, 4, 5, 7, 8, 9, 13, 14, 17, 25, 26, 27, 28, 30, 31, 32, 34, 35, 36, 37, 38, 39, 40, 41, 42, 43, 44, 45, 46, 49, 50, 51, 53, 55, 59, 60, 61, 62, 63, 64, 65, 67, 68, 70, 72, 73, 74, 75, 76, 77, 80, 81, 83, 84, 85, 86, 87, 88, 92, 94, 95, 96, 97, 98, 99, 100, 102, 103, 104, 105, 106, 108, 109, 110, 111, 112, 113, 115, 117, 120, 121, 122, 123, 124, 125, 126, 127, 128, 129, 130, 132, 134, 135, 136, 137, 138, 141, 142, 144, 146, 148, 149, 150, 151, 154, 155, 156, 157, 158, 159, 160, 161, 162, 163, 164, 166, 167, 168, 169, 170, 171, 172, 173, 174, 179, 180, 181, 183, 186, 187, 189, 190, 192, 194, 195, 196, 198]"
Olaf,L0,short,139,94,45,6,0.305,200,"[0, 1, 2, 5, 9, 10, 11, 15, 16, 17, 18, 20, 21, 22, 23, 24, 26, 27, 28, 29, 30, 31, 33, 35, 36, 39, 40, 43, 44, 45, 46, 47, 48, 49, 50, 53, 55, 56, 57, 58, 59, 62, 63, 65, 67, 68, 69, 71, 72, 73, 74, 75, 77, 78, 80, 81, 82, 85, 86, 87, 88, 89, 91, 93, 95, 96, 99, 100, 104, 105, 106, 107, 108, 109, 114, 115, 116, 117, 118, 120, 121, 122, 123, 124, 126, 128, 129, 131, 132, 133, 134, 135, 138, 140, 141, 142, 143, 144, 145, 149, 152, 155, 156, 159, 160, 161, 162, 163, 164, 166, 167, 168, 169, 170, 171, 172, 173, 174, 175, 176, 177, 178, 179, 180, 182, 183, 185, 186, 187, 188, 190, 191, 192, 193, 195, 196, 197, 198, 199]"
Olaf,L0,short,126,63,63,13,0.37,200,"[3, 7, 10, 12, 13, 14, 15, 18, 19, 20, 22, 23, 24, 27, 28, 29, 30, 31, 35, 36, 38, 40, 41, 42, 43, 44, 46, 47, 48, 49, 50, 51, 52, 54, 55, 56, 59, 60, 61, 64, 66, 67, 70, 71, 72, 73, 74, 75, 78, 80, 81, 82, 83, 84, 91, 92, 93, 94, 96, 98, 99, 100, 102, 103, 106, 107, 108, 109, 110, 112, 113, 117, 119, 120, 123, 126, 130, 132, 134, 136, 137, 138, 140, 141, 142, 143, 144, 145, 148, 150, 151, 152, 154, 155, 156, 159, 160, 163, 165, 166, 167, 169, 170, 171, 172, 173, 174, 175, 176, 177, 178, 179, 181, 182, 183, 186, 187, 188, 189, 191, 193, 194, 195, 196, 198, 199]"
Olaf,L0,short,137,63,74,8,0.315,200,"[0, 2, 3, 4, 5, 7, 9, 11, 12, 13, 14, 15, 16, 18, 19, 20, 21, 22, 23, 24, 27, 29, 35, 36, 37, 38, 39, 41, 42, 43, 44, 45, 47, 49, 50, 51, 52, 53, 55, 57, 58, 59, 60, 61, 63, 64, 66, 67, 68, 69, 70, 71, 73, 74, 76, 79, 81, 82, 84, 85, 86, 87, 88, 90, 91, 92, 93, 95, 98, 99, 101, 102, 103, 104, 105, 106, 108, 109, 111, 112, 114, 116, 117, 118, 119, 120, 121, 124, 125, 126, 127, 129, 130, 131, 132, 133, 134, 135, 136, 137, 138, 141, 142, 145, 146, 149, 150, 152, 153, 155, 156, 160, 161, 163, 164, 165, 166, 167, 168, 171, 172, 173, 175, 178, 182, 183, 184, 185, 187, 188, 191, 193, 194, 195, 196, 197, 198]"
Olaf,L0,short,131,60,71,9,0.345,200,"[0, 2, 3, 4, 5, 6, 9, 10, 12, 13, 14, 15, 16, 17, 20, 21, 22, 23, 24, 26, 27, 28, 29, 30, 33, 36, 39, 40, 41, 43, 45, 47, 48, 49, 50, 52, 55, 56, 58, 59, 60, 61, 62, 63, 64, 66, 68, 70, 73, 75, 76, 77, 79, 80, 82, 83, 86, 88, 89, 90, 91, 92, 93, 94, 98, 99, 100, 102, 103, 104, 105, 106, 107, 108, 109, 110, 111, 113, 114, 117, 118, 120, 121, 123, 124, 126, 127, 129, 137, 138, 139, 140, 142, 145, 146, 147, 148, 149, 152, 153, 154, 155, 156, 157, 158, 159, 162, 164, 166, 168, 169, 170, 171, 177, 178, 179, 180, 181, 182, 184, 186, 187, 188, 189, 191, 192, 193, 195, 197, 198, 199]"
Olaf,L0,short,129,74,55,10,0.355,200,"[0, 1, 2, 5, 6, 14, 15, 16, 17, 18, 19, 20, 21, 23, 24, 26, 27, 32, 34, 36, 37, 40, 41, 42, 44, 45, 46, 47, 50, 51, 52, 53, 54, 55, 57, 61, 62, 63, 67, 69, 70, 73, 74, 75, 76, 77, 79, 82, 85, 87, 91, 92, 93, 95, 96, 97, 98, 99, 100, 101, 102, 105, 106, 107, 109, 110, 111, 112, 113, 114, 115, 121, 122, 123, 124, 125, 126, 128, 129, 130, 131, 132, 133, 135, 136, 137, 138, 139, 142, 143, 144, 146, 148, 150, 151, 152, 153, 154, 155, 156, 157, 158, 163, 165, 166, 168, 171, 172, 173, 174, 175, 176, 177, 178, 180, 181, 184, 186, 187, 188, 189, 190, 191, 192, 193, 194, 195, 197, 199]"
Olaf,L0,short,140,69,71,12,0.3,200,"[0, 1, 2, 3, 4, 5, 6, 7, 9, 11, 13, 14, 15, 16, 17, 18, 19, 20, 24, 25, 26, 27, 28, 29, 30, 31, 32, 33, 40, 41, 45, 46, 47, 50, 51, 52, 53, 54, 56, 57, 58, 59, 60, 61, 62, 63, 64, 66, 69, 73, 74, 80, 81, 82, 83, 84, 87, 88, 89, 90, 91, 93, 95, 96, 97, 98, 99, 100, 101, 102, 103, 105, 106, 107, 110, 111, 112, 114, 116, 118, 120, 122, 123, 124, 125, 127, 128, 129, 130, 131, 132, 135, 136, 138, 139, 140, 142, 143, 144, 146, 147, 148, 149, 150, 151, 153, 154, 155, 156, 157, 158, 160, 161, 163, 164, 165, 166, 168, 169, 170, 172, 174, 175, 176, 177, 182, 183, 184, 185, 187, 188, 189, 191, 192, 193, 194, 196, 197, 198, 199]"
Olaf,L0,short,127,60,67,6,0.365,200,"[0, 4, 5, 6, 7, 8, 9, 11, 13, 15, 16, 17, 18, 20, 21, 22, 27, 29, 30, 34, 35, 36, 37, 38, 41, 42, 43, 44, 45, 46, 49, 50, 52, 53, 55, 56, 57, 60, 61, 62, 64, 66, 67, 69, 70, 71, 72, 76, 77, 80, 81, 82, 84, 86, 87, 88, 89, 91, 95, 96, 97, 98, 99, 100, 101, 105, 108, 109, 110, 111, 112, 113, 114, 116, 117, 119, 120, 121, 124, 126, 127, 128, 129, 130, 131, 133, 134, 135, 137, 139, 142, 144, 145, 146, 149, 151, 152, 154, 156, 157, 158, 159, 160, 161, 162, 163, 164, 165, 166, 169, 171, 173, 174, 175, 177, 180, 181, 182, 183, 190, 191, 193, 194, 195, 196, 198, 199]"
Olaf,L0,short,138,75,63,6,0.31,200,"[0, 1, 2, 3, 4, 5, 7, 8, 10, 12, 13, 14, 15, 17, 18, 19, 20, 21, 22, 26, 28, 29, 30, 31, 32, 33, 34, 35, 36, 37, 41, 42, 43, 45, 46, 48, 50, 52, 53, 55, 56, 57, 59, 60, 61, 62, 64, 65, 67, 68, 69, 71, 73, 74, 75, 76, 78, 80, 81, 82, 83, 84, 85, 86, 87, 88, 89, 92, 94, 96, 99, 100, 101, 104, 106, 107, 108, 110, 113, 114, 115, 117, 118, 119, 121, 122, 125, 126, 128, 129, 132, 133, 134, 135, 136, 137, 138, 139, 141, 142, 144, 145, 146, 149, 150, 151, 152, 154, 155, 157, 158, 159, 161, 163, 164, 165, 167, 168, 170, 171, 172, 173, 175, 176, 177, 178, 180, 181, 183, 184, 187, 188, 189, 193, 195, 196, 198, 199]"
Olaf,L0,short,136,50,86,9,0.32,200,"[0, 1, 4, 5, 6, 7, 8, 10, 11, 12, 13, 16, 17, 18, 19, 20, 22, 23, 24, 25, 26, 27, 28, 29, 30, 31, 32, 33, 35, 36, 38, 39, 43, 45, 46, 47, 48, 50, 53, 54, 55, 56, 57, 58, 59, 62, 63, 65, 66, 68, 69, 70, 71, 72, 74, 77, 79, 84, 87, 88, 89, 90, 92, 93, 94, 95, 96, 97, 98, 99, 100, 104, 106, 107, 108, 109, 110, 112, 113, 114, 115, 116, 117, 118, 119, 120, 121, 122, 123, 124, 125, 126, 127, 130, 131, 132, 133, 136, 137, 138, 141, 146, 147, 148, 152, 155, 157, 159, 160, 161, 162, 163, 164, 167, 169, 170, 171, 174, 175, 178, 179, 181, 182, 183, 184, 186, 187, 188, 189, 190, 191, 194, 195, 196, 197, 199]"
Olaf,L0,short,140,41,99,8,0.3,200,"[1, 3, 4, 6, 7, 8, 9, 10, 11, 12, 13, 14, 15, 16, 17, 18, 19, 20, 21, 22, 23, 24, 25, 26, 30, 31, 32, 34, 35, 37, 38, 39, 42, 43, 44, 45, 47, 48, 49, 50, 52, 55, 56, 59, 60, 62, 63, 64, 65, 66, 67, 69, 70, 71, 72, 73, 74, 75, 78, 79, 81, 82, 85, 86, 87, 88, 89, 90, 91, 93, 95, 96, 99, 100, 102, 104, 106, 107, 108, 109, 111, 112, 113, 114, 115, 116, 117, 119, 120, 121, 124, 129, 130, 131, 133, 134, 135, 136, 137, 138, 140, 143, 144, 145, 146, 147, 149, 152, 153, 155, 156, 157, 158, 160, 161, 163, 165, 166, 168, 170, 172, 174, 176, 177, 178, 179, 181, 182, 183, 184, 186, 187, 188, 190, 191, 192, 193, 195, 197, 199]"
Olaf,L0,short,130,68,62,9,0.35,200,"[0, 1, 2, 3, 4, 5, 6, 7, 8, 10, 11, 13, 14, 16, 17, 18, 21, 23, 24, 28, 29, 30, 32, 34, 36, 37, 38, 39, 40, 42, 43, 44, 45, 47, 48, 50, 51, 53, 54, 56, 58, 59, 60, 61, 63, 64, 70, 71, 72, 74, 77, 78, 81, 82, 83, 85, 86, 87, 88, 92, 93, 95, 97, 100, 102, 103, 105, 107, 109, 110, 111, 112, 114, 117, 118, 121, 123, 124, 126, 127, 128, 129, 131, 132, 133, 134, 136, 137, 138, 139, 140, 141, 143, 144, 145, 146, 148, 149, 152, 153, 154, 155, 156, 158, 159, 160, 162, 163, 165, 167, 168, 170, 171, 172, 173, 174, 176, 177, 178, 181, 185, 187, 190, 191, 192, 194, 195, 196, 197, 199]"
Olaf,L0,short,129,81,48,10,0.355,200,"[0, 1, 3, 4, 7, 8, 9, 11, 12, 13, 15, 16, 17, 18, 19, 20, 21, 22, 24, 25, 27, 28, 29, 30, 32, 34, 35, 37, 38, 39, 40, 41, 42, 44, 46, 47, 48, 49, 51, 54, 55, 57, 59, 60, 61, 62, 63, 64, 66, 67, 69, 70, 71, 73, 74, 75, 76, 77, 78, 81, 83, 84, 86, 87, 90, 91, 94, 95, 96, 98, 99, 100, 103, 104, 107, 108, 109, 113, 114, 115, 116, 117, 118, 119, 120, 123, 124, 125, 127, 128, 130, 131, 133, 134, 136, 138, 139, 140, 142, 144, 151, 154, 156, 159, 160, 164, 168, 172, 173, 174, 175, 176, 177, 180, 181, 182, 183, 185, 186, 187, 188, 189, 190, 191, 193, 194, 195, 196, 199]"
Olaf,L0,short,120,60,60,11,0.4,200,"[3, 4, 5, 9, 10, 11, 14, 15, 16, 18, 19, 20, 21, 22, 23, 24, 25, 27, 28, 29, 30, 33, 34, 35, 38, 39, 43, 44, 45, 48, 49, 50, 51, 52, 54, 55, 58, 59, 60, 61, 62, 63, 65, 66, 68, 70, 72, 74, 75, 76, 78, 80, 83, 86, 87, 90, 94, 95, 96, 97, 98, 99, 101, 103, 104, 106, 107, 109, 110, 114, 115, 116, 119, 121, 122, 123, 126, 130, 131, 132, 133, 135, 137, 138, 139, 140, 141, 142, 144, 145, 146, 147, 148, 149, 153, 154, 155, 158, 161, 162, 164, 167, 168, 171, 173, 175, 178, 179, 180, 181, 182, 184, 185, 187, 190, 191, 192, 195, 197, 199]"
Olaf,L0,short,134,72,62,9,0.33,200,"[0, 1, 2, 3, 4, 5, 6, 7, 8, 9, 12, 14, 16, 17, 18, 19, 20, 21, 22, 24, 25, 26, 31, 33, 35, 36, 38, 39, 40, 41, 42, 44, 45, 46, 47, 48, 49, 50, 52, 53, 54, 55, 57, 58, 59, 63, 65, 67, 69, 70, 71, 72, 74, 75, 77, 78, 79, 80, 83, 85, 86, 87, 89, 90, 91, 94, 96, 98, 99, 101, 103, 104, 105, 106, 108, 109, 111, 112, 113, 114, 116, 117, 120, 121, 123, 126, 127, 129, 131, 132, 133, 136, 137, 140, 141, 142, 143, 145, 146, 147, 149, 151, 152, 153, 155, 156, 157, 158, 160, 162, 163, 164, 165, 166, 167, 168, 173, 175, 177, 178, 179, 180, 181, 185, 187, 189, 190, 191, 192, 193, 195, 196, 197, 199]"
Olaf,L0,short,133,54,79,10,0.335,200,"[0, 2, 3, 4, 5, 6, 7, 8, 9, 11, 13, 14, 15, 16, 17, 19, 21, 22, 25, 27, 28, 29, 30, 33, 35, 36, 37, 38, 39, 40, 41, 45, 46, 47, 50, 51, 53, 54, 55, 57, 58, 59, 60, 61, 62, 63, 65, 67, 68, 70, 71, 73, 75, 76, 77, 79, 81, 83, 85, 88, 90, 92, 93, 97, 98, 99, 101, 102, 103, 104, 106, 108, 109, 110, 111, 112, 114, 116, 117, 118, 120, 121, 122, 124, 125, 127, 130, 131, 132, 135, 136, 137, 142, 143, 144, 147, 148, 149, 152, 153, 154, 155, 156, 157, 160, 161, 162, 163, 165, 166, 167, 169, 170, 172, 173, 174, 175, 176, 177, 178, 179, 180, 182, 185, 187, 189, 192, 193, 194, 195, 196, 197, 199]"
Olaf,L0,short,138,58,80,6,0.31,200,"[0, 1, 3, 4, 5, 8, 9, 10, 11, 12, 14, 17, 20, 22, 23, 25, 26, 28, 30, 32, 34, 35, 38, 39, 40, 41, 42, 43, 46, 47, 48, 50, 55, 56, 57, 58, 59, 60, 61, 64, 65, 66, 67, 69, 70, 71, 72, 73, 74, 75, 76, 77, 79, 81, 83, 84, 85, 86, 88, 89, 90, 91, 92, 93, 95, 96, 97, 98, 99, 100, 101, 102, 104, 106, 107, 108, 109, 111, 112, 113, 114, 117, 118, 120, 121, 122, 123, 124, 125, 128, 129, 130, 131, 132, 134, 135, 137, 138, 140, 141, 142, 144, 145, 146, 148, 149, 150, 151, 152, 156, 157, 158, 159, 160, 161, 162, 165, 166, 167, 168, 170, 171, 173, 174, 175, 176, 179, 180, 183, 184, 185, 187, 188, 189, 191, 194, 195, 199]"
Olaf,L0,short,135,83,52,5,0.325,200,"[0, 1, 3, 5, 6, 9, 11, 12, 13, 14, 17, 18, 19, 20, 21, 22, 24, 26, 27, 28, 29, 31, 32, 33, 34, 35, 37, 38, 39, 41, 42, 43, 44, 46, 47, 48, 51, 53, 54, 56, 57, 58, 60, 61, 63, 65, 66, 67, 68, 72, 73, 76, 77, 80, 83, 84, 85, 88, 89, 90, 93, 94, 95, 96, 97, 98, 99, 100, 101, 102, 103, 104, 105, 106, 108, 109, 111, 113, 114, 115, 116, 117, 118, 120, 122, 123, 125, 126, 129, 131, 132, 134, 137, 138, 140, 141, 143, 144, 145, 148, 149, 150, 151, 152, 155, 156, 159, 160, 161, 162, 164, 165, 166, 169, 171, 172, 173, 175, 177, 178, 179, 180, 182, 183, 184, 185, 188, 191, 192, 193, 194, 195, 196, 197, 198]"
Olaf,L0,short,144,95,49,15,0.28,200,"[0, 1, 2, 3, 4, 5, 6, 7, 9, 12, 13, 14, 15, 17, 18, 19, 21, 26, 27, 28, 29, 31, 32, 33, 34, 35, 36, 37, 38, 39, 40, 43, 44, 45, 46, 48, 49, 52, 53, 54, 56, 57, 59, 60, 61, 62, 64, 65, 66, 70, 71, 72, 73, 74, 75, 76, 77, 78, 79, 80, 82, 86, 87, 88, 89, 91, 92, 94, 95, 96, 97, 101, 102, 105, 106, 107, 109, 111, 112, 113, 116, 117, 118, 119, 120, 121, 122, 123, 124, 125, 126, 127, 128, 129, 130, 131, 133, 134, 135, 138, 139, 140, 142, 143, 145, 146, 147, 148, 149, 150, 153, 154, 156, 157, 158, 160, 162, 164, 165, 166, 167, 168, 169, 170, 172, 174, 175, 176, 177, 178, 179, 180, 181, 184, 186, 188, 189, 190, 192, 193, 195, 197, 198, 199]"
Olaf,L0,short,134,64,70,7,0.33,200,"[0, 1, 3, 5, 6, 7, 9, 10, 11, 12, 13, 15, 16, 17, 19, 23, 24, 25, 27, 29, 31, 33, 34, 36, 37, 39, 41, 42, 43, 44, 46, 47, 48, 49, 50, 51, 53, 56, 57, 58, 61, 62, 63, 64, 67, 68, 73, 74, 75, 76, 79, 80, 82, 83, 84, 85, 87, 88, 89, 90, 91, 93, 95, 96, 98, 99, 102, 103, 104, 105, 107, 109, 111, 112, 114, 118, 119, 120, 121, 122, 123, 124, 125, 126, 127, 128, 131, 132, 135, 136, 139, 140, 141, 143, 144, 145, 146, 147, 148, 151, 152, 153, 155, 156, 157, 158, 159, 160, 161, 163, 167, 170, 171, 172, 173, 174, 176, 178, 179, 180, 181, 182, 185, 186, 187, 188, 189, 190, 192, 193, 195, 196, 197, 199]"
Olaf,L0,short,119,73,46,16,0.405,200,"[0, 1, 3, 4, 5, 6, 7, 8, 9, 15, 16, 17, 18, 22, 24, 25, 27, 29, 31, 32, 33, 35, 36, 38, 41, 44, 46, 48, 49, 50, 52, 53, 54, 56, 57, 61, 62, 66, 69, 71, 72, 73, 75, 76, 77, 80, 81, 82, 86, 87, 88, 90, 91, 92, 98, 99, 102, 104, 107, 108, 109, 114, 116, 117, 118, 119, 121, 122, 123, 124, 126, 128, 129, 132, 134, 135, 136, 138, 140, 141, 143, 145, 147, 148, 149, 150, 151, 152, 157, 158, 159, 160, 161, 162, 163, 164, 165, 166, 171, 172, 173, 174, 176, 177, 180, 181, 182, 183, 184, 186, 188, 190, 192, 193, 195, 196, 197, 198, 199]"
Olaf,L0,short,149,75,74,7,0.255,200,"[1, 3, 4, 6, 10, 11, 12, 13, 14, 15, 16, 18, 19, 21, 22, 25, 27, 28, 29, 30, 31, 33, 34, 37, 38, 40, 42, 43, 44, 46, 53, 56, 57, 58, 59, 61, 62, 63, 65, 66, 67, 68, 69, 70, 71, 72, 73, 74, 75, 76, 77, 79, 80, 81, 83, 84, 85, 89, 91, 92, 94, 96, 97, 98, 99, 100, 101, 102, 103, 104, 105, 106, 107, 108, 109, 111, 112, 113, 114, 115, 116, 117, 118, 120, 121, 122, 123, 124, 125, 126, 127, 128, 130, 133, 134, 135, 136, 137, 138, 140, 141, 142, 143, 144, 145, 146, 149, 151, 152, 154, 155, 156, 157, 158, 161, 162, 164, 165, 166, 167, 168, 169, 170, 171, 173, 174, 175, 176, 177, 178, 179, 180, 182, 183, 184, 185, 186, 187, 188, 190, 191, 192, 193, 194, 195, 196, 197, 198, 199]"
Olaf,L0,short,134,69,65,4,0.33,200,"[0, 1, 2, 4, 5, 9, 10, 11, 14, 16, 17, 18, 19, 22, 23, 24, 25, 26, 27, 29, 30, 31, 32, 33, 34, 35, 37, 38, 39, 40, 41, 42, 43, 44, 45, 48, 49, 51, 53, 54, 55, 58, 59, 60, 61, 62, 63, 64, 65, 66, 67, 68, 70, 71, 74, 75, 77, 78, 80, 82, 84, 87, 88, 89, 91, 93, 94, 96, 97, 98, 99, 100, 101, 102, 103, 105, 107, 109, 110, 112, 113, 114, 115, 116, 117, 118, 121, 122, 123, 124, 127, 131, 133, 134, 136, 137, 138, 139, 140, 142, 143, 144, 145, 147, 151, 152, 153, 154, 155, 158, 159, 160, 161, 162, 163, 164, 166, 167, 168, 169, 170, 172, 173, 181, 184, 185, 186, 190, 191, 192, 193, 196, 197, 198]"
Olaf,L0,short,131,78,53,16,0.345,200,"[0, 1, 2, 3, 5, 6, 7, 8, 11, 12, 13, 14, 15, 16, 18, 19, 21, 22, 25, 26, 27, 31, 33, 34, 35, 36, 37, 38, 43, 44, 45, 46, 47, 49, 54, 55, 57, 58, 61, 62, 63, 65, 67, 68, 70, 71, 72, 73, 74, 76, 77, 80, 81, 84, 87, 88, 89, 92, 94, 96, 97, 98, 100, 102, 106, 107, 108, 109, 112, 113, 114, 116, 117, 118, 119, 120, 121, 122, 123, 124, 125, 126, 127, 128, 129, 132, 133, 134, 135, 136, 137, 139, 140, 141, 142, 144, 145, 146, 150, 152, 153, 154, 155, 156, 157, 158, 160, 161, 165, 166, 170, 171, 173, 174, 175, 176, 177, 179, 182, 184, 185, 187, 189, 190, 191, 192, 194, 195, 196, 197, 199]"
Olaf,L0,short,130,89,41,10,0.35,200,"[1, 2, 4, 5, 6, 10, 11, 13, 14, 17, 18, 19, 21, 22, 23, 24, 25, 26, 27, 28, 29, 30, 31, 32, 34, 35, 36, 38, 39, 41, 44, 45, 48, 49, 50, 51, 52, 53, 54, 56, 57, 58, 61, 65, 66, 67, 68, 69, 70, 73, 74, 75, 76, 78, 79, 80, 82, 83, 84, 86, 92, 93, 94, 95, 97, 98, 100, 101, 104, 105, 107, 108, 109, 111, 116, 117, 120, 121, 123, 124, 125, 127, 128, 129, 134, 135, 136, 139, 140, 141, 142, 143, 144, 145, 146, 147, 148, 149, 150, 151, 152, 154, 156, 158, 159, 161, 162, 163, 164, 165, 166, 168, 169, 170, 173, 175, 176, 177, 179, 180, 181, 184, 186, 187, 188, 189, 192, 193, 196, 198]"
Olaf,L0,short,130,64,66,4,0.35,200,"[1, 2, 6, 7, 9, 10, 11, 12, 13, 14, 15, 18, 19, 20, 22, 24, 26, 28, 29, 30, 31, 32, 33, 35, 36, 37, 38, 39, 40, 44, 45, 46, 51, 52, 53, 55, 57, 58, 61, 62, 63, 64, 65, 69, 74, 75, 76, 77, 78, 79, 80, 82, 86, 87, 88, 90, 91, 92, 93, 94, 96, 98, 99, 103, 104, 106, 108, 110, 112, 114, 115, 116, 117, 122, 123, 124, 127, 129, 130, 131, 132, 133, 136, 137, 138, 139, 140, 141, 142, 143, 147, 148, 149, 151, 152, 153, 154, 156, 158, 160, 161, 162, 163, 164, 165, 166, 167, 168, 169, 170, 172, 173, 174, 175, 176, 177, 178, 179, 180, 184, 185, 186, 187, 188, 189, 190, 192, 195, 198, 199]"
Olaf,L0,short,129,69,60,8,0.355,200,"[0, 1, 2, 7, 11, 13, 14, 15, 16, 19, 21, 22, 23, 24, 25, 26, 30, 31, 33, 34, 35, 36, 37, 39, 40, 41, 42, 44, 45, 46, 47, 48, 49, 50, 51, 52, 53, 54, 55, 56, 58, 60, 62, 63, 64, 65, 67, 68, 69, 70, 71, 72, 80, 82, 83, 85, 86, 87, 88, 90, 93, 96, 97, 98, 99, 100, 101, 102, 105, 107, 108, 109, 110, 111, 112, 113, 115, 116, 118, 119, 120, 123, 125, 127, 128, 131, 132, 134, 137, 138, 139, 141, 142, 143, 147, 148, 149, 150, 151, 152, 153, 156, 157, 158, 159, 161, 162, 163, 165, 166, 167, 168, 170, 173, 174, 175, 176, 178, 181, 183, 185, 187, 188, 189, 191, 196, 197, 198, 199]"
Olaf,L0,short,135,52,83,13,0.325,200,"[0, 1, 2, 3, 4, 5, 6, 7, 9, 11, 13, 15, 16, 17, 19, 20, 22, 23, 25, 26, 27, 28, 29, 30, 31, 32, 33, 35, 36, 38, 40, 42, 43, 44, 45, 46, 47, 48, 49, 50, 52, 54, 56, 57, 59, 60, 62, 63, 65, 66, 68, 69, 71, 72, 73, 74, 77, 78, 80, 81, 82, 83, 84, 85, 86, 88, 89, 90, 92, 93, 94, 95, 97, 98, 99, 100, 101, 102, 103, 105, 109, 110, 111, 112, 114, 115, 119, 121, 122, 123, 124, 127, 128, 129, 130, 131, 137, 139, 140, 141, 145, 147, 149, 153, 154, 155, 156, 157, 158, 159, 160, 161, 163, 164, 165, 166, 170, 172, 173, 177, 178, 179, 181, 182, 183, 184, 185, 186, 188, 190, 193, 194, 195, 198, 199]"
Olaf,L0,short,132,67,65,8,0.34,200,"[2, 3, 5, 6, 10, 11, 14, 15, 16, 19, 20, 21, 22, 25, 26, 27, 28, 29, 30, 32, 34, 35, 36, 37, 39, 40, 41, 42, 44, 45, 46, 47, 48, 49, 50, 51, 52, 53, 54, 55, 56, 57, 59, 61, 63, 65, 68, 70, 71, 73, 74, 77, 78, 81, 82, 83, 86, 87, 88, 89, 91, 92, 95, 96, 97, 98, 100, 103, 104, 106, 107, 111, 113, 114, 116, 118, 119, 120, 121, 122, 125, 126, 128, 131, 132, 133, 135, 137, 139, 140, 141, 142, 144, 148, 149, 150, 151, 152, 153, 154, 155, 157, 158, 159, 160, 161, 163, 164, 165, 168, 169, 170, 171, 172, 173, 174, 176, 178, 179, 181, 182, 184, 187, 188, 190, 191, 193, 195, 196, 197, 198, 199]"
Olaf,L0,short,136,75,61,11,0.32,200,"[1, 2, 4, 5, 6, 9, 11, 12, 13, 14, 15, 16, 17, 18, 21, 23, 24, 25, 30, 31, 32, 34, 36, 37, 38, 39, 40, 41, 42, 43, 45, 46, 47, 48, 49, 50, 53, 54, 55, 56, 57, 59, 60, 62, 63, 65, 66, 67, 68, 70, 71, 73, 74, 76, 77, 80, 81, 82, 83, 84, 86, 88, 89, 93, 94, 96, 97, 98, 99, 100, 101, 102, 103, 104, 106, 107, 109, 110, 111, 112, 113, 114, 115, 116, 117, 119, 121, 122, 124, 125, 126, 127, 129, 130, 132, 139, 141, 142, 143, 144, 145, 146, 147, 149, 150, 151, 152, 153, 154, 156, 157, 159, 160, 161, 162, 167, 171, 172, 174, 175, 176, 177, 178, 179, 180, 181, 182, 186, 187, 188, 190, 191, 194, 196, 197, 198]"
Olaf,L0,short,126,52,74,10,0.37,200,"[0, 2, 3, 5, 6, 7, 9, 10, 11, 14, 15, 17, 18, 20, 21, 22, 23, 24, 25, 26, 27, 28, 30, 31, 32, 35, 36, 37, 40, 41, 42, 44, 46, 51, 52, 53, 54, 56, 58, 60, 62, 64, 65, 66, 67, 68, 69, 72, 73, 74, 75, 76, 77, 80, 81, 83, 84, 86, 89, 90, 91, 92, 95, 96, 97, 98, 101, 102, 104, 107, 108, 110, 111, 114, 116, 117, 118, 119, 120, 122, 127, 131, 132, 134, 136, 137, 138, 140, 141, 144, 145, 146, 147, 148, 149, 150, 154, 156, 159, 160, 161, 163, 166, 167, 168, 169, 170, 171, 173, 174, 175, 176, 178, 180, 182, 183, 186, 187, 190, 192, 193, 195, 196, 197, 198, 199]"
Olaf,L0,short,149,89,60,6,0.255,200,"[1, 2, 3, 4, 5, 6, 8, 9, 10, 11, 12, 13, 14, 15, 16, 17, 19, 20, 21, 23, 24, 25, 26, 27, 28, 29, 30, 31, 33, 35, 37, 38, 40, 42, 44, 47, 48, 49, 52, 53, 55, 56, 57, 58, 59, 60, 62, 63, 67, 69, 71, 73, 74, 76, 77, 78, 79, 80, 82, 83, 84, 85, 87, 88, 89, 90, 92, 93, 94, 95, 96, 97, 98, 99, 100, 102, 104, 105, 106, 107, 108, 109, 111, 112, 113, 114, 115, 116, 117, 118, 119, 120, 121, 123, 124, 126, 128, 129, 130, 132, 133, 135, 136, 137, 139, 140, 141, 142, 145, 146, 147, 149, 152, 153, 155, 156, 157, 160, 162, 164, 165, 166, 167, 168, 169, 171, 172, 174, 177, 178, 179, 180, 181, 182, 183, 184, 185, 186, 187, 188, 189, 190, 191, 192, 193, 194, 195, 197, 199]"
Olaf,L0,short,131,46,85,9,0.345,200,"[0, 1, 3, 4, 5, 6, 7, 9, 10, 13, 16, 17, 18, 19, 20, 21, 23, 24, 25, 26, 29, 31, 32, 33, 34, 35, 37, 38, 39, 40, 42, 43, 45, 46, 48, 49, 50, 51, 52, 53, 54, 55, 56, 57, 58, 59, 60, 62, 65, 66, 68, 69, 71, 72, 73, 76, 77, 80, 81, 84, 85, 86, 87, 89, 91, 92, 93, 95, 96, 99, 100, 102, 103, 105, 106, 107, 109, 110, 113, 114, 115, 117, 121, 122, 123, 124, 125, 126, 127, 128, 129, 130, 132, 133, 134, 135, 136, 137, 138, 139, 145, 148, 151, 152, 154, 155, 156, 157, 158, 159, 160, 161, 162, 163, 164, 167, 168, 170, 173, 175, 181, 183, 184, 185, 186, 188, 189, 190, 193, 195, 196]"
Olaf,L0,short,131,59,72,7,0.345,200,"[1, 2, 3, 5, 6, 7, 8, 9, 10, 11, 12, 13, 14, 16, 17, 18, 19, 20, 21, 23, 25, 27, 28, 29, 30, 31, 32, 35, 37, 40, 41, 42, 43, 44, 45, 46, 47, 49, 52, 54, 56, 58, 61, 62, 65, 68, 71, 72, 74, 75, 76, 77, 78, 80, 81, 82, 84, 85, 86, 87, 88, 90, 91, 92, 93, 94, 96, 100, 102, 103, 105, 106, 108, 109, 111, 113, 116, 119, 120, 121, 122, 123, 125, 127, 128, 129, 130, 132, 133, 134, 135, 136, 137, 138, 139, 140, 141, 144, 145, 147, 148, 150, 151, 152, 153, 154, 157, 158, 159, 161, 165, 166, 168, 169, 172, 173, 174, 177, 178, 179, 183, 184, 185, 186, 187, 188, 190, 192, 195, 198, 199]"
Olaf,L0,short,147,77,70,4,0.265,200,"[0, 3, 4, 5, 8, 9, 10, 11, 13, 14, 15, 17, 18, 19, 21, 22, 23, 30, 31, 32, 34, 36, 37, 38, 40, 41, 42, 43, 44, 45, 46, 47, 48, 49, 50, 51, 52, 54, 56, 57, 58, 59, 60, 62, 63, 64, 66, 67, 69, 70, 72, 74, 75, 77, 78, 79, 80, 82, 84, 85, 86, 87, 88, 89, 91, 93, 94, 95, 96, 97, 99, 100, 101, 102, 103, 105, 107, 108, 109, 110, 111, 112, 113, 114, 115, 119, 120, 121, 122, 123, 124, 126, 127, 128, 129, 130, 131, 132, 133, 134, 135, 136, 138, 139, 141, 142, 143, 144, 145, 146, 147, 149, 150, 151, 152, 153, 154, 156, 157, 158, 159, 160, 162, 163, 165, 166, 170, 171, 172, 173, 175, 176, 177, 178, 179, 180, 183, 185, 186, 191, 192, 193, 194, 195, 197, 198, 199]"
Olaf,L0,short,141,76,65,7,0.295,200,"[0, 3, 4, 5, 7, 8, 10, 11, 12, 13, 14, 15, 16, 17, 18, 19, 20, 21, 22, 23, 24, 25, 26, 27, 28, 29, 31, 32, 33, 34, 35, 38, 39, 40, 42, 45, 50, 52, 53, 54, 56, 57, 58, 59, 60, 62, 63, 64, 65, 66, 67, 69, 71, 73, 74, 75, 76, 77, 78, 80, 82, 83, 84, 88, 90, 91, 92, 93, 95, 96, 98, 99, 101, 103, 104, 105, 106, 110, 112, 113, 114, 118, 119, 120, 121, 124, 125, 126, 127, 128, 129, 130, 131, 132, 133, 134, 136, 137, 138, 141, 142, 143, 144, 145, 149, 150, 151, 152, 155, 156, 159, 160, 162, 163, 165, 166, 169, 170, 171, 172, 173, 174, 175, 176, 178, 179, 180, 182, 183, 184, 187, 188, 189, 190, 191, 194, 195, 196, 197, 198, 199]"
Olaf,L0,short,136,82,54,6,0.32,200,"[1, 2, 3, 4, 7, 9, 10, 11, 13, 15, 17, 18, 21, 23, 25, 27, 28, 30, 31, 32, 33, 35, 39, 40, 42, 45, 46, 47, 48, 49, 50, 52, 53, 55, 56, 59, 60, 61, 62, 63, 65, 66, 70, 71, 72, 73, 74, 76, 77, 78, 80, 82, 87, 88, 91, 92, 93, 94, 95, 96, 97, 99, 100, 101, 102, 103, 104, 106, 108, 109, 111, 112, 113, 114, 115, 116, 117, 118, 119, 121, 123, 124, 125, 126, 127, 128, 129, 130, 131, 132, 133, 134, 139, 140, 141, 143, 145, 147, 148, 149, 150, 151, 153, 154, 156, 157, 158, 159, 160, 162, 164, 165, 166, 167, 170, 171, 172, 173, 174, 175, 177, 180, 182, 183, 184, 187, 189, 190, 191, 192, 194, 195, 196, 197, 198, 199]"
Olaf,L0,short,126,80,46,15,0.37,200,"[0, 1, 2, 3, 4, 6, 8, 9, 10, 12, 13, 15, 16, 17, 18, 19, 20, 21, 23, 24, 26, 27, 30, 31, 32, 33, 36, 37, 38, 41, 43, 44, 45, 46, 47, 48, 50, 51, 52, 55, 57, 58, 59, 60, 61, 64, 65, 66, 67, 69, 70, 71, 72, 73, 76, 78, 79, 82, 83, 88, 89, 90, 91, 92, 93, 94, 95, 96, 97, 98, 102, 104, 106, 107, 112, 116, 120, 121, 123, 124, 130, 131, 132, 135, 136, 137, 138, 139, 144, 148, 150, 151, 152, 154, 155, 159, 160, 161, 163, 164, 165, 166, 167, 168, 170, 171, 172, 173, 174, 175, 176, 177, 178, 179, 182, 184, 187, 188, 189, 190, 191, 192, 193, 195, 198, 199]"
Olaf,L0,short,137,70,67,10,0.315,200,"[0, 3, 4, 5, 7, 8, 9, 10, 12, 13, 15, 16, 19, 21, 22, 24, 25, 26, 28, 29, 33, 35, 36, 37, 38, 40, 42, 44, 45, 46, 47, 48, 50, 51, 52, 53, 54, 55, 57, 59, 60, 61, 62, 64, 65, 66, 67, 68, 69, 70, 71, 72, 74, 75, 78, 80, 81, 82, 84, 85, 89, 90, 91, 92, 96, 97, 98, 100, 101, 102, 103, 105, 106, 107, 108, 109, 110, 114, 115, 116, 118, 119, 120, 121, 123, 124, 125, 126, 127, 129, 130, 132, 134, 135, 136, 138, 140, 142, 143, 144, 145, 146, 150, 151, 154, 155, 156, 157, 158, 159, 160, 162, 164, 166, 167, 169, 170, 172, 173, 174, 175, 176, 178, 180, 181, 182, 183, 184, 185, 186, 188, 189, 194, 195, 196, 197, 198]"
Olaf,L0,short,131,76,55,13,0.345,200,"[0, 1, 2, 4, 5, 6, 8, 10, 11, 13, 14, 15, 16, 17, 19, 20, 22, 23, 25, 27, 28, 29, 30, 34, 35, 37, 39, 40, 41, 42, 43, 44, 46, 47, 49, 51, 52, 54, 55, 56, 59, 62, 64, 65, 68, 69, 72, 73, 74, 75, 76, 80, 81, 82, 83, 85, 87, 88, 91, 92, 93, 95, 97, 98, 100, 102, 103, 105, 108, 109, 110, 111, 112, 113, 115, 117, 119, 120, 121, 122, 124, 125, 127, 129, 130, 132, 134, 135, 136, 138, 139, 140, 142, 143, 147, 151, 152, 153, 154, 155, 157, 160, 162, 163, 164, 165, 166, 167, 168, 170, 172, 173, 174, 175, 177, 178, 179, 180, 182, 184, 186, 187, 188, 189, 190, 191, 193, 194, 195, 196, 199]"
Olaf,L0,short,126,55,71,7,0.37,200,"[0, 3, 4, 5, 6, 10, 12, 13, 14, 17, 20, 23, 25, 27, 28, 29, 30, 33, 35, 37, 38, 42, 43, 44, 45, 47, 48, 49, 50, 52, 53, 54, 56, 58, 60, 61, 62, 64, 65, 66, 69, 70, 71, 72, 76, 77, 78, 79, 80, 81, 84, 86, 87, 89, 90, 91, 92, 94, 95, 97, 98, 99, 100, 102, 103, 105, 107, 108, 109, 111, 113, 116, 117, 119, 123, 124, 125, 126, 129, 130, 131, 133, 134, 135, 140, 142, 143, 145, 146, 147, 148, 149, 152, 153, 155, 157, 158, 159, 160, 161, 162, 163, 165, 166, 168, 170, 171, 173, 175, 177, 179, 180, 182, 184, 185, 186, 187, 188, 189, 190, 191, 192, 193, 194, 196, 199]"
Olaf,L0,short,136,85,51,6,0.32,200,"[0, 2, 3, 5, 6, 8, 9, 11, 12, 13, 15, 19, 20, 21, 24, 25, 26, 27, 29, 31, 32, 33, 34, 36, 38, 39, 40, 41, 42, 43, 44, 51, 52, 53, 54, 55, 56, 57, 58, 59, 60, 61, 62, 63, 65, 69, 70, 71, 72, 73, 76, 78, 80, 81, 84, 85, 86, 87, 89, 90, 91, 92, 96, 97, 98, 100, 102, 103, 104, 106, 107, 108, 109, 110, 111, 113, 115, 117, 118, 119, 120, 122, 123, 124, 126, 128, 130, 131, 132, 133, 134, 135, 136, 137, 138, 140, 143, 146, 147, 148, 149, 150, 151, 152, 153, 154, 155, 156, 158, 159, 161, 162, 164, 166, 167, 168, 169, 172, 173, 175, 177, 178, 179, 181, 182, 183, 184, 185, 186, 187, 188, 189, 190, 197, 198, 199]"
Olaf,L0,short,131,79,52,12,0.345,200,"[1, 3, 4, 5, 6, 7, 8, 10, 11, 12, 14, 16, 18, 19, 21, 22, 23, 25, 26, 27, 28, 29, 30, 31, 32, 35, 37, 38, 39, 41, 42, 43, 45, 46, 47, 50, 51, 52, 53, 55, 56, 58, 59, 63, 66, 68, 69, 70, 72, 73, 74, 75, 76, 77, 78, 79, 81, 82, 83, 84, 85, 89, 90, 91, 94, 95, 96, 98, 99, 101, 102, 103, 104, 106, 107, 109, 110, 111, 113, 114, 116, 117, 118, 119, 121, 122, 123, 124, 125, 129, 130, 131, 133, 134, 136, 138, 139, 140, 144, 145, 146, 149, 153, 155, 156, 157, 159, 160, 161, 162, 165, 166, 168, 169, 171, 174, 175, 176, 177, 180, 181, 186, 187, 188, 191, 192, 195, 196, 197, 198, 199]"
Olaf,L0,short,134,60,74,9,0.33,200,"[0, 2, 3, 5, 6, 8, 10, 11, 14, 15, 17, 20, 21, 22, 23, 24, 25, 27, 29, 30, 31, 32, 37, 38, 39, 40, 45, 46, 47, 48, 50, 51, 53, 55, 56, 57, 58, 59, 60, 61, 62, 63, 64, 66, 68, 69, 73, 74, 76, 77, 78, 79, 80, 81, 82, 85, 86, 87, 88, 89, 90, 92, 93, 94, 97, 98, 99, 100, 101, 102, 103, 104, 107, 108, 109, 110, 111, 112, 114, 115, 116, 117, 118, 122, 123, 125, 127, 129, 130, 131, 133, 134, 135, 139, 141, 143, 145, 146, 147, 148, 150, 152, 153, 154, 157, 158, 159, 161, 163, 164, 168, 170, 171, 172, 174, 175, 176, 177, 180, 182, 184, 185, 186, 187, 188, 190, 191, 192, 193, 194, 196, 197, 198, 199]"
Olaf,L0,short,145,51,94,8,0.275,200,"[2, 3, 4, 6, 7, 8, 9, 10, 11, 12, 14, 15, 17, 19, 20, 21, 22, 23, 24, 26, 28, 29, 31, 32, 33, 34, 38, 39, 40, 41, 42, 45, 47, 48, 50, 52, 54, 55, 56, 57, 58, 59, 60, 61, 62, 63, 64, 65, 66, 67, 68, 69, 70, 71, 72, 73, 74, 75, 76, 77, 79, 80, 82, 83, 84, 85, 86, 89, 90, 91, 92, 93, 94, 95, 97, 99, 100, 101, 102, 103, 104, 105, 106, 110, 111, 112, 113, 114, 116, 117, 119, 121, 122, 124, 125, 126, 127, 128, 129, 130, 132, 133, 134, 135, 138, 140, 142, 143, 144, 145, 147, 148, 150, 152, 153, 154, 155, 156, 157, 160, 161, 163, 164, 165, 168, 169, 170, 172, 173, 175, 176, 177, 178, 179, 180, 181, 182, 183, 184, 186, 193, 194, 196, 197, 199]"
Olaf,L0,short,126,45,81,9,0.37,200,"[0, 1, 2, 3, 7, 8, 9, 11, 12, 13, 17, 18, 19, 20, 24, 25, 26, 27, 28, 30, 31, 33, 34, 37, 38, 39, 41, 43, 46, 48, 49, 52, 55, 56, 57, 58, 59, 60, 61, 62, 63, 66, 68, 69, 70, 72, 74, 75, 77, 78, 79, 82, 83, 85, 90, 91, 93, 94, 95, 96, 97, 98, 100, 101, 102, 103, 105, 106, 107, 108, 109, 113, 114, 115, 116, 117, 118, 119, 120, 121, 122, 124, 126, 128, 129, 130, 131, 132, 134, 135, 138, 139, 144, 148, 152, 153, 154, 155, 156, 157, 158, 160, 161, 162, 164, 165, 168, 169, 170, 171, 172, 175, 176, 177, 178, 180, 181, 182, 186, 189, 191, 192, 193, 194, 195, 196]"
Olaf,L0,short,127,65,62,11,0.365,200,"[0, 2, 3, 5, 6, 8, 9, 11, 15, 17, 18, 19, 20, 21, 22, 25, 27, 32, 33, 34, 36, 39, 40, 41, 42, 43, 44, 46, 47, 48, 50, 51, 53, 54, 55, 56, 57, 58, 60, 61, 63, 65, 66, 68, 70, 71, 72, 73, 75, 77, 80, 82, 83, 84, 86, 87, 88, 91, 92, 94, 95, 97, 98, 99, 100, 102, 104, 106, 107, 109, 110, 111, 113, 115, 116, 117, 118, 119, 121, 124, 125, 126, 127, 128, 129, 130, 133, 134, 140, 141, 142, 143, 144, 148, 149, 152, 153, 156, 158, 159, 160, 161, 162, 163, 164, 168, 169, 170, 173, 174, 175, 177, 178, 179, 181, 182, 183, 186, 188, 189, 191, 192, 195, 196, 197, 198, 199]"
Olaf,L0,short,133,72,61,9,0.335,200,"[0, 1, 2, 3, 5, 6, 7, 9, 10, 11, 12, 14, 15, 17, 18, 19, 22, 24, 27, 28, 30, 31, 33, 35, 36, 37, 38, 39, 40, 43, 44, 45, 46, 47, 49, 50, 52, 53, 54, 55, 56, 58, 60, 61, 62, 64, 65, 69, 70, 72, 73, 75, 76, 78, 79, 80, 81, 82, 83, 84, 86, 88, 90, 91, 92, 96, 99, 100, 101, 104, 105, 107, 108, 109, 110, 111, 112, 114, 117, 118, 120, 123, 126, 127, 128, 129, 130, 131, 132, 134, 135, 136, 137, 138, 141, 142, 144, 145, 146, 147, 149, 150, 152, 153, 154, 155, 156, 157, 158, 160, 163, 166, 167, 168, 169, 171, 172, 174, 176, 178, 180, 183, 185, 186, 188, 189, 192, 193, 194, 195, 196, 198, 199]"
Olaf,L0,short,129,63,66,13,0.355,200,"[0, 1, 3, 5, 6, 7, 9, 10, 13, 15, 16, 18, 19, 20, 21, 25, 26, 27, 30, 31, 35, 36, 37, 38, 39, 40, 41, 42, 43, 44, 45, 46, 47, 48, 51, 52, 53, 58, 59, 60, 62, 63, 64, 66, 67, 68, 69, 70, 71, 73, 74, 76, 78, 79, 82, 84, 85, 87, 89, 90, 91, 92, 93, 96, 97, 99, 100, 101, 102, 103, 104, 106, 107, 108, 111, 112, 113, 114, 115, 116, 121, 122, 125, 126, 128, 129, 130, 133, 135, 136, 138, 139, 140, 141, 142, 144, 145, 146, 147, 148, 152, 153, 154, 155, 157, 160, 161, 164, 165, 166, 167, 169, 170, 174, 175, 176, 177, 178, 179, 183, 185, 188, 190, 191, 192, 194, 195, 198, 199]"
Olaf,L0,short,136,64,72,11,0.32,200,"[0, 1, 2, 4, 6, 8, 10, 11, 12, 13, 14, 15, 19, 20, 24, 25, 26, 30, 31, 32, 33, 35, 36, 37, 38, 39, 40, 41, 42, 43, 44, 45, 46, 48, 49, 50, 54, 56, 58, 59, 60, 62, 63, 64, 65, 66, 67, 69, 73, 74, 77, 79, 80, 81, 83, 84, 85, 86, 87, 88, 89, 91, 92, 93, 95, 96, 97, 99, 100, 101, 103, 104, 106, 107, 108, 109, 110, 112, 113, 114, 119, 120, 124, 125, 130, 131, 132, 133, 135, 136, 137, 140, 141, 143, 144, 146, 148, 149, 150, 151, 152, 153, 154, 155, 157, 158, 160, 161, 163, 164, 168, 169, 171, 172, 174, 175, 176, 177, 179, 181, 182, 183, 185, 186, 187, 188, 189, 190, 191, 193, 194, 195, 196, 197, 198, 199]"
Olaf,L0,short,134,86,48,14,0.33,200,"[0, 1, 5, 7, 10, 11, 12, 14, 16, 18, 19, 20, 21, 23, 24, 25, 26, 27, 28, 29, 32, 33, 34, 36, 37, 38, 39, 40, 41, 42, 43, 45, 47, 51, 53, 54, 55, 56, 58, 59, 60, 61, 63, 64, 65, 66, 67, 68, 69, 70, 71, 72, 75, 76, 81, 84, 85, 86, 87, 91, 93, 94, 95, 96, 99, 100, 101, 102, 104, 105, 106, 107, 108, 109, 110, 112, 113, 116, 117, 120, 121, 122, 123, 124, 126, 127, 129, 131, 134, 135, 136, 138, 140, 141, 142, 143, 144, 145, 149, 150, 153, 156, 157, 159, 161, 163, 164, 165, 167, 168, 170, 171, 172, 173, 174, 175, 176, 178, 179, 180, 183, 184, 186, 187, 188, 189, 190, 191, 192, 193, 194, 195, 198, 199]"
Olaf,L0,short,117,62,55,12,0.415,200,"[0, 2, 4, 5, 6, 7, 9, 10, 12, 13, 14, 15, 16, 18, 20, 21, 23, 25, 26, 27, 32, 36, 37, 38, 40, 41, 42, 43, 45, 46, 47, 48, 51, 52, 54, 57, 58, 62, 63, 64, 65, 66, 67, 68, 70, 71, 73, 75, 77, 78, 80, 84, 85, 88, 89, 90, 95, 96, 98, 103, 104, 105, 107, 108, 109, 110, 112, 114, 115, 116, 117, 118, 119, 121, 123, 124, 125, 126, 127, 130, 131, 132, 134, 135, 136, 137, 142, 143, 145, 149, 151, 153, 154, 156, 157, 158, 159, 160, 162, 163, 164, 165, 166, 170, 174, 176, 177, 178, 179, 180, 189, 192, 195, 196, 197, 198, 199]"
Olaf,L0,short,130,63,67,11,0.35,200,"[1, 2, 3, 6, 10, 11, 12, 14, 16, 17, 18, 19, 21, 23, 24, 25, 28, 29, 31, 34, 38, 39, 40, 41, 43, 44, 45, 46, 47, 49, 50, 51, 52, 53, 55, 56, 59, 60, 61, 63, 65, 68, 72, 74, 75, 76, 77, 80, 83, 85, 87, 89, 90, 94, 95, 96, 97, 98, 99, 100, 101, 102, 103, 104, 105, 107, 108, 110, 111, 112, 115, 116, 118, 119, 120, 121, 124, 125, 126, 127, 128, 129, 130, 133, 134, 135, 137, 139, 141, 143, 144, 145, 146, 147, 148, 149, 150, 153, 154, 156, 157, 158, 159, 160, 161, 162, 163, 164, 166, 167, 168, 169, 170, 172, 173, 174, 175, 179, 180, 182, 183, 186, 188, 189, 190, 194, 195, 196, 197, 198]"
Olaf,L0,short,131,65,66,3,0.345,200,"[1, 2, 3, 4, 5, 9, 10, 11, 13, 14, 15, 16, 19, 21, 26, 28, 29, 30, 31, 33, 34, 36, 37, 38, 39, 40, 41, 42, 44, 46, 48, 51, 54, 55, 56, 59, 60, 62, 63, 64, 65, 67, 68, 69, 70, 72, 73, 74, 75, 76, 78, 79, 80, 81, 82, 85, 87, 88, 90, 91, 92, 93, 96, 97, 99, 100, 101, 103, 104, 105, 106, 107, 109, 112, 113, 117, 118, 119, 120, 122, 123, 124, 126, 127, 128, 129, 130, 132, 134, 136, 138, 139, 140, 143, 145, 146, 147, 148, 149, 151, 152, 153, 154, 156, 159, 163, 164, 166, 167, 168, 169, 171, 173, 174, 175, 176, 177, 178, 179, 181, 182, 187, 188, 190, 191, 192, 193, 194, 195, 196, 198]"
Olaf,L0,short,141,59,82,7,0.295,200,"[0, 1, 3, 5, 6, 7, 8, 9, 10, 11, 12, 14, 15, 16, 18, 19, 20, 21, 22, 25, 26, 27, 29, 31, 32, 33, 34, 35, 36, 37, 38, 39, 40, 42, 43, 44, 46, 47, 48, 50, 52, 53, 55, 56, 58, 59, 60, 61, 62, 63, 64, 65, 66, 67, 68, 69, 71, 72, 73, 74, 75, 76, 77, 81, 85, 86, 87, 89, 90, 91, 92, 95, 96, 97, 99, 101, 102, 105, 106, 107, 108, 109, 111, 112, 114, 115, 118, 120, 121, 123, 124, 126, 127, 129, 130, 134, 135, 137, 139, 142, 143, 144, 145, 148, 150, 151, 152, 154, 155, 156, 158, 160, 161, 162, 163, 164, 165, 167, 168, 169, 170, 171, 172, 173, 174, 175, 177, 178, 179, 180, 182, 183, 184, 185, 187, 189, 190, 195, 196, 197, 199]"
Olaf,L0,short,127,61,66,16,0.365,200,"[0, 2, 3, 5, 6, 7, 8, 13, 14, 17, 18, 19, 20, 21, 23, 25, 26, 28, 29, 30, 31, 32, 35, 36, 37, 41, 43, 45, 47, 48, 49, 50, 51, 56, 57, 58, 59, 60, 61, 62, 64, 65, 66, 69, 70, 73, 75, 76, 78, 79, 80, 81, 82, 83, 84, 85, 86, 87, 88, 89, 94, 96, 98, 100, 107, 109, 110, 112, 113, 118, 119, 120, 121, 122, 123, 124, 126, 128, 130, 131, 132, 133, 134, 135, 136, 137, 139, 140, 143, 144, 145, 149, 150, 151, 152, 153, 155, 157, 158, 159, 162, 164, 165, 166, 167, 168, 169, 170, 172, 173, 174, 176, 178, 180, 181, 184, 185, 186, 189, 191, 193, 194, 195, 196, 197, 198, 199]"
Olaf,L0,short,127,66,61,5,0.365,200,"[2, 3, 4, 6, 7, 8, 9, 10, 11, 12, 13, 15, 20, 22, 24, 26, 27, 28, 29, 31, 32, 33, 34, 35, 38, 39, 40, 42, 46, 49, 50, 52, 53, 54, 55, 59, 61, 62, 63, 64, 65, 72, 74, 79, 80, 81, 82, 83, 86, 87, 88, 89, 90, 91, 92, 93, 96, 97, 98, 99, 100, 101, 103, 104, 105, 106, 109, 110, 111, 112, 113, 114, 118, 120, 121, 122, 123, 125, 129, 130, 131, 134, 137, 138, 141, 142, 143, 144, 146, 147, 149, 150, 153, 154, 155, 157, 158, 160, 163, 164, 165, 166, 167, 169, 171, 172, 173, 175, 176, 177, 179, 180, 181, 182, 183, 184, 185, 187, 188, 189, 190, 193, 195, 196, 197, 198, 199]"
Olaf,L0,short,132,76,56,4,0.34,200,"[0, 2, 3, 4, 5, 6, 7, 8, 9, 10, 11, 13, 15, 16, 17, 18, 19, 20, 21, 23, 24, 27, 28, 29, 31, 32, 33, 35, 37, 38, 39, 42, 44, 47, 48, 49, 50, 51, 54, 55, 56, 57, 58, 59, 60, 61, 62, 63, 64, 66, 68, 70, 72, 74, 75, 76, 78, 79, 82, 83, 84, 85, 86, 89, 91, 93, 94, 98, 104, 105, 106, 107, 108, 110, 113, 115, 116, 117, 118, 119, 121, 123, 124, 125, 126, 129, 131, 132, 133, 134, 135, 138, 139, 140, 141, 142, 143, 146, 147, 150, 153, 154, 158, 159, 160, 161, 162, 165, 166, 167, 168, 169, 170, 171, 172, 174, 175, 178, 181, 183, 184, 185, 186, 187, 189, 191, 192, 194, 195, 196, 197, 199]"
Olaf,L0,short,148,84,64,2,0.26,200,"[0, 1, 2, 4, 5, 6, 8, 9, 10, 11, 12, 14, 15, 16, 17, 18, 19, 20, 21, 23, 25, 26, 28, 30, 31, 32, 34, 35, 36, 37, 38, 39, 41, 42, 44, 45, 46, 47, 48, 51, 52, 53, 54, 55, 57, 59, 60, 61, 62, 64, 65, 66, 68, 69, 70, 71, 72, 73, 74, 75, 76, 77, 78, 80, 82, 83, 84, 85, 86, 87, 88, 89, 91, 93, 94, 95, 96, 98, 99, 100, 101, 103, 105, 106, 108, 109, 113, 114, 115, 117, 118, 119, 120, 122, 123, 125, 126, 128, 130, 132, 133, 134, 136, 137, 138, 139, 141, 143, 145, 146, 148, 149, 151, 153, 154, 155, 156, 159, 161, 162, 163, 164, 166, 167, 168, 169, 170, 172, 173, 174, 175, 177, 178, 179, 180, 183, 185, 186, 187, 188, 192, 193, 194, 195, 196, 197, 198, 199]"
Olaf,L0,short,133,68,65,10,0.335,200,"[0, 1, 2, 3, 4, 5, 7, 9, 10, 11, 12, 13, 15, 17, 18, 19, 20, 21, 22, 24, 25, 29, 32, 33, 34, 35, 36, 37, 38, 39, 41, 42, 44, 45, 48, 49, 51, 53, 54, 57, 58, 61, 64, 65, 66, 67, 68, 74, 75, 76, 77, 78, 79, 80, 81, 82, 83, 85, 86, 88, 89, 90, 91, 93, 94, 95, 96, 99, 100, 101, 103, 109, 110, 111, 112, 113, 114, 116, 121, 122, 125, 126, 127, 128, 129, 130, 131, 132, 134, 137, 143, 145, 146, 147, 148, 150, 152, 153, 154, 156, 157, 158, 159, 160, 161, 162, 163, 166, 168, 169, 170, 171, 172, 174, 175, 176, 178, 179, 180, 183, 184, 185, 186, 188, 189, 190, 191, 193, 194, 195, 196, 197, 199]"
Olaf,L0,short,118,71,47,9,0.41,200,"[0, 2, 4, 5, 6, 7, 8, 9, 10, 14, 15, 16, 20, 21, 23, 24, 25, 29, 32, 33, 35, 37, 42, 43, 45, 46, 47, 50, 53, 55, 56, 58, 59, 61, 62, 63, 65, 69, 70, 71, 72, 75, 79, 81, 83, 85, 86, 87, 89, 93, 94, 95, 96, 97, 98, 99, 100, 101, 102, 103, 104, 105, 110, 112, 113, 114, 115, 116, 117, 121, 122, 123, 125, 126, 127, 128, 130, 131, 134, 136, 137, 138, 140, 142, 143, 144, 148, 152, 153, 154, 155, 162, 163, 164, 165, 166, 167, 168, 170, 171, 174, 175, 176, 177, 182, 183, 184, 185, 186, 187, 189, 190, 193, 194, 195, 197, 198, 199]"
Olaf,L0,short,142,69,73,3,0.29,200,"[0, 1, 2, 3, 5, 6, 7, 10, 11, 12, 14, 15, 17, 18, 19, 20, 23, 24, 26, 28, 30, 32, 34, 35, 36, 37, 38, 39, 42, 43, 45, 47, 48, 49, 50, 52, 53, 54, 57, 58, 60, 61, 64, 65, 66, 68, 69, 71, 72, 73, 74, 77, 78, 79, 80, 81, 83, 84, 85, 86, 87, 88, 89, 90, 91, 93, 94, 95, 97, 99, 100, 101, 102, 103, 104, 105, 108, 109, 110, 111, 112, 113, 114, 115, 116, 117, 119, 121, 122, 124, 125, 127, 130, 131, 132, 134, 135, 137, 138, 140, 141, 143, 144, 145, 147, 148, 149, 150, 152, 153, 154, 155, 157, 158, 160, 161, 162, 165, 168, 169, 170, 171, 172, 175, 177, 179, 180, 182, 183, 184, 185, 186, 187, 189, 191, 192, 193, 194, 195, 197, 198, 199]"
Olaf,L0,short,135,77,58,10,0.325,200,"[0, 1, 3, 4, 6, 7, 8, 9, 10, 11, 12, 13, 15, 16, 17, 18, 19, 21, 22, 23, 24, 25, 26, 27, 28, 29, 31, 32, 33, 34, 35, 39, 41, 42, 44, 46, 47, 49, 51, 53, 57, 58, 59, 62, 66, 67, 68, 69, 70, 72, 73, 75, 76, 78, 79, 81, 82, 83, 85, 91, 94, 96, 97, 98, 103, 105, 107, 108, 109, 110, 111, 112, 115, 117, 118, 119, 120, 121, 122, 123, 124, 125, 126, 127, 129, 130, 131, 132, 133, 134, 136, 138, 139, 140, 141, 142, 143, 145, 146, 147, 148, 149, 150, 151, 152, 153, 155, 156, 157, 158, 160, 161, 162, 164, 165, 166, 167, 168, 170, 174, 179, 181, 182, 183, 185, 186, 187, 188, 191, 192, 193, 194, 195, 196, 198]"
Olaf,L0,short,115,53,62,11,0.425,200,"[2, 3, 4, 5, 6, 12, 13, 14, 15, 17, 18, 20, 22, 26, 27, 28, 30, 31, 33, 34, 35, 38, 39, 40, 41, 42, 45, 46, 52, 54, 56, 57, 58, 59, 60, 64, 65, 66, 69, 70, 71, 76, 78, 79, 80, 82, 83, 84, 85, 87, 88, 89, 90, 91, 92, 96, 100, 101, 102, 104, 106, 109, 110, 112, 114, 116, 118, 119, 120, 121, 122, 123, 124, 125, 128, 129, 131, 134, 137, 141, 146, 147, 148, 150, 153, 155, 156, 157, 158, 161, 162, 165, 167, 168, 169, 170, 171, 173, 174, 176, 178, 180, 181, 182, 183, 184, 185, 187, 189, 190, 191, 192, 193, 194, 197]"
Olaf,L0,short,125,40,85,15,0.375,200,"[2, 3, 4, 5, 6, 7, 8, 9, 10, 11, 12, 13, 14, 15, 16, 17, 19, 20, 21, 23, 24, 25, 26, 28, 29, 31, 32, 33, 34, 37, 38, 39, 40, 41, 44, 45, 46, 48, 50, 53, 55, 58, 60, 62, 64, 68, 69, 70, 72, 75, 76, 77, 78, 80, 82, 84, 88, 89, 91, 94, 95, 98, 100, 101, 102, 104, 108, 109, 110, 111, 112, 114, 115, 116, 117, 118, 119, 121, 123, 124, 126, 127, 128, 129, 132, 133, 134, 135, 137, 138, 140, 141, 144, 145, 149, 150, 151, 152, 153, 154, 155, 156, 158, 159, 161, 163, 170, 172, 173, 174, 176, 177, 179, 180, 181, 182, 183, 185, 188, 189, 191, 192, 193, 197, 199]"
Olaf,L50,short,134,53,81,13,0.33,200,"[1, 2, 3, 5, 6, 7, 12, 13, 15, 17, 19, 20, 24, 25, 26, 27, 28, 29, 30, 31, 32, 33, 34, 36, 38, 39, 40, 41, 42, 43, 44, 45, 46, 47, 48, 50, 51, 54, 56, 57, 59, 60, 63, 65, 66, 68, 69, 70, 71, 73, 76, 80, 81, 83, 84, 86, 88, 89, 90, 92, 95, 97, 98, 99, 101, 103, 104, 105, 106, 108, 109, 110, 111, 112, 113, 114, 115, 116, 117, 118, 121, 123, 124, 125, 126, 127, 128, 129, 130, 134, 135, 136, 138, 140, 141, 142, 145, 147, 150, 151, 152, 153, 154, 155, 157, 158, 159, 161, 162, 163, 165, 166, 167, 168, 169, 170, 171, 172, 173, 176, 177, 178, 180, 182, 184, 185, 186, 187, 190, 191, 192, 193, 194, 198]"
Olaf,L50,short,135,74,61,3,0.325,200,"[1, 2, 3, 5, 9, 10, 11, 13, 14, 15, 17, 18, 20, 21, 23, 24, 25, 26, 27, 29, 30, 31, 33, 35, 36, 37, 39, 40, 41, 43, 45, 46, 47, 49, 50, 51, 52, 53, 55, 56, 58, 60, 61, 63, 64, 68, 70, 71, 72, 73, 74, 75, 76, 77, 78, 80, 82, 84, 85, 88, 89, 91, 92, 93, 95, 96, 97, 98, 101, 103, 104, 105, 106, 107, 109, 110, 113, 115, 116, 118, 119, 120, 122, 123, 124, 125, 126, 128, 129, 130, 131, 132, 135, 137, 140, 141, 142, 143, 145, 146, 147, 148, 149, 150, 151, 152, 154, 156, 157, 158, 159, 160, 161, 164, 165, 166, 167, 169, 174, 175, 177, 178, 179, 181, 184, 187, 188, 189, 192, 193, 194, 195, 196, 197, 199]"
Olaf,L50,short,135,80,55,10,0.325,200,"[0, 1, 2, 5, 7, 9, 10, 11, 12, 14, 15, 16, 21, 22, 24, 26, 27, 28, 29, 30, 32, 33, 34, 35, 40, 41, 43, 44, 45, 46, 49, 50, 51, 53, 54, 59, 61, 62, 63, 64, 65, 66, 68, 69, 71, 73, 76, 77, 78, 79, 80, 81, 82, 83, 84, 85, 86, 88, 89, 90, 93, 94, 96, 99, 100, 101, 102, 103, 109, 110, 113, 114, 116, 118, 119, 120, 121, 122, 124, 125, 126, 127, 128, 130, 131, 133, 134, 135, 136, 138, 139, 141, 142, 143, 145, 146, 147, 148, 150, 151, 152, 153, 154, 155, 156, 157, 159, 160, 161, 162, 163, 164, 165, 168, 169, 171, 172, 173, 174, 175, 178, 181, 183, 184, 186, 188, 189, 190, 191, 192, 193, 195, 196, 197, 198]"
Olaf,L50,short,127,59,68,7,0.365,200,"[0, 1, 3, 5, 7, 9, 10, 11, 13, 14, 15, 16, 17, 18, 19, 20, 21, 22, 26, 29, 31, 32, 33, 35, 37, 38, 39, 40, 41, 44, 45, 46, 47, 48, 51, 53, 54, 55, 57, 58, 59, 60, 63, 64, 65, 67, 68, 69, 70, 71, 72, 74, 75, 76, 77, 79, 82, 83, 85, 87, 88, 89, 92, 93, 94, 95, 96, 97, 99, 100, 103, 105, 106, 108, 111, 114, 115, 116, 117, 119, 120, 121, 123, 124, 125, 126, 128, 129, 131, 132, 133, 135, 137, 140, 142, 144, 146, 149, 150, 151, 153, 154, 156, 157, 158, 162, 164, 165, 166, 168, 169, 171, 172, 176, 178, 179, 182, 183, 185, 186, 188, 189, 191, 194, 195, 198, 199]"
Olaf,L50,short,127,73,54,12,0.365,200,"[0, 1, 2, 3, 5, 6, 7, 10, 12, 14, 16, 18, 19, 20, 21, 22, 24, 25, 28, 29, 30, 31, 32, 33, 34, 36, 38, 39, 43, 48, 49, 51, 52, 53, 55, 56, 57, 58, 60, 61, 62, 63, 65, 66, 67, 70, 71, 72, 75, 76, 78, 79, 81, 82, 83, 84, 85, 87, 88, 90, 92, 97, 99, 100, 101, 102, 103, 104, 105, 111, 112, 113, 115, 118, 119, 120, 121, 123, 125, 126, 127, 133, 134, 136, 137, 142, 143, 144, 145, 146, 147, 148, 150, 151, 153, 158, 159, 160, 161, 162, 163, 165, 167, 168, 169, 170, 171, 172, 173, 175, 176, 177, 178, 180, 182, 183, 184, 185, 186, 188, 189, 190, 191, 194, 195, 197, 198]"
Olaf,L50,short,135,62,73,3,0.325,200,"[0, 1, 2, 4, 5, 7, 8, 9, 12, 13, 15, 17, 19, 20, 22, 23, 24, 25, 26, 27, 28, 31, 32, 33, 34, 37, 38, 39, 40, 42, 44, 46, 47, 48, 49, 50, 52, 53, 56, 57, 58, 59, 60, 61, 62, 63, 64, 66, 67, 68, 70, 71, 72, 74, 75, 76, 78, 81, 82, 84, 95, 97, 98, 100, 101, 102, 104, 105, 106, 109, 110, 111, 113, 114, 115, 116, 118, 119, 121, 122, 123, 124, 125, 126, 127, 128, 129, 130, 133, 134, 135, 137, 138, 139, 140, 141, 142, 145, 146, 148, 150, 151, 152, 153, 154, 155, 156, 158, 159, 160, 161, 164, 165, 167, 168, 170, 171, 174, 177, 178, 179, 180, 181, 183, 184, 185, 186, 187, 189, 190, 191, 194, 195, 198, 199]"
Olaf,L50,short,130,75,55,5,0.35,200,"[0, 4, 6, 8, 10, 13, 14, 16, 19, 20, 23, 24, 25, 26, 27, 29, 30, 31, 32, 33, 35, 36, 39, 40, 41, 42, 43, 44, 45, 49, 50, 51, 53, 55, 56, 57, 58, 59, 62, 63, 64, 65, 66, 67, 68, 69, 70, 71, 73, 75, 79, 80, 82, 83, 84, 85, 87, 88, 91, 93, 95, 97, 98, 99, 100, 101, 103, 104, 105, 107, 108, 110, 112, 113, 115, 116, 117, 118, 120, 122, 123, 124, 127, 128, 130, 133, 135, 136, 137, 138, 141, 142, 144, 145, 147, 149, 150, 151, 152, 154, 155, 156, 157, 158, 160, 162, 164, 165, 166, 167, 168, 169, 171, 173, 174, 175, 176, 178, 179, 180, 184, 185, 188, 190, 191, 192, 194, 196, 197, 198]"
Olaf,L50,short,142,68,74,8,0.29,200,"[0, 1, 2, 3, 4, 5, 8, 9, 10, 11, 13, 14, 15, 16, 17, 18, 19, 20, 22, 23, 24, 25, 26, 27, 29, 31, 32, 33, 36, 38, 39, 41, 42, 45, 46, 47, 48, 49, 50, 53, 54, 56, 57, 61, 62, 65, 68, 69, 70, 72, 73, 74, 76, 77, 78, 79, 80, 82, 83, 84, 85, 86, 87, 88, 91, 93, 95, 97, 98, 99, 100, 101, 102, 103, 104, 105, 106, 107, 108, 109, 111, 113, 114, 115, 117, 118, 121, 122, 124, 125, 128, 129, 130, 131, 132, 134, 136, 139, 140, 141, 143, 144, 146, 147, 148, 152, 153, 154, 155, 156, 158, 159, 161, 162, 165, 166, 167, 168, 169, 170, 171, 173, 174, 175, 177, 178, 179, 180, 181, 182, 185, 186, 187, 188, 190, 191, 192, 193, 194, 195, 197, 199]"
Olaf,L50,short,131,49,82,6,0.345,200,"[1, 2, 4, 6, 7, 8, 10, 15, 18, 22, 23, 24, 25, 26, 27, 28, 30, 31, 32, 33, 34, 35, 37, 38, 40, 41, 44, 45, 46, 47, 48, 49, 50, 51, 52, 53, 54, 58, 60, 62, 63, 64, 65, 66, 67, 68, 69, 74, 75, 76, 79, 80, 81, 82, 83, 84, 85, 86, 88, 89, 93, 95, 96, 97, 98, 100, 101, 102, 105, 106, 109, 110, 111, 112, 113, 116, 117, 119, 123, 125, 126, 127, 128, 129, 130, 131, 132, 133, 135, 136, 137, 138, 139, 141, 143, 144, 145, 147, 148, 149, 151, 152, 154, 155, 156, 157, 162, 164, 165, 167, 168, 169, 170, 171, 173, 177, 178, 181, 182, 184, 185, 186, 187, 188, 189, 191, 192, 193, 195, 197, 198]"
Olaf,L50,short,133,57,76,8,0.335,200,"[0, 1, 2, 3, 4, 6, 7, 8, 10, 11, 17, 18, 19, 20, 21, 24, 26, 27, 28, 30, 31, 33, 38, 39, 40, 43, 44, 45, 46, 48, 49, 50, 51, 52, 53, 54, 55, 56, 57, 58, 60, 62, 63, 65, 66, 67, 70, 72, 75, 76, 77, 78, 79, 84, 85, 87, 89, 90, 91, 92, 93, 96, 97, 98, 99, 101, 102, 103, 105, 106, 107, 108, 110, 111, 112, 114, 116, 118, 119, 120, 121, 122, 123, 124, 125, 127, 128, 130, 133, 137, 138, 139, 141, 142, 144, 146, 147, 148, 149, 150, 151, 152, 153, 154, 155, 156, 157, 160, 162, 163, 164, 165, 166, 168, 171, 172, 174, 175, 179, 183, 185, 186, 187, 188, 189, 190, 192, 193, 194, 195, 196, 197, 198]"
Olaf,L50,short,131,76,55,16,0.345,200,"[1, 3, 4, 6, 8, 9, 11, 15, 16, 17, 18, 19, 20, 22, 23, 24, 25, 27, 28, 31, 32, 33, 34, 36, 38, 39, 40, 41, 42, 43, 44, 45, 46, 47, 51, 52, 53, 54, 58, 59, 60, 62, 63, 66, 67, 68, 69, 70, 71, 72, 73, 75, 76, 77, 80, 81, 82, 83, 86, 87, 88, 89, 91, 92, 96, 99, 104, 106, 108, 109, 111, 112, 113, 115, 116, 117, 121, 123, 125, 126, 127, 129, 130, 132, 133, 135, 136, 137, 140, 141, 145, 147, 148, 149, 150, 151, 152, 153, 156, 157, 158, 159, 160, 161, 163, 164, 165, 167, 168, 169, 170, 171, 173, 174, 176, 178, 180, 181, 182, 184, 185, 186, 188, 189, 191, 193, 194, 196, 197, 198, 199]"
Olaf,L50,short,140,55,85,12,0.3,200,"[0, 1, 3, 4, 5, 6, 8, 10, 13, 15, 21, 23, 24, 27, 28, 29, 30, 32, 37, 41, 42, 43, 44, 45, 46, 47, 48, 49, 50, 52, 53, 54, 56, 57, 58, 59, 61, 62, 63, 64, 65, 66, 67, 68, 70, 71, 72, 73, 74, 75, 78, 79, 80, 81, 83, 84, 85, 87, 89, 90, 91, 92, 93, 95, 98, 99, 100, 101, 102, 104, 105, 106, 107, 108, 109, 110, 112, 113, 115, 117, 118, 119, 121, 122, 123, 124, 125, 126, 127, 129, 130, 131, 132, 133, 134, 135, 138, 140, 141, 143, 146, 148, 149, 150, 151, 152, 153, 155, 156, 157, 160, 161, 162, 163, 164, 165, 166, 168, 170, 171, 172, 173, 176, 178, 180, 181, 182, 183, 184, 185, 186, 189, 191, 192, 193, 194, 195, 196, 197, 199]"
Olaf,L50,short,126,61,65,18,0.37,200,"[1, 3, 4, 6, 8, 9, 10, 14, 15, 16, 17, 18, 19, 20, 24, 26, 28, 29, 32, 36, 39, 40, 41, 42, 43, 44, 46, 47, 48, 49, 52, 55, 57, 58, 60, 61, 63, 67, 69, 70, 71, 72, 73, 76, 77, 79, 83, 85, 86, 87, 89, 90, 91, 94, 95, 98, 100, 101, 102, 103, 104, 105, 106, 107, 109, 110, 111, 112, 113, 114, 115, 116, 117, 118, 119, 121, 122, 125, 128, 130, 132, 133, 135, 137, 138, 139, 140, 142, 143, 144, 146, 147, 149, 150, 151, 152, 153, 155, 156, 157, 158, 160, 162, 164, 167, 168, 169, 173, 176, 178, 181, 182, 183, 184, 185, 187, 188, 189, 190, 192, 193, 194, 195, 197, 198, 199]"
Olaf,L50,short,133,78,55,5,0.335,200,"[1, 4, 6, 7, 8, 9, 10, 11, 12, 13, 15, 17, 19, 20, 22, 23, 25, 26, 27, 28, 29, 31, 33, 36, 39, 40, 43, 44, 45, 46, 47, 48, 49, 50, 52, 53, 54, 55, 56, 57, 58, 59, 60, 64, 66, 68, 69, 70, 72, 73, 74, 77, 78, 79, 81, 82, 83, 84, 86, 88, 89, 93, 94, 97, 98, 100, 101, 102, 104, 105, 106, 108, 110, 113, 118, 119, 120, 121, 122, 123, 124, 125, 126, 127, 128, 129, 130, 131, 132, 134, 136, 138, 140, 142, 144, 147, 149, 150, 152, 153, 154, 155, 156, 157, 158, 160, 161, 162, 164, 165, 166, 167, 168, 169, 170, 171, 172, 173, 175, 176, 178, 179, 180, 183, 184, 186, 190, 192, 194, 195, 196, 197, 199]"
Olaf,L50,short,136,76,60,12,0.32,200,"[0, 6, 7, 8, 9, 10, 11, 14, 15, 16, 17, 18, 20, 21, 23, 24, 25, 27, 28, 30, 32, 34, 35, 36, 37, 40, 41, 42, 43, 44, 45, 46, 47, 49, 50, 51, 52, 57, 58, 59, 60, 66, 67, 68, 69, 70, 73, 74, 76, 78, 79, 80, 81, 82, 83, 85, 86, 88, 89, 90, 92, 93, 94, 95, 96, 97, 101, 103, 106, 107, 108, 109, 111, 115, 116, 117, 119, 120, 123, 124, 128, 129, 130, 131, 132, 134, 135, 137, 139, 140, 141, 142, 143, 144, 148, 151, 152, 153, 154, 155, 157, 158, 160, 161, 162, 163, 164, 168, 169, 170, 171, 172, 173, 175, 176, 177, 178, 179, 180, 181, 182, 184, 185, 186, 187, 188, 190, 191, 192, 193, 194, 195, 196, 197, 198, 199]"
Olaf,L50,short,141,59,82,8,0.295,200,"[3, 4, 6, 7, 9, 10, 11, 12, 13, 15, 16, 17, 18, 20, 21, 22, 23, 26, 28, 29, 32, 33, 35, 36, 37, 38, 39, 40, 43, 44, 45, 46, 48, 49, 50, 52, 54, 57, 58, 61, 62, 63, 64, 65, 66, 67, 68, 69, 70, 71, 72, 73, 76, 78, 79, 81, 84, 86, 87, 88, 89, 91, 93, 94, 95, 96, 97, 98, 100, 101, 102, 103, 104, 105, 106, 107, 108, 111, 113, 115, 118, 121, 122, 123, 125, 128, 129, 131, 132, 135, 136, 137, 138, 139, 140, 141, 142, 143, 144, 145, 146, 147, 148, 149, 150, 152, 153, 154, 155, 156, 157, 158, 159, 161, 163, 164, 165, 167, 168, 169, 170, 172, 174, 175, 176, 177, 178, 180, 181, 182, 184, 185, 186, 188, 189, 190, 191, 194, 196, 197, 198]"
Olaf,L50,short,136,75,61,4,0.32,200,"[2, 3, 4, 5, 6, 8, 9, 10, 12, 13, 15, 16, 17, 18, 19, 21, 23, 25, 26, 27, 28, 29, 30, 32, 34, 35, 36, 38, 39, 40, 42, 47, 48, 49, 52, 53, 54, 59, 61, 62, 64, 65, 66, 67, 68, 69, 74, 76, 77, 78, 82, 83, 84, 85, 89, 90, 92, 93, 94, 96, 97, 98, 99, 100, 101, 102, 104, 105, 107, 109, 111, 112, 115, 116, 117, 122, 123, 124, 125, 126, 127, 128, 129, 131, 132, 133, 134, 135, 136, 138, 139, 140, 141, 142, 144, 145, 146, 148, 149, 150, 151, 153, 154, 155, 156, 159, 160, 161, 162, 163, 165, 168, 169, 170, 171, 172, 174, 175, 177, 178, 181, 182, 183, 184, 185, 186, 187, 190, 191, 192, 193, 194, 195, 197, 198, 199]"
Olaf,L50,short,144,80,64,5,0.28,200,"[0, 1, 2, 4, 7, 8, 9, 10, 11, 15, 16, 17, 18, 19, 20, 22, 25, 26, 27, 28, 33, 35, 36, 37, 38, 39, 40, 41, 42, 43, 45, 46, 48, 50, 51, 52, 53, 56, 57, 58, 60, 63, 65, 66, 68, 69, 70, 71, 72, 73, 75, 76, 77, 78, 79, 81, 83, 84, 85, 87, 88, 89, 90, 91, 93, 94, 95, 96, 97, 98, 99, 100, 102, 103, 105, 106, 109, 110, 111, 112, 113, 114, 115, 117, 118, 119, 120, 121, 122, 127, 129, 130, 131, 132, 133, 135, 136, 137, 138, 139, 140, 141, 142, 144, 145, 146, 147, 148, 150, 153, 154, 155, 158, 159, 162, 163, 164, 165, 166, 168, 170, 172, 173, 174, 176, 177, 178, 179, 180, 182, 183, 184, 185, 187, 188, 189, 190, 191, 192, 193, 194, 197, 198, 199]"
Olaf,L50,short,130,73,57,22,0.35,200,"[0, 1, 3, 5, 6, 7, 8, 10, 11, 12, 13, 14, 15, 16, 17, 21, 22, 23, 24, 27, 28, 29, 31, 33, 34, 35, 36, 37, 39, 40, 42, 43, 44, 45, 46, 47, 48, 49, 57, 59, 60, 62, 66, 67, 68, 70, 71, 72, 73, 75, 76, 78, 79, 80, 82, 85, 86, 87, 90, 92, 93, 94, 95, 96, 97, 98, 99, 100, 102, 104, 105, 106, 107, 109, 110, 113, 115, 116, 118, 119, 121, 122, 124, 125, 128, 130, 131, 132, 134, 135, 139, 140, 141, 142, 143, 144, 145, 146, 147, 148, 149, 150, 151, 152, 153, 155, 157, 158, 161, 162, 164, 167, 168, 169, 171, 174, 176, 178, 179, 180, 181, 182, 184, 185, 186, 191, 193, 197, 198, 199]"
Olaf,L50,short,124,72,52,11,0.38,200,"[0, 1, 3, 8, 9, 10, 11, 12, 14, 15, 16, 18, 21, 22, 23, 25, 26, 27, 28, 29, 31, 33, 34, 35, 37, 38, 39, 40, 41, 44, 47, 49, 52, 53, 56, 58, 60, 61, 63, 67, 68, 69, 70, 71, 72, 73, 74, 78, 79, 80, 84, 86, 87, 88, 89, 91, 92, 93, 94, 95, 97, 98, 99, 102, 103, 104, 106, 108, 109, 110, 111, 113, 115, 117, 119, 122, 123, 124, 127, 128, 129, 131, 133, 134, 135, 136, 138, 139, 140, 142, 146, 147, 149, 151, 153, 155, 158, 159, 161, 163, 164, 165, 166, 167, 168, 169, 170, 172, 174, 175, 176, 177, 178, 179, 182, 184, 185, 187, 189, 190, 193, 195, 196, 197]"
Olaf,L50,short,147,75,72,0,0.265,200,"[0, 1, 2, 3, 6, 7, 8, 9, 10, 11, 12, 13, 15, 18, 19, 20, 21, 22, 23, 24, 25, 26, 27, 28, 29, 31, 33, 35, 36, 37, 38, 39, 40, 42, 45, 46, 48, 49, 52, 53, 56, 58, 59, 60, 62, 63, 64, 67, 68, 69, 71, 73, 74, 75, 76, 77, 78, 79, 80, 81, 82, 83, 84, 85, 86, 87, 88, 89, 90, 92, 93, 94, 95, 96, 97, 99, 101, 102, 105, 106, 107, 109, 110, 111, 112, 114, 115, 116, 117, 118, 119, 120, 122, 123, 124, 126, 127, 128, 129, 130, 131, 134, 135, 136, 137, 138, 140, 141, 142, 145, 146, 147, 148, 149, 150, 151, 155, 157, 158, 159, 161, 163, 164, 165, 167, 168, 169, 170, 171, 173, 174, 175, 177, 180, 181, 183, 184, 185, 188, 189, 191, 192, 194, 195, 197, 198, 199]"
Olaf,L50,short,139,61,78,8,0.305,200,"[0, 2, 3, 4, 5, 6, 7, 10, 11, 13, 16, 21, 22, 23, 24, 25, 26, 27, 28, 30, 31, 33, 34, 35, 36, 37, 38, 39, 40, 41, 42, 44, 45, 47, 49, 53, 57, 59, 60, 61, 62, 63, 65, 67, 68, 71, 72, 73, 75, 76, 77, 80, 81, 82, 83, 84, 85, 86, 87, 88, 89, 90, 91, 92, 95, 96, 97, 99, 100, 102, 104, 105, 106, 107, 108, 109, 110, 111, 112, 113, 114, 115, 117, 118, 119, 121, 122, 123, 127, 129, 130, 132, 133, 134, 136, 141, 143, 144, 145, 146, 147, 149, 151, 153, 154, 155, 156, 157, 159, 160, 161, 162, 163, 164, 165, 167, 168, 170, 171, 172, 173, 175, 176, 177, 179, 180, 181, 182, 183, 185, 187, 188, 189, 190, 191, 193, 194, 195, 196]"
Olaf,L50,short,132,66,66,9,0.34,200,"[1, 3, 6, 9, 11, 13, 14, 15, 17, 18, 19, 20, 21, 23, 24, 26, 27, 28, 29, 30, 31, 32, 33, 34, 39, 41, 42, 44, 45, 46, 48, 49, 50, 51, 52, 55, 58, 60, 61, 62, 64, 65, 66, 67, 68, 69, 71, 72, 73, 75, 80, 84, 85, 87, 88, 90, 91, 92, 94, 95, 96, 99, 100, 102, 104, 105, 106, 107, 110, 111, 114, 115, 116, 117, 118, 119, 120, 123, 124, 127, 132, 133, 134, 136, 137, 139, 140, 143, 146, 147, 148, 149, 150, 151, 152, 153, 155, 156, 157, 158, 159, 160, 161, 162, 163, 165, 166, 167, 169, 170, 171, 172, 173, 175, 177, 178, 180, 182, 183, 184, 185, 186, 188, 189, 191, 192, 193, 194, 196, 197, 198, 199]"
Olaf,L50,short,131,67,64,9,0.345,200,"[0, 2, 3, 6, 10, 13, 16, 17, 19, 20, 21, 23, 25, 30, 31, 32, 34, 35, 36, 37, 38, 40, 41, 42, 43, 46, 48, 49, 50, 53, 54, 56, 57, 58, 59, 60, 61, 62, 63, 64, 67, 68, 69, 70, 71, 72, 73, 74, 75, 77, 80, 82, 84, 90, 91, 93, 94, 96, 98, 99, 100, 101, 103, 106, 107, 108, 111, 112, 113, 114, 115, 116, 119, 120, 123, 125, 126, 127, 129, 130, 132, 133, 134, 135, 136, 137, 138, 139, 140, 142, 143, 144, 145, 146, 147, 148, 150, 151, 152, 153, 154, 156, 158, 159, 161, 162, 166, 167, 168, 171, 172, 173, 174, 175, 176, 178, 179, 180, 182, 185, 186, 187, 188, 189, 191, 193, 194, 195, 197, 198, 199]"
Olaf,L50,short,136,64,72,6,0.32,200,"[0, 1, 2, 4, 5, 7, 8, 9, 10, 11, 12, 13, 15, 16, 17, 18, 19, 20, 21, 22, 24, 25, 27, 28, 29, 30, 31, 32, 33, 34, 35, 36, 39, 40, 41, 43, 44, 45, 48, 50, 51, 52, 53, 54, 55, 58, 59, 62, 63, 64, 66, 68, 71, 73, 76, 77, 78, 79, 81, 82, 84, 87, 88, 90, 92, 94, 96, 100, 101, 103, 104, 105, 106, 107, 109, 110, 113, 114, 115, 116, 119, 121, 128, 129, 130, 132, 134, 135, 136, 138, 139, 140, 141, 142, 143, 144, 145, 146, 147, 149, 150, 151, 152, 153, 155, 156, 157, 158, 161, 163, 165, 166, 168, 169, 170, 171, 173, 174, 176, 178, 179, 180, 181, 183, 185, 186, 187, 188, 189, 190, 191, 193, 194, 195, 197, 199]"
Olaf,L50,short,125,82,43,7,0.375,200,"[1, 2, 3, 4, 6, 7, 9, 10, 11, 13, 15, 18, 19, 22, 24, 25, 26, 29, 31, 32, 33, 35, 37, 41, 43, 44, 47, 48, 49, 54, 55, 57, 61, 62, 63, 64, 65, 66, 68, 71, 72, 73, 74, 75, 77, 78, 79, 82, 85, 86, 87, 91, 93, 94, 98, 99, 101, 102, 106, 107, 108, 109, 110, 111, 113, 115, 116, 118, 119, 121, 122, 123, 124, 125, 126, 127, 129, 130, 134, 135, 136, 137, 138, 139, 140, 141, 142, 145, 147, 148, 149, 150, 151, 152, 153, 155, 156, 159, 160, 163, 165, 166, 167, 170, 171, 172, 173, 175, 176, 179, 180, 181, 182, 183, 186, 188, 189, 190, 191, 192, 193, 194, 195, 198, 199]"
Olaf,L50,short,130,69,61,11,0.35,200,"[0, 1, 3, 4, 5, 7, 9, 10, 11, 12, 13, 14, 21, 24, 26, 27, 28, 29, 30, 31, 33, 34, 35, 36, 38, 39, 42, 43, 44, 48, 50, 51, 53, 55, 56, 58, 60, 61, 62, 63, 64, 66, 67, 69, 70, 71, 73, 76, 78, 79, 80, 81, 82, 83, 84, 85, 86, 89, 90, 91, 92, 99, 101, 102, 103, 105, 107, 109, 112, 113, 114, 115, 116, 117, 119, 120, 121, 124, 125, 126, 127, 128, 130, 132, 135, 136, 138, 141, 142, 144, 145, 146, 147, 148, 149, 150, 151, 153, 155, 156, 159, 162, 163, 164, 168, 169, 171, 172, 173, 174, 176, 178, 179, 180, 181, 182, 183, 184, 185, 188, 189, 190, 191, 192, 193, 194, 195, 196, 198, 199]"
Olaf,L50,short,124,51,73,12,0.38,200,"[0, 1, 3, 10, 11, 12, 13, 14, 15, 18, 20, 21, 22, 23, 24, 25, 26, 27, 28, 29, 30, 32, 33, 34, 35, 40, 41, 42, 43, 45, 47, 48, 50, 51, 52, 53, 56, 57, 58, 59, 60, 61, 62, 63, 64, 67, 68, 69, 70, 71, 72, 73, 74, 75, 77, 79, 81, 82, 83, 84, 85, 86, 87, 88, 90, 92, 93, 94, 95, 96, 98, 99, 104, 105, 109, 111, 112, 114, 115, 116, 117, 121, 123, 127, 128, 129, 130, 133, 134, 136, 137, 141, 143, 147, 148, 149, 152, 156, 157, 159, 160, 163, 164, 165, 166, 169, 170, 172, 173, 174, 175, 177, 178, 179, 180, 182, 186, 187, 188, 190, 193, 195, 196, 198]"
Olaf,L50,short,126,71,55,12,0.37,200,"[0, 1, 2, 4, 5, 7, 8, 9, 12, 15, 16, 18, 20, 21, 22, 23, 25, 28, 29, 31, 32, 33, 34, 35, 36, 37, 38, 39, 40, 41, 42, 43, 44, 46, 50, 52, 53, 54, 55, 58, 59, 60, 61, 62, 64, 65, 66, 70, 71, 73, 74, 78, 79, 80, 81, 83, 85, 87, 90, 91, 92, 93, 94, 95, 97, 98, 100, 101, 103, 107, 111, 116, 117, 119, 120, 121, 122, 123, 124, 125, 126, 127, 129, 130, 131, 133, 134, 135, 138, 139, 140, 141, 144, 146, 147, 150, 152, 153, 154, 155, 156, 157, 158, 161, 163, 167, 169, 170, 175, 176, 178, 179, 180, 181, 182, 183, 184, 185, 188, 189, 190, 191, 192, 194, 195, 198]"
Olaf,L50,short,145,71,74,8,0.275,200,"[0, 2, 3, 4, 6, 8, 9, 10, 11, 12, 13, 15, 16, 17, 18, 19, 21, 22, 23, 24, 26, 27, 28, 29, 30, 31, 32, 35, 36, 37, 39, 40, 41, 44, 45, 46, 48, 49, 50, 51, 52, 53, 54, 55, 56, 57, 58, 59, 61, 63, 64, 65, 66, 67, 68, 70, 71, 72, 73, 74, 75, 77, 78, 79, 80, 81, 82, 83, 85, 86, 88, 90, 94, 95, 96, 97, 99, 101, 104, 105, 106, 108, 109, 110, 112, 113, 114, 115, 117, 118, 119, 120, 121, 124, 125, 126, 127, 128, 130, 133, 134, 135, 138, 140, 142, 143, 144, 145, 146, 147, 148, 149, 150, 151, 152, 153, 157, 160, 161, 162, 163, 166, 167, 168, 171, 172, 173, 174, 175, 176, 178, 179, 180, 181, 182, 183, 185, 188, 190, 191, 192, 193, 194, 195, 199]"
Olaf,L50,short,136,80,56,9,0.32,200,"[0, 1, 2, 3, 4, 5, 6, 7, 9, 10, 11, 13, 14, 16, 17, 20, 21, 22, 23, 24, 26, 27, 29, 30, 31, 32, 34, 36, 38, 40, 41, 42, 44, 45, 46, 48, 49, 50, 52, 54, 56, 58, 59, 60, 62, 63, 65, 67, 68, 69, 70, 71, 72, 73, 74, 75, 76, 80, 81, 82, 84, 85, 86, 87, 88, 89, 91, 92, 93, 95, 96, 97, 98, 100, 101, 102, 103, 104, 106, 108, 109, 110, 111, 112, 114, 116, 117, 118, 119, 123, 125, 127, 128, 129, 130, 131, 132, 133, 134, 135, 137, 138, 140, 141, 142, 143, 145, 147, 150, 151, 153, 157, 159, 160, 161, 163, 164, 166, 170, 175, 176, 177, 178, 179, 181, 182, 183, 184, 186, 187, 189, 190, 192, 193, 197, 198]"
Olaf,L50,short,137,59,78,6,0.315,200,"[0, 2, 3, 4, 6, 8, 9, 10, 11, 14, 15, 17, 19, 23, 24, 25, 26, 27, 28, 30, 31, 32, 34, 36, 38, 39, 40, 41, 42, 43, 44, 47, 48, 50, 51, 52, 53, 55, 57, 58, 59, 60, 61, 62, 63, 64, 65, 68, 69, 72, 73, 74, 75, 77, 78, 79, 80, 82, 84, 85, 86, 88, 89, 90, 91, 92, 93, 94, 95, 96, 97, 98, 100, 101, 103, 104, 107, 108, 110, 111, 112, 113, 114, 115, 118, 121, 126, 128, 132, 133, 136, 137, 138, 139, 140, 143, 144, 146, 147, 148, 149, 151, 153, 154, 156, 157, 158, 159, 160, 161, 162, 163, 164, 165, 167, 168, 170, 171, 172, 175, 176, 177, 180, 181, 183, 184, 185, 186, 189, 190, 192, 194, 195, 196, 197, 198, 199]"
Olaf,L50,short,139,64,75,9,0.305,200,"[0, 1, 2, 3, 6, 7, 8, 9, 10, 11, 12, 14, 16, 18, 21, 22, 23, 24, 25, 27, 30, 31, 32, 35, 36, 37, 40, 41, 42, 43, 44, 45, 46, 49, 51, 52, 53, 54, 55, 56, 58, 59, 60, 61, 62, 64, 65, 68, 70, 74, 79, 80, 82, 83, 84, 85, 89, 92, 93, 95, 96, 97, 98, 99, 101, 102, 103, 104, 106, 107, 108, 109, 110, 112, 113, 114, 115, 116, 117, 118, 119, 120, 121, 122, 124, 125, 126, 127, 128, 130, 133, 134, 136, 137, 138, 140, 141, 143, 148, 149, 150, 151, 152, 153, 154, 155, 157, 158, 159, 160, 161, 164, 165, 166, 167, 168, 169, 170, 171, 172, 173, 174, 175, 176, 177, 178, 179, 180, 183, 187, 188, 189, 190, 192, 194, 195, 196, 197, 198]"
Olaf,L50,short,139,79,60,8,0.305,200,"[1, 2, 3, 4, 6, 9, 10, 11, 12, 16, 17, 18, 19, 20, 22, 23, 24, 26, 27, 31, 32, 33, 35, 36, 37, 38, 39, 40, 42, 43, 44, 48, 50, 51, 52, 53, 54, 55, 56, 57, 58, 59, 60, 61, 62, 63, 64, 66, 71, 73, 74, 75, 77, 78, 79, 81, 82, 86, 87, 89, 91, 93, 94, 95, 96, 98, 100, 101, 102, 104, 106, 107, 108, 109, 111, 112, 113, 114, 115, 116, 117, 119, 120, 121, 122, 124, 125, 126, 131, 133, 134, 136, 137, 138, 139, 142, 145, 146, 147, 150, 151, 152, 154, 155, 156, 160, 161, 163, 165, 166, 167, 168, 169, 170, 173, 174, 175, 176, 177, 178, 179, 180, 181, 182, 183, 184, 186, 187, 188, 189, 190, 191, 192, 193, 194, 195, 196, 197, 198]"
Olaf,L50,short,139,67,72,6,0.305,200,"[0, 1, 2, 3, 4, 6, 9, 10, 12, 13, 14, 16, 18, 19, 21, 23, 26, 27, 28, 29, 32, 33, 36, 37, 39, 40, 41, 42, 43, 45, 46, 47, 49, 50, 51, 52, 54, 56, 57, 59, 60, 61, 63, 64, 65, 67, 68, 72, 73, 75, 76, 81, 83, 85, 86, 87, 88, 90, 91, 92, 93, 94, 95, 96, 97, 98, 99, 100, 101, 102, 103, 105, 106, 107, 108, 110, 112, 113, 114, 116, 117, 118, 120, 122, 124, 126, 127, 131, 136, 139, 141, 142, 143, 144, 145, 146, 147, 148, 149, 150, 151, 152, 153, 154, 155, 156, 157, 159, 160, 162, 163, 164, 165, 166, 168, 169, 170, 171, 172, 173, 174, 175, 176, 179, 181, 183, 184, 185, 186, 187, 188, 189, 190, 191, 192, 193, 194, 195, 198]"
Olaf,L50,short,136,59,77,9,0.32,200,"[4, 5, 6, 7, 9, 10, 12, 16, 17, 18, 19, 20, 22, 24, 25, 26, 27, 28, 29, 31, 33, 34, 36, 37, 40, 41, 42, 44, 45, 46, 47, 48, 49, 51, 52, 53, 55, 58, 59, 62, 63, 64, 65, 66, 67, 71, 72, 73, 75, 76, 77, 80, 81, 83, 84, 85, 91, 92, 93, 94, 96, 98, 100, 102, 103, 104, 105, 106, 107, 108, 109, 110, 112, 113, 114, 117, 119, 120, 121, 122, 124, 125, 127, 128, 129, 131, 132, 133, 134, 135, 136, 137, 138, 139, 140, 141, 142, 143, 144, 145, 146, 148, 153, 154, 155, 157, 158, 159, 160, 161, 163, 166, 169, 170, 171, 172, 173, 174, 175, 176, 177, 178, 181, 182, 183, 184, 186, 187, 189, 190, 192, 194, 195, 196, 198, 199]"
Olaf,L50,short,126,62,64,16,0.37,200,"[1, 3, 4, 6, 7, 9, 10, 12, 13, 14, 17, 18, 19, 20, 22, 23, 24, 25, 26, 27, 28, 29, 30, 32, 33, 36, 37, 41, 42, 44, 45, 46, 47, 48, 49, 51, 55, 56, 57, 58, 60, 62, 63, 64, 66, 67, 68, 69, 71, 72, 73, 74, 75, 77, 79, 80, 81, 83, 84, 85, 87, 88, 89, 91, 95, 96, 97, 99, 100, 101, 103, 106, 107, 108, 109, 111, 113, 114, 115, 116, 117, 119, 120, 122, 123, 127, 128, 129, 130, 132, 133, 139, 140, 141, 143, 144, 146, 148, 149, 151, 153, 156, 159, 160, 161, 163, 165, 169, 171, 174, 175, 177, 180, 181, 182, 184, 185, 186, 187, 189, 192, 193, 194, 195, 196, 198]"
Olaf,L50,short,138,65,73,8,0.31,200,"[0, 2, 4, 6, 7, 8, 10, 11, 12, 13, 16, 18, 19, 22, 23, 24, 25, 26, 27, 29, 30, 31, 32, 33, 34, 35, 36, 37, 38, 42, 43, 44, 45, 46, 47, 49, 51, 52, 53, 54, 55, 56, 57, 59, 60, 61, 63, 65, 67, 69, 73, 77, 78, 80, 81, 83, 84, 85, 86, 88, 90, 92, 93, 94, 95, 96, 97, 101, 102, 103, 105, 106, 110, 115, 116, 117, 118, 119, 121, 122, 123, 125, 126, 127, 131, 132, 133, 134, 135, 136, 137, 138, 140, 141, 142, 144, 145, 146, 147, 148, 149, 150, 152, 154, 155, 156, 158, 159, 160, 162, 164, 165, 166, 168, 169, 171, 172, 173, 174, 175, 176, 177, 178, 179, 180, 181, 183, 184, 187, 189, 190, 191, 192, 193, 194, 196, 198, 199]"
Olaf,L50,short,129,72,57,4,0.355,200,"[1, 2, 4, 5, 6, 7, 9, 12, 13, 14, 16, 18, 19, 22, 23, 24, 25, 26, 27, 28, 29, 31, 33, 34, 35, 36, 37, 38, 41, 42, 44, 46, 48, 49, 50, 51, 53, 54, 58, 62, 64, 66, 67, 68, 71, 72, 73, 74, 75, 77, 79, 81, 86, 87, 88, 90, 91, 93, 95, 96, 98, 99, 103, 105, 106, 108, 109, 110, 112, 113, 114, 115, 116, 117, 118, 119, 120, 121, 122, 124, 125, 126, 127, 128, 129, 130, 131, 133, 134, 135, 137, 140, 141, 143, 144, 145, 146, 150, 154, 156, 157, 158, 160, 161, 163, 164, 166, 167, 170, 171, 172, 173, 175, 176, 178, 179, 180, 183, 185, 187, 188, 189, 191, 192, 193, 194, 195, 196, 199]"
Olaf,L50,short,121,60,61,12,0.395,200,"[2, 6, 9, 11, 12, 13, 17, 18, 19, 20, 21, 24, 25, 28, 29, 33, 34, 35, 37, 40, 42, 44, 46, 47, 49, 50, 51, 54, 55, 56, 57, 58, 59, 60, 63, 64, 65, 66, 68, 73, 75, 78, 83, 84, 85, 88, 89, 91, 92, 93, 97, 98, 99, 100, 102, 103, 104, 105, 107, 108, 110, 112, 113, 115, 116, 117, 118, 119, 120, 121, 123, 126, 128, 129, 130, 131, 132, 133, 136, 138, 139, 140, 141, 142, 145, 148, 149, 150, 151, 152, 153, 154, 155, 156, 157, 158, 161, 162, 163, 164, 165, 166, 167, 169, 170, 172, 173, 175, 176, 177, 178, 181, 183, 185, 186, 188, 189, 190, 192, 194, 199]"
Olaf,L50,short,140,56,84,3,0.3,200,"[0, 2, 3, 5, 6, 8, 9, 10, 11, 12, 13, 14, 15, 18, 19, 20, 22, 24, 25, 26, 27, 29, 30, 31, 32, 37, 40, 41, 44, 45, 46, 47, 48, 49, 50, 53, 55, 56, 57, 58, 59, 60, 61, 62, 63, 65, 66, 68, 69, 71, 72, 73, 77, 79, 80, 82, 83, 84, 85, 86, 88, 89, 90, 91, 93, 94, 96, 97, 98, 100, 101, 102, 104, 105, 106, 107, 110, 111, 113, 114, 116, 118, 119, 121, 122, 123, 125, 126, 127, 128, 129, 130, 131, 133, 136, 137, 138, 140, 141, 143, 144, 145, 146, 147, 148, 150, 152, 153, 154, 155, 157, 159, 163, 165, 166, 167, 168, 171, 172, 173, 174, 175, 176, 178, 179, 182, 183, 184, 185, 186, 188, 189, 190, 191, 192, 193, 194, 195, 198, 199]"
Olaf,L50,short,138,95,43,10,0.31,200,"[0, 1, 3, 4, 5, 6, 7, 8, 9, 10, 11, 12, 13, 14, 15, 16, 17, 19, 20, 22, 23, 24, 25, 27, 28, 29, 30, 35, 37, 40, 41, 43, 44, 45, 48, 49, 53, 55, 57, 59, 60, 61, 62, 64, 65, 66, 69, 71, 73, 76, 77, 79, 81, 82, 83, 84, 85, 86, 88, 91, 92, 93, 94, 95, 96, 97, 98, 99, 100, 102, 103, 105, 107, 111, 112, 113, 114, 115, 116, 118, 119, 120, 121, 123, 124, 125, 127, 128, 129, 131, 132, 133, 134, 137, 138, 139, 140, 142, 143, 144, 147, 148, 149, 150, 152, 154, 155, 156, 157, 158, 159, 160, 161, 162, 163, 166, 167, 168, 170, 172, 174, 175, 176, 178, 180, 181, 182, 187, 188, 189, 190, 192, 193, 194, 195, 196, 197, 198]"
Olaf,L50,short,132,60,72,5,0.34,200,"[2, 3, 4, 6, 7, 8, 9, 12, 13, 15, 17, 18, 19, 21, 22, 23, 24, 25, 26, 27, 28, 31, 32, 34, 35, 36, 37, 41, 42, 44, 45, 46, 47, 51, 52, 53, 54, 55, 56, 57, 58, 60, 61, 62, 64, 65, 66, 67, 68, 70, 71, 74, 75, 77, 78, 83, 85, 87, 89, 90, 91, 92, 93, 94, 97, 99, 100, 104, 105, 108, 110, 111, 112, 114, 115, 116, 118, 120, 121, 122, 123, 124, 126, 127, 128, 130, 131, 134, 135, 136, 138, 140, 141, 142, 143, 144, 145, 146, 147, 150, 151, 152, 154, 156, 159, 160, 164, 165, 166, 167, 169, 170, 171, 172, 174, 175, 176, 178, 179, 181, 182, 183, 184, 187, 188, 189, 191, 192, 193, 194, 195, 196]"
Olaf,L50,short,143,91,52,13,0.285,200,"[0, 1, 3, 4, 5, 6, 7, 8, 9, 10, 14, 15, 16, 17, 18, 20, 21, 22, 23, 24, 25, 26, 27, 28, 29, 32, 33, 36, 37, 38, 39, 40, 41, 42, 44, 45, 46, 47, 49, 50, 51, 52, 53, 55, 57, 58, 59, 60, 62, 65, 66, 68, 69, 70, 73, 74, 75, 77, 78, 79, 81, 82, 83, 84, 87, 89, 90, 91, 92, 95, 97, 100, 101, 102, 103, 106, 107, 108, 109, 111, 112, 113, 114, 115, 117, 118, 120, 121, 122, 123, 124, 126, 127, 129, 130, 131, 132, 134, 137, 138, 139, 141, 142, 143, 144, 145, 146, 147, 151, 152, 154, 157, 158, 159, 161, 162, 163, 164, 165, 166, 168, 170, 171, 172, 174, 176, 177, 178, 179, 180, 181, 182, 183, 186, 187, 188, 192, 193, 194, 195, 196, 197, 198]"
Olaf,L50,short,140,41,99,11,0.3,200,"[1, 3, 4, 5, 6, 7, 8, 9, 11, 18, 21, 22, 23, 24, 25, 28, 30, 31, 32, 34, 35, 38, 39, 40, 41, 42, 43, 44, 45, 47, 48, 49, 50, 51, 52, 53, 54, 55, 56, 61, 63, 64, 65, 66, 67, 68, 69, 70, 71, 72, 73, 75, 76, 77, 78, 79, 83, 84, 85, 86, 87, 88, 89, 90, 91, 92, 97, 98, 99, 101, 102, 103, 104, 105, 107, 108, 109, 110, 112, 114, 116, 118, 119, 121, 123, 125, 127, 128, 130, 131, 133, 134, 135, 136, 137, 138, 139, 140, 142, 143, 145, 147, 148, 149, 150, 151, 153, 155, 157, 159, 161, 162, 163, 164, 165, 166, 167, 168, 169, 172, 174, 175, 178, 179, 181, 182, 184, 185, 186, 188, 189, 190, 191, 192, 193, 194, 195, 196, 197, 198]"
Olaf,L50,short,129,61,68,14,0.355,200,"[2, 3, 4, 6, 7, 8, 10, 11, 15, 16, 17, 18, 23, 24, 26, 27, 30, 31, 34, 36, 38, 40, 41, 42, 43, 44, 45, 47, 48, 50, 52, 53, 55, 57, 58, 61, 62, 64, 65, 66, 67, 68, 71, 72, 73, 76, 77, 78, 84, 85, 86, 87, 89, 90, 92, 94, 96, 98, 99, 100, 101, 102, 103, 104, 105, 106, 108, 109, 110, 111, 112, 113, 114, 117, 119, 120, 121, 123, 124, 125, 127, 129, 130, 131, 132, 133, 136, 137, 138, 139, 143, 145, 147, 148, 151, 152, 156, 157, 158, 159, 160, 162, 163, 164, 165, 166, 167, 169, 170, 171, 172, 173, 175, 177, 178, 179, 180, 181, 182, 186, 187, 188, 189, 192, 193, 195, 197, 198, 199]"
Olaf,L50,short,143,69,74,7,0.285,200,"[0, 1, 2, 3, 5, 7, 8, 9, 10, 11, 13, 14, 15, 16, 17, 18, 19, 20, 21, 22, 23, 25, 26, 28, 29, 30, 31, 32, 33, 34, 35, 37, 38, 39, 41, 42, 43, 44, 45, 46, 47, 48, 49, 50, 52, 54, 55, 57, 58, 59, 61, 63, 64, 65, 66, 67, 68, 69, 71, 72, 73, 74, 76, 79, 82, 83, 84, 85, 86, 87, 88, 89, 92, 93, 94, 95, 96, 97, 99, 101, 102, 103, 104, 107, 108, 111, 112, 114, 115, 118, 120, 121, 123, 124, 125, 127, 130, 131, 132, 133, 134, 135, 137, 139, 140, 141, 143, 144, 146, 148, 151, 152, 153, 154, 155, 158, 160, 161, 162, 163, 164, 167, 168, 169, 172, 173, 175, 176, 177, 178, 180, 181, 183, 185, 187, 190, 191, 192, 194, 195, 196, 197, 199]"
Olaf,L50,short,131,62,69,5,0.345,200,"[1, 3, 5, 7, 8, 9, 10, 13, 15, 16, 17, 18, 20, 21, 22, 23, 24, 25, 26, 27, 29, 30, 32, 34, 37, 38, 41, 42, 45, 47, 49, 50, 51, 53, 54, 58, 59, 60, 61, 62, 63, 68, 69, 72, 73, 74, 75, 76, 77, 78, 80, 81, 82, 83, 85, 86, 87, 88, 89, 90, 92, 93, 94, 95, 97, 98, 99, 100, 101, 104, 105, 106, 107, 109, 112, 114, 116, 117, 118, 119, 121, 123, 124, 126, 127, 129, 130, 132, 134, 135, 136, 137, 138, 139, 142, 143, 146, 148, 151, 152, 157, 159, 160, 161, 162, 163, 165, 167, 168, 171, 173, 174, 175, 177, 179, 180, 181, 182, 184, 185, 186, 187, 188, 189, 190, 191, 195, 196, 197, 198, 199]"
Olaf,L50,short,132,55,77,10,0.34,200,"[0, 5, 9, 10, 11, 12, 14, 17, 18, 19, 20, 21, 22, 23, 24, 26, 27, 28, 30, 31, 32, 33, 34, 35, 36, 39, 40, 41, 43, 44, 46, 48, 49, 50, 51, 53, 55, 58, 59, 60, 61, 63, 64, 66, 68, 69, 70, 71, 72, 73, 74, 75, 76, 77, 78, 81, 83, 84, 87, 88, 89, 90, 92, 93, 94, 95, 96, 97, 98, 100, 101, 102, 104, 105, 106, 108, 110, 111, 113, 114, 117, 118, 119, 121, 123, 124, 127, 129, 131, 132, 133, 134, 135, 137, 138, 141, 142, 143, 144, 145, 147, 148, 149, 151, 152, 155, 156, 157, 159, 160, 161, 163, 166, 170, 172, 173, 174, 175, 176, 177, 181, 183, 185, 187, 188, 190, 191, 192, 193, 195, 196, 197]"
Olaf,L50,short,134,50,84,12,0.33,200,"[1, 2, 3, 6, 7, 8, 9, 10, 11, 12, 13, 15, 17, 18, 19, 20, 22, 23, 25, 27, 29, 30, 31, 32, 33, 34, 35, 38, 39, 40, 43, 44, 46, 47, 48, 50, 51, 52, 54, 57, 58, 59, 61, 62, 63, 64, 65, 66, 67, 69, 72, 73, 74, 75, 77, 79, 81, 82, 83, 85, 86, 88, 89, 91, 92, 93, 94, 95, 96, 97, 99, 101, 103, 106, 109, 110, 111, 113, 115, 117, 119, 120, 121, 125, 127, 130, 131, 132, 133, 134, 135, 137, 138, 139, 140, 141, 142, 143, 145, 146, 147, 148, 149, 150, 151, 152, 154, 159, 160, 161, 168, 169, 170, 171, 172, 173, 174, 175, 176, 177, 178, 180, 181, 182, 183, 185, 186, 187, 189, 191, 192, 194, 195, 197]"
Olaf,L50,short,138,51,87,13,0.31,200,"[0, 1, 2, 3, 4, 6, 7, 9, 13, 14, 15, 19, 20, 21, 22, 24, 25, 26, 27, 28, 30, 31, 32, 33, 35, 36, 37, 39, 40, 43, 44, 46, 47, 49, 50, 52, 54, 55, 56, 57, 59, 60, 61, 62, 64, 65, 66, 68, 70, 72, 73, 74, 75, 76, 77, 78, 79, 80, 81, 82, 83, 84, 87, 88, 89, 90, 91, 93, 94, 95, 98, 100, 103, 104, 105, 106, 107, 108, 110, 111, 112, 113, 118, 119, 121, 122, 123, 125, 126, 127, 128, 129, 130, 131, 132, 133, 135, 136, 137, 138, 140, 142, 145, 147, 150, 151, 152, 153, 154, 155, 157, 158, 159, 161, 168, 169, 170, 171, 172, 173, 174, 175, 176, 177, 179, 180, 181, 182, 184, 187, 188, 189, 190, 192, 194, 196, 198, 199]"
Olaf,L50,short,138,66,72,5,0.31,200,"[0, 2, 3, 4, 5, 6, 9, 10, 13, 14, 16, 17, 19, 20, 21, 22, 24, 26, 28, 30, 31, 32, 33, 36, 37, 38, 39, 40, 41, 43, 44, 45, 47, 48, 49, 50, 52, 54, 55, 56, 58, 59, 60, 62, 63, 64, 65, 66, 67, 71, 72, 75, 78, 79, 80, 81, 83, 85, 87, 88, 92, 93, 94, 95, 96, 97, 100, 101, 102, 104, 105, 107, 110, 111, 113, 114, 117, 118, 119, 120, 121, 122, 123, 124, 126, 128, 130, 131, 132, 133, 134, 135, 136, 137, 138, 139, 141, 142, 143, 146, 147, 148, 149, 151, 155, 156, 157, 158, 159, 160, 161, 162, 163, 165, 168, 169, 170, 171, 173, 174, 175, 177, 179, 180, 181, 182, 183, 184, 185, 187, 188, 189, 192, 193, 195, 196, 198, 199]"
Olaf,L50,short,141,63,78,6,0.295,200,"[0, 1, 2, 3, 5, 7, 9, 10, 11, 13, 14, 16, 18, 20, 22, 23, 24, 25, 27, 28, 29, 30, 31, 32, 33, 34, 35, 36, 38, 39, 40, 41, 42, 46, 47, 48, 50, 52, 53, 54, 55, 56, 57, 59, 61, 62, 63, 64, 65, 66, 70, 72, 74, 77, 80, 82, 83, 84, 85, 89, 90, 91, 92, 93, 94, 95, 96, 97, 98, 99, 101, 102, 105, 106, 108, 109, 110, 111, 113, 114, 115, 116, 118, 119, 120, 121, 122, 123, 124, 125, 128, 130, 131, 132, 133, 136, 138, 139, 140, 141, 143, 144, 145, 146, 147, 148, 149, 150, 151, 152, 153, 157, 158, 159, 162, 165, 166, 169, 170, 171, 172, 173, 174, 175, 176, 178, 179, 180, 181, 182, 184, 186, 188, 190, 191, 193, 194, 195, 197, 198, 199]"
Olaf,L50,short,132,55,77,8,0.34,200,"[2, 4, 5, 6, 7, 8, 11, 13, 15, 16, 18, 19, 22, 23, 24, 26, 27, 28, 30, 31, 32, 34, 35, 37, 39, 40, 42, 43, 44, 45, 47, 48, 49, 50, 52, 53, 55, 56, 57, 60, 62, 63, 64, 65, 66, 67, 71, 72, 74, 75, 77, 78, 79, 82, 84, 87, 88, 89, 90, 91, 92, 93, 94, 96, 97, 98, 100, 101, 102, 103, 104, 106, 107, 108, 109, 110, 111, 112, 114, 115, 118, 119, 120, 121, 123, 124, 125, 127, 128, 129, 130, 132, 133, 134, 137, 139, 143, 144, 145, 146, 147, 148, 149, 150, 153, 154, 156, 157, 159, 160, 162, 163, 164, 166, 168, 169, 171, 172, 173, 174, 176, 178, 179, 180, 181, 183, 185, 187, 189, 190, 192, 193]"
Olaf,L50,short,138,81,57,3,0.31,200,"[0, 2, 3, 5, 7, 8, 9, 10, 11, 12, 13, 14, 15, 16, 18, 19, 21, 22, 23, 25, 28, 29, 31, 32, 33, 34, 36, 39, 40, 41, 42, 43, 44, 45, 46, 47, 48, 49, 51, 53, 55, 60, 62, 63, 66, 67, 71, 72, 73, 77, 78, 79, 80, 81, 82, 83, 84, 85, 86, 87, 88, 90, 91, 93, 94, 95, 96, 97, 98, 100, 101, 102, 103, 105, 107, 108, 110, 111, 112, 113, 114, 115, 116, 118, 119, 121, 122, 123, 124, 125, 126, 127, 128, 129, 131, 136, 137, 138, 140, 141, 142, 144, 145, 150, 151, 152, 155, 156, 157, 158, 160, 162, 163, 164, 165, 167, 168, 173, 174, 175, 176, 177, 178, 179, 181, 182, 185, 186, 187, 188, 189, 190, 191, 193, 194, 195, 196, 198]"
Olaf,L50,short,135,78,57,9,0.325,200,"[0, 1, 2, 3, 4, 5, 6, 7, 12, 15, 18, 19, 20, 21, 22, 24, 25, 26, 28, 30, 31, 32, 34, 35, 37, 39, 41, 42, 43, 44, 46, 47, 48, 49, 52, 54, 58, 59, 60, 61, 63, 64, 67, 68, 70, 71, 72, 73, 74, 75, 77, 79, 82, 84, 85, 86, 89, 90, 91, 92, 95, 97, 98, 99, 100, 102, 103, 105, 106, 107, 109, 111, 112, 114, 115, 116, 117, 118, 119, 120, 121, 122, 124, 125, 127, 128, 129, 130, 132, 136, 137, 138, 140, 142, 144, 145, 148, 151, 153, 154, 155, 156, 157, 158, 160, 161, 162, 163, 164, 165, 166, 168, 171, 172, 174, 175, 177, 178, 179, 180, 181, 182, 183, 185, 187, 188, 190, 191, 192, 193, 195, 196, 197, 198, 199]"
Olaf,L50,short,132,73,59,10,0.34,200,"[1, 3, 5, 7, 8, 10, 11, 12, 13, 14, 15, 17, 19, 20, 21, 22, 23, 24, 28, 31, 32, 33, 35, 36, 38, 43, 44, 45, 47, 48, 49, 52, 53, 54, 55, 56, 57, 58, 61, 62, 63, 64, 66, 67, 68, 69, 70, 71, 72, 74, 75, 76, 79, 80, 83, 84, 85, 89, 91, 92, 94, 97, 100, 102, 104, 106, 108, 109, 110, 111, 112, 113, 114, 115, 116, 120, 122, 123, 124, 125, 126, 129, 131, 132, 133, 135, 136, 137, 138, 139, 140, 143, 144, 145, 146, 147, 150, 152, 154, 155, 156, 157, 158, 160, 161, 162, 163, 165, 166, 167, 169, 170, 171, 173, 174, 176, 179, 182, 183, 185, 186, 187, 188, 191, 192, 193, 194, 195, 196, 197, 198, 199]"
Olaf,L50,short,135,51,84,13,0.325,200,"[1, 2, 3, 4, 6, 8, 9, 16, 18, 21, 23, 24, 25, 27, 30, 32, 35, 36, 38, 39, 40, 43, 44, 45, 46, 48, 49, 50, 51, 52, 53, 54, 55, 56, 57, 58, 59, 60, 61, 62, 63, 64, 65, 66, 67, 69, 70, 71, 72, 73, 75, 78, 79, 81, 82, 84, 86, 87, 88, 89, 92, 93, 94, 97, 98, 101, 104, 105, 106, 107, 108, 109, 110, 111, 113, 114, 115, 116, 117, 118, 119, 120, 123, 124, 126, 127, 128, 129, 131, 132, 133, 134, 136, 137, 138, 140, 142, 144, 145, 146, 147, 148, 149, 152, 155, 156, 160, 161, 163, 166, 167, 169, 171, 172, 174, 175, 177, 178, 179, 180, 181, 182, 184, 186, 187, 188, 189, 190, 192, 193, 194, 195, 196, 197, 198]"
Olaf,L50,short,127,39,88,13,0.365,200,"[3, 7, 8, 10, 11, 12, 13, 15, 16, 18, 19, 22, 23, 24, 25, 26, 27, 28, 31, 32, 38, 39, 40, 41, 42, 43, 44, 46, 49, 50, 53, 54, 56, 57, 58, 61, 62, 63, 64, 65, 70, 71, 72, 73, 74, 75, 76, 77, 78, 79, 81, 82, 83, 84, 85, 86, 88, 89, 90, 93, 95, 97, 98, 101, 102, 103, 104, 105, 106, 107, 108, 110, 112, 113, 115, 116, 118, 119, 120, 121, 122, 123, 124, 125, 127, 128, 129, 131, 132, 133, 134, 135, 136, 138, 140, 141, 142, 143, 144, 145, 146, 148, 149, 150, 151, 161, 163, 167, 170, 172, 173, 175, 176, 177, 179, 180, 183, 184, 185, 186, 188, 190, 193, 194, 195, 197, 199]"
Olaf,L50,short,133,73,60,11,0.335,200,"[0, 1, 3, 5, 6, 8, 11, 13, 16, 17, 18, 21, 22, 23, 24, 25, 28, 29, 31, 32, 36, 37, 39, 40, 41, 43, 44, 45, 46, 47, 49, 51, 52, 54, 55, 57, 58, 59, 60, 63, 64, 65, 67, 69, 70, 72, 74, 76, 77, 78, 79, 80, 82, 83, 85, 87, 88, 91, 93, 94, 95, 96, 100, 102, 104, 105, 106, 109, 110, 112, 113, 115, 117, 118, 119, 122, 123, 124, 126, 127, 128, 129, 130, 131, 132, 134, 136, 137, 138, 139, 140, 141, 142, 143, 144, 145, 147, 148, 149, 150, 151, 152, 155, 156, 157, 158, 159, 160, 162, 165, 166, 167, 168, 169, 170, 172, 173, 174, 175, 176, 177, 178, 181, 183, 185, 186, 187, 188, 189, 193, 196, 198, 199]"
Olaf,L50,short,140,72,68,5,0.3,200,"[0, 2, 3, 5, 7, 8, 9, 11, 12, 14, 15, 16, 17, 18, 20, 21, 22, 24, 26, 27, 28, 29, 31, 33, 34, 38, 40, 41, 42, 43, 44, 45, 46, 47, 49, 51, 52, 53, 54, 55, 59, 60, 61, 63, 64, 65, 66, 69, 71, 72, 73, 78, 79, 80, 81, 82, 83, 84, 85, 86, 87, 90, 92, 94, 96, 98, 99, 100, 101, 102, 104, 105, 106, 107, 108, 109, 110, 112, 113, 116, 117, 118, 120, 121, 122, 123, 124, 125, 127, 128, 129, 130, 131, 132, 135, 136, 137, 141, 142, 143, 144, 145, 146, 147, 148, 149, 150, 151, 153, 156, 158, 159, 160, 162, 163, 165, 166, 168, 170, 171, 172, 173, 176, 177, 179, 180, 182, 183, 185, 186, 187, 188, 189, 190, 193, 195, 196, 197, 198, 199]"
Olaf,L50,short,121,59,62,12,0.395,200,"[2, 3, 4, 7, 8, 10, 11, 12, 13, 14, 15, 17, 18, 19, 21, 22, 23, 24, 25, 26, 32, 33, 34, 38, 41, 42, 47, 48, 53, 55, 59, 60, 63, 68, 70, 71, 72, 73, 75, 77, 78, 79, 80, 81, 83, 84, 86, 87, 89, 90, 91, 92, 93, 96, 97, 98, 103, 104, 105, 106, 107, 108, 110, 113, 114, 118, 119, 120, 121, 125, 126, 127, 128, 129, 131, 132, 133, 134, 135, 136, 142, 143, 144, 147, 148, 149, 152, 153, 154, 157, 158, 159, 161, 162, 168, 169, 170, 171, 172, 173, 175, 176, 177, 178, 179, 180, 181, 182, 183, 184, 186, 187, 188, 189, 191, 194, 195, 196, 197, 198, 199]"
Olaf,L50,short,131,73,58,9,0.345,200,"[0, 1, 3, 4, 5, 7, 8, 9, 10, 14, 15, 16, 17, 18, 19, 20, 23, 24, 26, 27, 28, 30, 31, 32, 33, 35, 37, 38, 41, 42, 43, 44, 45, 46, 47, 48, 50, 51, 53, 55, 56, 58, 60, 61, 62, 65, 66, 67, 68, 70, 75, 79, 80, 83, 85, 86, 88, 89, 91, 92, 93, 94, 95, 97, 99, 100, 103, 104, 105, 106, 109, 110, 112, 114, 115, 116, 118, 119, 122, 123, 125, 126, 128, 131, 132, 133, 134, 135, 140, 141, 143, 144, 145, 149, 150, 153, 154, 155, 156, 158, 159, 160, 163, 166, 167, 168, 169, 170, 171, 172, 173, 174, 175, 176, 177, 178, 179, 180, 181, 182, 184, 185, 186, 189, 190, 191, 192, 193, 194, 195, 197]"
Olaf,L50,short,138,84,54,11,0.31,200,"[0, 2, 3, 4, 5, 6, 7, 8, 9, 11, 14, 16, 17, 18, 19, 21, 23, 24, 25, 26, 28, 29, 30, 31, 34, 37, 39, 40, 41, 43, 44, 45, 46, 47, 49, 50, 53, 54, 56, 58, 60, 61, 63, 64, 65, 67, 68, 71, 72, 73, 74, 75, 76, 77, 78, 79, 81, 82, 83, 85, 86, 89, 90, 91, 93, 94, 95, 96, 97, 98, 99, 100, 101, 102, 104, 105, 106, 108, 109, 111, 113, 115, 117, 118, 119, 120, 121, 122, 123, 124, 125, 126, 127, 128, 129, 130, 135, 136, 137, 138, 140, 141, 142, 143, 144, 145, 146, 149, 150, 151, 152, 155, 156, 159, 161, 164, 165, 169, 171, 172, 173, 174, 175, 176, 177, 178, 179, 180, 181, 182, 183, 184, 190, 191, 193, 194, 196, 197]"
Olaf,L50,short,133,64,69,6,0.335,200,"[1, 2, 3, 4, 5, 7, 8, 9, 10, 11, 14, 15, 18, 19, 20, 22, 23, 25, 26, 27, 29, 31, 32, 33, 34, 35, 37, 38, 39, 40, 41, 42, 43, 45, 47, 48, 49, 50, 52, 54, 55, 56, 57, 58, 60, 61, 62, 63, 64, 66, 67, 68, 70, 73, 74, 76, 77, 78, 79, 80, 82, 83, 84, 85, 86, 87, 88, 90, 91, 93, 94, 95, 96, 98, 101, 102, 105, 106, 107, 110, 111, 113, 114, 115, 116, 119, 120, 121, 122, 123, 124, 127, 129, 130, 132, 136, 137, 138, 139, 140, 142, 144, 145, 148, 152, 154, 156, 157, 159, 160, 161, 162, 165, 166, 169, 172, 174, 175, 176, 177, 180, 181, 183, 184, 187, 188, 190, 191, 193, 195, 197, 198, 199]"
Olaf,L50,short,133,48,85,12,0.335,200,"[2, 3, 4, 5, 6, 7, 8, 9, 10, 12, 13, 14, 15, 17, 19, 23, 24, 25, 28, 29, 30, 31, 32, 34, 35, 36, 37, 38, 39, 40, 41, 44, 45, 46, 47, 48, 49, 50, 52, 54, 55, 57, 58, 59, 60, 62, 63, 64, 66, 68, 70, 72, 73, 75, 76, 77, 78, 79, 81, 82, 83, 84, 85, 86, 87, 88, 89, 91, 92, 93, 94, 97, 98, 100, 102, 103, 105, 106, 108, 110, 111, 112, 114, 116, 117, 119, 120, 121, 122, 123, 126, 128, 130, 131, 132, 133, 134, 135, 137, 138, 139, 141, 142, 143, 146, 147, 149, 150, 152, 158, 159, 160, 161, 163, 164, 165, 166, 167, 170, 174, 175, 176, 178, 183, 184, 188, 189, 190, 193, 195, 196, 198, 199]"
Olaf,L50,short,131,75,56,10,0.345,200,"[0, 2, 5, 6, 8, 11, 12, 13, 15, 17, 18, 19, 21, 23, 26, 27, 28, 33, 35, 36, 37, 38, 39, 41, 42, 43, 44, 45, 46, 48, 49, 50, 51, 52, 54, 55, 57, 58, 60, 61, 62, 63, 64, 66, 67, 69, 70, 71, 72, 75, 76, 78, 79, 80, 81, 82, 83, 85, 86, 87, 89, 90, 91, 92, 93, 95, 97, 98, 99, 105, 106, 107, 109, 110, 114, 115, 119, 120, 122, 123, 124, 125, 126, 127, 128, 129, 130, 132, 133, 134, 135, 136, 137, 139, 140, 141, 142, 143, 144, 147, 148, 149, 150, 152, 153, 155, 156, 157, 158, 160, 164, 165, 166, 169, 172, 173, 176, 178, 182, 183, 187, 189, 190, 191, 192, 193, 194, 195, 196, 198, 199]"
Olaf,L50,short,137,67,70,12,0.315,200,"[0, 1, 2, 5, 7, 8, 9, 10, 12, 13, 16, 17, 21, 22, 23, 26, 27, 34, 35, 37, 40, 41, 42, 43, 46, 49, 50, 52, 53, 54, 55, 56, 57, 58, 60, 61, 62, 64, 65, 67, 68, 69, 70, 71, 72, 73, 75, 77, 78, 80, 81, 82, 83, 85, 86, 88, 89, 90, 91, 93, 94, 96, 97, 98, 100, 101, 102, 105, 107, 108, 109, 110, 111, 112, 114, 116, 117, 122, 123, 124, 125, 126, 127, 128, 130, 131, 132, 135, 136, 137, 139, 141, 142, 143, 144, 145, 146, 147, 148, 149, 150, 151, 152, 153, 154, 156, 157, 159, 160, 161, 162, 164, 165, 166, 167, 168, 170, 171, 173, 174, 175, 176, 178, 180, 181, 183, 184, 185, 186, 187, 188, 189, 190, 194, 196, 198, 199]"
Olaf,L50,short,125,64,61,15,0.375,200,"[0, 1, 4, 6, 10, 11, 12, 13, 14, 15, 16, 17, 18, 19, 20, 24, 26, 27, 30, 33, 38, 39, 42, 43, 44, 45, 47, 48, 49, 51, 52, 53, 54, 56, 57, 58, 59, 60, 61, 62, 63, 64, 67, 68, 70, 77, 78, 80, 81, 82, 84, 85, 86, 87, 89, 90, 93, 94, 95, 96, 97, 100, 102, 105, 106, 110, 111, 112, 113, 116, 117, 119, 120, 121, 122, 123, 124, 126, 127, 132, 133, 134, 137, 138, 139, 141, 142, 143, 144, 146, 148, 149, 150, 151, 152, 153, 156, 157, 159, 160, 161, 163, 164, 165, 166, 167, 169, 170, 172, 173, 174, 175, 176, 177, 180, 183, 185, 186, 190, 191, 192, 193, 195, 196, 198]"
Olaf,L50,short,137,84,53,7,0.315,200,"[0, 1, 2, 3, 4, 6, 7, 8, 9, 10, 11, 12, 13, 14, 16, 17, 19, 20, 22, 23, 24, 25, 27, 28, 29, 31, 38, 40, 43, 44, 46, 48, 49, 50, 51, 52, 53, 57, 58, 59, 60, 62, 64, 65, 67, 68, 70, 71, 72, 73, 74, 77, 78, 79, 80, 84, 85, 86, 87, 88, 91, 93, 94, 95, 97, 98, 99, 104, 105, 106, 108, 109, 110, 111, 113, 115, 116, 121, 122, 123, 124, 125, 127, 128, 129, 130, 131, 132, 134, 135, 136, 138, 139, 140, 141, 143, 144, 146, 147, 150, 151, 152, 153, 154, 155, 156, 157, 159, 160, 161, 162, 164, 167, 168, 172, 173, 175, 177, 178, 179, 181, 182, 183, 184, 185, 188, 189, 190, 191, 192, 193, 194, 195, 196, 197, 198, 199]"
Olaf,L50,short,134,48,86,8,0.33,200,"[3, 6, 7, 8, 9, 10, 11, 12, 13, 14, 16, 17, 18, 19, 20, 21, 24, 25, 26, 27, 31, 32, 34, 35, 37, 39, 40, 41, 42, 43, 45, 46, 48, 50, 51, 53, 54, 55, 56, 57, 58, 59, 61, 62, 63, 64, 65, 66, 67, 69, 70, 71, 74, 77, 78, 79, 80, 81, 82, 84, 85, 87, 89, 91, 94, 95, 96, 97, 99, 100, 102, 105, 106, 107, 108, 109, 110, 111, 112, 113, 114, 115, 117, 119, 121, 123, 124, 125, 128, 130, 132, 134, 137, 139, 140, 141, 142, 143, 144, 145, 146, 147, 149, 150, 152, 153, 155, 156, 157, 158, 164, 165, 166, 167, 168, 169, 170, 171, 172, 175, 178, 179, 180, 181, 184, 188, 189, 192, 193, 194, 196, 197, 198, 199]"
Olaf,L50,short,130,65,65,22,0.35,200,"[0, 1, 4, 8, 10, 11, 12, 16, 18, 19, 24, 26, 27, 28, 30, 31, 32, 34, 35, 36, 37, 39, 40, 41, 44, 45, 46, 47, 48, 49, 54, 55, 58, 59, 60, 62, 63, 65, 67, 69, 70, 72, 73, 74, 75, 78, 79, 80, 81, 82, 83, 84, 86, 87, 88, 89, 91, 92, 93, 94, 95, 98, 99, 100, 101, 102, 103, 104, 105, 108, 109, 110, 111, 112, 113, 114, 115, 116, 118, 123, 124, 125, 126, 127, 128, 130, 132, 133, 134, 135, 138, 139, 140, 142, 143, 144, 145, 146, 147, 148, 149, 150, 151, 152, 154, 155, 158, 159, 160, 161, 162, 165, 166, 167, 169, 170, 171, 172, 177, 181, 182, 183, 185, 186, 187, 188, 190, 192, 195, 196]"
Olaf,L50,short,134,51,83,9,0.33,200,"[0, 1, 2, 3, 4, 5, 6, 7, 9, 10, 11, 12, 13, 15, 17, 18, 19, 20, 22, 23, 24, 25, 26, 30, 31, 33, 36, 38, 39, 40, 41, 43, 44, 46, 48, 49, 50, 51, 52, 53, 57, 59, 62, 63, 64, 67, 68, 70, 73, 75, 77, 78, 79, 80, 81, 83, 85, 86, 87, 88, 89, 90, 93, 95, 96, 97, 98, 99, 100, 101, 102, 103, 106, 108, 109, 114, 115, 116, 117, 118, 119, 121, 122, 125, 126, 127, 132, 133, 134, 136, 137, 138, 142, 143, 144, 145, 146, 147, 148, 149, 151, 152, 153, 154, 157, 158, 160, 161, 162, 163, 164, 165, 167, 169, 172, 173, 174, 175, 176, 178, 179, 180, 183, 185, 187, 188, 189, 190, 191, 192, 193, 195, 196, 199]"
Olaf,L50,short,129,63,66,10,0.355,200,"[2, 3, 4, 5, 6, 8, 9, 10, 12, 13, 14, 16, 17, 21, 22, 23, 26, 28, 29, 30, 32, 34, 36, 37, 40, 43, 44, 45, 47, 48, 49, 50, 52, 53, 55, 56, 57, 58, 59, 63, 64, 66, 68, 69, 71, 72, 73, 74, 75, 76, 77, 78, 79, 83, 84, 87, 89, 90, 91, 94, 95, 96, 97, 98, 99, 100, 101, 102, 103, 107, 108, 111, 112, 115, 117, 118, 119, 123, 124, 125, 126, 127, 130, 131, 132, 133, 134, 135, 136, 137, 138, 139, 141, 142, 144, 148, 149, 152, 154, 155, 157, 158, 159, 162, 164, 166, 167, 168, 169, 170, 171, 173, 175, 177, 178, 179, 181, 182, 183, 184, 185, 186, 188, 189, 192, 195, 196, 198, 199]"
Olaf,L50,short,132,81,51,9,0.34,200,"[3, 5, 6, 7, 8, 9, 12, 13, 14, 16, 17, 18, 19, 20, 26, 28, 29, 30, 31, 32, 33, 34, 35, 36, 37, 39, 41, 42, 43, 44, 46, 47, 48, 49, 52, 53, 55, 57, 58, 59, 61, 62, 63, 65, 66, 67, 68, 72, 73, 74, 75, 76, 78, 80, 82, 83, 84, 85, 86, 87, 88, 89, 91, 93, 96, 97, 99, 100, 101, 105, 106, 111, 113, 114, 115, 117, 118, 119, 121, 125, 126, 127, 129, 130, 131, 133, 134, 135, 137, 138, 139, 140, 142, 144, 145, 146, 149, 150, 153, 154, 156, 157, 158, 159, 161, 162, 163, 164, 166, 167, 170, 171, 173, 174, 175, 176, 178, 179, 180, 183, 185, 186, 187, 188, 189, 191, 192, 194, 195, 196, 197, 199]"
Olaf,L50,short,134,60,74,10,0.33,200,"[1, 3, 4, 6, 7, 8, 9, 10, 11, 13, 16, 17, 19, 20, 21, 22, 26, 28, 30, 32, 33, 34, 36, 39, 40, 41, 42, 43, 44, 45, 46, 47, 48, 49, 50, 51, 53, 55, 56, 57, 60, 61, 62, 63, 64, 65, 66, 68, 69, 70, 71, 73, 74, 75, 76, 77, 79, 81, 82, 83, 84, 85, 88, 89, 90, 91, 93, 94, 95, 96, 100, 101, 102, 103, 104, 107, 108, 109, 110, 113, 114, 116, 117, 118, 121, 123, 125, 126, 128, 129, 131, 132, 134, 135, 136, 137, 138, 141, 142, 143, 145, 147, 148, 149, 151, 152, 153, 154, 155, 162, 163, 164, 165, 167, 168, 169, 170, 173, 174, 175, 176, 182, 183, 185, 186, 187, 188, 189, 190, 192, 195, 197, 198, 199]"
Olaf,L50,short,139,60,79,6,0.305,200,"[0, 2, 3, 6, 8, 9, 10, 11, 15, 16, 18, 19, 21, 22, 24, 25, 27, 28, 29, 31, 32, 33, 36, 37, 38, 39, 41, 42, 43, 44, 45, 47, 48, 49, 51, 53, 54, 55, 56, 57, 58, 59, 61, 62, 63, 64, 65, 67, 71, 73, 74, 77, 80, 81, 82, 86, 88, 89, 91, 92, 93, 96, 97, 98, 99, 101, 102, 104, 105, 106, 107, 108, 109, 110, 111, 112, 113, 114, 115, 116, 118, 119, 123, 124, 125, 126, 127, 128, 130, 131, 135, 136, 137, 138, 140, 142, 143, 144, 146, 147, 149, 150, 151, 152, 154, 155, 157, 158, 159, 160, 164, 165, 166, 167, 168, 169, 170, 171, 172, 173, 174, 175, 176, 177, 179, 180, 181, 182, 186, 187, 188, 189, 190, 191, 192, 193, 195, 196, 197]"
Olaf,L50,short,139,63,76,3,0.305,200,"[0, 1, 2, 3, 4, 5, 8, 10, 15, 16, 17, 19, 20, 21, 23, 24, 25, 27, 28, 29, 30, 31, 34, 35, 36, 37, 39, 40, 41, 42, 45, 47, 49, 51, 52, 53, 54, 56, 57, 60, 61, 63, 64, 65, 67, 68, 69, 70, 71, 72, 74, 75, 77, 79, 82, 83, 85, 86, 88, 89, 91, 92, 93, 94, 95, 96, 99, 100, 101, 102, 103, 104, 106, 111, 112, 113, 114, 115, 116, 117, 118, 119, 120, 121, 123, 124, 126, 127, 128, 129, 130, 133, 134, 135, 136, 137, 139, 141, 142, 144, 147, 148, 151, 153, 155, 156, 157, 158, 159, 160, 161, 162, 163, 164, 165, 169, 170, 172, 173, 174, 176, 177, 178, 180, 181, 182, 183, 184, 185, 186, 187, 188, 189, 190, 193, 194, 197, 198, 199]"
Olaf,L50,short,140,67,73,8,0.3,200,"[0, 2, 3, 5, 6, 8, 9, 10, 11, 14, 15, 16, 17, 20, 22, 23, 26, 27, 28, 29, 31, 33, 34, 37, 38, 39, 40, 42, 43, 44, 47, 48, 50, 51, 53, 54, 55, 56, 57, 60, 62, 64, 65, 66, 67, 68, 69, 70, 72, 73, 74, 76, 77, 78, 79, 80, 81, 82, 83, 84, 85, 86, 87, 89, 90, 92, 94, 96, 97, 98, 101, 103, 105, 107, 109, 111, 112, 114, 115, 116, 117, 118, 119, 120, 121, 122, 124, 125, 128, 129, 130, 131, 132, 133, 134, 136, 138, 140, 141, 142, 143, 144, 146, 149, 150, 151, 152, 154, 155, 156, 159, 160, 161, 162, 164, 168, 170, 171, 172, 173, 174, 176, 177, 179, 181, 182, 183, 184, 186, 188, 189, 190, 191, 192, 193, 194, 195, 196, 198, 199]"
Olaf,L50,short,131,60,71,17,0.345,200,"[0, 2, 3, 4, 5, 6, 7, 9, 10, 11, 13, 14, 16, 17, 18, 19, 20, 21, 22, 23, 24, 25, 27, 30, 33, 34, 35, 36, 38, 39, 43, 46, 47, 48, 49, 50, 51, 56, 57, 58, 59, 62, 64, 65, 66, 67, 68, 72, 73, 75, 76, 77, 78, 79, 80, 81, 82, 83, 86, 87, 88, 89, 90, 91, 93, 96, 97, 99, 100, 102, 103, 104, 109, 110, 111, 112, 113, 115, 116, 122, 125, 127, 128, 129, 130, 131, 132, 134, 136, 140, 141, 142, 143, 145, 146, 148, 149, 150, 152, 153, 156, 157, 160, 162, 163, 164, 167, 168, 169, 170, 171, 172, 173, 174, 176, 177, 178, 180, 181, 182, 183, 184, 185, 186, 187, 188, 192, 193, 195, 196, 197]"
Olaf,L50,short,131,73,58,6,0.345,200,"[0, 1, 2, 3, 7, 11, 12, 13, 14, 21, 22, 23, 25, 26, 27, 30, 32, 33, 37, 39, 40, 41, 42, 43, 45, 47, 49, 51, 52, 53, 54, 55, 57, 59, 60, 61, 63, 64, 65, 66, 67, 68, 69, 70, 72, 77, 78, 79, 83, 84, 86, 87, 88, 89, 90, 91, 92, 93, 95, 98, 99, 101, 102, 105, 106, 107, 108, 109, 110, 111, 113, 114, 116, 117, 119, 120, 121, 122, 124, 125, 128, 130, 131, 132, 133, 134, 135, 137, 138, 140, 141, 142, 143, 144, 145, 146, 147, 149, 150, 151, 152, 153, 154, 155, 156, 158, 159, 162, 163, 164, 167, 168, 169, 171, 172, 176, 177, 178, 180, 181, 182, 183, 184, 185, 186, 188, 190, 191, 192, 194, 199]"
Olaf,L50,short,120,56,64,11,0.4,200,"[1, 2, 4, 6, 7, 8, 9, 10, 11, 12, 14, 15, 16, 17, 20, 21, 24, 25, 26, 28, 29, 31, 32, 34, 38, 39, 40, 42, 43, 48, 49, 52, 53, 54, 55, 56, 57, 63, 64, 65, 68, 70, 71, 73, 75, 76, 77, 78, 79, 80, 82, 86, 90, 92, 93, 94, 95, 96, 97, 99, 100, 101, 105, 107, 108, 110, 113, 114, 116, 117, 119, 120, 122, 124, 125, 127, 128, 129, 130, 131, 132, 133, 135, 136, 137, 138, 139, 140, 141, 143, 144, 145, 146, 147, 149, 151, 153, 156, 158, 159, 160, 162, 163, 166, 168, 170, 172, 173, 175, 176, 177, 178, 179, 191, 192, 193, 194, 196, 198, 199]"
Olaf,L50,short,140,77,63,8,0.3,200,"[0, 1, 2, 3, 5, 6, 7, 8, 10, 11, 16, 17, 18, 19, 20, 26, 27, 28, 29, 32, 33, 34, 35, 36, 37, 38, 40, 41, 42, 43, 44, 45, 47, 48, 50, 51, 54, 55, 56, 60, 61, 62, 64, 65, 66, 67, 70, 71, 72, 73, 74, 75, 80, 81, 82, 84, 86, 87, 88, 90, 91, 93, 94, 95, 97, 98, 99, 100, 102, 104, 105, 106, 107, 109, 110, 112, 113, 114, 115, 116, 117, 118, 119, 120, 121, 123, 124, 126, 127, 128, 129, 131, 132, 133, 134, 136, 137, 138, 139, 140, 141, 142, 143, 145, 147, 150, 152, 154, 155, 157, 159, 160, 162, 163, 164, 165, 166, 169, 172, 174, 177, 178, 179, 180, 181, 182, 183, 184, 185, 186, 187, 189, 190, 191, 192, 193, 194, 195, 196, 198]"
Olaf,L50,short,135,57,78,9,0.325,200,"[0, 2, 3, 5, 6, 7, 9, 10, 11, 13, 14, 15, 16, 19, 20, 21, 22, 23, 24, 25, 27, 32, 33, 34, 35, 37, 38, 40, 44, 46, 48, 49, 50, 51, 52, 53, 54, 55, 57, 58, 60, 61, 62, 64, 65, 68, 69, 70, 72, 74, 75, 76, 78, 79, 83, 84, 86, 87, 88, 90, 92, 97, 98, 100, 101, 103, 104, 105, 107, 108, 109, 111, 112, 114, 115, 116, 117, 120, 121, 122, 123, 124, 125, 126, 127, 129, 130, 131, 133, 135, 138, 139, 141, 143, 144, 145, 146, 147, 148, 149, 150, 151, 153, 155, 156, 158, 159, 160, 162, 165, 166, 167, 168, 171, 172, 174, 175, 176, 180, 181, 182, 183, 184, 185, 187, 188, 189, 190, 192, 193, 195, 196, 197, 198, 199]"
Olaf,L50,short,131,69,62,13,0.345,200,"[0, 1, 3, 5, 6, 7, 9, 13, 15, 16, 17, 19, 20, 26, 27, 29, 30, 32, 33, 34, 35, 36, 38, 40, 41, 42, 43, 44, 47, 50, 51, 54, 56, 57, 59, 60, 62, 63, 65, 67, 68, 69, 70, 71, 74, 75, 76, 77, 78, 79, 80, 83, 84, 85, 86, 87, 88, 90, 93, 94, 96, 97, 98, 100, 101, 102, 104, 108, 109, 110, 111, 112, 114, 115, 116, 117, 123, 124, 125, 126, 127, 128, 130, 131, 132, 134, 135, 136, 138, 140, 141, 142, 143, 145, 146, 147, 149, 151, 154, 155, 156, 157, 158, 160, 162, 163, 164, 167, 168, 169, 170, 171, 172, 175, 176, 177, 181, 182, 184, 185, 186, 187, 188, 189, 190, 191, 192, 193, 196, 197, 198]"
Olaf,L50,short,134,57,77,16,0.33,200,"[0, 1, 2, 3, 5, 7, 13, 15, 16, 17, 18, 19, 23, 24, 26, 27, 29, 30, 33, 34, 35, 36, 37, 39, 40, 41, 43, 44, 45, 48, 49, 50, 51, 52, 53, 54, 55, 56, 57, 58, 59, 60, 61, 62, 63, 64, 66, 68, 69, 70, 71, 73, 74, 76, 77, 78, 79, 80, 81, 83, 85, 86, 88, 93, 94, 96, 97, 98, 99, 100, 101, 102, 106, 107, 108, 110, 112, 114, 115, 116, 121, 122, 123, 125, 127, 128, 131, 132, 135, 136, 137, 138, 139, 141, 142, 143, 145, 146, 147, 149, 150, 152, 153, 156, 160, 161, 162, 163, 165, 166, 167, 168, 169, 171, 173, 175, 177, 179, 180, 181, 182, 183, 184, 185, 189, 190, 192, 193, 194, 195, 196, 197, 198, 199]"
Olaf,L50,short,137,65,72,6,0.315,200,"[0, 1, 2, 3, 4, 5, 6, 8, 9, 11, 12, 13, 14, 15, 16, 17, 20, 22, 23, 24, 25, 27, 29, 30, 31, 32, 33, 36, 39, 40, 43, 44, 46, 47, 49, 50, 52, 53, 57, 58, 59, 61, 63, 64, 67, 68, 69, 70, 71, 72, 75, 76, 77, 78, 79, 80, 82, 83, 85, 86, 89, 90, 92, 93, 94, 95, 96, 97, 98, 101, 103, 104, 105, 106, 107, 109, 110, 111, 112, 113, 115, 116, 119, 120, 122, 123, 128, 129, 130, 132, 133, 134, 136, 137, 138, 140, 145, 146, 147, 148, 149, 150, 151, 152, 153, 155, 156, 158, 160, 161, 162, 165, 168, 170, 171, 172, 173, 174, 175, 177, 178, 179, 180, 181, 183, 184, 185, 186, 188, 189, 190, 192, 194, 196, 197, 198, 199]"
Olaf,L50,short,132,60,72,10,0.34,200,"[0, 1, 2, 3, 4, 5, 9, 10, 11, 12, 13, 14, 17, 18, 19, 20, 24, 26, 28, 31, 32, 34, 35, 36, 37, 41, 44, 45, 47, 48, 49, 50, 54, 55, 56, 57, 59, 60, 62, 64, 65, 66, 67, 68, 69, 70, 73, 74, 75, 76, 77, 79, 81, 83, 84, 86, 87, 88, 89, 90, 91, 94, 96, 97, 98, 99, 100, 101, 102, 103, 104, 105, 108, 109, 110, 111, 112, 113, 115, 116, 118, 119, 120, 123, 125, 127, 128, 129, 130, 131, 135, 136, 139, 140, 141, 143, 146, 147, 149, 150, 151, 152, 153, 154, 155, 156, 159, 163, 164, 166, 168, 169, 170, 173, 174, 175, 176, 177, 178, 180, 181, 182, 183, 186, 188, 189, 191, 193, 194, 195, 196, 198]"
Olaf,L50,short,124,58,66,8,0.38,200,"[0, 2, 3, 6, 7, 8, 11, 13, 14, 16, 17, 19, 20, 22, 23, 24, 25, 26, 27, 28, 29, 31, 32, 33, 35, 36, 37, 38, 39, 40, 42, 45, 46, 47, 49, 50, 52, 53, 54, 55, 56, 58, 59, 63, 66, 73, 74, 76, 77, 79, 80, 82, 85, 86, 87, 88, 89, 90, 92, 95, 96, 97, 100, 101, 102, 104, 108, 110, 111, 112, 113, 114, 115, 116, 117, 118, 119, 120, 121, 124, 127, 128, 129, 131, 132, 133, 134, 135, 136, 137, 138, 139, 144, 145, 146, 148, 150, 151, 152, 157, 158, 159, 160, 163, 165, 167, 170, 171, 173, 176, 177, 178, 179, 181, 185, 188, 190, 191, 192, 193, 194, 195, 196, 199]"
Olaf,L50,short,137,68,69,8,0.315,200,"[0, 1, 2, 3, 4, 5, 6, 10, 11, 12, 13, 14, 15, 18, 19, 20, 21, 22, 23, 24, 26, 27, 28, 29, 30, 31, 32, 34, 39, 40, 41, 42, 43, 45, 46, 47, 49, 50, 52, 54, 55, 57, 59, 60, 61, 64, 65, 67, 68, 69, 70, 72, 73, 74, 75, 77, 78, 79, 80, 83, 85, 87, 89, 90, 91, 92, 96, 98, 99, 101, 102, 105, 107, 109, 110, 111, 112, 113, 114, 115, 116, 117, 118, 120, 122, 123, 124, 125, 127, 129, 133, 134, 135, 136, 138, 139, 140, 141, 142, 143, 145, 148, 149, 150, 152, 153, 154, 155, 156, 157, 160, 161, 162, 163, 164, 166, 167, 168, 169, 170, 171, 175, 177, 179, 180, 182, 183, 185, 188, 189, 190, 191, 194, 195, 197, 198, 199]"
Olaf,L50,short,138,74,64,3,0.31,200,"[0, 2, 3, 4, 5, 6, 8, 10, 11, 15, 18, 20, 21, 23, 24, 25, 27, 28, 29, 30, 31, 32, 33, 35, 36, 37, 38, 39, 41, 42, 43, 44, 47, 48, 50, 51, 52, 53, 54, 57, 58, 59, 60, 61, 62, 65, 66, 67, 68, 69, 70, 71, 72, 74, 75, 76, 77, 80, 81, 82, 84, 86, 88, 93, 94, 95, 96, 97, 98, 99, 101, 102, 104, 106, 108, 110, 111, 112, 114, 117, 119, 120, 121, 122, 124, 126, 127, 128, 129, 130, 131, 132, 135, 136, 137, 139, 140, 141, 143, 144, 147, 148, 149, 150, 151, 152, 153, 154, 156, 157, 158, 160, 161, 162, 163, 164, 166, 167, 169, 171, 172, 173, 174, 176, 177, 178, 179, 182, 183, 184, 186, 188, 191, 192, 195, 196, 197, 199]"
Olaf,L50,short,132,50,82,9,0.34,200,"[2, 3, 4, 6, 7, 8, 10, 11, 14, 15, 16, 17, 19, 20, 22, 24, 25, 27, 33, 34, 35, 36, 39, 42, 43, 46, 47, 48, 49, 50, 51, 53, 57, 59, 60, 62, 63, 64, 66, 67, 68, 69, 72, 74, 75, 76, 77, 78, 79, 80, 81, 82, 85, 86, 88, 90, 91, 92, 95, 96, 97, 100, 101, 104, 105, 106, 110, 111, 112, 113, 114, 115, 116, 119, 120, 121, 122, 123, 125, 128, 129, 130, 133, 135, 136, 138, 139, 140, 141, 142, 144, 146, 147, 148, 149, 151, 152, 154, 155, 157, 158, 159, 160, 161, 163, 164, 165, 166, 167, 169, 171, 172, 174, 175, 176, 177, 178, 179, 180, 181, 182, 183, 184, 185, 186, 187, 189, 190, 193, 196, 197, 198]"
Olaf,L50,short,128,52,76,13,0.36,200,"[3, 4, 6, 8, 10, 12, 13, 15, 16, 17, 20, 21, 24, 25, 26, 27, 29, 30, 31, 33, 34, 36, 37, 38, 39, 40, 41, 43, 44, 45, 47, 48, 50, 51, 52, 54, 56, 57, 59, 61, 62, 63, 64, 65, 66, 67, 69, 70, 71, 72, 73, 74, 75, 77, 78, 79, 81, 82, 83, 84, 86, 87, 88, 89, 91, 93, 94, 97, 98, 99, 101, 102, 105, 107, 109, 110, 111, 112, 113, 117, 118, 119, 120, 121, 122, 123, 128, 135, 137, 139, 140, 141, 144, 145, 147, 150, 152, 153, 154, 155, 157, 160, 161, 163, 164, 165, 169, 170, 171, 173, 175, 176, 177, 179, 180, 181, 182, 183, 184, 186, 187, 188, 190, 194, 196, 197, 198, 199]"
Olaf,L50,short,135,70,65,8,0.325,200,"[0, 1, 4, 5, 7, 9, 10, 11, 12, 13, 14, 16, 17, 18, 20, 21, 22, 23, 25, 26, 27, 28, 30, 31, 34, 36, 37, 38, 39, 40, 41, 42, 45, 46, 47, 48, 49, 50, 52, 53, 55, 56, 57, 58, 60, 61, 62, 63, 64, 65, 69, 70, 73, 74, 75, 77, 78, 81, 82, 84, 85, 86, 87, 88, 89, 91, 92, 95, 96, 99, 100, 102, 105, 107, 109, 110, 111, 112, 113, 114, 115, 116, 119, 120, 121, 124, 127, 128, 129, 132, 135, 136, 138, 140, 141, 142, 143, 144, 147, 148, 149, 150, 151, 152, 153, 154, 158, 159, 160, 161, 162, 164, 165, 166, 167, 168, 169, 171, 172, 173, 174, 175, 176, 178, 182, 184, 185, 186, 188, 189, 191, 193, 194, 196, 198]"
Olaf,L50,short,137,85,52,3,0.315,200,"[0, 1, 2, 5, 6, 7, 9, 11, 12, 13, 14, 15, 16, 17, 18, 19, 20, 21, 22, 23, 24, 25, 26, 27, 28, 29, 30, 31, 32, 33, 35, 36, 38, 39, 41, 42, 43, 45, 47, 49, 50, 51, 52, 53, 54, 56, 57, 58, 60, 61, 62, 64, 65, 66, 67, 68, 69, 70, 71, 72, 73, 74, 76, 78, 79, 80, 81, 83, 87, 88, 92, 93, 94, 97, 99, 100, 103, 105, 109, 110, 111, 113, 114, 116, 117, 118, 119, 120, 121, 122, 125, 127, 130, 131, 133, 135, 137, 138, 140, 142, 144, 145, 146, 147, 148, 154, 155, 156, 157, 158, 159, 161, 162, 166, 167, 168, 169, 170, 172, 173, 174, 177, 178, 180, 181, 182, 183, 184, 186, 187, 189, 193, 194, 195, 196, 197, 198]"
Olaf,L50,short,128,48,80,11,0.36,200,"[1, 3, 4, 5, 6, 8, 9, 10, 11, 12, 13, 16, 17, 20, 21, 22, 23, 24, 25, 28, 29, 30, 31, 32, 34, 35, 37, 38, 40, 41, 43, 44, 46, 48, 49, 50, 52, 53, 54, 55, 56, 57, 59, 60, 62, 64, 65, 67, 68, 70, 72, 73, 77, 78, 80, 81, 82, 83, 89, 90, 92, 96, 97, 98, 100, 101, 102, 103, 104, 105, 106, 109, 110, 112, 113, 114, 115, 116, 117, 123, 124, 126, 127, 129, 130, 132, 133, 135, 136, 139, 141, 142, 143, 145, 146, 147, 148, 149, 150, 153, 154, 156, 157, 159, 161, 163, 164, 168, 171, 172, 173, 174, 175, 176, 177, 178, 182, 183, 185, 186, 190, 191, 192, 193, 194, 195, 196, 197]"
Olaf,L50,short,145,72,73,6,0.275,200,"[0, 1, 2, 5, 6, 7, 9, 11, 12, 14, 15, 16, 17, 18, 19, 20, 21, 23, 24, 25, 28, 29, 30, 31, 32, 34, 35, 36, 37, 38, 40, 41, 43, 44, 46, 48, 50, 51, 52, 53, 55, 56, 57, 59, 62, 63, 64, 65, 66, 67, 68, 69, 70, 71, 72, 73, 74, 75, 77, 78, 79, 80, 82, 83, 84, 87, 89, 90, 92, 93, 94, 95, 96, 98, 99, 100, 101, 102, 103, 105, 106, 110, 111, 112, 114, 115, 117, 120, 122, 123, 124, 126, 127, 128, 129, 130, 133, 134, 135, 136, 137, 138, 139, 140, 141, 143, 144, 146, 148, 149, 150, 152, 153, 154, 155, 156, 157, 158, 159, 160, 162, 163, 164, 165, 166, 167, 168, 169, 170, 172, 175, 176, 178, 179, 180, 181, 184, 185, 189, 190, 192, 193, 194, 197, 199]"
Olaf,L50,short,135,54,81,9,0.325,200,"[0, 3, 5, 6, 7, 11, 12, 14, 15, 16, 19, 20, 21, 22, 23, 26, 28, 30, 31, 33, 34, 35, 36, 37, 38, 39, 40, 42, 43, 46, 49, 50, 51, 52, 53, 54, 55, 56, 59, 60, 61, 62, 64, 66, 67, 70, 71, 72, 73, 74, 75, 77, 78, 79, 80, 81, 82, 83, 84, 88, 90, 92, 93, 94, 95, 96, 97, 98, 99, 100, 101, 102, 103, 104, 105, 106, 108, 109, 112, 114, 115, 118, 120, 121, 123, 125, 127, 129, 133, 134, 136, 137, 139, 140, 142, 143, 144, 145, 146, 148, 149, 150, 151, 152, 153, 154, 156, 157, 158, 160, 163, 164, 165, 166, 167, 169, 172, 173, 176, 177, 178, 181, 182, 184, 185, 186, 187, 189, 190, 191, 192, 193, 194, 196, 199]"
Olaf,L50,short,144,80,64,6,0.28,200,"[0, 1, 2, 6, 7, 9, 10, 12, 14, 16, 18, 19, 20, 21, 23, 24, 25, 26, 27, 28, 30, 31, 33, 34, 37, 38, 39, 40, 41, 44, 45, 46, 47, 48, 49, 52, 53, 54, 55, 56, 57, 58, 59, 60, 61, 62, 63, 64, 65, 66, 67, 68, 70, 71, 72, 73, 74, 75, 76, 77, 78, 79, 80, 81, 83, 84, 85, 86, 87, 88, 89, 90, 91, 92, 93, 95, 97, 100, 103, 104, 105, 106, 109, 110, 112, 116, 117, 119, 121, 122, 124, 126, 129, 130, 131, 132, 133, 134, 135, 137, 138, 139, 140, 141, 143, 144, 147, 148, 149, 152, 153, 155, 156, 157, 159, 160, 161, 162, 163, 164, 166, 167, 168, 171, 173, 174, 175, 176, 179, 180, 181, 183, 184, 185, 186, 187, 188, 190, 191, 193, 194, 196, 197, 198]"
Olaf,L50,short,126,60,66,12,0.37,200,"[0, 3, 4, 6, 7, 8, 10, 12, 14, 15, 16, 19, 21, 23, 24, 27, 28, 29, 31, 32, 33, 34, 35, 37, 38, 39, 40, 41, 46, 47, 48, 50, 54, 55, 56, 57, 58, 59, 60, 62, 63, 64, 68, 69, 71, 72, 73, 76, 78, 79, 81, 82, 83, 84, 85, 86, 88, 91, 92, 96, 97, 98, 99, 100, 102, 105, 106, 107, 109, 110, 112, 113, 115, 117, 118, 119, 120, 121, 124, 127, 128, 129, 131, 133, 135, 136, 139, 140, 145, 146, 147, 148, 149, 150, 151, 154, 155, 157, 159, 164, 165, 166, 169, 170, 171, 172, 173, 174, 175, 177, 179, 180, 181, 182, 183, 184, 186, 187, 188, 190, 192, 193, 194, 196, 197, 199]"
Olaf,L100,short,141,69,72,7,0.295,200,"[0, 1, 3, 4, 5, 6, 9, 13, 14, 16, 17, 18, 19, 22, 23, 24, 28, 29, 31, 32, 35, 39, 40, 41, 42, 43, 44, 45, 46, 47, 48, 51, 53, 54, 55, 56, 57, 60, 62, 64, 66, 67, 68, 69, 71, 72, 74, 75, 76, 77, 80, 82, 83, 84, 85, 86, 88, 90, 91, 92, 93, 94, 95, 96, 97, 98, 99, 101, 102, 103, 104, 105, 106, 107, 109, 111, 112, 113, 114, 115, 116, 117, 118, 119, 120, 122, 123, 124, 125, 126, 129, 130, 131, 132, 134, 136, 139, 141, 142, 144, 145, 146, 147, 148, 150, 151, 152, 154, 155, 156, 159, 160, 163, 164, 166, 169, 170, 171, 173, 174, 175, 177, 178, 180, 181, 182, 183, 185, 186, 187, 188, 189, 190, 191, 192, 193, 194, 195, 196, 197, 199]"
Olaf,L100,short,143,60,83,6,0.285,200,"[0, 1, 3, 5, 6, 9, 11, 13, 14, 17, 18, 19, 20, 21, 22, 23, 24, 25, 26, 27, 31, 32, 34, 36, 37, 38, 39, 40, 42, 43, 44, 45, 46, 48, 49, 50, 52, 56, 57, 60, 61, 62, 63, 64, 66, 67, 68, 69, 70, 74, 76, 77, 79, 80, 81, 82, 83, 84, 85, 87, 89, 90, 92, 93, 94, 96, 99, 100, 101, 102, 104, 106, 107, 108, 109, 110, 111, 112, 114, 115, 116, 117, 118, 119, 120, 121, 124, 125, 126, 127, 128, 129, 130, 131, 132, 133, 134, 135, 137, 138, 139, 140, 141, 142, 146, 147, 148, 149, 150, 151, 152, 153, 155, 156, 157, 159, 160, 161, 162, 164, 165, 167, 168, 170, 172, 173, 174, 176, 178, 180, 181, 182, 183, 184, 186, 187, 188, 190, 192, 193, 195, 197, 199]"
Olaf,L100,short,131,71,60,10,0.345,200,"[1, 3, 4, 5, 6, 7, 8, 10, 11, 14, 15, 16, 17, 19, 21, 22, 24, 26, 29, 31, 35, 37, 38, 41, 44, 48, 51, 54, 55, 56, 57, 58, 60, 62, 64, 65, 66, 67, 68, 70, 71, 73, 74, 75, 76, 80, 82, 85, 86, 87, 89, 90, 91, 92, 93, 95, 97, 98, 99, 100, 101, 102, 103, 104, 105, 107, 109, 110, 112, 113, 115, 116, 117, 119, 120, 121, 122, 123, 125, 128, 131, 132, 133, 134, 136, 138, 139, 140, 141, 142, 143, 144, 145, 147, 148, 150, 151, 153, 154, 155, 156, 157, 159, 162, 163, 164, 166, 167, 168, 169, 170, 171, 173, 174, 176, 177, 179, 181, 182, 183, 185, 187, 190, 191, 192, 193, 195, 196, 197, 198, 199]"
Olaf,L100,short,128,70,58,3,0.36,200,"[1, 2, 3, 4, 5, 6, 7, 8, 10, 11, 12, 13, 14, 15, 22, 23, 24, 25, 26, 27, 30, 31, 32, 34, 36, 37, 38, 39, 41, 42, 43, 45, 47, 49, 51, 53, 54, 55, 57, 58, 59, 61, 64, 65, 67, 68, 69, 71, 72, 73, 74, 75, 77, 78, 79, 80, 81, 82, 83, 84, 85, 86, 87, 88, 89, 96, 97, 98, 101, 103, 108, 109, 110, 112, 113, 114, 115, 118, 119, 120, 121, 123, 128, 129, 131, 132, 134, 135, 136, 137, 139, 140, 141, 142, 143, 144, 145, 146, 148, 150, 151, 152, 156, 157, 159, 163, 164, 165, 167, 168, 169, 170, 171, 175, 177, 178, 181, 182, 183, 184, 185, 186, 187, 188, 193, 195, 198, 199]"
Olaf,L100,short,122,67,55,11,0.39,200,"[5, 6, 10, 12, 16, 18, 19, 22, 25, 26, 28, 29, 30, 33, 34, 36, 37, 38, 40, 41, 43, 44, 46, 47, 49, 50, 51, 52, 54, 56, 58, 59, 63, 65, 69, 70, 71, 72, 73, 74, 76, 77, 78, 79, 81, 82, 85, 86, 87, 88, 90, 91, 93, 94, 95, 96, 97, 98, 99, 103, 104, 105, 106, 108, 109, 110, 111, 113, 114, 115, 118, 119, 120, 122, 123, 125, 126, 129, 130, 131, 133, 135, 138, 141, 142, 144, 145, 146, 147, 148, 150, 152, 154, 155, 159, 160, 161, 163, 165, 166, 167, 168, 169, 170, 171, 172, 173, 174, 176, 177, 178, 179, 183, 184, 185, 186, 187, 190, 193, 194, 196, 199]"
Olaf,L100,short,138,73,65,6,0.31,200,"[0, 1, 2, 3, 7, 9, 11, 13, 14, 15, 16, 17, 18, 19, 20, 21, 23, 26, 30, 31, 32, 33, 37, 39, 40, 41, 42, 43, 44, 45, 46, 47, 51, 52, 53, 54, 55, 58, 59, 61, 62, 64, 66, 67, 69, 70, 71, 72, 74, 75, 76, 77, 79, 80, 81, 82, 84, 86, 87, 88, 89, 90, 91, 92, 94, 95, 96, 99, 100, 103, 104, 105, 106, 107, 108, 109, 111, 114, 115, 116, 117, 119, 120, 121, 122, 124, 125, 127, 131, 132, 133, 134, 135, 137, 138, 139, 142, 143, 144, 147, 148, 149, 150, 151, 152, 153, 154, 156, 159, 160, 161, 163, 164, 165, 168, 170, 171, 172, 173, 174, 176, 177, 178, 180, 181, 182, 183, 184, 185, 186, 189, 190, 191, 194, 195, 196, 197, 198]"
Olaf,L100,short,125,71,54,5,0.375,200,"[0, 1, 2, 3, 4, 7, 9, 10, 11, 12, 13, 14, 16, 17, 19, 21, 22, 24, 25, 28, 29, 31, 32, 33, 35, 38, 39, 42, 44, 46, 47, 48, 49, 50, 51, 53, 54, 55, 56, 57, 58, 59, 61, 62, 63, 65, 67, 68, 69, 72, 73, 74, 75, 77, 82, 84, 85, 86, 87, 88, 90, 91, 92, 94, 95, 96, 98, 99, 102, 103, 104, 108, 109, 110, 112, 114, 115, 116, 118, 119, 121, 122, 124, 125, 129, 130, 132, 133, 135, 137, 139, 145, 146, 147, 151, 152, 153, 154, 155, 156, 157, 158, 163, 164, 165, 167, 170, 172, 173, 177, 178, 180, 181, 182, 183, 187, 188, 189, 191, 192, 193, 194, 195, 198, 199]"
Olaf,L100,short,122,60,62,13,0.39,200,"[0, 2, 4, 6, 8, 9, 11, 12, 14, 16, 17, 21, 23, 26, 27, 31, 32, 33, 36, 37, 40, 41, 42, 44, 47, 48, 49, 50, 51, 53, 57, 58, 62, 64, 65, 66, 69, 70, 71, 72, 73, 74, 76, 77, 80, 81, 82, 83, 84, 86, 87, 88, 89, 90, 92, 97, 99, 100, 101, 102, 103, 105, 106, 107, 108, 109, 110, 113, 114, 115, 118, 122, 125, 126, 127, 129, 132, 134, 137, 138, 139, 141, 142, 143, 144, 145, 146, 147, 151, 152, 153, 154, 155, 156, 158, 159, 160, 161, 165, 166, 169, 170, 171, 174, 175, 176, 177, 180, 181, 183, 184, 185, 187, 188, 189, 193, 194, 195, 196, 197, 198, 199]"
Olaf,L100,short,140,91,49,6,0.3,200,"[0, 2, 4, 5, 6, 9, 11, 12, 13, 14, 15, 16, 17, 18, 19, 21, 23, 24, 27, 29, 30, 31, 32, 36, 37, 38, 39, 40, 43, 44, 45, 48, 49, 50, 51, 52, 53, 55, 56, 58, 59, 60, 61, 63, 64, 65, 66, 67, 68, 69, 70, 72, 73, 75, 76, 80, 81, 83, 84, 85, 87, 90, 91, 92, 95, 97, 99, 100, 101, 102, 103, 104, 105, 106, 108, 109, 110, 111, 112, 113, 115, 116, 117, 118, 119, 120, 121, 122, 124, 125, 126, 127, 128, 129, 130, 131, 132, 135, 136, 137, 140, 141, 142, 143, 144, 145, 149, 151, 153, 155, 158, 159, 160, 161, 162, 163, 165, 166, 167, 170, 173, 174, 175, 176, 177, 181, 183, 184, 185, 186, 187, 188, 189, 190, 191, 192, 194, 195, 197, 199]"
Olaf,L100,short,137,66,71,12,0.315,200,"[2, 3, 4, 5, 6, 8, 9, 10, 13, 14, 15, 16, 17, 18, 19, 20, 21, 22, 23, 25, 26, 27, 29, 30, 31, 32, 33, 34, 35, 36, 37, 40, 41, 43, 45, 46, 47, 48, 49, 52, 53, 54, 55, 56, 57, 58, 59, 60, 61, 63, 65, 66, 68, 69, 75, 76, 79, 80, 82, 83, 84, 87, 88, 89, 91, 92, 93, 95, 98, 100, 102, 103, 104, 105, 106, 110, 111, 113, 114, 116, 117, 118, 119, 120, 121, 123, 125, 129, 130, 131, 133, 134, 135, 136, 137, 138, 139, 140, 141, 142, 143, 145, 146, 147, 148, 149, 152, 153, 154, 157, 158, 159, 160, 161, 162, 163, 167, 168, 169, 171, 173, 174, 175, 177, 178, 182, 184, 185, 186, 187, 190, 192, 193, 194, 195, 197, 198]"
Olaf,L100,short,125,76,49,9,0.375,200,"[0, 1, 2, 4, 5, 6, 7, 9, 10, 11, 13, 14, 15, 16, 17, 18, 21, 22, 25, 26, 28, 29, 31, 32, 34, 35, 36, 40, 43, 44, 46, 47, 48, 49, 50, 51, 52, 53, 54, 56, 57, 58, 62, 64, 66, 67, 68, 69, 70, 71, 72, 74, 79, 80, 81, 82, 84, 85, 86, 87, 88, 90, 92, 94, 97, 99, 100, 102, 103, 105, 110, 111, 112, 114, 117, 119, 122, 123, 124, 125, 129, 130, 131, 132, 133, 134, 135, 136, 137, 139, 140, 141, 142, 143, 146, 148, 152, 153, 154, 157, 158, 159, 162, 163, 165, 166, 170, 171, 172, 174, 177, 178, 180, 182, 183, 184, 185, 189, 190, 191, 192, 193, 195, 196, 197]"
Olaf,L100,short,124,76,48,7,0.38,200,"[0, 3, 5, 6, 7, 8, 10, 14, 15, 16, 17, 18, 19, 21, 22, 23, 24, 25, 26, 28, 32, 33, 34, 35, 36, 39, 40, 41, 42, 44, 45, 47, 48, 49, 50, 52, 54, 55, 58, 59, 60, 62, 63, 64, 65, 66, 67, 68, 70, 71, 72, 74, 75, 76, 77, 80, 81, 86, 87, 89, 90, 92, 93, 95, 97, 98, 99, 100, 103, 104, 106, 108, 109, 110, 111, 116, 118, 120, 121, 125, 128, 129, 130, 131, 132, 133, 138, 139, 140, 141, 142, 143, 144, 147, 148, 152, 153, 154, 155, 159, 160, 161, 162, 163, 164, 165, 166, 167, 169, 172, 173, 174, 176, 177, 180, 182, 183, 185, 186, 188, 190, 192, 196, 198]"
Olaf,L100,short,130,72,58,12,0.35,200,"[0, 1, 2, 3, 4, 6, 7, 8, 13, 15, 17, 18, 20, 21, 22, 24, 26, 27, 28, 29, 31, 33, 34, 35, 36, 37, 41, 43, 45, 47, 48, 50, 51, 52, 53, 54, 55, 58, 61, 64, 65, 67, 71, 72, 76, 77, 78, 79, 82, 83, 84, 85, 86, 87, 88, 89, 91, 92, 93, 94, 95, 96, 97, 98, 101, 102, 103, 104, 105, 106, 107, 109, 112, 113, 115, 116, 117, 118, 119, 120, 121, 122, 123, 124, 125, 127, 130, 132, 134, 138, 140, 141, 142, 144, 145, 146, 148, 149, 150, 151, 153, 154, 155, 156, 157, 158, 161, 162, 163, 164, 166, 167, 168, 169, 170, 171, 172, 173, 175, 178, 179, 180, 181, 182, 186, 188, 189, 190, 196, 199]"
Olaf,L100,short,142,76,66,9,0.29,200,"[1, 2, 4, 5, 6, 7, 8, 9, 10, 11, 12, 13, 14, 15, 17, 18, 20, 21, 22, 24, 26, 28, 29, 30, 32, 33, 34, 35, 36, 37, 38, 39, 40, 41, 43, 44, 45, 47, 48, 49, 50, 51, 54, 56, 58, 60, 61, 62, 63, 64, 66, 67, 68, 70, 72, 74, 75, 76, 77, 78, 80, 82, 83, 85, 88, 89, 90, 92, 93, 94, 95, 96, 97, 98, 99, 100, 101, 103, 104, 105, 108, 109, 110, 111, 112, 113, 114, 116, 117, 118, 122, 123, 124, 126, 128, 130, 131, 133, 135, 136, 137, 138, 139, 140, 141, 143, 144, 145, 146, 148, 149, 151, 152, 153, 154, 159, 163, 164, 165, 167, 170, 171, 172, 176, 177, 178, 180, 181, 183, 184, 185, 186, 187, 188, 189, 191, 192, 193, 195, 197, 198, 199]"
Olaf,L100,short,135,66,69,7,0.325,200,"[0, 2, 4, 6, 7, 8, 9, 12, 13, 16, 19, 21, 22, 23, 26, 27, 30, 31, 33, 34, 35, 36, 37, 39, 41, 42, 43, 44, 45, 46, 48, 50, 51, 52, 54, 56, 57, 58, 61, 62, 64, 65, 66, 67, 68, 70, 71, 72, 73, 76, 77, 78, 81, 82, 83, 85, 86, 90, 91, 92, 93, 94, 95, 96, 97, 98, 99, 100, 102, 103, 105, 106, 107, 108, 109, 110, 111, 112, 113, 114, 115, 117, 118, 119, 120, 121, 122, 124, 125, 127, 128, 129, 130, 132, 134, 137, 139, 140, 141, 142, 144, 146, 147, 148, 149, 152, 153, 154, 157, 158, 160, 161, 162, 164, 165, 166, 168, 169, 170, 172, 174, 175, 176, 177, 179, 180, 181, 184, 185, 189, 191, 193, 194, 195, 198]"
Olaf,L100,short,129,78,51,24,0.355,200,"[0, 1, 3, 4, 5, 8, 11, 12, 13, 15, 17, 20, 21, 23, 24, 25, 26, 28, 30, 31, 33, 34, 36, 37, 39, 40, 46, 48, 49, 50, 54, 55, 56, 57, 58, 59, 63, 64, 65, 66, 69, 70, 71, 72, 73, 75, 78, 79, 81, 83, 84, 85, 88, 89, 92, 94, 96, 97, 98, 99, 100, 101, 102, 103, 104, 108, 109, 110, 112, 113, 114, 115, 117, 119, 120, 121, 122, 124, 125, 130, 131, 132, 133, 134, 135, 136, 138, 139, 140, 141, 147, 148, 149, 150, 151, 152, 154, 155, 156, 157, 158, 160, 161, 162, 163, 165, 166, 167, 168, 172, 174, 175, 176, 178, 179, 180, 181, 182, 186, 187, 188, 189, 191, 192, 193, 194, 196, 198, 199]"
Olaf,L100,short,133,66,67,9,0.335,200,"[0, 1, 2, 4, 6, 7, 8, 9, 10, 12, 15, 16, 17, 18, 20, 21, 23, 24, 26, 27, 28, 29, 30, 33, 35, 36, 38, 41, 42, 45, 46, 47, 49, 50, 51, 53, 54, 55, 56, 57, 58, 59, 62, 63, 64, 65, 67, 68, 71, 72, 74, 75, 77, 78, 80, 81, 82, 83, 84, 85, 86, 87, 88, 90, 91, 93, 94, 96, 97, 99, 103, 105, 107, 109, 111, 113, 115, 116, 118, 119, 121, 122, 123, 124, 125, 127, 129, 130, 131, 132, 135, 136, 137, 139, 140, 144, 145, 147, 151, 153, 154, 155, 157, 158, 160, 161, 162, 163, 164, 167, 168, 169, 170, 172, 174, 175, 178, 179, 180, 181, 182, 185, 186, 187, 188, 189, 190, 191, 193, 194, 196, 198, 199]"
Olaf,L100,short,136,71,65,5,0.32,200,"[0, 1, 2, 4, 6, 9, 10, 13, 14, 15, 16, 17, 19, 20, 21, 22, 23, 24, 25, 26, 27, 30, 31, 33, 36, 38, 39, 40, 41, 43, 44, 45, 47, 48, 50, 51, 52, 53, 55, 56, 57, 58, 60, 63, 65, 66, 67, 69, 70, 71, 72, 75, 76, 77, 78, 79, 80, 81, 83, 84, 85, 86, 88, 89, 90, 91, 92, 93, 98, 99, 103, 104, 105, 106, 107, 108, 112, 113, 115, 118, 119, 121, 122, 123, 124, 125, 127, 129, 130, 132, 133, 135, 137, 138, 139, 141, 142, 144, 145, 146, 147, 148, 149, 150, 151, 152, 153, 155, 156, 157, 158, 159, 161, 163, 167, 170, 172, 173, 174, 175, 176, 179, 180, 181, 182, 183, 185, 186, 188, 189, 190, 193, 195, 196, 197, 199]"
Olaf,L100,short,135,56,79,6,0.325,200,"[0, 1, 3, 5, 6, 12, 14, 15, 16, 17, 18, 19, 20, 21, 22, 23, 24, 25, 27, 28, 30, 31, 33, 34, 35, 36, 37, 39, 41, 42, 43, 44, 45, 46, 47, 49, 52, 53, 56, 57, 58, 59, 60, 61, 62, 64, 65, 66, 70, 71, 72, 73, 74, 75, 76, 77, 82, 83, 86, 87, 88, 89, 92, 93, 96, 97, 98, 102, 104, 105, 107, 108, 109, 110, 111, 112, 114, 115, 116, 117, 118, 119, 120, 121, 123, 124, 125, 128, 129, 131, 132, 133, 134, 135, 136, 137, 138, 140, 141, 142, 143, 144, 145, 146, 147, 148, 149, 150, 152, 153, 156, 157, 158, 161, 162, 163, 165, 168, 169, 170, 171, 172, 173, 174, 178, 181, 183, 184, 187, 188, 189, 191, 195, 197, 198]"
Olaf,L100,short,136,51,85,8,0.32,200,"[1, 2, 3, 4, 5, 8, 9, 14, 15, 17, 18, 19, 20, 22, 23, 24, 26, 27, 28, 29, 30, 32, 34, 35, 39, 42, 45, 46, 47, 48, 49, 51, 54, 55, 56, 57, 58, 59, 60, 61, 62, 63, 64, 65, 67, 69, 71, 72, 74, 75, 76, 77, 78, 80, 81, 82, 83, 84, 85, 86, 87, 88, 89, 90, 92, 95, 96, 97, 98, 99, 101, 103, 104, 105, 106, 108, 110, 111, 112, 113, 115, 117, 118, 119, 123, 124, 125, 128, 129, 131, 133, 135, 137, 139, 140, 142, 143, 144, 146, 147, 148, 152, 153, 154, 155, 158, 159, 161, 163, 165, 166, 167, 169, 170, 172, 173, 174, 175, 177, 178, 179, 181, 182, 183, 185, 186, 188, 190, 191, 192, 193, 194, 196, 197, 198, 199]"
Olaf,L100,short,136,83,53,12,0.32,200,"[0, 1, 2, 3, 4, 5, 6, 7, 8, 9, 10, 12, 13, 15, 16, 17, 19, 20, 22, 23, 24, 25, 26, 27, 29, 30, 31, 32, 33, 34, 36, 38, 40, 41, 42, 43, 44, 45, 46, 47, 49, 51, 52, 53, 54, 55, 56, 61, 62, 63, 66, 68, 70, 71, 72, 73, 74, 76, 78, 79, 80, 81, 82, 84, 85, 86, 87, 89, 91, 92, 93, 95, 96, 97, 98, 100, 102, 103, 104, 107, 108, 109, 110, 111, 113, 114, 115, 116, 117, 118, 119, 120, 122, 128, 129, 130, 131, 132, 135, 136, 137, 138, 139, 140, 141, 144, 145, 146, 147, 148, 149, 150, 156, 157, 159, 160, 163, 164, 165, 166, 167, 171, 173, 174, 177, 180, 182, 183, 187, 190, 191, 192, 193, 194, 195, 198]"
Olaf,L100,short,120,69,51,22,0.4,200,"[0, 1, 2, 3, 5, 6, 8, 13, 14, 15, 17, 18, 20, 21, 22, 24, 25, 26, 32, 35, 38, 39, 40, 41, 42, 47, 49, 52, 56, 58, 59, 60, 62, 65, 66, 67, 68, 70, 71, 72, 73, 74, 76, 77, 78, 84, 85, 86, 88, 89, 92, 93, 95, 98, 99, 100, 104, 109, 110, 111, 112, 113, 114, 115, 116, 117, 118, 119, 120, 123, 124, 125, 127, 128, 129, 130, 131, 132, 133, 134, 136, 139, 140, 141, 143, 145, 146, 147, 148, 151, 152, 153, 158, 160, 161, 163, 164, 166, 170, 171, 173, 174, 176, 179, 180, 181, 182, 183, 184, 185, 186, 187, 188, 189, 192, 193, 194, 195, 197, 199]"
Olaf,L100,short,131,65,66,8,0.345,200,"[1, 2, 3, 4, 5, 6, 8, 12, 13, 14, 15, 16, 19, 20, 21, 22, 23, 24, 25, 27, 28, 29, 32, 34, 37, 40, 41, 42, 43, 45, 46, 47, 48, 50, 51, 53, 56, 58, 59, 60, 61, 64, 66, 68, 73, 75, 76, 77, 79, 80, 81, 82, 83, 85, 86, 87, 88, 90, 91, 94, 96, 97, 99, 100, 101, 102, 103, 105, 108, 109, 111, 113, 114, 115, 116, 117, 118, 119, 121, 122, 123, 125, 126, 127, 130, 131, 132, 133, 135, 136, 140, 141, 144, 145, 148, 149, 150, 151, 152, 153, 154, 155, 156, 157, 159, 160, 163, 164, 166, 167, 168, 169, 172, 174, 176, 178, 179, 180, 182, 186, 187, 189, 190, 191, 192, 193, 194, 196, 197, 198, 199]"
Olaf,L100,short,145,63,82,14,0.275,200,"[0, 1, 3, 4, 5, 7, 8, 10, 11, 12, 13, 14, 15, 16, 17, 18, 19, 20, 21, 22, 23, 24, 25, 26, 29, 30, 33, 34, 36, 37, 39, 40, 42, 43, 46, 47, 48, 49, 50, 51, 52, 53, 55, 57, 59, 61, 62, 63, 65, 66, 68, 69, 70, 71, 72, 73, 74, 75, 76, 78, 79, 80, 83, 85, 88, 89, 91, 92, 96, 99, 101, 102, 103, 104, 105, 107, 108, 109, 110, 111, 112, 114, 115, 116, 120, 121, 123, 126, 127, 128, 129, 130, 131, 132, 133, 134, 138, 139, 140, 141, 142, 144, 146, 147, 149, 150, 151, 152, 153, 154, 155, 158, 159, 160, 161, 162, 163, 165, 166, 167, 168, 169, 170, 171, 173, 175, 176, 177, 178, 179, 180, 181, 184, 185, 187, 189, 190, 192, 193, 194, 195, 196, 197, 198, 199]"
Olaf,L100,short,125,56,69,15,0.375,200,"[2, 3, 4, 9, 10, 12, 13, 16, 18, 19, 20, 21, 22, 23, 24, 26, 27, 28, 29, 31, 32, 33, 35, 36, 38, 39, 41, 45, 46, 47, 48, 49, 50, 53, 54, 55, 58, 59, 62, 64, 65, 66, 68, 71, 72, 74, 75, 76, 77, 78, 79, 82, 83, 84, 85, 87, 88, 91, 92, 93, 96, 98, 100, 101, 104, 106, 107, 108, 110, 112, 113, 114, 115, 116, 120, 122, 123, 124, 125, 126, 128, 129, 132, 133, 135, 136, 137, 138, 139, 140, 142, 143, 144, 145, 146, 147, 148, 153, 155, 156, 158, 160, 161, 162, 163, 165, 166, 170, 173, 175, 177, 178, 180, 182, 183, 184, 185, 186, 187, 188, 189, 192, 195, 196, 197]"
Olaf,L100,short,129,67,62,9,0.355,200,"[0, 1, 3, 4, 5, 6, 9, 11, 12, 13, 14, 16, 17, 21, 22, 23, 24, 25, 26, 27, 29, 31, 35, 36, 40, 42, 46, 47, 48, 50, 52, 53, 56, 57, 58, 62, 65, 66, 68, 69, 70, 71, 74, 76, 77, 78, 79, 80, 82, 83, 84, 85, 86, 87, 88, 89, 92, 94, 95, 97, 98, 99, 100, 101, 102, 103, 106, 107, 108, 111, 113, 114, 115, 116, 117, 120, 122, 124, 125, 126, 128, 130, 131, 133, 134, 136, 137, 138, 139, 140, 144, 145, 147, 149, 152, 153, 154, 155, 156, 158, 159, 160, 161, 163, 164, 166, 169, 170, 171, 172, 173, 174, 176, 177, 178, 179, 180, 184, 185, 186, 188, 189, 191, 192, 193, 194, 195, 196, 197]"
Olaf,L100,short,133,61,72,13,0.335,200,"[0, 1, 2, 3, 5, 6, 7, 9, 11, 12, 13, 14, 15, 17, 19, 20, 21, 22, 25, 26, 27, 28, 30, 32, 36, 37, 38, 40, 41, 43, 44, 45, 46, 47, 49, 50, 51, 52, 53, 55, 56, 57, 58, 59, 62, 63, 64, 68, 71, 73, 74, 75, 76, 77, 78, 79, 80, 81, 82, 83, 85, 88, 90, 91, 93, 95, 96, 97, 98, 99, 100, 102, 105, 106, 107, 108, 111, 115, 116, 117, 118, 120, 122, 123, 125, 126, 127, 128, 129, 130, 132, 135, 137, 139, 140, 141, 142, 143, 144, 146, 147, 148, 149, 150, 151, 152, 154, 155, 156, 160, 161, 162, 163, 167, 168, 169, 170, 171, 173, 176, 180, 183, 184, 185, 187, 188, 189, 190, 192, 193, 196, 197, 198]"
Olaf,L100,short,125,70,55,16,0.375,200,"[0, 1, 6, 7, 8, 9, 10, 11, 13, 14, 16, 18, 19, 20, 24, 25, 28, 29, 30, 31, 33, 36, 37, 39, 40, 41, 42, 44, 45, 46, 47, 48, 49, 51, 52, 53, 54, 56, 57, 58, 59, 61, 62, 63, 66, 67, 68, 70, 71, 72, 75, 77, 79, 80, 81, 83, 84, 85, 87, 88, 89, 93, 95, 97, 99, 100, 101, 103, 105, 106, 107, 109, 110, 114, 115, 116, 117, 118, 119, 121, 124, 125, 126, 127, 129, 130, 131, 132, 135, 137, 138, 142, 143, 144, 149, 151, 152, 155, 156, 157, 158, 160, 163, 164, 165, 167, 173, 174, 175, 176, 177, 178, 180, 181, 182, 183, 186, 187, 188, 190, 192, 193, 194, 196, 198]"
Olaf,L100,short,131,66,65,4,0.345,200,"[0, 1, 2, 3, 4, 5, 8, 9, 10, 11, 12, 13, 14, 15, 18, 19, 20, 21, 22, 23, 24, 27, 29, 30, 31, 32, 33, 34, 37, 38, 39, 40, 41, 42, 43, 44, 46, 47, 49, 50, 54, 55, 56, 57, 61, 62, 65, 66, 67, 68, 69, 70, 71, 72, 75, 76, 77, 78, 80, 81, 82, 85, 87, 88, 89, 90, 94, 96, 97, 98, 99, 100, 101, 102, 103, 104, 105, 107, 109, 110, 111, 115, 120, 122, 124, 125, 127, 128, 130, 132, 133, 134, 135, 136, 137, 138, 139, 143, 144, 147, 149, 150, 151, 152, 153, 155, 156, 158, 161, 162, 164, 165, 168, 171, 172, 174, 175, 176, 177, 178, 179, 185, 186, 188, 192, 193, 194, 195, 197, 198, 199]"
Olaf,L100,short,130,67,63,5,0.35,200,"[1, 2, 3, 4, 5, 6, 9, 10, 11, 12, 14, 16, 17, 18, 19, 20, 21, 24, 25, 27, 28, 31, 32, 35, 36, 39, 43, 46, 49, 51, 52, 53, 54, 55, 56, 57, 58, 61, 62, 63, 64, 67, 70, 71, 72, 73, 74, 75, 76, 77, 78, 81, 82, 84, 85, 86, 87, 88, 89, 90, 91, 92, 93, 94, 96, 97, 100, 102, 103, 104, 107, 108, 109, 110, 111, 113, 114, 117, 119, 121, 123, 124, 127, 128, 130, 132, 133, 136, 137, 138, 139, 141, 142, 143, 147, 148, 149, 151, 154, 156, 157, 158, 159, 162, 163, 166, 167, 168, 169, 170, 171, 173, 174, 175, 180, 181, 182, 183, 184, 185, 187, 188, 189, 191, 192, 193, 194, 195, 196, 199]"
Olaf,L100,short,134,79,55,6,0.33,200,"[0, 1, 2, 3, 4, 5, 7, 8, 9, 10, 11, 14, 15, 16, 17, 18, 19, 20, 21, 22, 24, 25, 26, 27, 28, 29, 30, 32, 33, 34, 35, 36, 37, 40, 41, 43, 44, 48, 49, 50, 51, 52, 55, 56, 57, 58, 59, 60, 61, 62, 65, 66, 67, 70, 71, 74, 75, 76, 78, 79, 81, 83, 84, 86, 87, 88, 89, 91, 92, 94, 97, 98, 99, 100, 102, 103, 104, 105, 108, 111, 113, 115, 116, 119, 120, 121, 122, 124, 126, 127, 128, 129, 132, 133, 134, 135, 140, 141, 143, 146, 147, 149, 150, 151, 154, 155, 156, 159, 160, 161, 162, 163, 164, 165, 170, 172, 173, 174, 175, 176, 177, 180, 181, 182, 183, 184, 185, 186, 187, 188, 190, 193, 197, 199]"
Olaf,L100,short,136,70,66,8,0.32,200,"[1, 3, 5, 7, 8, 9, 10, 11, 13, 16, 17, 18, 19, 20, 21, 22, 23, 25, 29, 30, 32, 33, 34, 35, 37, 38, 40, 42, 43, 44, 47, 48, 49, 52, 53, 55, 56, 57, 58, 59, 61, 62, 63, 64, 65, 66, 67, 68, 70, 72, 73, 74, 75, 78, 79, 80, 81, 82, 84, 85, 86, 87, 88, 89, 91, 92, 93, 95, 98, 99, 100, 101, 102, 104, 105, 106, 110, 111, 112, 113, 115, 116, 118, 119, 121, 125, 126, 128, 130, 131, 132, 133, 136, 137, 138, 140, 143, 144, 147, 149, 150, 151, 153, 155, 157, 158, 159, 161, 163, 165, 166, 168, 169, 170, 171, 172, 174, 177, 178, 179, 181, 182, 183, 184, 186, 187, 188, 189, 190, 192, 193, 195, 196, 197, 198, 199]"
Olaf,L100,short,144,77,67,4,0.28,200,"[1, 3, 4, 5, 7, 8, 9, 10, 11, 12, 13, 14, 15, 18, 19, 20, 22, 24, 25, 27, 28, 29, 30, 31, 32, 33, 35, 36, 38, 40, 42, 43, 44, 45, 46, 48, 49, 51, 53, 54, 55, 56, 57, 58, 62, 63, 65, 66, 68, 71, 73, 74, 75, 76, 77, 78, 79, 83, 84, 86, 88, 89, 90, 92, 93, 94, 96, 99, 100, 101, 102, 104, 105, 106, 107, 108, 109, 110, 111, 113, 114, 115, 116, 119, 120, 121, 122, 123, 125, 126, 128, 129, 131, 132, 133, 134, 136, 137, 138, 139, 140, 141, 143, 144, 145, 146, 147, 148, 149, 150, 151, 152, 153, 156, 157, 159, 160, 161, 163, 165, 166, 167, 168, 170, 174, 175, 176, 177, 178, 179, 180, 181, 184, 185, 186, 187, 188, 189, 190, 192, 193, 194, 196, 198]"
Olaf,L100,short,138,56,82,8,0.31,200,"[1, 2, 3, 4, 5, 6, 9, 10, 13, 14, 16, 17, 19, 20, 21, 22, 23, 25, 29, 31, 32, 34, 35, 36, 38, 39, 40, 43, 47, 49, 50, 52, 54, 55, 57, 58, 59, 60, 63, 64, 66, 68, 69, 70, 73, 75, 77, 78, 79, 80, 81, 82, 83, 84, 87, 88, 89, 90, 91, 92, 95, 96, 97, 98, 100, 101, 102, 103, 104, 105, 106, 107, 109, 111, 112, 113, 114, 115, 116, 117, 118, 120, 122, 124, 125, 126, 127, 128, 129, 132, 133, 135, 136, 138, 139, 141, 142, 143, 145, 146, 148, 151, 152, 154, 155, 156, 158, 159, 162, 163, 164, 165, 166, 167, 168, 169, 170, 171, 173, 175, 177, 178, 179, 180, 182, 183, 184, 185, 187, 188, 189, 190, 193, 195, 196, 197, 198, 199]"
Olaf,L100,short,128,74,54,8,0.36,200,"[0, 5, 6, 7, 9, 10, 14, 15, 16, 18, 19, 21, 22, 23, 24, 26, 27, 28, 29, 30, 31, 33, 34, 35, 37, 38, 42, 43, 47, 48, 51, 53, 56, 57, 59, 60, 62, 63, 64, 65, 67, 68, 69, 70, 71, 73, 75, 76, 77, 78, 79, 82, 83, 85, 86, 87, 88, 89, 91, 92, 96, 97, 99, 100, 101, 102, 103, 104, 110, 113, 114, 115, 116, 117, 118, 119, 120, 125, 126, 127, 132, 133, 135, 137, 139, 140, 144, 145, 146, 147, 148, 150, 152, 153, 155, 158, 159, 160, 161, 164, 165, 166, 168, 169, 170, 171, 172, 174, 175, 177, 178, 180, 182, 183, 185, 186, 187, 188, 189, 190, 191, 193, 194, 195, 196, 197, 198, 199]"
Olaf,L100,short,124,73,51,13,0.38,200,"[0, 2, 3, 4, 5, 6, 8, 9, 10, 11, 13, 15, 16, 17, 18, 19, 20, 21, 23, 26, 27, 28, 29, 30, 31, 32, 34, 35, 36, 38, 39, 40, 41, 42, 43, 44, 46, 48, 50, 51, 52, 54, 56, 57, 58, 59, 60, 61, 64, 65, 66, 67, 68, 70, 71, 72, 73, 74, 76, 78, 80, 81, 86, 88, 89, 90, 93, 94, 96, 98, 103, 104, 107, 108, 109, 112, 115, 116, 117, 119, 120, 121, 122, 124, 126, 127, 129, 130, 132, 133, 137, 138, 139, 140, 145, 146, 147, 150, 152, 154, 158, 160, 162, 167, 168, 169, 171, 172, 175, 177, 179, 181, 182, 184, 186, 187, 188, 189, 192, 194, 196, 197, 198, 199]"
Olaf,L100,short,129,56,73,10,0.355,200,"[0, 1, 3, 6, 7, 9, 10, 11, 14, 15, 16, 17, 18, 19, 20, 22, 23, 24, 27, 28, 31, 32, 33, 34, 37, 38, 40, 41, 44, 45, 46, 49, 50, 52, 53, 54, 55, 57, 61, 63, 64, 66, 67, 71, 73, 74, 77, 78, 79, 80, 81, 82, 83, 86, 87, 88, 89, 90, 91, 92, 93, 94, 96, 98, 99, 100, 103, 104, 108, 109, 111, 113, 115, 118, 119, 121, 122, 123, 126, 129, 131, 132, 133, 134, 135, 136, 137, 138, 140, 141, 142, 143, 145, 147, 148, 149, 150, 152, 153, 154, 155, 158, 162, 163, 164, 165, 166, 168, 169, 170, 172, 174, 175, 176, 177, 179, 182, 183, 184, 185, 186, 187, 188, 191, 192, 193, 197, 198, 199]"
Olaf,L100,short,128,62,66,6,0.36,200,"[1, 3, 4, 5, 7, 10, 11, 12, 14, 16, 17, 18, 19, 20, 22, 23, 27, 28, 29, 30, 31, 35, 36, 38, 40, 42, 43, 44, 45, 47, 48, 51, 53, 54, 55, 56, 57, 58, 61, 64, 65, 66, 67, 68, 70, 71, 73, 75, 76, 77, 78, 79, 82, 85, 86, 88, 91, 92, 93, 95, 96, 98, 103, 104, 105, 108, 109, 113, 114, 115, 117, 118, 119, 122, 124, 125, 126, 128, 130, 131, 132, 134, 135, 136, 137, 138, 139, 142, 143, 144, 145, 146, 148, 150, 151, 152, 154, 155, 156, 157, 158, 159, 162, 165, 167, 168, 169, 172, 174, 176, 177, 178, 179, 182, 183, 184, 185, 186, 188, 190, 191, 192, 193, 194, 196, 197, 198, 199]"
Olaf,L100,short,128,60,68,8,0.36,200,"[0, 1, 3, 5, 6, 7, 8, 9, 10, 11, 13, 14, 15, 17, 19, 22, 26, 27, 30, 31, 33, 34, 36, 37, 38, 41, 42, 44, 45, 46, 47, 49, 51, 54, 56, 58, 59, 60, 61, 63, 65, 66, 68, 69, 71, 72, 73, 76, 78, 79, 80, 81, 82, 83, 84, 85, 87, 92, 93, 94, 95, 96, 97, 98, 100, 101, 102, 103, 104, 105, 107, 109, 110, 111, 112, 114, 115, 116, 117, 119, 120, 122, 124, 127, 129, 130, 133, 135, 136, 138, 139, 140, 142, 143, 146, 147, 148, 150, 152, 153, 155, 156, 158, 160, 162, 164, 165, 167, 168, 169, 170, 171, 174, 175, 176, 177, 178, 181, 182, 184, 185, 186, 194, 195, 196, 197, 198, 199]"
Olaf,L100,short,134,66,68,7,0.33,200,"[1, 2, 5, 6, 7, 8, 9, 10, 11, 13, 16, 17, 18, 19, 20, 21, 23, 24, 26, 27, 29, 30, 31, 32, 33, 35, 37, 38, 39, 40, 43, 44, 45, 46, 47, 48, 49, 51, 54, 55, 56, 57, 60, 61, 63, 65, 66, 67, 68, 69, 71, 74, 75, 77, 79, 80, 81, 82, 83, 86, 87, 88, 89, 90, 91, 94, 95, 96, 97, 98, 100, 101, 102, 103, 106, 107, 108, 110, 112, 113, 114, 115, 117, 119, 121, 122, 123, 124, 129, 131, 132, 133, 134, 135, 136, 137, 138, 140, 141, 142, 143, 145, 146, 149, 150, 152, 153, 155, 157, 158, 159, 160, 161, 163, 164, 167, 168, 169, 173, 175, 176, 181, 182, 185, 186, 187, 189, 192, 193, 194, 196, 197, 198, 199]"
Olaf,L100,short,127,54,73,11,0.365,200,"[0, 1, 2, 6, 7, 8, 9, 10, 14, 16, 17, 18, 19, 20, 26, 28, 29, 30, 31, 32, 34, 36, 37, 42, 43, 45, 46, 48, 49, 50, 51, 53, 54, 55, 56, 57, 58, 60, 61, 63, 64, 67, 69, 70, 71, 72, 73, 74, 75, 80, 82, 83, 84, 85, 87, 88, 89, 90, 91, 93, 94, 95, 97, 98, 99, 100, 105, 106, 107, 108, 111, 113, 116, 119, 120, 122, 123, 124, 125, 127, 128, 131, 132, 135, 136, 137, 138, 140, 141, 142, 143, 145, 146, 152, 153, 156, 157, 158, 159, 161, 162, 163, 165, 166, 167, 168, 170, 171, 172, 174, 177, 178, 179, 180, 181, 182, 183, 184, 185, 187, 188, 189, 190, 192, 193, 197, 198]"
Olaf,L100,short,134,74,60,6,0.33,200,"[1, 5, 9, 10, 11, 13, 15, 16, 17, 18, 19, 21, 22, 23, 26, 27, 28, 30, 31, 32, 36, 37, 39, 43, 44, 45, 46, 47, 48, 51, 52, 53, 54, 55, 57, 58, 59, 60, 61, 62, 63, 64, 65, 67, 68, 69, 70, 71, 73, 75, 80, 81, 82, 84, 85, 87, 88, 89, 91, 92, 94, 95, 96, 97, 99, 100, 101, 102, 103, 106, 107, 109, 111, 112, 114, 115, 116, 118, 120, 121, 122, 125, 126, 127, 128, 129, 130, 131, 132, 134, 136, 137, 138, 139, 140, 141, 142, 143, 144, 145, 148, 149, 150, 151, 153, 156, 158, 160, 161, 163, 165, 166, 169, 170, 171, 173, 177, 178, 179, 180, 181, 184, 185, 187, 188, 189, 190, 191, 192, 193, 194, 196, 198, 199]"
Olaf,L100,short,137,69,68,16,0.315,200,"[0, 1, 2, 4, 6, 7, 9, 11, 12, 13, 15, 17, 18, 19, 22, 23, 24, 25, 27, 28, 30, 31, 33, 34, 36, 37, 38, 39, 40, 41, 43, 44, 45, 46, 47, 49, 51, 52, 53, 54, 55, 57, 58, 60, 61, 62, 65, 66, 67, 68, 72, 74, 75, 76, 77, 78, 79, 80, 81, 82, 87, 89, 90, 91, 92, 93, 95, 96, 97, 98, 99, 100, 101, 102, 103, 106, 107, 110, 111, 112, 116, 117, 119, 120, 123, 124, 125, 126, 128, 130, 133, 134, 135, 136, 137, 139, 140, 141, 142, 143, 146, 147, 148, 149, 152, 153, 157, 159, 160, 162, 163, 166, 168, 169, 173, 174, 175, 177, 178, 179, 182, 183, 184, 185, 186, 187, 188, 189, 190, 191, 192, 193, 194, 195, 197, 198, 199]"
Olaf,L100,short,134,65,69,9,0.33,200,"[0, 2, 3, 4, 5, 6, 7, 8, 10, 11, 12, 13, 14, 16, 17, 18, 20, 21, 22, 23, 24, 26, 27, 28, 29, 30, 32, 34, 35, 36, 37, 38, 41, 42, 43, 45, 46, 47, 50, 52, 53, 55, 57, 59, 61, 63, 65, 66, 67, 68, 69, 70, 71, 73, 74, 75, 76, 78, 79, 81, 82, 83, 84, 87, 91, 92, 93, 95, 96, 98, 99, 101, 102, 103, 105, 107, 109, 111, 114, 116, 117, 118, 119, 120, 121, 122, 123, 124, 125, 127, 129, 130, 131, 132, 133, 134, 135, 136, 140, 141, 142, 143, 146, 147, 150, 151, 152, 155, 157, 158, 161, 162, 163, 164, 165, 167, 171, 173, 174, 175, 178, 179, 180, 181, 184, 186, 187, 188, 190, 192, 193, 195, 197, 199]"
Olaf,L100,short,137,74,63,10,0.315,200,"[0, 1, 2, 3, 4, 6, 7, 8, 9, 10, 11, 12, 14, 15, 16, 17, 19, 21, 23, 24, 25, 27, 29, 30, 32, 34, 35, 36, 37, 38, 41, 44, 45, 46, 48, 50, 51, 54, 56, 58, 59, 61, 62, 63, 64, 65, 68, 70, 71, 72, 73, 74, 75, 78, 79, 80, 81, 85, 86, 88, 91, 92, 94, 97, 98, 99, 100, 102, 104, 106, 108, 111, 114, 116, 117, 118, 119, 120, 123, 124, 125, 126, 127, 130, 131, 133, 134, 135, 136, 137, 138, 140, 141, 142, 146, 147, 148, 150, 151, 152, 154, 155, 156, 160, 161, 162, 163, 164, 166, 167, 168, 169, 170, 171, 172, 173, 174, 175, 176, 177, 178, 180, 181, 182, 183, 185, 186, 187, 188, 189, 190, 192, 194, 195, 196, 198, 199]"
Olaf,L100,short,128,76,52,16,0.36,200,"[0, 1, 2, 3, 4, 5, 6, 7, 8, 9, 10, 14, 15, 16, 18, 20, 22, 23, 25, 26, 28, 31, 32, 33, 35, 36, 37, 40, 41, 42, 46, 47, 48, 49, 50, 51, 52, 53, 56, 57, 59, 61, 62, 63, 64, 67, 70, 71, 72, 73, 74, 75, 76, 77, 79, 81, 82, 83, 84, 85, 88, 89, 90, 91, 92, 93, 94, 95, 96, 97, 98, 99, 102, 103, 104, 105, 106, 108, 110, 111, 112, 113, 116, 118, 119, 120, 121, 122, 126, 128, 130, 131, 132, 135, 137, 138, 140, 141, 142, 147, 152, 153, 154, 155, 156, 157, 161, 163, 165, 168, 170, 171, 173, 174, 175, 176, 177, 179, 181, 182, 186, 187, 188, 190, 194, 196, 197, 198]"
Olaf,L100,short,127,69,58,2,0.365,200,"[1, 2, 3, 4, 6, 7, 9, 10, 11, 13, 14, 15, 16, 19, 20, 22, 29, 30, 31, 33, 34, 35, 40, 41, 44, 46, 47, 50, 51, 52, 53, 55, 56, 57, 61, 62, 64, 65, 68, 69, 71, 72, 73, 74, 75, 76, 77, 79, 80, 82, 84, 85, 88, 90, 91, 92, 93, 94, 95, 96, 98, 99, 100, 103, 104, 105, 108, 109, 111, 112, 113, 114, 117, 118, 119, 120, 121, 122, 123, 124, 127, 130, 133, 134, 136, 137, 138, 139, 140, 141, 142, 145, 148, 149, 150, 152, 154, 155, 156, 157, 160, 163, 164, 166, 167, 168, 169, 170, 173, 175, 178, 179, 180, 181, 182, 183, 184, 185, 186, 187, 188, 189, 192, 194, 195, 197, 198]"
Olaf,L100,short,141,48,93,9,0.295,200,"[0, 1, 2, 5, 7, 8, 9, 10, 11, 12, 13, 15, 16, 18, 19, 21, 22, 23, 24, 25, 26, 27, 28, 30, 31, 32, 33, 35, 36, 37, 38, 39, 40, 41, 42, 45, 46, 48, 50, 52, 53, 56, 57, 58, 59, 60, 61, 62, 63, 64, 65, 66, 67, 68, 69, 71, 72, 75, 78, 79, 81, 82, 83, 84, 85, 86, 88, 90, 91, 92, 93, 94, 95, 96, 98, 99, 101, 102, 103, 104, 106, 107, 109, 111, 112, 115, 116, 117, 118, 119, 121, 122, 123, 125, 128, 130, 131, 132, 133, 135, 137, 138, 139, 140, 142, 143, 145, 146, 147, 148, 149, 150, 151, 152, 154, 157, 158, 159, 163, 164, 165, 167, 169, 170, 171, 176, 177, 180, 181, 183, 184, 185, 186, 187, 188, 189, 190, 195, 196, 197, 198]"
Olaf,L100,short,126,56,70,11,0.37,200,"[0, 1, 3, 4, 5, 8, 9, 14, 16, 17, 21, 22, 23, 25, 26, 29, 30, 31, 32, 33, 36, 38, 39, 41, 42, 43, 49, 50, 52, 53, 55, 56, 58, 59, 61, 62, 63, 66, 68, 71, 73, 75, 78, 80, 82, 84, 85, 86, 87, 88, 90, 91, 92, 93, 94, 96, 98, 99, 100, 102, 103, 104, 106, 107, 108, 111, 112, 114, 115, 116, 117, 118, 119, 120, 121, 122, 123, 124, 125, 126, 127, 128, 129, 130, 133, 134, 135, 136, 137, 138, 139, 140, 142, 143, 145, 148, 149, 151, 152, 155, 156, 159, 160, 163, 165, 166, 168, 169, 170, 172, 173, 175, 178, 180, 181, 182, 184, 185, 186, 187, 192, 193, 194, 195, 197, 198]"
Olaf,L100,short,134,75,59,14,0.33,200,"[0, 1, 2, 3, 4, 6, 9, 11, 12, 14, 16, 17, 22, 23, 24, 26, 28, 30, 31, 33, 34, 35, 36, 37, 39, 40, 43, 44, 45, 46, 47, 49, 50, 51, 52, 53, 54, 57, 58, 61, 65, 67, 69, 70, 71, 72, 73, 76, 77, 78, 79, 80, 83, 86, 87, 88, 89, 90, 92, 93, 95, 99, 100, 101, 103, 105, 106, 108, 110, 111, 112, 113, 116, 117, 118, 119, 120, 121, 122, 123, 124, 126, 127, 128, 129, 130, 131, 132, 133, 134, 135, 136, 137, 140, 141, 142, 143, 145, 146, 147, 148, 150, 151, 152, 153, 154, 157, 158, 159, 162, 163, 164, 167, 168, 169, 170, 174, 176, 178, 181, 184, 185, 187, 188, 189, 190, 191, 192, 194, 195, 196, 197, 198, 199]"
Olaf,L100,short,142,75,67,6,0.29,200,"[0, 1, 3, 5, 6, 8, 10, 11, 12, 13, 14, 15, 16, 18, 19, 20, 21, 22, 23, 24, 25, 26, 28, 29, 30, 32, 34, 35, 36, 38, 39, 40, 42, 44, 46, 47, 49, 50, 51, 53, 54, 58, 60, 61, 62, 64, 66, 67, 68, 69, 70, 71, 74, 75, 76, 77, 78, 79, 80, 81, 85, 86, 87, 89, 90, 91, 92, 93, 94, 95, 97, 98, 99, 102, 104, 105, 106, 107, 108, 109, 111, 114, 116, 117, 119, 121, 123, 125, 126, 127, 128, 129, 130, 132, 133, 134, 137, 138, 139, 140, 141, 142, 143, 144, 145, 148, 149, 151, 153, 155, 157, 158, 159, 161, 163, 164, 165, 166, 167, 170, 171, 173, 174, 175, 176, 177, 178, 179, 180, 181, 182, 183, 185, 186, 188, 190, 191, 192, 195, 197, 198, 199]"
Olaf,L100,short,117,51,66,13,0.415,200,"[0, 1, 3, 5, 6, 7, 8, 9, 10, 11, 12, 14, 15, 16, 17, 18, 19, 20, 23, 25, 26, 27, 30, 31, 32, 33, 34, 35, 36, 38, 39, 40, 41, 45, 49, 50, 51, 52, 55, 56, 57, 58, 59, 60, 62, 63, 64, 65, 67, 68, 71, 72, 75, 77, 78, 79, 80, 83, 84, 86, 87, 88, 90, 94, 95, 96, 97, 98, 102, 110, 111, 112, 113, 117, 120, 121, 122, 123, 125, 129, 131, 132, 133, 136, 137, 138, 141, 143, 146, 151, 152, 153, 155, 156, 157, 158, 159, 162, 163, 167, 169, 172, 173, 175, 176, 178, 181, 183, 184, 186, 187, 188, 190, 191, 195, 198, 199]"
Olaf,L100,short,138,64,74,8,0.31,200,"[0, 1, 3, 6, 7, 10, 12, 14, 15, 19, 20, 21, 22, 23, 24, 25, 26, 27, 28, 29, 32, 34, 35, 36, 37, 38, 40, 41, 42, 43, 44, 46, 47, 48, 49, 50, 52, 54, 55, 58, 59, 60, 61, 63, 65, 66, 67, 70, 71, 73, 74, 75, 76, 77, 78, 79, 80, 81, 82, 84, 85, 88, 93, 94, 95, 96, 97, 98, 100, 102, 103, 104, 105, 108, 109, 111, 112, 115, 116, 117, 119, 120, 121, 122, 125, 127, 128, 130, 131, 132, 133, 134, 135, 137, 138, 139, 141, 142, 144, 145, 146, 148, 150, 151, 152, 154, 155, 159, 160, 163, 164, 166, 168, 169, 171, 172, 173, 174, 175, 176, 177, 178, 179, 180, 183, 184, 185, 186, 187, 188, 190, 191, 192, 195, 196, 197, 198, 199]"
Olaf,L100,short,136,56,80,10,0.32,200,"[2, 3, 5, 6, 7, 8, 11, 13, 15, 16, 18, 19, 20, 21, 22, 23, 24, 27, 28, 30, 31, 32, 34, 35, 37, 38, 39, 40, 41, 42, 45, 48, 49, 51, 52, 53, 54, 55, 56, 57, 58, 59, 60, 61, 64, 65, 68, 69, 70, 71, 72, 74, 75, 76, 78, 81, 82, 84, 86, 87, 88, 89, 90, 91, 93, 94, 96, 97, 98, 99, 100, 101, 102, 103, 106, 107, 109, 114, 117, 118, 119, 120, 121, 122, 124, 125, 126, 131, 134, 135, 136, 137, 139, 140, 141, 142, 143, 144, 145, 146, 148, 151, 152, 154, 155, 157, 158, 161, 162, 165, 166, 167, 168, 170, 171, 172, 173, 174, 175, 176, 177, 180, 181, 182, 183, 184, 186, 187, 188, 190, 192, 194, 195, 196, 197, 198]"
Olaf,L100,short,126,60,66,9,0.37,200,"[0, 1, 3, 5, 9, 10, 11, 12, 13, 14, 17, 18, 19, 20, 21, 22, 23, 24, 25, 26, 27, 29, 30, 31, 32, 34, 37, 38, 40, 42, 43, 45, 48, 49, 50, 51, 52, 53, 55, 56, 57, 59, 60, 62, 63, 64, 65, 66, 67, 70, 71, 73, 74, 75, 76, 77, 79, 80, 81, 82, 83, 84, 85, 86, 88, 89, 90, 93, 94, 95, 99, 103, 104, 105, 106, 107, 108, 109, 114, 115, 117, 119, 120, 121, 122, 123, 125, 127, 128, 129, 130, 131, 132, 133, 134, 137, 138, 140, 143, 146, 149, 150, 152, 153, 157, 159, 160, 161, 162, 164, 165, 170, 172, 173, 176, 177, 179, 180, 182, 185, 188, 189, 192, 194, 196, 199]"
Olaf,L100,short,141,79,62,10,0.295,200,"[0, 2, 3, 6, 7, 8, 9, 10, 11, 12, 13, 14, 15, 17, 18, 19, 21, 22, 23, 24, 25, 26, 27, 28, 29, 31, 32, 34, 37, 38, 39, 40, 42, 44, 45, 46, 48, 52, 53, 58, 59, 60, 61, 62, 63, 65, 67, 68, 70, 72, 74, 75, 77, 78, 79, 80, 81, 82, 83, 85, 87, 89, 90, 91, 93, 94, 95, 96, 97, 99, 101, 102, 103, 105, 110, 111, 112, 113, 114, 116, 118, 120, 122, 123, 124, 125, 126, 127, 128, 129, 130, 132, 133, 134, 136, 137, 138, 139, 140, 143, 144, 145, 147, 151, 152, 153, 154, 156, 158, 160, 161, 162, 164, 165, 166, 167, 168, 169, 170, 171, 173, 174, 176, 177, 178, 179, 180, 181, 183, 184, 185, 186, 187, 188, 189, 190, 191, 192, 193, 195, 199]"
Olaf,L100,short,130,84,46,14,0.35,200,"[1, 2, 3, 4, 5, 6, 7, 11, 14, 16, 17, 19, 22, 23, 24, 28, 29, 30, 31, 32, 33, 34, 35, 36, 39, 41, 42, 44, 45, 46, 47, 49, 53, 54, 55, 56, 60, 63, 64, 65, 67, 68, 71, 74, 75, 76, 77, 78, 79, 80, 81, 82, 84, 85, 88, 91, 92, 93, 94, 96, 97, 99, 100, 101, 103, 104, 106, 107, 109, 110, 112, 113, 115, 117, 118, 119, 121, 122, 124, 125, 126, 129, 130, 131, 132, 133, 134, 136, 137, 138, 139, 140, 141, 142, 143, 144, 145, 146, 147, 148, 149, 152, 153, 154, 155, 156, 158, 160, 164, 165, 166, 167, 169, 171, 172, 174, 175, 177, 178, 179, 180, 183, 184, 185, 188, 190, 191, 192, 197, 198]"
Olaf,L100,short,131,71,60,12,0.345,200,"[0, 4, 5, 7, 8, 9, 10, 12, 13, 15, 17, 18, 20, 21, 23, 25, 27, 29, 30, 32, 33, 36, 37, 38, 39, 40, 41, 43, 44, 45, 47, 48, 50, 51, 53, 54, 55, 56, 57, 58, 59, 63, 64, 65, 66, 67, 68, 69, 70, 71, 72, 73, 74, 76, 78, 80, 81, 82, 84, 86, 87, 92, 94, 95, 96, 97, 98, 100, 101, 102, 103, 104, 105, 106, 107, 110, 111, 112, 114, 120, 121, 123, 125, 126, 128, 129, 130, 133, 134, 135, 136, 137, 140, 141, 142, 143, 149, 150, 151, 152, 154, 156, 157, 159, 160, 161, 163, 165, 167, 168, 169, 171, 172, 173, 174, 175, 176, 177, 178, 179, 181, 182, 186, 187, 188, 189, 192, 194, 195, 197, 199]"
Olaf,L100,short,122,75,47,10,0.39,200,"[5, 6, 7, 8, 10, 11, 12, 13, 14, 15, 18, 21, 23, 24, 25, 26, 27, 28, 30, 31, 34, 37, 38, 40, 44, 45, 46, 47, 48, 50, 51, 52, 53, 54, 55, 56, 57, 58, 60, 61, 63, 64, 67, 68, 69, 70, 71, 72, 73, 74, 75, 77, 78, 80, 86, 87, 89, 90, 91, 93, 96, 97, 98, 100, 101, 102, 104, 107, 113, 115, 116, 117, 119, 120, 121, 122, 123, 124, 126, 127, 128, 130, 132, 134, 136, 138, 142, 143, 144, 145, 147, 148, 150, 151, 154, 155, 156, 157, 159, 162, 163, 164, 165, 167, 169, 172, 174, 175, 176, 177, 180, 181, 183, 185, 186, 188, 189, 190, 194, 197, 198, 199]"
Olaf,L100,short,132,70,62,11,0.34,200,"[1, 2, 3, 4, 5, 6, 7, 8, 9, 10, 11, 12, 13, 15, 16, 17, 21, 22, 23, 25, 26, 27, 29, 30, 32, 33, 34, 35, 36, 37, 38, 42, 43, 44, 45, 46, 50, 51, 52, 53, 55, 56, 57, 58, 59, 60, 61, 62, 63, 64, 66, 67, 69, 71, 72, 74, 75, 77, 78, 79, 80, 81, 82, 83, 85, 86, 87, 88, 89, 91, 95, 97, 98, 100, 103, 104, 105, 107, 108, 110, 111, 112, 113, 115, 117, 118, 119, 120, 121, 122, 124, 126, 129, 130, 131, 132, 133, 134, 136, 137, 143, 144, 145, 147, 148, 149, 152, 153, 155, 156, 157, 159, 162, 164, 165, 166, 168, 169, 171, 172, 173, 174, 178, 179, 181, 183, 188, 191, 193, 195, 196, 198]"
Olaf,L100,short,128,51,77,12,0.36,200,"[1, 2, 3, 4, 7, 8, 10, 11, 12, 16, 18, 19, 20, 24, 25, 26, 29, 30, 33, 38, 41, 42, 43, 44, 46, 51, 53, 54, 56, 58, 59, 60, 62, 63, 64, 65, 66, 67, 68, 69, 70, 71, 72, 73, 74, 75, 77, 78, 79, 80, 81, 82, 83, 85, 86, 90, 91, 92, 94, 96, 98, 99, 101, 102, 105, 106, 107, 108, 109, 110, 111, 113, 114, 116, 117, 118, 120, 121, 123, 127, 129, 130, 131, 132, 133, 134, 136, 137, 138, 139, 140, 142, 143, 144, 146, 149, 152, 156, 157, 160, 161, 162, 163, 165, 166, 167, 168, 173, 174, 175, 176, 177, 178, 179, 181, 182, 183, 185, 186, 187, 190, 191, 192, 193, 194, 196, 197, 199]"
Olaf,L100,short,129,49,80,13,0.355,200,"[1, 2, 3, 4, 7, 8, 11, 12, 13, 14, 19, 20, 21, 22, 23, 24, 27, 30, 31, 33, 34, 35, 36, 37, 38, 39, 41, 42, 45, 46, 47, 49, 50, 51, 52, 53, 54, 55, 57, 59, 60, 61, 63, 66, 68, 69, 71, 73, 74, 75, 76, 77, 78, 79, 81, 82, 86, 91, 92, 94, 96, 98, 100, 102, 103, 104, 107, 109, 110, 111, 113, 114, 115, 116, 117, 119, 121, 123, 124, 125, 126, 127, 128, 129, 130, 131, 132, 133, 134, 136, 138, 140, 142, 143, 144, 145, 146, 147, 148, 150, 152, 153, 154, 155, 156, 157, 160, 161, 162, 163, 167, 168, 173, 174, 177, 179, 184, 186, 187, 188, 189, 191, 192, 194, 195, 196, 197, 198, 199]"
Olaf,L100,short,130,73,57,10,0.35,200,"[0, 1, 2, 3, 8, 10, 12, 13, 14, 15, 20, 21, 22, 23, 24, 28, 29, 30, 31, 32, 34, 35, 40, 42, 43, 45, 46, 47, 49, 50, 52, 55, 56, 57, 59, 60, 61, 62, 64, 65, 68, 70, 71, 72, 73, 74, 75, 76, 77, 78, 80, 82, 83, 84, 85, 86, 87, 88, 89, 91, 93, 94, 95, 97, 98, 101, 102, 103, 107, 110, 112, 113, 115, 117, 119, 120, 121, 123, 124, 125, 127, 128, 129, 130, 136, 137, 138, 140, 141, 142, 144, 146, 147, 148, 149, 151, 152, 153, 154, 155, 156, 157, 158, 160, 161, 162, 164, 165, 166, 167, 168, 170, 171, 173, 176, 177, 179, 180, 182, 183, 184, 185, 186, 187, 190, 191, 195, 196, 197, 198]"
Olaf,L100,short,127,49,78,10,0.365,200,"[0, 2, 3, 5, 7, 9, 10, 11, 12, 13, 15, 18, 20, 22, 23, 28, 29, 31, 35, 36, 37, 42, 44, 45, 46, 47, 49, 50, 52, 53, 54, 55, 56, 58, 60, 61, 62, 65, 68, 69, 73, 74, 76, 78, 79, 80, 81, 82, 83, 86, 87, 88, 89, 91, 92, 93, 94, 99, 100, 103, 105, 106, 109, 110, 111, 112, 113, 114, 115, 116, 117, 118, 119, 121, 122, 123, 124, 125, 126, 127, 129, 132, 133, 134, 135, 136, 137, 139, 142, 144, 145, 146, 147, 150, 152, 153, 154, 155, 156, 157, 158, 159, 161, 164, 165, 167, 168, 169, 173, 175, 176, 177, 178, 179, 181, 182, 183, 184, 186, 189, 190, 191, 192, 193, 195, 196, 199]"
Olaf,L100,short,137,73,64,11,0.315,200,"[1, 2, 3, 4, 5, 7, 8, 9, 12, 13, 14, 15, 17, 18, 19, 20, 21, 22, 24, 25, 27, 30, 31, 33, 34, 35, 36, 37, 38, 39, 40, 41, 42, 43, 44, 45, 46, 47, 53, 54, 55, 56, 58, 61, 63, 64, 65, 67, 68, 69, 70, 71, 73, 74, 76, 78, 80, 82, 84, 85, 86, 87, 89, 90, 92, 96, 97, 100, 101, 102, 103, 105, 108, 111, 113, 114, 115, 116, 118, 119, 120, 121, 122, 124, 126, 127, 128, 129, 130, 133, 134, 135, 136, 137, 139, 140, 144, 145, 146, 147, 148, 150, 153, 154, 155, 157, 158, 159, 160, 161, 162, 164, 165, 166, 167, 170, 171, 172, 173, 174, 175, 176, 177, 178, 180, 182, 183, 188, 189, 190, 191, 192, 193, 194, 195, 197, 199]"
Olaf,L100,short,123,55,68,6,0.385,200,"[0, 1, 3, 4, 6, 7, 8, 9, 10, 11, 13, 14, 16, 17, 18, 19, 22, 24, 26, 27, 28, 30, 32, 34, 35, 36, 37, 41, 43, 44, 45, 46, 47, 48, 49, 51, 54, 55, 56, 57, 58, 61, 62, 63, 66, 68, 70, 71, 73, 77, 78, 80, 82, 84, 86, 89, 92, 93, 94, 97, 98, 100, 101, 102, 103, 104, 105, 106, 107, 108, 109, 111, 112, 116, 119, 120, 121, 122, 123, 126, 128, 129, 132, 133, 134, 137, 140, 142, 143, 144, 145, 148, 151, 152, 153, 154, 156, 157, 158, 159, 160, 161, 162, 163, 165, 166, 167, 168, 170, 171, 175, 178, 182, 184, 186, 189, 190, 192, 193, 195, 196, 197, 198]"
Olaf,L100,short,126,74,52,13,0.37,200,"[0, 3, 4, 5, 7, 8, 10, 13, 14, 15, 16, 18, 19, 20, 22, 23, 24, 25, 27, 28, 29, 30, 33, 34, 36, 40, 41, 42, 43, 44, 45, 46, 48, 49, 50, 51, 55, 56, 57, 58, 59, 60, 61, 62, 65, 66, 71, 72, 73, 76, 78, 79, 80, 81, 82, 83, 84, 85, 86, 87, 89, 92, 93, 94, 95, 98, 100, 102, 103, 104, 105, 106, 108, 109, 114, 117, 120, 121, 122, 123, 124, 125, 126, 127, 128, 129, 130, 133, 136, 137, 138, 139, 141, 142, 144, 147, 148, 149, 150, 151, 153, 156, 157, 158, 159, 160, 162, 163, 164, 167, 171, 172, 173, 174, 178, 179, 183, 185, 186, 187, 189, 191, 192, 195, 196, 198]"
Olaf,L100,short,120,66,54,14,0.4,200,"[0, 1, 4, 5, 6, 7, 8, 9, 10, 15, 18, 20, 21, 22, 23, 24, 25, 26, 28, 29, 30, 32, 33, 34, 35, 37, 38, 40, 41, 43, 44, 46, 48, 49, 50, 51, 52, 53, 54, 56, 61, 62, 63, 64, 68, 69, 72, 73, 78, 80, 82, 86, 88, 90, 91, 92, 93, 94, 97, 99, 103, 104, 105, 106, 107, 108, 109, 111, 113, 114, 115, 117, 119, 123, 127, 128, 130, 131, 132, 133, 134, 135, 138, 139, 140, 141, 142, 145, 146, 147, 148, 151, 152, 153, 154, 155, 156, 157, 158, 159, 163, 165, 166, 171, 172, 173, 174, 176, 177, 180, 181, 182, 183, 184, 185, 192, 194, 196, 197, 199]"
Olaf,L100,short,137,80,57,6,0.315,200,"[0, 2, 4, 6, 7, 8, 10, 12, 13, 14, 15, 17, 18, 19, 21, 22, 23, 24, 27, 30, 31, 33, 34, 35, 37, 38, 39, 41, 43, 44, 45, 46, 47, 49, 50, 51, 53, 54, 58, 60, 61, 62, 63, 65, 66, 68, 69, 70, 72, 75, 77, 78, 80, 81, 83, 84, 87, 88, 89, 90, 91, 92, 93, 94, 96, 98, 99, 100, 101, 102, 103, 104, 105, 106, 108, 109, 111, 113, 114, 115, 116, 119, 121, 122, 123, 125, 126, 127, 128, 129, 130, 131, 137, 140, 141, 143, 144, 145, 146, 148, 152, 153, 154, 155, 157, 159, 160, 163, 164, 165, 166, 167, 169, 170, 172, 173, 174, 176, 177, 179, 180, 182, 183, 184, 185, 186, 187, 188, 189, 190, 191, 193, 194, 195, 197, 198, 199]"
Olaf,L100,short,143,78,65,11,0.285,200,"[0, 1, 5, 6, 8, 9, 11, 12, 13, 14, 16, 19, 21, 22, 23, 26, 27, 29, 31, 32, 34, 35, 36, 38, 39, 41, 42, 46, 47, 48, 51, 52, 53, 54, 55, 56, 57, 58, 59, 61, 62, 63, 64, 65, 66, 67, 69, 70, 71, 72, 73, 75, 77, 78, 79, 80, 81, 82, 84, 85, 86, 87, 88, 90, 91, 93, 94, 96, 97, 98, 99, 101, 102, 104, 105, 106, 109, 111, 112, 113, 116, 118, 119, 120, 122, 123, 124, 125, 126, 127, 128, 129, 130, 131, 132, 133, 134, 137, 138, 142, 143, 144, 145, 147, 148, 150, 151, 152, 153, 154, 155, 156, 157, 161, 162, 163, 164, 165, 166, 167, 169, 170, 172, 173, 174, 175, 176, 177, 179, 182, 183, 184, 185, 187, 190, 191, 192, 193, 194, 195, 197, 198, 199]"
Olaf,L100,short,140,83,57,12,0.3,200,"[0, 2, 4, 6, 12, 13, 14, 15, 17, 18, 19, 21, 22, 23, 26, 27, 28, 31, 32, 33, 35, 36, 37, 38, 40, 42, 43, 45, 46, 47, 48, 49, 50, 51, 52, 53, 54, 55, 56, 57, 58, 61, 62, 63, 64, 65, 66, 67, 70, 71, 73, 74, 75, 77, 78, 79, 80, 81, 82, 83, 85, 86, 87, 88, 89, 90, 92, 95, 96, 97, 98, 100, 102, 104, 105, 106, 107, 109, 110, 111, 112, 116, 117, 119, 120, 121, 122, 123, 124, 126, 127, 128, 129, 130, 133, 135, 136, 137, 138, 139, 140, 141, 142, 143, 144, 146, 147, 148, 150, 151, 152, 154, 156, 157, 159, 160, 167, 168, 171, 172, 173, 174, 175, 178, 181, 182, 183, 184, 186, 187, 189, 190, 191, 192, 193, 194, 195, 196, 198, 199]"
Olaf,L100,short,142,65,77,6,0.29,200,"[0, 1, 2, 3, 4, 6, 9, 10, 12, 13, 14, 15, 16, 18, 20, 21, 22, 23, 26, 29, 30, 31, 32, 33, 34, 35, 36, 37, 38, 39, 41, 42, 43, 44, 46, 47, 51, 52, 53, 54, 55, 56, 57, 58, 59, 60, 61, 62, 63, 64, 65, 67, 68, 69, 71, 73, 75, 77, 80, 82, 84, 85, 86, 87, 88, 89, 91, 92, 93, 95, 96, 97, 98, 99, 102, 106, 107, 109, 110, 114, 115, 117, 119, 120, 122, 123, 124, 125, 126, 127, 128, 130, 131, 132, 133, 134, 135, 136, 137, 138, 141, 142, 143, 144, 145, 146, 147, 149, 151, 153, 154, 155, 156, 157, 159, 160, 161, 162, 164, 166, 167, 169, 170, 171, 172, 173, 174, 175, 176, 177, 178, 179, 180, 181, 184, 186, 190, 192, 195, 197, 198, 199]"
Olaf,L100,short,124,56,68,14,0.38,200,"[1, 3, 6, 7, 8, 10, 11, 12, 13, 16, 17, 18, 20, 21, 22, 25, 28, 31, 35, 38, 42, 43, 44, 45, 48, 49, 50, 51, 52, 55, 57, 58, 59, 60, 61, 62, 64, 66, 68, 69, 70, 71, 72, 73, 79, 80, 82, 83, 84, 85, 86, 87, 89, 91, 92, 93, 95, 96, 97, 98, 99, 102, 103, 105, 106, 107, 108, 109, 111, 113, 115, 116, 117, 119, 120, 123, 125, 126, 128, 130, 131, 132, 133, 134, 135, 136, 138, 139, 140, 141, 142, 144, 145, 148, 149, 150, 152, 155, 156, 157, 159, 160, 163, 165, 166, 167, 169, 171, 172, 174, 175, 176, 177, 178, 183, 184, 186, 187, 188, 190, 193, 195, 197, 199]"
Olaf,L100,short,133,75,58,16,0.335,200,"[0, 1, 2, 3, 4, 6, 7, 8, 11, 12, 14, 16, 17, 20, 23, 24, 26, 28, 29, 30, 31, 32, 33, 34, 35, 36, 37, 38, 39, 43, 44, 45, 46, 47, 50, 51, 52, 53, 54, 56, 57, 58, 59, 62, 64, 65, 69, 70, 71, 73, 74, 75, 77, 80, 82, 88, 91, 92, 93, 96, 97, 98, 101, 102, 103, 104, 105, 106, 108, 109, 110, 111, 112, 113, 114, 115, 116, 119, 123, 124, 126, 127, 128, 129, 130, 131, 132, 134, 135, 136, 137, 138, 139, 141, 142, 143, 144, 147, 150, 151, 152, 153, 154, 155, 156, 157, 158, 159, 160, 163, 166, 167, 169, 173, 174, 175, 176, 177, 178, 179, 181, 182, 183, 184, 186, 187, 189, 191, 193, 195, 196, 197, 198]"
Olaf,L100,short,134,69,65,11,0.33,200,"[0, 1, 2, 4, 5, 7, 9, 10, 11, 12, 13, 14, 16, 18, 19, 22, 24, 25, 26, 27, 29, 30, 31, 32, 33, 34, 35, 36, 37, 38, 39, 41, 42, 44, 45, 47, 48, 50, 51, 52, 53, 54, 55, 56, 57, 59, 62, 64, 65, 66, 68, 69, 70, 71, 72, 73, 74, 75, 76, 81, 82, 83, 85, 86, 87, 88, 89, 91, 94, 98, 99, 100, 101, 102, 104, 105, 107, 108, 110, 111, 112, 114, 116, 120, 121, 122, 123, 124, 125, 126, 128, 131, 132, 135, 136, 137, 142, 143, 144, 146, 147, 149, 151, 152, 153, 156, 157, 158, 159, 163, 164, 165, 169, 172, 173, 174, 175, 176, 177, 179, 180, 181, 182, 183, 185, 189, 190, 193, 194, 195, 196, 197, 198, 199]"
Olaf,L100,short,127,61,66,14,0.365,200,"[0, 1, 2, 3, 4, 6, 7, 8, 11, 12, 17, 18, 20, 21, 22, 26, 29, 30, 31, 32, 34, 35, 37, 38, 40, 41, 42, 47, 48, 49, 53, 54, 57, 58, 59, 61, 62, 63, 65, 67, 68, 69, 70, 72, 74, 75, 79, 80, 82, 83, 84, 85, 87, 90, 95, 96, 98, 100, 101, 102, 104, 105, 106, 107, 108, 109, 110, 117, 118, 123, 124, 125, 126, 127, 129, 132, 133, 135, 136, 138, 139, 140, 141, 143, 144, 145, 148, 149, 150, 151, 153, 154, 155, 156, 157, 158, 159, 160, 161, 162, 164, 165, 166, 167, 168, 170, 171, 173, 174, 175, 176, 177, 178, 180, 181, 183, 184, 185, 189, 190, 191, 192, 194, 195, 196, 197, 198]"
Olaf,L100,short,137,79,58,8,0.315,200,"[0, 1, 2, 4, 6, 7, 9, 11, 14, 15, 16, 17, 18, 19, 21, 23, 24, 25, 26, 28, 29, 30, 31, 32, 33, 37, 40, 41, 42, 43, 46, 49, 50, 52, 54, 55, 56, 57, 58, 59, 60, 61, 62, 63, 64, 65, 66, 67, 68, 69, 71, 72, 73, 74, 75, 76, 77, 79, 82, 85, 86, 87, 88, 89, 90, 92, 93, 95, 96, 97, 98, 100, 101, 103, 105, 106, 107, 109, 111, 112, 114, 115, 117, 118, 120, 122, 124, 125, 126, 127, 128, 129, 130, 131, 132, 134, 135, 136, 139, 140, 144, 147, 149, 154, 156, 157, 158, 159, 161, 162, 163, 164, 165, 166, 169, 172, 173, 175, 177, 178, 180, 182, 183, 184, 185, 186, 187, 188, 189, 190, 191, 192, 194, 196, 197, 198, 199]"
Olaf,L100,short,136,74,62,4,0.32,200,"[0, 1, 3, 6, 7, 9, 10, 13, 14, 15, 18, 20, 21, 22, 24, 25, 26, 28, 29, 30, 31, 33, 34, 35, 36, 40, 41, 43, 44, 47, 48, 50, 51, 52, 53, 56, 57, 58, 60, 61, 62, 64, 65, 66, 67, 68, 69, 70, 71, 72, 73, 75, 76, 77, 79, 80, 81, 82, 83, 84, 85, 87, 88, 90, 92, 93, 94, 95, 96, 98, 99, 100, 101, 102, 103, 104, 105, 106, 108, 109, 110, 111, 112, 114, 115, 117, 119, 120, 121, 122, 123, 125, 126, 127, 129, 130, 132, 134, 135, 136, 137, 139, 140, 144, 145, 146, 147, 148, 149, 150, 151, 152, 153, 156, 158, 159, 160, 163, 164, 165, 166, 167, 170, 172, 173, 174, 175, 176, 177, 180, 185, 187, 191, 192, 196, 198]"
Olaf,L100,short,142,88,54,8,0.29,200,"[0, 1, 2, 3, 4, 5, 6, 7, 8, 9, 10, 12, 13, 14, 15, 16, 17, 18, 19, 21, 22, 23, 25, 26, 28, 29, 30, 32, 33, 34, 35, 36, 37, 38, 39, 40, 43, 44, 45, 47, 48, 49, 50, 51, 53, 54, 55, 56, 57, 58, 59, 61, 63, 64, 66, 67, 68, 69, 74, 75, 77, 78, 80, 81, 82, 84, 85, 86, 88, 89, 91, 93, 94, 95, 97, 98, 101, 102, 105, 107, 110, 111, 113, 114, 115, 117, 118, 119, 120, 122, 123, 125, 126, 127, 128, 129, 131, 133, 136, 140, 141, 142, 145, 146, 147, 148, 150, 151, 153, 154, 155, 156, 158, 159, 163, 164, 166, 167, 168, 169, 170, 171, 172, 173, 174, 176, 177, 178, 179, 181, 183, 184, 185, 186, 191, 192, 193, 194, 195, 196, 197, 198]"
Olaf,L100,short,124,65,59,6,0.38,200,"[0, 2, 3, 4, 5, 6, 7, 8, 10, 11, 13, 14, 15, 16, 17, 18, 22, 23, 25, 27, 31, 34, 37, 40, 41, 43, 44, 47, 50, 52, 53, 54, 55, 56, 59, 61, 62, 63, 64, 66, 69, 70, 72, 73, 78, 79, 80, 81, 83, 84, 85, 86, 87, 88, 89, 91, 92, 95, 96, 99, 100, 101, 102, 103, 104, 107, 110, 114, 115, 116, 117, 120, 121, 123, 127, 131, 132, 133, 134, 136, 137, 138, 139, 141, 145, 146, 147, 148, 149, 151, 154, 155, 156, 157, 158, 159, 160, 162, 163, 166, 168, 169, 170, 171, 172, 173, 174, 176, 178, 181, 182, 183, 185, 186, 188, 190, 191, 192, 193, 194, 195, 196, 198, 199]"
Olaf,L100,short,140,73,67,11,0.3,200,"[0, 1, 2, 3, 4, 8, 9, 10, 11, 12, 13, 14, 15, 16, 17, 18, 19, 20, 21, 22, 23, 24, 25, 26, 27, 28, 29, 31, 32, 33, 34, 35, 36, 37, 39, 40, 43, 45, 46, 47, 48, 50, 52, 54, 55, 59, 62, 63, 65, 66, 68, 69, 70, 72, 73, 75, 76, 77, 79, 80, 82, 83, 84, 85, 86, 87, 88, 93, 95, 96, 97, 99, 101, 102, 103, 106, 108, 109, 110, 112, 115, 116, 117, 119, 120, 121, 122, 123, 124, 127, 128, 130, 133, 134, 135, 136, 137, 138, 141, 142, 143, 145, 146, 148, 150, 151, 153, 154, 155, 156, 158, 161, 162, 163, 165, 166, 168, 169, 170, 174, 176, 177, 178, 179, 180, 181, 182, 184, 185, 186, 187, 188, 189, 191, 193, 195, 196, 197, 198, 199]"
Olaf,L100,short,135,69,66,6,0.325,200,"[0, 1, 4, 5, 6, 7, 8, 9, 10, 11, 12, 13, 14, 15, 17, 18, 19, 21, 22, 23, 24, 26, 27, 28, 30, 32, 33, 34, 35, 36, 37, 38, 42, 43, 44, 45, 46, 50, 51, 52, 53, 55, 57, 61, 62, 64, 65, 66, 68, 70, 73, 74, 76, 78, 80, 82, 84, 86, 87, 88, 89, 90, 93, 95, 96, 97, 98, 103, 104, 106, 107, 109, 111, 112, 113, 114, 115, 118, 119, 120, 122, 123, 124, 128, 129, 130, 131, 132, 133, 134, 135, 136, 137, 139, 142, 144, 145, 146, 148, 152, 153, 154, 156, 159, 161, 162, 163, 164, 167, 168, 169, 170, 172, 173, 174, 176, 177, 178, 180, 181, 182, 183, 185, 186, 187, 188, 189, 190, 192, 193, 194, 195, 196, 197, 198]"
Olaf,L100,short,143,63,80,10,0.285,200,"[0, 1, 2, 3, 4, 6, 7, 8, 9, 11, 12, 13, 14, 16, 17, 18, 19, 20, 22, 23, 24, 27, 29, 30, 34, 35, 37, 38, 39, 40, 42, 45, 46, 48, 49, 51, 54, 55, 57, 58, 59, 60, 63, 64, 66, 67, 69, 70, 71, 73, 74, 75, 76, 77, 78, 80, 81, 82, 83, 89, 91, 92, 93, 94, 95, 97, 100, 101, 103, 104, 105, 106, 107, 108, 109, 110, 111, 112, 113, 114, 116, 118, 119, 120, 121, 122, 123, 125, 126, 127, 128, 130, 132, 133, 134, 135, 136, 137, 138, 139, 141, 142, 146, 147, 148, 149, 150, 151, 154, 155, 156, 157, 159, 160, 161, 164, 165, 166, 168, 169, 171, 173, 174, 175, 178, 180, 181, 182, 183, 184, 185, 186, 187, 188, 189, 190, 193, 194, 195, 196, 197, 198, 199]"
Olaf,L100,short,134,69,65,12,0.33,200,"[0, 2, 3, 4, 6, 7, 8, 9, 11, 12, 14, 16, 17, 18, 21, 25, 26, 27, 28, 29, 31, 32, 33, 34, 35, 36, 38, 41, 42, 46, 47, 49, 50, 51, 53, 56, 57, 59, 63, 64, 65, 68, 69, 70, 72, 73, 74, 75, 77, 78, 79, 80, 81, 82, 85, 86, 87, 89, 91, 92, 94, 95, 96, 97, 98, 99, 101, 103, 104, 105, 106, 110, 112, 113, 114, 115, 116, 117, 118, 119, 120, 121, 122, 123, 124, 125, 127, 128, 129, 130, 132, 133, 134, 135, 136, 137, 139, 140, 145, 146, 147, 148, 149, 152, 153, 154, 157, 158, 159, 160, 161, 162, 164, 166, 167, 168, 170, 171, 172, 173, 174, 175, 176, 179, 181, 182, 186, 187, 188, 189, 195, 196, 197, 198]"
Olaf,L100,short,121,55,66,12,0.395,200,"[2, 5, 6, 7, 9, 11, 12, 13, 15, 20, 21, 23, 28, 29, 30, 31, 33, 34, 36, 37, 39, 40, 41, 42, 47, 48, 50, 51, 52, 53, 54, 55, 58, 59, 60, 65, 66, 67, 69, 72, 73, 76, 77, 80, 82, 83, 86, 87, 88, 91, 92, 93, 94, 96, 97, 99, 100, 101, 102, 106, 107, 109, 111, 112, 113, 116, 118, 119, 121, 122, 123, 124, 125, 126, 127, 129, 130, 131, 132, 133, 134, 135, 136, 139, 140, 142, 143, 148, 149, 151, 152, 153, 154, 156, 157, 159, 163, 164, 165, 166, 167, 168, 169, 172, 173, 174, 175, 177, 181, 183, 185, 186, 188, 189, 190, 193, 194, 195, 196, 197, 199]"
Olaf,L100,short,145,67,78,6,0.275,200,"[0, 1, 2, 6, 9, 10, 11, 13, 15, 16, 17, 18, 19, 22, 23, 24, 25, 27, 28, 29, 31, 32, 33, 34, 35, 36, 37, 38, 39, 40, 41, 43, 45, 46, 48, 49, 52, 54, 55, 56, 59, 60, 61, 62, 65, 66, 68, 69, 71, 73, 74, 77, 80, 81, 82, 83, 84, 85, 86, 87, 89, 90, 92, 94, 95, 96, 98, 100, 101, 102, 103, 104, 105, 107, 108, 109, 110, 111, 112, 113, 114, 115, 119, 120, 121, 122, 123, 124, 125, 126, 127, 128, 130, 133, 135, 136, 137, 138, 142, 143, 144, 145, 147, 148, 149, 150, 151, 152, 153, 155, 156, 157, 158, 159, 160, 161, 162, 163, 164, 165, 166, 168, 170, 172, 174, 175, 176, 177, 178, 179, 180, 181, 182, 183, 185, 188, 190, 191, 192, 193, 195, 196, 197, 198, 199]"
Olaf,L100,short,141,61,80,5,0.295,200,"[1, 3, 4, 5, 6, 8, 9, 10, 13, 15, 16, 20, 21, 22, 23, 26, 27, 28, 29, 30, 31, 32, 34, 35, 36, 37, 38, 40, 42, 43, 45, 46, 47, 48, 49, 50, 52, 55, 56, 57, 59, 60, 61, 62, 63, 64, 65, 66, 67, 68, 69, 71, 73, 74, 75, 76, 77, 81, 82, 83, 85, 86, 90, 91, 92, 93, 95, 96, 97, 98, 99, 100, 102, 103, 104, 106, 107, 109, 110, 111, 114, 115, 116, 119, 120, 121, 122, 123, 124, 125, 127, 128, 130, 134, 135, 138, 139, 141, 144, 145, 147, 148, 149, 150, 151, 152, 153, 155, 156, 157, 158, 159, 161, 163, 164, 165, 167, 168, 169, 170, 172, 174, 175, 176, 178, 179, 180, 181, 182, 183, 184, 185, 186, 187, 188, 189, 191, 192, 194, 195, 199]"
Olaf,L100,short,142,58,84,15,0.29,200,"[0, 1, 2, 4, 6, 8, 9, 10, 12, 14, 15, 16, 17, 18, 19, 20, 22, 23, 24, 25, 26, 28, 29, 30, 31, 32, 36, 37, 38, 40, 41, 42, 45, 46, 48, 49, 51, 52, 53, 55, 56, 57, 58, 61, 62, 63, 65, 67, 68, 70, 72, 73, 75, 76, 77, 78, 80, 82, 83, 85, 88, 89, 90, 91, 92, 95, 96, 97, 98, 99, 101, 102, 103, 105, 106, 109, 110, 111, 115, 117, 118, 119, 120, 121, 122, 123, 125, 126, 128, 129, 130, 131, 132, 133, 135, 136, 138, 139, 140, 142, 143, 144, 145, 146, 147, 148, 149, 151, 153, 154, 155, 157, 158, 159, 160, 161, 163, 165, 167, 168, 170, 171, 173, 174, 175, 176, 177, 179, 180, 181, 182, 183, 184, 187, 188, 189, 190, 193, 194, 196, 197, 198]"
Olaf,L100,short,139,57,82,9,0.305,200,"[0, 1, 3, 4, 5, 8, 9, 10, 11, 12, 13, 14, 15, 16, 17, 18, 19, 20, 22, 23, 24, 25, 26, 27, 30, 31, 32, 33, 34, 35, 36, 37, 38, 39, 40, 41, 43, 47, 48, 50, 51, 52, 53, 54, 55, 57, 58, 59, 60, 61, 62, 63, 64, 68, 71, 72, 73, 74, 84, 85, 86, 87, 89, 91, 93, 94, 95, 96, 98, 99, 101, 102, 103, 104, 105, 106, 107, 108, 109, 110, 111, 112, 113, 114, 117, 118, 119, 120, 122, 125, 126, 127, 129, 131, 132, 133, 134, 135, 136, 137, 138, 141, 142, 143, 144, 145, 146, 147, 148, 149, 151, 152, 154, 155, 156, 157, 159, 160, 162, 166, 167, 168, 169, 170, 171, 172, 174, 175, 177, 178, 180, 181, 185, 191, 193, 195, 196, 197, 198]"
Olaf,L100,short,130,67,63,14,0.35,200,"[0, 1, 3, 7, 8, 9, 10, 11, 12, 13, 15, 16, 17, 18, 20, 21, 23, 25, 27, 29, 30, 32, 33, 34, 35, 36, 37, 38, 40, 44, 45, 46, 47, 50, 51, 54, 55, 57, 59, 60, 61, 62, 64, 65, 66, 68, 71, 72, 73, 74, 76, 78, 80, 81, 83, 84, 88, 89, 91, 93, 94, 95, 96, 98, 99, 100, 101, 102, 104, 106, 107, 108, 109, 110, 111, 113, 117, 118, 119, 120, 121, 122, 123, 124, 125, 126, 129, 130, 134, 135, 136, 138, 139, 140, 142, 143, 144, 149, 151, 152, 154, 156, 157, 159, 160, 161, 162, 163, 165, 168, 169, 172, 175, 178, 180, 181, 182, 183, 185, 187, 190, 191, 192, 193, 194, 195, 196, 197, 198, 199]"
Olaf,L100,short,128,63,65,5,0.36,200,"[2, 5, 6, 7, 8, 11, 13, 16, 17, 18, 19, 20, 21, 23, 24, 25, 27, 29, 30, 32, 33, 34, 35, 37, 38, 39, 40, 41, 44, 45, 51, 52, 57, 60, 62, 66, 68, 71, 73, 74, 75, 76, 77, 78, 79, 80, 82, 83, 84, 85, 86, 90, 91, 92, 93, 94, 96, 97, 98, 99, 101, 102, 103, 104, 105, 106, 107, 109, 113, 115, 116, 117, 118, 119, 120, 123, 124, 125, 126, 127, 132, 133, 135, 139, 140, 141, 144, 145, 146, 147, 148, 149, 150, 152, 153, 155, 156, 159, 160, 161, 162, 164, 165, 166, 168, 169, 170, 171, 174, 175, 176, 177, 178, 179, 180, 181, 182, 183, 184, 185, 186, 187, 190, 192, 196, 197, 198, 199]"
Olaf,L100,short,132,72,60,8,0.34,200,"[1, 2, 4, 5, 7, 8, 9, 10, 11, 12, 13, 14, 15, 16, 17, 19, 20, 21, 22, 23, 24, 25, 27, 28, 29, 32, 34, 35, 38, 39, 43, 45, 49, 51, 52, 54, 56, 57, 58, 60, 61, 62, 63, 67, 69, 70, 71, 72, 73, 74, 76, 77, 78, 79, 80, 83, 85, 86, 87, 91, 92, 96, 99, 100, 102, 104, 105, 106, 107, 108, 110, 114, 117, 118, 119, 120, 121, 122, 126, 127, 128, 129, 130, 131, 132, 136, 137, 140, 142, 143, 144, 146, 147, 148, 149, 150, 151, 152, 153, 154, 156, 158, 159, 162, 163, 166, 167, 168, 169, 171, 172, 173, 174, 175, 176, 177, 178, 180, 182, 183, 184, 185, 187, 188, 189, 190, 192, 194, 196, 197, 198, 199]"
Olaf,L100,short,135,66,69,8,0.325,200,"[0, 1, 2, 4, 6, 7, 9, 10, 11, 12, 13, 14, 18, 19, 20, 21, 22, 24, 28, 30, 31, 32, 33, 35, 36, 37, 39, 41, 42, 44, 45, 46, 47, 50, 51, 52, 54, 57, 58, 59, 61, 62, 63, 64, 68, 69, 71, 73, 75, 76, 77, 78, 79, 80, 82, 84, 85, 88, 89, 90, 92, 94, 95, 96, 99, 100, 101, 102, 103, 106, 107, 108, 110, 111, 112, 113, 114, 116, 118, 119, 121, 123, 125, 127, 129, 130, 131, 132, 133, 134, 136, 137, 138, 139, 140, 141, 143, 145, 146, 147, 149, 152, 153, 154, 155, 157, 161, 162, 164, 166, 167, 168, 169, 170, 171, 173, 174, 175, 177, 179, 180, 181, 182, 185, 186, 188, 190, 191, 192, 193, 194, 196, 197, 198, 199]"
Olaf,L100,short,119,66,53,8,0.405,200,"[0, 2, 4, 7, 9, 10, 11, 12, 14, 15, 16, 17, 18, 20, 21, 22, 23, 24, 28, 30, 32, 33, 36, 37, 40, 41, 42, 43, 44, 45, 46, 47, 48, 50, 51, 52, 53, 54, 56, 59, 65, 66, 68, 69, 73, 74, 75, 76, 79, 80, 84, 85, 88, 90, 91, 92, 94, 96, 97, 98, 99, 101, 102, 103, 104, 108, 110, 112, 114, 115, 117, 118, 119, 120, 121, 123, 125, 126, 128, 131, 132, 133, 134, 135, 137, 139, 141, 143, 144, 147, 148, 151, 152, 153, 154, 157, 159, 161, 162, 163, 168, 172, 173, 175, 176, 177, 178, 180, 182, 183, 185, 186, 187, 188, 190, 192, 194, 195, 197]"
Olaf,L100,short,126,70,56,11,0.37,200,"[0, 2, 5, 6, 7, 9, 10, 11, 14, 15, 20, 21, 22, 23, 26, 27, 28, 31, 32, 35, 36, 38, 40, 42, 43, 44, 46, 47, 49, 50, 52, 53, 54, 55, 57, 58, 60, 62, 63, 66, 67, 68, 69, 70, 72, 73, 74, 75, 77, 81, 83, 84, 86, 90, 91, 93, 95, 96, 97, 98, 99, 100, 101, 102, 103, 104, 105, 106, 107, 108, 109, 114, 115, 117, 118, 119, 120, 121, 122, 123, 124, 129, 130, 131, 133, 134, 135, 136, 137, 140, 141, 145, 147, 149, 150, 151, 153, 154, 155, 156, 157, 161, 162, 164, 165, 167, 171, 172, 173, 174, 175, 176, 177, 179, 181, 182, 183, 186, 187, 188, 189, 190, 193, 194, 196, 198]"
Olaf,L100,short,134,78,56,7,0.33,200,"[0, 1, 2, 8, 11, 13, 14, 15, 16, 18, 19, 20, 21, 23, 24, 28, 29, 30, 32, 33, 34, 36, 37, 39, 40, 43, 44, 45, 46, 47, 50, 51, 52, 53, 54, 55, 57, 58, 61, 63, 64, 65, 66, 67, 68, 69, 70, 71, 72, 76, 77, 78, 79, 80, 82, 83, 85, 86, 87, 90, 93, 94, 95, 96, 97, 98, 101, 103, 107, 108, 111, 112, 113, 114, 115, 117, 118, 120, 122, 123, 124, 126, 127, 128, 129, 131, 133, 134, 135, 137, 138, 139, 141, 142, 144, 145, 146, 148, 149, 151, 152, 153, 154, 157, 158, 160, 162, 165, 166, 167, 168, 169, 170, 171, 172, 173, 174, 175, 176, 177, 179, 180, 182, 183, 184, 186, 187, 188, 190, 191, 193, 195, 196, 197]"
Olaf,L100,short,142,75,67,4,0.29,200,"[0, 2, 4, 5, 6, 7, 8, 10, 11, 12, 13, 14, 16, 17, 19, 20, 21, 22, 23, 25, 26, 28, 29, 31, 33, 35, 36, 37, 38, 39, 40, 41, 42, 45, 46, 47, 48, 49, 50, 52, 53, 54, 55, 57, 58, 59, 60, 61, 63, 64, 65, 66, 67, 68, 69, 70, 71, 72, 73, 77, 78, 81, 82, 83, 84, 85, 86, 87, 88, 89, 90, 91, 92, 93, 94, 95, 96, 97, 98, 99, 102, 103, 104, 106, 107, 108, 109, 110, 111, 114, 115, 116, 117, 121, 122, 123, 124, 126, 127, 128, 129, 133, 134, 136, 140, 141, 143, 145, 146, 148, 152, 154, 157, 158, 159, 160, 161, 162, 164, 165, 167, 168, 169, 170, 172, 174, 176, 178, 179, 183, 185, 187, 188, 189, 190, 191, 192, 193, 194, 195, 198, 199]"
Olaf,L100,short,140,69,71,11,0.3,200,"[0, 1, 2, 3, 4, 6, 7, 10, 17, 18, 19, 20, 21, 23, 24, 25, 27, 28, 29, 30, 32, 33, 34, 35, 37, 38, 41, 42, 43, 44, 45, 47, 48, 49, 51, 52, 53, 55, 57, 58, 60, 62, 65, 66, 67, 69, 70, 71, 72, 73, 74, 75, 76, 77, 79, 80, 81, 82, 84, 85, 86, 87, 88, 89, 91, 92, 93, 97, 98, 99, 101, 103, 106, 108, 109, 111, 112, 114, 115, 116, 117, 118, 119, 121, 122, 123, 125, 126, 128, 129, 131, 132, 135, 136, 139, 141, 142, 143, 146, 148, 149, 150, 152, 153, 154, 155, 156, 157, 158, 159, 160, 161, 162, 163, 167, 168, 169, 170, 171, 172, 173, 174, 176, 177, 178, 179, 180, 181, 183, 185, 186, 189, 190, 191, 192, 193, 195, 196, 198, 199]"
Olaf,L100,short,124,69,55,10,0.38,200,"[1, 2, 3, 4, 5, 6, 7, 9, 10, 11, 14, 15, 18, 19, 20, 21, 25, 26, 28, 30, 31, 33, 34, 35, 36, 37, 40, 41, 43, 47, 48, 49, 50, 51, 54, 55, 56, 58, 60, 65, 66, 67, 68, 71, 73, 74, 76, 77, 78, 80, 81, 82, 83, 84, 85, 89, 92, 94, 95, 97, 100, 102, 104, 107, 110, 111, 112, 115, 118, 120, 121, 122, 123, 125, 126, 127, 128, 129, 133, 134, 137, 138, 139, 140, 141, 142, 146, 147, 148, 149, 150, 151, 152, 153, 154, 155, 156, 157, 160, 163, 165, 166, 167, 168, 169, 170, 173, 175, 176, 177, 180, 181, 182, 183, 185, 187, 188, 189, 190, 191, 192, 195, 196, 198]"
Olaf,L100,short,136,82,54,6,0.32,200,"[1, 2, 3, 4, 5, 8, 9, 10, 12, 13, 15, 16, 17, 21, 25, 28, 29, 30, 31, 32, 35, 36, 37, 38, 39, 40, 41, 44, 45, 46, 47, 48, 49, 50, 51, 54, 58, 59, 61, 63, 65, 66, 67, 68, 69, 71, 72, 73, 75, 76, 78, 79, 80, 81, 82, 83, 86, 87, 88, 89, 90, 91, 94, 95, 97, 99, 101, 103, 104, 105, 106, 107, 108, 111, 114, 115, 116, 117, 118, 121, 123, 124, 125, 128, 129, 132, 136, 137, 138, 140, 141, 143, 144, 145, 146, 147, 148, 149, 151, 152, 153, 154, 155, 156, 157, 158, 159, 160, 161, 162, 165, 166, 168, 169, 170, 171, 172, 173, 174, 176, 177, 179, 180, 181, 182, 183, 184, 185, 187, 188, 189, 190, 192, 194, 196, 198]"
Olaf,L0,middle,135,76,59,5,0.325,200,"[0, 1, 2, 3, 4, 5, 6, 7, 9, 10, 11, 13, 14, 15, 16, 17, 18, 19, 20, 21, 22, 23, 24, 26, 27, 30, 31, 33, 34, 35, 36, 37, 38, 40, 42, 44, 45, 48, 51, 53, 54, 55, 57, 58, 60, 61, 65, 69, 70, 74, 75, 76, 77, 78, 79, 80, 81, 84, 89, 92, 95, 98, 99, 100, 101, 102, 103, 104, 106, 108, 109, 110, 114, 118, 119, 123, 124, 125, 126, 127, 130, 131, 132, 134, 135, 136, 139, 140, 141, 142, 143, 144, 145, 149, 150, 152, 153, 154, 155, 156, 157, 158, 159, 160, 161, 162, 163, 166, 168, 169, 170, 172, 174, 175, 176, 177, 178, 180, 181, 182, 183, 184, 185, 186, 187, 188, 190, 192, 193, 194, 195, 196, 197, 198, 199]"
Olaf,L0,middle,126,55,71,4,0.37,200,"[1, 2, 3, 4, 6, 7, 9, 10, 11, 15, 16, 17, 18, 19, 20, 22, 23, 24, 25, 26, 27, 28, 29, 31, 33, 34, 36, 38, 39, 44, 45, 46, 49, 50, 51, 52, 53, 54, 55, 57, 59, 60, 61, 63, 65, 66, 67, 69, 73, 74, 75, 76, 77, 79, 81, 84, 85, 86, 87, 88, 91, 96, 97, 98, 101, 102, 103, 104, 106, 107, 109, 111, 112, 114, 115, 116, 117, 119, 120, 122, 124, 125, 126, 127, 129, 131, 132, 133, 134, 135, 136, 137, 142, 146, 150, 151, 154, 155, 157, 160, 161, 162, 164, 165, 166, 167, 168, 169, 172, 174, 175, 177, 180, 183, 184, 185, 186, 187, 188, 189, 191, 192, 193, 196, 197, 199]"
Olaf,L0,middle,136,87,49,5,0.32,200,"[0, 2, 3, 4, 6, 8, 10, 11, 12, 14, 15, 16, 17, 18, 19, 20, 21, 22, 23, 25, 28, 29, 30, 31, 32, 33, 34, 35, 37, 38, 39, 40, 41, 43, 44, 45, 46, 47, 48, 49, 52, 53, 54, 56, 57, 58, 61, 64, 66, 70, 71, 72, 73, 74, 76, 78, 79, 80, 83, 84, 88, 90, 91, 92, 93, 94, 95, 96, 97, 98, 102, 104, 105, 106, 107, 108, 109, 110, 113, 115, 116, 117, 119, 121, 124, 125, 126, 130, 131, 134, 136, 138, 141, 142, 144, 145, 146, 147, 148, 149, 150, 151, 152, 156, 157, 158, 160, 161, 163, 164, 165, 167, 168, 169, 170, 171, 172, 173, 177, 178, 179, 180, 181, 182, 183, 184, 186, 187, 188, 190, 191, 194, 195, 196, 197, 198]"
Olaf,L0,middle,125,58,67,6,0.375,200,"[0, 2, 3, 5, 7, 10, 11, 13, 14, 15, 17, 20, 22, 23, 24, 25, 27, 28, 29, 30, 32, 33, 34, 35, 37, 38, 40, 41, 42, 44, 48, 50, 52, 53, 55, 57, 58, 59, 60, 61, 62, 63, 64, 71, 72, 73, 74, 75, 80, 81, 84, 86, 90, 91, 92, 93, 94, 95, 96, 97, 99, 101, 102, 104, 105, 106, 109, 110, 111, 115, 117, 120, 121, 123, 124, 126, 127, 129, 130, 131, 133, 134, 135, 136, 137, 139, 140, 141, 142, 143, 144, 145, 147, 149, 154, 155, 156, 157, 158, 159, 164, 168, 170, 171, 172, 173, 174, 175, 176, 178, 179, 184, 185, 186, 187, 189, 190, 191, 192, 193, 195, 196, 197, 198, 199]"
Olaf,L0,middle,132,84,48,1,0.34,200,"[1, 4, 5, 6, 7, 8, 10, 12, 13, 15, 16, 17, 18, 19, 20, 23, 24, 25, 26, 27, 29, 30, 31, 32, 33, 34, 35, 39, 40, 41, 43, 45, 47, 48, 49, 50, 51, 53, 54, 55, 56, 57, 58, 59, 60, 61, 63, 64, 65, 66, 68, 71, 73, 75, 76, 77, 78, 80, 82, 84, 85, 86, 88, 90, 93, 94, 95, 99, 100, 101, 104, 105, 106, 107, 108, 109, 110, 112, 114, 115, 116, 117, 118, 119, 120, 122, 123, 124, 125, 129, 130, 131, 132, 134, 135, 137, 138, 140, 142, 143, 144, 149, 150, 152, 153, 154, 155, 157, 158, 161, 162, 163, 164, 165, 167, 168, 169, 172, 173, 175, 178, 179, 180, 184, 185, 187, 189, 190, 193, 194, 196, 198]"
Olaf,L0,middle,135,75,60,3,0.325,200,"[0, 1, 3, 4, 5, 6, 8, 9, 11, 13, 17, 18, 19, 20, 24, 25, 26, 27, 29, 30, 31, 32, 33, 34, 35, 36, 37, 38, 39, 41, 44, 45, 48, 49, 52, 53, 54, 56, 57, 60, 61, 62, 63, 64, 65, 68, 69, 72, 73, 74, 75, 76, 77, 78, 79, 80, 81, 83, 84, 86, 88, 89, 93, 95, 96, 97, 98, 100, 101, 102, 103, 104, 105, 107, 108, 109, 110, 111, 115, 116, 117, 118, 119, 120, 123, 124, 127, 128, 129, 131, 132, 134, 135, 138, 139, 140, 141, 142, 143, 144, 145, 146, 147, 148, 149, 150, 151, 152, 155, 156, 158, 159, 160, 163, 164, 166, 170, 174, 175, 176, 177, 178, 181, 182, 183, 184, 185, 186, 188, 189, 192, 193, 197, 198, 199]"
Olaf,L0,middle,130,77,53,6,0.35,200,"[3, 4, 6, 7, 8, 10, 11, 12, 13, 14, 15, 16, 18, 19, 22, 23, 25, 27, 28, 29, 30, 32, 34, 35, 36, 38, 40, 41, 42, 45, 47, 49, 50, 53, 55, 58, 60, 61, 62, 66, 67, 69, 70, 72, 75, 76, 77, 78, 79, 80, 82, 84, 85, 86, 89, 90, 92, 93, 95, 96, 97, 98, 99, 102, 103, 104, 105, 107, 108, 109, 111, 112, 113, 114, 115, 118, 119, 120, 121, 123, 124, 126, 127, 129, 130, 132, 133, 135, 136, 138, 140, 141, 143, 144, 145, 147, 148, 150, 151, 152, 153, 154, 155, 156, 157, 159, 160, 161, 163, 165, 166, 167, 169, 174, 175, 176, 177, 178, 179, 180, 181, 182, 185, 189, 191, 192, 193, 194, 196, 199]"
Olaf,L0,middle,137,74,63,5,0.315,200,"[0, 1, 3, 4, 6, 9, 10, 11, 14, 16, 17, 19, 20, 21, 22, 24, 25, 26, 29, 30, 31, 33, 34, 35, 38, 39, 40, 41, 44, 45, 46, 47, 48, 49, 50, 51, 52, 54, 55, 57, 58, 59, 61, 62, 64, 65, 66, 68, 69, 73, 74, 75, 76, 78, 79, 80, 82, 83, 85, 88, 89, 90, 91, 93, 95, 97, 99, 100, 102, 105, 106, 107, 108, 110, 111, 112, 113, 114, 116, 117, 118, 119, 120, 121, 122, 123, 124, 125, 126, 128, 129, 130, 132, 133, 136, 137, 138, 141, 142, 143, 144, 146, 148, 149, 150, 151, 152, 153, 157, 158, 160, 161, 163, 164, 165, 166, 167, 169, 171, 172, 174, 176, 178, 179, 180, 182, 184, 185, 186, 187, 188, 189, 191, 192, 193, 195, 196]"
Olaf,L0,middle,139,70,69,3,0.305,200,"[0, 1, 7, 8, 9, 10, 11, 12, 13, 14, 16, 20, 25, 26, 28, 29, 30, 31, 32, 33, 34, 37, 38, 39, 41, 42, 43, 44, 46, 48, 50, 52, 54, 55, 56, 58, 59, 60, 61, 62, 63, 64, 65, 67, 68, 70, 71, 72, 73, 74, 75, 76, 77, 79, 80, 81, 82, 83, 84, 85, 87, 89, 90, 91, 92, 93, 94, 95, 96, 98, 99, 101, 102, 103, 106, 107, 108, 109, 111, 112, 114, 116, 117, 118, 119, 120, 122, 126, 128, 129, 130, 131, 132, 133, 134, 137, 138, 139, 140, 141, 142, 143, 144, 145, 146, 147, 149, 151, 153, 155, 156, 159, 160, 161, 163, 165, 166, 167, 168, 169, 170, 171, 173, 174, 175, 177, 178, 179, 180, 181, 185, 189, 190, 191, 193, 194, 196, 197, 198]"
Olaf,L0,middle,135,83,52,6,0.325,200,"[0, 3, 7, 11, 12, 13, 14, 15, 18, 19, 20, 21, 23, 25, 26, 27, 29, 32, 33, 34, 35, 36, 37, 38, 41, 42, 44, 45, 47, 49, 50, 51, 53, 55, 57, 58, 59, 61, 62, 63, 67, 68, 69, 71, 72, 73, 74, 75, 77, 81, 82, 83, 84, 86, 87, 88, 90, 91, 92, 93, 94, 95, 96, 98, 100, 101, 102, 103, 104, 105, 106, 107, 108, 109, 110, 113, 114, 116, 117, 118, 119, 120, 121, 123, 125, 127, 128, 130, 132, 133, 135, 137, 138, 142, 143, 144, 148, 149, 150, 151, 153, 154, 155, 156, 157, 162, 163, 164, 165, 166, 167, 168, 169, 170, 171, 174, 175, 177, 179, 181, 182, 183, 184, 186, 187, 189, 190, 191, 193, 194, 195, 196, 197, 198, 199]"
Olaf,L0,middle,131,67,64,6,0.345,200,"[2, 3, 4, 5, 6, 7, 8, 9, 10, 12, 18, 19, 21, 22, 24, 26, 28, 29, 30, 31, 32, 34, 35, 36, 41, 42, 44, 45, 48, 49, 50, 52, 55, 57, 59, 60, 61, 62, 64, 65, 67, 68, 70, 71, 72, 73, 74, 75, 76, 77, 80, 81, 82, 83, 84, 85, 86, 87, 88, 89, 91, 92, 94, 95, 97, 99, 101, 103, 105, 106, 108, 110, 111, 113, 115, 116, 118, 119, 122, 127, 129, 131, 132, 134, 135, 136, 138, 139, 140, 143, 147, 148, 150, 151, 153, 156, 157, 158, 159, 160, 161, 162, 163, 165, 167, 168, 169, 170, 171, 172, 173, 174, 175, 176, 177, 178, 180, 181, 182, 183, 185, 187, 189, 190, 191, 193, 194, 195, 196, 197, 198]"
Olaf,L0,middle,139,66,73,4,0.305,200,"[2, 3, 4, 5, 6, 7, 8, 9, 11, 12, 14, 15, 16, 17, 18, 19, 20, 21, 22, 23, 25, 26, 28, 29, 31, 32, 34, 35, 37, 41, 44, 47, 48, 49, 53, 54, 55, 56, 57, 58, 60, 61, 62, 63, 64, 65, 68, 69, 70, 71, 72, 73, 74, 75, 77, 79, 80, 81, 83, 84, 87, 88, 89, 93, 95, 96, 97, 98, 99, 100, 104, 105, 106, 107, 109, 110, 111, 112, 113, 114, 116, 117, 119, 120, 121, 122, 124, 126, 128, 129, 130, 131, 132, 134, 135, 136, 138, 139, 140, 141, 142, 143, 144, 145, 147, 148, 149, 152, 153, 154, 155, 157, 158, 161, 162, 163, 164, 167, 169, 171, 172, 173, 174, 176, 177, 178, 179, 180, 182, 186, 187, 189, 191, 192, 193, 194, 196, 197, 198]"
Olaf,L0,middle,119,60,59,9,0.405,200,"[0, 2, 3, 7, 8, 10, 11, 13, 14, 15, 17, 18, 19, 20, 21, 22, 23, 24, 25, 26, 29, 30, 32, 35, 37, 38, 43, 46, 47, 49, 51, 52, 58, 59, 60, 61, 62, 63, 64, 66, 67, 72, 74, 76, 77, 80, 81, 82, 89, 90, 91, 94, 95, 96, 97, 100, 101, 102, 103, 104, 105, 106, 111, 112, 114, 115, 116, 117, 118, 120, 121, 124, 125, 127, 128, 129, 131, 132, 133, 134, 135, 138, 139, 140, 141, 142, 143, 144, 145, 147, 149, 152, 153, 155, 157, 163, 164, 165, 166, 167, 169, 171, 172, 173, 174, 176, 178, 179, 180, 181, 183, 184, 185, 188, 190, 192, 193, 196, 199]"
Olaf,L0,middle,126,60,66,4,0.37,200,"[0, 2, 4, 6, 7, 8, 10, 11, 13, 14, 15, 16, 17, 18, 20, 21, 22, 24, 25, 27, 29, 30, 33, 34, 35, 36, 38, 39, 40, 41, 45, 46, 47, 50, 51, 52, 55, 56, 58, 59, 62, 64, 65, 68, 71, 72, 73, 75, 76, 77, 79, 80, 81, 85, 89, 90, 92, 93, 94, 97, 98, 99, 100, 102, 103, 104, 105, 106, 107, 108, 109, 110, 112, 113, 114, 115, 116, 118, 119, 121, 122, 124, 125, 126, 127, 129, 130, 133, 134, 135, 136, 137, 138, 139, 141, 143, 144, 146, 148, 149, 151, 153, 154, 155, 157, 158, 159, 161, 162, 166, 168, 170, 173, 174, 179, 181, 182, 183, 186, 189, 192, 193, 195, 196, 198, 199]"
Olaf,L0,middle,133,78,55,6,0.335,200,"[0, 1, 2, 3, 4, 5, 8, 9, 10, 11, 12, 13, 15, 16, 17, 18, 20, 21, 22, 23, 24, 25, 27, 31, 32, 33, 34, 35, 36, 40, 41, 42, 44, 45, 46, 50, 51, 53, 55, 56, 57, 58, 59, 62, 63, 64, 68, 69, 70, 72, 73, 74, 75, 78, 80, 81, 83, 84, 85, 87, 88, 89, 90, 91, 92, 93, 94, 95, 98, 100, 101, 103, 104, 105, 106, 107, 108, 110, 111, 112, 114, 115, 116, 117, 120, 121, 122, 123, 124, 125, 127, 128, 129, 130, 132, 133, 134, 135, 136, 137, 140, 142, 145, 146, 147, 148, 150, 152, 153, 160, 162, 163, 164, 165, 168, 171, 173, 174, 177, 178, 180, 181, 182, 184, 185, 186, 187, 191, 193, 195, 196, 197, 198]"
Olaf,L0,middle,129,55,74,3,0.355,200,"[1, 2, 3, 6, 7, 11, 13, 14, 16, 17, 18, 19, 21, 23, 25, 26, 27, 28, 29, 30, 32, 35, 36, 39, 40, 42, 43, 44, 45, 46, 47, 50, 51, 52, 54, 55, 56, 59, 60, 61, 62, 63, 64, 65, 66, 68, 69, 70, 71, 72, 73, 74, 76, 77, 78, 79, 80, 82, 83, 85, 86, 88, 90, 92, 93, 94, 96, 98, 102, 103, 104, 105, 107, 108, 110, 113, 114, 115, 116, 118, 119, 121, 125, 127, 128, 130, 132, 133, 135, 136, 137, 139, 141, 142, 143, 145, 149, 150, 152, 153, 154, 155, 157, 158, 159, 160, 163, 164, 165, 167, 168, 170, 171, 172, 174, 175, 176, 177, 180, 182, 183, 184, 186, 187, 189, 190, 192, 195, 196]"
Olaf,L0,middle,130,64,66,6,0.35,200,"[0, 3, 5, 6, 8, 9, 10, 13, 14, 15, 16, 17, 18, 20, 21, 22, 23, 24, 25, 26, 27, 28, 29, 32, 33, 35, 38, 40, 41, 43, 44, 46, 49, 50, 51, 52, 53, 56, 57, 58, 59, 61, 62, 63, 64, 65, 66, 67, 69, 70, 71, 73, 74, 76, 77, 78, 79, 80, 82, 84, 85, 86, 87, 88, 89, 90, 91, 92, 93, 94, 95, 96, 98, 101, 104, 105, 107, 109, 115, 119, 121, 122, 126, 127, 130, 131, 132, 133, 134, 135, 136, 137, 138, 140, 141, 142, 143, 144, 146, 147, 148, 149, 151, 153, 155, 158, 159, 164, 165, 168, 169, 171, 175, 176, 177, 178, 179, 181, 182, 183, 184, 186, 187, 188, 189, 192, 193, 194, 198, 199]"
Olaf,L0,middle,138,76,62,7,0.31,200,"[0, 1, 2, 3, 5, 6, 8, 10, 11, 12, 13, 14, 15, 16, 18, 19, 21, 24, 25, 26, 27, 28, 30, 31, 32, 34, 35, 36, 38, 39, 42, 43, 47, 49, 50, 51, 52, 53, 54, 55, 56, 57, 58, 59, 60, 61, 63, 64, 65, 66, 68, 69, 70, 71, 72, 74, 75, 78, 79, 80, 81, 82, 83, 84, 86, 87, 88, 90, 91, 92, 95, 96, 97, 98, 99, 100, 101, 102, 103, 105, 108, 110, 115, 117, 118, 119, 120, 121, 123, 124, 126, 128, 130, 131, 132, 133, 134, 136, 137, 140, 141, 146, 148, 150, 151, 152, 154, 155, 160, 161, 164, 165, 167, 168, 169, 171, 173, 174, 175, 177, 178, 179, 180, 181, 183, 185, 186, 187, 188, 189, 190, 191, 192, 193, 194, 197, 198, 199]"
Olaf,L0,middle,130,61,69,4,0.35,200,"[0, 1, 2, 3, 4, 6, 7, 8, 9, 10, 11, 17, 18, 19, 20, 21, 22, 24, 25, 28, 31, 32, 33, 36, 37, 39, 41, 43, 44, 45, 46, 50, 52, 53, 54, 56, 59, 61, 63, 64, 65, 66, 68, 70, 73, 76, 77, 80, 81, 82, 83, 84, 88, 89, 91, 92, 94, 95, 96, 97, 98, 99, 100, 101, 102, 103, 104, 105, 106, 107, 108, 109, 110, 111, 112, 116, 117, 118, 119, 120, 122, 123, 124, 126, 127, 128, 129, 133, 134, 138, 140, 142, 145, 148, 149, 150, 151, 153, 155, 156, 157, 159, 160, 162, 163, 164, 165, 166, 167, 168, 169, 170, 172, 174, 175, 176, 178, 181, 182, 183, 184, 187, 188, 189, 191, 193, 194, 195, 196, 198]"
Olaf,L0,middle,130,69,61,2,0.35,200,"[0, 1, 4, 5, 6, 7, 8, 10, 11, 12, 13, 15, 17, 18, 19, 20, 21, 22, 25, 27, 28, 32, 34, 35, 36, 37, 38, 39, 41, 42, 44, 46, 48, 50, 53, 54, 55, 56, 57, 58, 59, 60, 61, 62, 65, 67, 70, 71, 74, 75, 77, 78, 80, 81, 85, 86, 88, 89, 90, 91, 92, 94, 95, 98, 99, 100, 102, 103, 104, 105, 107, 110, 111, 113, 114, 115, 116, 117, 118, 119, 121, 123, 124, 125, 126, 129, 130, 131, 132, 133, 134, 135, 136, 137, 139, 140, 142, 144, 145, 146, 147, 149, 150, 151, 155, 158, 160, 161, 162, 163, 165, 167, 169, 171, 173, 177, 179, 183, 184, 185, 187, 188, 189, 191, 192, 193, 194, 196, 197, 199]"
Olaf,L0,middle,128,65,63,5,0.36,200,"[0, 1, 2, 6, 7, 10, 11, 13, 15, 16, 17, 18, 19, 20, 21, 22, 25, 26, 27, 28, 29, 30, 32, 34, 35, 37, 38, 39, 41, 46, 47, 48, 49, 51, 52, 53, 54, 56, 58, 59, 60, 61, 62, 63, 67, 68, 69, 71, 73, 75, 77, 78, 80, 82, 84, 86, 88, 89, 90, 91, 93, 95, 97, 98, 99, 101, 102, 103, 105, 106, 107, 111, 112, 113, 114, 115, 119, 120, 121, 124, 125, 126, 128, 129, 131, 132, 135, 138, 139, 141, 143, 146, 147, 150, 151, 153, 154, 155, 159, 160, 161, 163, 164, 165, 166, 168, 169, 170, 172, 173, 175, 176, 177, 178, 179, 182, 185, 187, 188, 189, 191, 192, 193, 194, 195, 196, 197, 199]"
Olaf,L0,middle,142,79,63,2,0.29,200,"[0, 2, 3, 4, 5, 6, 7, 9, 10, 11, 12, 14, 15, 16, 17, 18, 19, 20, 21, 22, 23, 26, 27, 28, 29, 30, 31, 32, 33, 34, 35, 39, 40, 41, 43, 44, 45, 46, 47, 48, 49, 51, 52, 53, 54, 55, 56, 58, 60, 62, 63, 64, 66, 68, 69, 70, 71, 72, 73, 74, 77, 81, 84, 85, 87, 89, 91, 92, 93, 95, 96, 97, 98, 101, 102, 103, 104, 105, 107, 108, 110, 113, 115, 116, 117, 118, 119, 121, 122, 123, 124, 125, 126, 127, 128, 129, 131, 132, 134, 135, 136, 138, 139, 142, 144, 148, 149, 150, 151, 152, 155, 156, 157, 158, 160, 161, 162, 164, 166, 167, 168, 169, 170, 171, 172, 175, 176, 178, 179, 182, 183, 185, 188, 189, 190, 191, 192, 193, 195, 196, 197, 198]"
Olaf,L0,middle,136,74,62,1,0.32,200,"[0, 1, 3, 7, 8, 9, 10, 12, 13, 14, 18, 20, 21, 22, 23, 24, 25, 26, 28, 29, 30, 31, 33, 34, 35, 38, 39, 40, 41, 43, 44, 47, 49, 50, 52, 53, 54, 55, 56, 57, 58, 60, 61, 62, 63, 64, 68, 70, 71, 77, 78, 79, 80, 81, 82, 83, 84, 85, 87, 90, 91, 92, 93, 94, 95, 96, 97, 98, 99, 100, 101, 104, 107, 108, 109, 110, 111, 112, 113, 114, 116, 117, 118, 119, 120, 121, 122, 124, 126, 129, 130, 131, 132, 133, 134, 135, 136, 141, 143, 145, 148, 149, 150, 151, 152, 153, 158, 159, 160, 161, 162, 164, 165, 166, 167, 168, 169, 170, 171, 173, 174, 175, 176, 177, 178, 179, 180, 185, 186, 188, 190, 193, 194, 195, 197, 198]"
Olaf,L0,middle,135,78,57,5,0.325,200,"[5, 8, 11, 12, 13, 14, 15, 16, 17, 18, 19, 20, 21, 23, 24, 25, 26, 27, 28, 29, 30, 32, 35, 36, 37, 38, 39, 41, 42, 43, 44, 46, 47, 49, 51, 52, 53, 54, 56, 59, 60, 61, 62, 63, 65, 67, 68, 71, 73, 74, 77, 79, 80, 83, 84, 85, 86, 88, 89, 90, 91, 93, 95, 98, 99, 100, 101, 102, 103, 104, 105, 106, 108, 109, 110, 115, 116, 118, 119, 120, 121, 122, 124, 126, 127, 129, 132, 133, 134, 136, 137, 139, 140, 141, 145, 146, 147, 148, 150, 151, 152, 153, 158, 160, 161, 162, 163, 164, 165, 167, 168, 169, 171, 172, 173, 175, 176, 177, 178, 179, 181, 182, 183, 184, 185, 188, 189, 192, 193, 194, 195, 196, 197, 198, 199]"
Olaf,L0,middle,141,60,81,2,0.295,200,"[1, 3, 5, 6, 7, 8, 10, 11, 12, 13, 18, 19, 20, 21, 23, 24, 26, 27, 29, 30, 31, 32, 34, 36, 37, 38, 39, 40, 41, 43, 44, 45, 47, 48, 49, 50, 51, 52, 53, 54, 55, 56, 58, 59, 60, 61, 62, 64, 65, 66, 67, 68, 70, 71, 72, 73, 74, 75, 76, 78, 79, 80, 81, 84, 85, 86, 87, 88, 89, 92, 93, 94, 95, 98, 99, 100, 103, 104, 105, 106, 107, 109, 110, 112, 114, 115, 116, 118, 119, 120, 121, 124, 125, 127, 129, 130, 131, 133, 136, 137, 138, 139, 141, 142, 143, 145, 146, 147, 148, 149, 150, 151, 152, 153, 155, 157, 158, 160, 161, 162, 163, 165, 168, 169, 173, 174, 175, 178, 179, 180, 183, 184, 187, 188, 189, 190, 192, 195, 197, 198, 199]"
Olaf,L0,middle,133,64,69,0,0.335,200,"[2, 4, 5, 6, 7, 8, 9, 10, 11, 12, 13, 14, 15, 17, 18, 19, 21, 22, 23, 24, 25, 27, 28, 31, 32, 34, 36, 37, 40, 41, 43, 44, 45, 46, 47, 48, 49, 50, 52, 53, 54, 56, 57, 59, 61, 64, 65, 66, 67, 68, 72, 73, 74, 75, 76, 77, 79, 80, 81, 82, 83, 84, 85, 87, 88, 89, 90, 91, 95, 96, 97, 100, 101, 103, 105, 106, 107, 109, 113, 115, 116, 117, 118, 119, 120, 121, 122, 123, 124, 125, 127, 129, 131, 132, 133, 134, 136, 138, 141, 143, 144, 145, 146, 151, 152, 154, 156, 157, 159, 160, 162, 163, 164, 165, 166, 167, 169, 170, 171, 174, 176, 178, 180, 181, 182, 183, 184, 186, 187, 190, 193, 198, 199]"
Olaf,L0,middle,137,95,42,8,0.315,200,"[0, 1, 2, 3, 4, 5, 6, 7, 8, 9, 11, 12, 13, 14, 15, 16, 18, 21, 22, 23, 25, 28, 29, 31, 32, 33, 34, 36, 37, 38, 43, 44, 45, 46, 47, 50, 52, 53, 54, 56, 57, 58, 60, 61, 63, 65, 67, 68, 70, 71, 72, 75, 78, 81, 82, 84, 85, 86, 87, 88, 92, 93, 94, 95, 96, 99, 100, 102, 104, 105, 106, 107, 108, 109, 110, 112, 113, 114, 115, 117, 118, 119, 120, 121, 123, 124, 125, 126, 127, 128, 130, 131, 133, 134, 137, 139, 141, 142, 143, 146, 147, 148, 149, 150, 151, 152, 154, 155, 156, 157, 158, 159, 161, 162, 163, 164, 166, 167, 168, 169, 172, 174, 175, 177, 181, 184, 186, 187, 188, 189, 191, 192, 193, 194, 197, 198, 199]"
Olaf,L0,middle,138,74,64,1,0.31,200,"[1, 2, 4, 6, 7, 8, 9, 10, 13, 15, 18, 19, 21, 22, 24, 26, 29, 30, 31, 33, 37, 38, 39, 40, 41, 44, 45, 47, 48, 49, 52, 53, 54, 55, 58, 59, 60, 61, 62, 63, 64, 65, 66, 67, 68, 69, 70, 71, 73, 74, 75, 76, 77, 78, 80, 82, 83, 84, 87, 88, 89, 90, 91, 92, 93, 94, 96, 97, 98, 99, 100, 101, 102, 104, 105, 106, 107, 108, 109, 110, 111, 112, 115, 116, 117, 119, 120, 121, 122, 123, 125, 127, 128, 130, 131, 132, 133, 134, 135, 137, 139, 140, 141, 143, 145, 146, 147, 149, 150, 151, 152, 153, 155, 157, 158, 161, 162, 164, 166, 167, 169, 170, 171, 173, 174, 176, 177, 179, 182, 183, 184, 187, 188, 191, 195, 196, 197, 199]"
Olaf,L0,middle,139,74,65,4,0.305,200,"[0, 1, 2, 5, 7, 8, 9, 12, 14, 15, 16, 17, 21, 22, 24, 26, 28, 29, 30, 31, 33, 34, 35, 37, 39, 40, 41, 42, 43, 44, 45, 46, 47, 48, 49, 50, 53, 54, 55, 56, 57, 58, 59, 60, 62, 63, 64, 65, 66, 68, 69, 70, 71, 72, 74, 77, 80, 81, 82, 83, 84, 85, 86, 87, 88, 89, 90, 91, 92, 93, 94, 95, 96, 97, 98, 100, 101, 102, 106, 107, 110, 111, 113, 116, 118, 120, 122, 123, 124, 125, 127, 130, 131, 133, 134, 135, 136, 137, 142, 144, 145, 147, 148, 149, 151, 154, 157, 158, 159, 160, 161, 162, 163, 164, 165, 166, 167, 168, 170, 171, 172, 175, 176, 178, 180, 181, 182, 183, 184, 185, 186, 188, 191, 192, 193, 194, 195, 198, 199]"
Olaf,L0,middle,123,54,69,4,0.385,200,"[0, 1, 2, 3, 4, 5, 6, 7, 10, 11, 12, 13, 15, 17, 19, 21, 23, 24, 26, 28, 31, 32, 33, 34, 35, 36, 37, 38, 40, 41, 46, 47, 52, 53, 54, 55, 56, 57, 59, 61, 62, 63, 65, 67, 71, 72, 76, 77, 78, 79, 80, 81, 83, 85, 86, 87, 88, 90, 92, 95, 96, 97, 100, 101, 102, 103, 104, 105, 107, 108, 110, 111, 112, 113, 114, 117, 118, 122, 123, 126, 129, 131, 135, 136, 137, 140, 141, 142, 143, 144, 145, 149, 150, 151, 156, 157, 159, 161, 163, 165, 167, 169, 170, 172, 173, 175, 176, 177, 178, 179, 182, 183, 186, 187, 188, 189, 190, 191, 192, 194, 196, 197, 199]"
Olaf,L0,middle,138,60,78,3,0.31,200,"[0, 1, 2, 3, 4, 5, 6, 10, 11, 12, 15, 17, 18, 19, 20, 21, 23, 25, 26, 29, 30, 31, 34, 35, 37, 38, 39, 40, 41, 42, 43, 46, 48, 49, 50, 52, 53, 54, 56, 57, 58, 59, 60, 61, 66, 67, 70, 71, 72, 73, 75, 76, 77, 79, 81, 82, 83, 84, 85, 86, 87, 88, 89, 90, 91, 92, 93, 94, 97, 99, 100, 101, 102, 103, 104, 106, 107, 108, 109, 110, 111, 114, 115, 116, 117, 118, 120, 121, 122, 126, 128, 129, 130, 131, 134, 135, 136, 137, 139, 140, 142, 143, 147, 150, 151, 153, 155, 157, 158, 160, 161, 162, 163, 164, 165, 167, 168, 171, 173, 174, 176, 177, 178, 180, 181, 182, 183, 184, 186, 187, 189, 190, 192, 193, 196, 197, 198, 199]"
Olaf,L0,middle,129,64,65,7,0.355,200,"[1, 3, 4, 6, 7, 8, 10, 12, 13, 14, 16, 17, 18, 19, 20, 21, 23, 24, 26, 27, 28, 29, 32, 33, 34, 35, 36, 37, 39, 42, 43, 44, 48, 49, 50, 51, 52, 57, 58, 59, 60, 61, 62, 65, 67, 70, 72, 74, 76, 79, 80, 81, 84, 86, 88, 89, 90, 92, 93, 94, 95, 96, 97, 99, 100, 102, 103, 104, 105, 106, 108, 110, 111, 112, 118, 120, 122, 123, 124, 125, 126, 127, 128, 129, 132, 134, 135, 136, 137, 138, 139, 144, 146, 148, 149, 151, 152, 154, 155, 156, 159, 161, 162, 163, 165, 166, 167, 168, 172, 174, 175, 177, 178, 179, 181, 182, 183, 186, 187, 188, 189, 190, 192, 193, 194, 196, 197, 198, 199]"
Olaf,L0,middle,136,66,70,0,0.32,200,"[1, 2, 3, 4, 5, 6, 7, 8, 9, 10, 12, 14, 15, 17, 19, 23, 24, 25, 26, 27, 28, 29, 34, 35, 36, 37, 38, 39, 40, 41, 43, 46, 47, 48, 50, 51, 52, 53, 56, 57, 58, 59, 60, 61, 62, 65, 66, 67, 68, 71, 72, 73, 76, 77, 78, 80, 81, 84, 85, 86, 89, 90, 91, 93, 94, 95, 96, 98, 99, 100, 101, 102, 103, 106, 108, 109, 111, 116, 117, 118, 119, 120, 121, 123, 125, 127, 128, 129, 130, 133, 135, 137, 138, 139, 140, 141, 142, 144, 145, 146, 147, 148, 149, 150, 151, 152, 153, 155, 156, 157, 159, 160, 161, 164, 165, 167, 168, 169, 170, 171, 173, 175, 176, 178, 179, 180, 181, 182, 185, 186, 187, 192, 194, 196, 197, 199]"
Olaf,L0,middle,124,80,44,11,0.38,200,"[0, 1, 2, 3, 5, 6, 7, 8, 10, 11, 12, 14, 15, 18, 19, 20, 21, 24, 27, 29, 30, 31, 33, 34, 36, 37, 39, 40, 43, 45, 46, 47, 49, 50, 51, 52, 53, 55, 58, 59, 60, 61, 62, 63, 64, 65, 66, 68, 76, 78, 79, 82, 84, 85, 87, 90, 92, 93, 94, 96, 97, 98, 100, 101, 102, 105, 106, 107, 109, 110, 111, 112, 114, 116, 119, 121, 123, 124, 126, 127, 128, 129, 133, 134, 135, 136, 137, 139, 140, 142, 148, 149, 151, 153, 154, 155, 156, 158, 159, 165, 166, 168, 170, 175, 176, 177, 178, 179, 180, 181, 182, 184, 185, 186, 188, 189, 190, 191, 193, 194, 195, 196, 197, 198]"
Olaf,L0,middle,133,66,67,2,0.335,200,"[0, 2, 3, 5, 8, 9, 10, 12, 15, 16, 17, 18, 19, 21, 22, 24, 25, 27, 29, 30, 31, 32, 35, 36, 37, 38, 41, 42, 43, 44, 47, 48, 51, 52, 53, 54, 55, 56, 57, 59, 60, 61, 62, 63, 64, 67, 68, 69, 70, 71, 73, 75, 76, 77, 78, 79, 81, 82, 84, 85, 87, 88, 91, 92, 93, 95, 96, 98, 100, 101, 102, 105, 107, 108, 109, 112, 114, 118, 119, 120, 121, 122, 123, 124, 126, 127, 129, 130, 132, 133, 135, 136, 139, 140, 141, 143, 144, 145, 147, 148, 149, 150, 151, 154, 155, 156, 157, 159, 161, 162, 164, 165, 166, 167, 168, 171, 172, 174, 175, 176, 179, 180, 181, 182, 183, 184, 185, 186, 187, 188, 195, 196, 199]"
Olaf,L0,middle,138,57,81,3,0.31,200,"[1, 3, 5, 6, 7, 8, 9, 11, 12, 13, 15, 17, 18, 19, 21, 22, 23, 24, 25, 28, 30, 32, 33, 34, 35, 36, 40, 41, 42, 43, 45, 46, 47, 48, 50, 51, 52, 53, 54, 55, 56, 57, 58, 59, 61, 62, 65, 66, 67, 71, 72, 73, 74, 75, 77, 78, 79, 80, 81, 83, 85, 86, 87, 88, 89, 93, 95, 98, 99, 100, 101, 102, 105, 107, 108, 109, 110, 111, 113, 114, 115, 116, 118, 122, 123, 125, 126, 127, 128, 129, 130, 131, 132, 135, 136, 139, 140, 141, 142, 143, 144, 147, 148, 149, 150, 152, 153, 154, 156, 158, 159, 160, 161, 162, 164, 165, 166, 167, 169, 170, 172, 174, 175, 177, 178, 179, 180, 181, 183, 187, 190, 191, 192, 193, 194, 195, 198, 199]"
Olaf,L0,middle,134,71,63,2,0.33,200,"[1, 7, 8, 9, 10, 11, 14, 16, 17, 19, 20, 21, 24, 25, 26, 27, 30, 32, 34, 35, 36, 38, 40, 41, 43, 44, 45, 46, 48, 49, 50, 51, 52, 53, 54, 55, 56, 58, 59, 60, 61, 62, 63, 67, 68, 69, 70, 71, 74, 75, 76, 77, 78, 79, 81, 82, 83, 85, 86, 88, 89, 92, 93, 94, 95, 96, 97, 102, 104, 105, 107, 108, 109, 112, 113, 114, 115, 116, 117, 118, 119, 120, 121, 122, 123, 125, 126, 127, 128, 131, 133, 134, 135, 136, 138, 139, 140, 144, 145, 146, 148, 149, 150, 151, 152, 153, 155, 157, 158, 159, 160, 161, 162, 165, 167, 171, 172, 173, 174, 175, 177, 178, 180, 182, 184, 186, 188, 190, 193, 194, 195, 196, 197, 199]"
Olaf,L0,middle,144,57,87,6,0.28,200,"[2, 3, 4, 5, 6, 9, 10, 11, 12, 13, 14, 15, 16, 17, 18, 20, 21, 22, 23, 25, 26, 28, 29, 30, 31, 32, 35, 36, 37, 38, 39, 41, 44, 46, 48, 49, 50, 51, 52, 53, 54, 55, 56, 57, 58, 59, 61, 63, 64, 65, 68, 69, 70, 71, 72, 73, 80, 82, 83, 84, 86, 87, 88, 89, 90, 91, 92, 93, 94, 95, 96, 97, 99, 101, 102, 103, 104, 106, 107, 108, 109, 110, 111, 112, 113, 119, 121, 122, 126, 127, 128, 131, 132, 135, 136, 137, 138, 139, 140, 141, 142, 143, 144, 145, 146, 149, 151, 152, 155, 157, 158, 160, 162, 166, 167, 168, 170, 171, 172, 173, 174, 175, 176, 177, 178, 179, 180, 181, 182, 183, 184, 185, 186, 187, 189, 190, 191, 192, 194, 195, 196, 197, 198, 199]"
Olaf,L0,middle,142,63,79,3,0.29,200,"[0, 2, 4, 5, 7, 8, 10, 11, 12, 13, 14, 15, 16, 17, 18, 19, 20, 21, 23, 25, 26, 27, 28, 30, 31, 32, 34, 37, 39, 40, 41, 43, 46, 47, 49, 50, 51, 53, 55, 56, 57, 58, 59, 61, 62, 63, 64, 65, 67, 68, 70, 71, 74, 75, 76, 77, 78, 79, 81, 82, 83, 84, 85, 86, 87, 88, 89, 92, 93, 97, 98, 99, 100, 101, 102, 103, 105, 107, 109, 110, 111, 112, 113, 114, 115, 116, 117, 119, 120, 121, 122, 123, 125, 126, 127, 128, 129, 130, 136, 137, 138, 139, 140, 142, 143, 144, 146, 147, 148, 149, 151, 152, 154, 155, 157, 160, 162, 163, 164, 167, 169, 170, 172, 173, 174, 175, 176, 178, 181, 184, 185, 187, 188, 189, 190, 192, 193, 195, 196, 197, 198, 199]"
Olaf,L0,middle,125,61,64,5,0.375,200,"[0, 5, 6, 7, 8, 9, 10, 11, 13, 14, 17, 18, 19, 20, 24, 28, 29, 31, 32, 34, 37, 39, 40, 41, 42, 43, 44, 45, 46, 47, 50, 54, 56, 57, 60, 61, 62, 63, 65, 66, 67, 68, 72, 75, 76, 78, 79, 80, 81, 83, 84, 86, 87, 89, 90, 91, 92, 96, 97, 98, 99, 100, 101, 102, 105, 106, 108, 110, 113, 116, 118, 119, 120, 121, 124, 126, 127, 128, 129, 130, 131, 133, 134, 135, 137, 138, 140, 141, 143, 144, 145, 147, 148, 149, 151, 152, 153, 154, 155, 156, 157, 158, 159, 160, 164, 165, 169, 170, 174, 176, 177, 178, 179, 181, 182, 183, 188, 189, 191, 192, 193, 196, 197, 198, 199]"
Olaf,L0,middle,133,76,57,8,0.335,200,"[0, 3, 4, 6, 8, 10, 11, 12, 14, 15, 16, 17, 20, 21, 23, 25, 27, 28, 29, 30, 32, 38, 42, 43, 45, 46, 47, 48, 49, 50, 51, 52, 53, 54, 55, 59, 61, 62, 65, 66, 68, 70, 71, 73, 74, 76, 77, 78, 79, 80, 81, 82, 84, 85, 86, 87, 88, 89, 90, 91, 92, 93, 95, 96, 98, 99, 100, 101, 104, 105, 106, 107, 108, 110, 111, 112, 113, 115, 116, 117, 120, 121, 122, 123, 126, 128, 129, 130, 131, 132, 134, 135, 138, 140, 143, 144, 148, 149, 150, 152, 154, 156, 157, 158, 159, 160, 162, 163, 164, 167, 168, 169, 170, 171, 173, 175, 176, 177, 178, 179, 180, 182, 184, 186, 187, 188, 190, 191, 193, 194, 196, 198, 199]"
Olaf,L0,middle,130,81,49,3,0.35,200,"[0, 4, 5, 6, 7, 8, 9, 11, 14, 16, 18, 20, 21, 23, 24, 27, 29, 30, 31, 33, 34, 35, 38, 40, 41, 42, 43, 44, 45, 46, 47, 48, 52, 56, 57, 58, 59, 62, 63, 64, 67, 68, 70, 71, 72, 74, 75, 77, 80, 81, 86, 87, 88, 91, 94, 95, 98, 99, 101, 103, 104, 105, 106, 107, 108, 110, 112, 114, 115, 117, 118, 119, 121, 122, 123, 124, 125, 126, 127, 128, 129, 130, 131, 134, 135, 136, 137, 138, 140, 141, 142, 144, 145, 147, 148, 149, 150, 152, 153, 154, 157, 160, 161, 163, 164, 166, 167, 168, 169, 172, 174, 175, 176, 177, 178, 179, 182, 184, 185, 186, 187, 188, 191, 192, 193, 194, 195, 196, 197, 199]"
Olaf,L0,middle,139,54,85,5,0.305,200,"[0, 1, 2, 5, 6, 7, 8, 9, 10, 11, 12, 13, 14, 16, 17, 18, 20, 21, 22, 23, 25, 26, 27, 28, 30, 33, 34, 35, 36, 37, 38, 43, 44, 45, 48, 49, 50, 52, 55, 56, 59, 61, 63, 65, 66, 67, 69, 70, 71, 72, 73, 74, 75, 76, 77, 78, 80, 81, 84, 85, 86, 87, 88, 89, 91, 92, 94, 96, 98, 99, 101, 102, 106, 107, 109, 110, 112, 113, 115, 117, 118, 119, 120, 121, 123, 124, 125, 126, 127, 129, 130, 131, 132, 134, 136, 138, 142, 143, 144, 146, 147, 148, 149, 150, 151, 153, 155, 156, 157, 158, 159, 160, 161, 163, 164, 165, 167, 168, 169, 170, 171, 173, 174, 176, 177, 179, 180, 183, 185, 187, 188, 190, 191, 192, 193, 195, 196, 197, 199]"
Olaf,L0,middle,120,58,62,7,0.4,200,"[1, 4, 6, 7, 8, 10, 11, 12, 13, 17, 18, 19, 20, 22, 23, 24, 27, 28, 29, 30, 31, 36, 38, 42, 43, 44, 45, 46, 47, 48, 49, 50, 51, 52, 53, 55, 57, 58, 60, 61, 65, 67, 70, 71, 72, 74, 76, 77, 78, 79, 80, 82, 83, 84, 85, 86, 88, 89, 90, 91, 94, 97, 99, 101, 102, 104, 106, 107, 110, 111, 112, 114, 115, 116, 118, 119, 122, 124, 125, 128, 130, 132, 135, 136, 137, 138, 142, 143, 148, 151, 152, 155, 156, 157, 159, 160, 161, 162, 163, 164, 165, 167, 169, 170, 172, 174, 176, 177, 178, 179, 180, 181, 185, 187, 189, 192, 193, 194, 197, 198]"
Olaf,L0,middle,141,58,83,1,0.295,200,"[0, 1, 3, 4, 5, 6, 8, 9, 11, 13, 14, 15, 16, 17, 18, 20, 24, 25, 26, 27, 30, 33, 35, 36, 38, 39, 40, 41, 42, 43, 44, 46, 49, 50, 53, 54, 55, 58, 60, 61, 62, 63, 64, 65, 66, 68, 69, 70, 71, 72, 75, 76, 77, 78, 80, 81, 82, 83, 84, 86, 87, 91, 93, 94, 95, 96, 97, 99, 102, 103, 106, 107, 109, 110, 111, 112, 113, 114, 115, 117, 118, 120, 121, 122, 124, 125, 126, 127, 128, 129, 131, 133, 134, 135, 136, 137, 139, 140, 142, 144, 145, 146, 147, 149, 151, 152, 153, 154, 156, 157, 158, 160, 161, 163, 164, 165, 166, 167, 169, 170, 171, 172, 176, 177, 178, 179, 180, 182, 183, 184, 185, 186, 187, 188, 189, 190, 192, 193, 194, 195, 198]"
Olaf,L0,middle,141,66,75,5,0.295,200,"[1, 2, 4, 5, 6, 7, 8, 11, 12, 13, 14, 15, 16, 17, 18, 19, 20, 21, 24, 25, 26, 27, 28, 29, 30, 32, 34, 35, 36, 37, 40, 44, 45, 46, 48, 49, 50, 52, 53, 54, 56, 57, 58, 59, 60, 61, 62, 63, 64, 65, 67, 68, 70, 71, 72, 74, 75, 76, 77, 78, 79, 80, 81, 82, 83, 84, 85, 86, 87, 88, 89, 92, 93, 96, 97, 98, 99, 100, 101, 102, 103, 105, 107, 110, 112, 113, 114, 116, 117, 119, 120, 122, 123, 124, 125, 126, 127, 128, 130, 131, 133, 135, 137, 139, 140, 142, 143, 144, 145, 146, 147, 148, 149, 154, 155, 156, 157, 158, 161, 162, 163, 164, 167, 170, 171, 177, 178, 180, 181, 182, 185, 186, 189, 191, 193, 194, 195, 196, 197, 198, 199]"
Olaf,L0,middle,127,62,65,6,0.365,200,"[0, 1, 3, 4, 5, 6, 8, 9, 10, 11, 12, 13, 16, 18, 19, 20, 22, 25, 26, 27, 28, 30, 31, 32, 34, 35, 36, 37, 38, 41, 42, 44, 45, 48, 49, 50, 51, 53, 55, 57, 58, 59, 60, 61, 62, 63, 65, 68, 70, 75, 76, 77, 78, 79, 80, 82, 83, 85, 86, 87, 88, 89, 91, 93, 94, 97, 98, 99, 101, 102, 104, 105, 107, 108, 109, 112, 113, 114, 115, 118, 120, 123, 124, 125, 128, 129, 130, 132, 134, 137, 138, 140, 141, 142, 143, 147, 148, 150, 151, 156, 159, 161, 163, 164, 165, 167, 168, 170, 171, 172, 173, 177, 178, 180, 182, 184, 187, 188, 189, 190, 191, 192, 193, 194, 195, 196, 198]"
Olaf,L0,middle,127,75,52,3,0.365,200,"[0, 1, 2, 4, 5, 7, 8, 9, 10, 11, 14, 16, 17, 18, 19, 24, 26, 27, 28, 29, 31, 32, 34, 36, 39, 40, 41, 43, 44, 45, 46, 47, 49, 50, 51, 52, 54, 56, 57, 58, 60, 61, 62, 63, 64, 65, 67, 70, 74, 77, 78, 80, 82, 84, 87, 88, 91, 92, 94, 95, 97, 101, 102, 103, 104, 105, 106, 107, 110, 111, 112, 114, 115, 116, 118, 119, 120, 122, 123, 124, 125, 126, 127, 129, 130, 131, 133, 135, 136, 137, 138, 139, 141, 142, 143, 144, 151, 152, 154, 155, 157, 158, 159, 162, 163, 164, 165, 169, 170, 171, 175, 176, 178, 179, 181, 182, 183, 184, 186, 187, 190, 192, 193, 195, 196, 198, 199]"
Olaf,L0,middle,136,64,72,3,0.32,200,"[2, 4, 5, 6, 8, 9, 10, 11, 12, 13, 14, 15, 16, 17, 18, 20, 21, 23, 24, 25, 26, 27, 28, 29, 30, 32, 33, 34, 35, 36, 37, 38, 40, 41, 42, 44, 45, 46, 47, 49, 52, 53, 54, 55, 56, 57, 58, 59, 60, 61, 62, 63, 66, 67, 68, 72, 73, 74, 75, 76, 78, 79, 82, 84, 86, 87, 88, 90, 91, 92, 93, 94, 96, 97, 102, 104, 105, 106, 107, 109, 110, 111, 112, 113, 114, 115, 116, 117, 120, 122, 125, 127, 128, 130, 131, 132, 134, 135, 136, 138, 139, 140, 144, 145, 146, 148, 149, 150, 151, 152, 153, 154, 155, 156, 158, 159, 161, 162, 165, 167, 170, 171, 172, 174, 175, 178, 179, 180, 182, 183, 186, 187, 190, 192, 193, 195]"
Olaf,L0,middle,131,78,53,7,0.345,200,"[0, 3, 4, 6, 8, 9, 11, 12, 14, 15, 19, 20, 21, 22, 23, 24, 25, 26, 28, 30, 31, 33, 36, 37, 38, 42, 43, 44, 45, 46, 49, 50, 51, 53, 54, 56, 57, 59, 61, 62, 63, 64, 65, 70, 71, 72, 73, 74, 76, 77, 78, 79, 80, 81, 84, 85, 88, 89, 92, 95, 96, 97, 98, 102, 103, 105, 106, 107, 108, 109, 110, 111, 112, 113, 114, 116, 117, 118, 119, 120, 121, 122, 124, 125, 126, 128, 129, 130, 132, 133, 134, 135, 136, 137, 139, 140, 142, 143, 146, 147, 149, 151, 152, 153, 155, 159, 161, 162, 163, 166, 167, 169, 170, 174, 175, 177, 178, 179, 181, 183, 184, 186, 187, 188, 189, 190, 191, 192, 194, 197, 199]"
Olaf,L0,middle,132,68,64,6,0.34,200,"[0, 2, 4, 5, 7, 9, 11, 13, 16, 17, 20, 21, 22, 24, 25, 26, 27, 28, 29, 30, 31, 34, 35, 36, 38, 39, 41, 42, 47, 49, 51, 52, 53, 55, 57, 58, 63, 64, 65, 67, 69, 70, 71, 72, 73, 74, 76, 77, 78, 81, 82, 83, 84, 85, 86, 88, 89, 90, 91, 93, 94, 95, 96, 97, 98, 99, 102, 103, 105, 106, 108, 112, 113, 114, 115, 117, 120, 121, 122, 124, 125, 126, 127, 129, 130, 133, 135, 136, 138, 139, 140, 142, 144, 147, 149, 150, 151, 154, 156, 157, 158, 159, 162, 163, 165, 166, 167, 168, 169, 172, 173, 175, 176, 178, 179, 180, 181, 183, 184, 185, 186, 187, 188, 189, 190, 191, 193, 195, 196, 197, 198, 199]"
Olaf,L0,middle,129,70,59,3,0.355,200,"[0, 1, 2, 4, 7, 10, 12, 13, 16, 18, 19, 20, 21, 25, 28, 29, 30, 32, 33, 35, 36, 37, 38, 40, 41, 42, 45, 46, 47, 48, 49, 50, 51, 52, 53, 54, 55, 56, 57, 59, 64, 65, 66, 68, 69, 70, 71, 72, 74, 75, 78, 80, 81, 82, 83, 86, 87, 88, 90, 91, 92, 94, 96, 97, 98, 100, 103, 104, 105, 106, 107, 109, 110, 113, 115, 117, 119, 123, 124, 125, 126, 129, 130, 133, 134, 135, 138, 139, 144, 145, 146, 147, 150, 151, 152, 153, 154, 155, 158, 159, 160, 161, 163, 164, 168, 170, 171, 172, 175, 177, 178, 179, 180, 181, 182, 183, 184, 185, 189, 190, 191, 192, 193, 194, 195, 196, 197, 198, 199]"
Olaf,L0,middle,124,56,68,5,0.38,200,"[1, 2, 3, 4, 5, 7, 9, 11, 13, 15, 17, 20, 21, 22, 23, 26, 30, 34, 35, 38, 39, 40, 41, 42, 43, 47, 48, 49, 50, 54, 55, 57, 59, 61, 62, 64, 65, 66, 67, 70, 72, 73, 74, 77, 78, 80, 82, 83, 85, 87, 88, 90, 91, 94, 95, 96, 98, 99, 100, 101, 103, 104, 105, 106, 108, 109, 110, 111, 112, 115, 117, 118, 119, 120, 122, 123, 124, 125, 126, 128, 129, 131, 132, 134, 135, 136, 138, 139, 141, 142, 143, 145, 147, 148, 150, 151, 153, 156, 158, 162, 163, 164, 167, 168, 172, 173, 176, 177, 178, 179, 180, 182, 183, 184, 185, 186, 187, 188, 190, 193, 194, 195, 197, 198]"
Olaf,L0,middle,126,54,72,2,0.37,200,"[0, 2, 4, 6, 7, 11, 12, 13, 14, 15, 16, 17, 20, 21, 22, 24, 26, 27, 28, 29, 30, 34, 38, 40, 42, 43, 44, 46, 47, 48, 49, 54, 55, 56, 57, 58, 59, 60, 61, 64, 65, 66, 67, 68, 69, 70, 71, 72, 73, 74, 77, 80, 82, 83, 85, 87, 88, 89, 91, 92, 94, 96, 97, 98, 99, 100, 101, 102, 103, 105, 107, 108, 109, 111, 112, 113, 114, 116, 118, 119, 120, 123, 124, 125, 126, 127, 130, 131, 135, 136, 138, 139, 143, 144, 146, 147, 150, 153, 155, 156, 158, 159, 160, 163, 164, 165, 168, 169, 170, 171, 173, 175, 179, 180, 181, 184, 185, 188, 189, 191, 192, 194, 195, 196, 197, 199]"
Olaf,L0,middle,131,67,64,5,0.345,200,"[0, 3, 5, 6, 10, 11, 12, 13, 14, 15, 16, 17, 18, 21, 22, 24, 26, 27, 28, 31, 32, 33, 34, 35, 36, 37, 40, 41, 42, 46, 47, 48, 51, 52, 55, 56, 57, 59, 60, 62, 63, 64, 65, 67, 70, 72, 73, 76, 78, 80, 81, 83, 84, 85, 86, 87, 88, 89, 90, 92, 93, 96, 99, 101, 102, 103, 105, 107, 108, 109, 111, 113, 114, 115, 116, 118, 119, 122, 123, 124, 127, 129, 132, 135, 136, 137, 138, 140, 142, 143, 144, 146, 148, 150, 152, 153, 154, 155, 157, 158, 159, 160, 161, 164, 165, 166, 167, 168, 171, 172, 173, 174, 176, 177, 178, 179, 180, 181, 182, 183, 187, 188, 190, 192, 193, 194, 195, 196, 197, 198, 199]"
Olaf,L0,middle,136,74,62,3,0.32,200,"[0, 1, 2, 5, 7, 8, 9, 10, 11, 12, 13, 15, 16, 18, 19, 20, 21, 22, 24, 26, 27, 28, 29, 30, 31, 32, 33, 34, 35, 39, 41, 42, 43, 44, 46, 47, 48, 49, 50, 51, 52, 53, 54, 55, 60, 62, 65, 66, 67, 68, 69, 70, 72, 73, 74, 76, 77, 78, 79, 80, 81, 83, 84, 85, 86, 88, 89, 92, 93, 94, 95, 97, 98, 99, 102, 103, 105, 106, 107, 108, 110, 111, 116, 118, 119, 120, 122, 123, 124, 127, 128, 131, 134, 135, 136, 137, 140, 142, 143, 144, 145, 146, 147, 148, 149, 150, 153, 154, 155, 156, 157, 158, 159, 161, 162, 164, 165, 166, 172, 173, 176, 177, 178, 179, 180, 181, 182, 184, 185, 190, 192, 194, 196, 197, 198, 199]"
Olaf,L0,middle,124,73,51,11,0.38,200,"[1, 3, 4, 5, 6, 8, 9, 12, 13, 14, 15, 17, 18, 19, 22, 26, 28, 30, 32, 34, 35, 36, 37, 38, 39, 42, 43, 44, 45, 46, 47, 50, 51, 52, 54, 55, 56, 57, 58, 61, 62, 63, 65, 68, 70, 71, 73, 74, 75, 78, 82, 83, 84, 85, 87, 88, 91, 94, 95, 96, 97, 98, 99, 100, 101, 102, 106, 107, 108, 110, 113, 114, 115, 116, 118, 119, 120, 121, 122, 123, 124, 125, 126, 131, 133, 135, 136, 139, 140, 142, 144, 146, 148, 149, 150, 151, 152, 153, 155, 156, 158, 161, 162, 163, 167, 168, 169, 171, 172, 173, 174, 177, 180, 181, 184, 185, 187, 188, 190, 193, 194, 195, 196, 199]"
Olaf,L0,middle,135,80,55,3,0.325,200,"[0, 4, 7, 8, 9, 10, 13, 15, 16, 17, 20, 24, 26, 27, 28, 29, 30, 31, 33, 34, 36, 38, 39, 40, 41, 42, 44, 45, 47, 48, 49, 51, 52, 53, 54, 57, 58, 59, 60, 61, 62, 63, 64, 67, 68, 69, 71, 72, 73, 74, 76, 77, 79, 81, 82, 83, 85, 86, 88, 90, 91, 92, 95, 97, 98, 101, 102, 103, 104, 105, 106, 107, 108, 109, 110, 111, 114, 116, 117, 120, 121, 122, 123, 124, 126, 130, 131, 133, 134, 135, 137, 138, 139, 140, 141, 144, 145, 149, 150, 151, 152, 153, 155, 156, 157, 158, 159, 160, 161, 162, 165, 166, 167, 169, 170, 171, 172, 173, 175, 176, 177, 179, 180, 181, 183, 184, 185, 187, 189, 191, 194, 195, 196, 198, 199]"
Olaf,L0,middle,138,67,71,2,0.31,200,"[0, 1, 2, 3, 4, 5, 9, 10, 12, 14, 15, 16, 17, 18, 19, 20, 21, 22, 23, 24, 25, 29, 30, 34, 35, 36, 37, 38, 39, 40, 41, 43, 44, 45, 46, 47, 48, 51, 52, 53, 56, 59, 61, 63, 65, 66, 67, 68, 70, 71, 72, 73, 74, 75, 76, 77, 79, 80, 81, 84, 86, 87, 88, 90, 91, 92, 94, 95, 96, 97, 98, 99, 100, 101, 102, 104, 105, 107, 108, 110, 112, 113, 114, 115, 118, 119, 120, 121, 124, 125, 126, 128, 129, 130, 132, 133, 134, 136, 138, 141, 142, 143, 144, 145, 146, 148, 151, 152, 153, 154, 156, 157, 158, 159, 161, 162, 163, 164, 165, 167, 171, 175, 176, 178, 179, 181, 182, 184, 186, 187, 189, 190, 192, 193, 195, 197, 198, 199]"
Olaf,L0,middle,129,61,68,5,0.355,200,"[0, 2, 4, 6, 11, 12, 13, 15, 16, 17, 19, 21, 22, 24, 25, 26, 27, 29, 30, 31, 32, 33, 34, 35, 36, 37, 38, 40, 41, 44, 45, 46, 47, 48, 50, 52, 53, 55, 56, 57, 58, 60, 61, 63, 64, 66, 67, 68, 70, 72, 73, 74, 75, 76, 77, 78, 79, 80, 82, 83, 84, 85, 86, 87, 92, 94, 95, 96, 97, 98, 99, 100, 101, 103, 105, 106, 107, 108, 109, 110, 112, 113, 114, 117, 120, 123, 124, 125, 126, 127, 129, 130, 131, 132, 133, 135, 136, 139, 142, 143, 144, 150, 152, 153, 154, 155, 156, 157, 158, 159, 160, 163, 166, 167, 170, 171, 175, 178, 180, 182, 185, 187, 189, 191, 192, 193, 195, 196, 198]"
Olaf,L0,middle,136,60,76,6,0.32,200,"[0, 1, 2, 3, 4, 5, 7, 9, 10, 11, 15, 16, 18, 19, 20, 21, 22, 23, 24, 25, 26, 27, 28, 29, 31, 32, 33, 34, 35, 36, 37, 38, 39, 41, 42, 43, 45, 46, 47, 50, 51, 52, 53, 57, 58, 59, 61, 62, 63, 66, 67, 68, 69, 70, 72, 73, 74, 76, 77, 78, 79, 80, 81, 82, 83, 85, 86, 87, 90, 91, 92, 93, 95, 97, 99, 100, 101, 102, 104, 106, 107, 108, 113, 114, 115, 117, 118, 119, 120, 121, 122, 123, 124, 126, 127, 128, 130, 133, 134, 135, 136, 139, 141, 142, 143, 144, 145, 146, 149, 151, 153, 154, 156, 157, 159, 160, 163, 165, 166, 169, 170, 171, 174, 175, 176, 177, 179, 180, 181, 187, 188, 192, 193, 195, 196, 199]"
Olaf,L0,middle,140,72,68,2,0.3,200,"[0, 1, 2, 3, 4, 5, 6, 7, 8, 9, 14, 15, 19, 20, 21, 22, 23, 24, 25, 26, 29, 31, 34, 37, 38, 39, 40, 41, 42, 43, 45, 47, 49, 51, 52, 53, 54, 55, 56, 57, 59, 60, 61, 62, 64, 65, 66, 67, 71, 73, 74, 79, 80, 82, 83, 84, 85, 86, 87, 88, 89, 90, 92, 93, 94, 95, 98, 100, 103, 104, 106, 108, 110, 111, 113, 117, 118, 119, 121, 122, 123, 124, 125, 126, 127, 129, 130, 131, 132, 133, 134, 135, 136, 137, 138, 139, 141, 142, 143, 144, 146, 148, 149, 150, 151, 152, 154, 155, 157, 158, 159, 160, 161, 162, 163, 164, 166, 169, 170, 171, 172, 174, 176, 177, 178, 179, 181, 182, 183, 184, 185, 186, 187, 189, 190, 192, 193, 195, 196, 199]"
Olaf,L0,middle,128,58,70,2,0.36,200,"[2, 3, 5, 6, 7, 8, 9, 10, 11, 12, 13, 15, 17, 19, 20, 21, 22, 23, 24, 25, 28, 29, 30, 31, 32, 34, 38, 39, 40, 41, 42, 43, 44, 46, 47, 49, 50, 51, 53, 54, 55, 57, 59, 60, 63, 64, 66, 67, 69, 70, 71, 75, 77, 79, 80, 81, 82, 83, 84, 85, 86, 88, 89, 90, 91, 93, 94, 95, 96, 98, 99, 100, 101, 102, 105, 106, 110, 111, 112, 113, 117, 118, 120, 121, 123, 125, 126, 128, 129, 130, 131, 134, 137, 138, 140, 141, 142, 144, 145, 147, 149, 151, 154, 156, 158, 160, 163, 165, 166, 167, 169, 171, 172, 174, 175, 177, 179, 181, 182, 184, 186, 187, 188, 190, 191, 196, 197, 198]"
Olaf,L0,middle,141,81,60,8,0.295,200,"[0, 1, 2, 3, 5, 6, 7, 10, 12, 13, 16, 18, 22, 23, 24, 25, 26, 27, 28, 29, 30, 31, 32, 33, 34, 35, 36, 38, 39, 41, 42, 43, 44, 45, 46, 47, 48, 49, 50, 51, 53, 54, 55, 58, 59, 60, 61, 62, 63, 65, 67, 71, 72, 75, 76, 80, 81, 82, 83, 84, 85, 86, 88, 89, 91, 92, 93, 94, 96, 97, 98, 99, 100, 101, 102, 105, 107, 110, 111, 112, 114, 116, 117, 118, 120, 121, 123, 124, 125, 126, 127, 128, 129, 130, 131, 133, 134, 135, 136, 137, 138, 140, 142, 143, 144, 146, 148, 150, 151, 157, 159, 160, 161, 162, 163, 166, 167, 168, 169, 170, 171, 172, 173, 174, 176, 177, 178, 179, 180, 181, 182, 183, 186, 189, 190, 191, 192, 193, 194, 195, 196]"
Olaf,L0,middle,141,60,81,2,0.295,200,"[0, 1, 2, 3, 4, 6, 8, 9, 10, 11, 12, 16, 17, 19, 20, 21, 22, 23, 25, 28, 30, 34, 35, 37, 38, 39, 40, 42, 43, 44, 46, 47, 49, 52, 53, 54, 55, 56, 57, 58, 59, 60, 61, 63, 64, 65, 68, 69, 70, 72, 73, 75, 76, 78, 79, 80, 83, 84, 86, 87, 88, 91, 92, 93, 96, 99, 100, 103, 104, 105, 106, 108, 109, 110, 111, 113, 114, 115, 116, 117, 118, 119, 120, 121, 122, 123, 125, 126, 127, 128, 129, 130, 131, 135, 137, 138, 139, 141, 142, 143, 144, 145, 146, 148, 149, 151, 152, 153, 154, 155, 156, 158, 159, 160, 161, 162, 163, 164, 166, 167, 168, 169, 170, 171, 172, 173, 174, 176, 177, 178, 179, 181, 184, 186, 190, 192, 193, 195, 197, 198, 199]"
Olaf,L0,middle,134,69,65,6,0.33,200,"[0, 1, 3, 4, 5, 7, 8, 9, 10, 11, 12, 13, 14, 15, 16, 17, 19, 21, 22, 23, 24, 26, 29, 30, 35, 36, 38, 41, 44, 45, 46, 48, 51, 52, 53, 54, 57, 58, 59, 60, 61, 62, 63, 64, 66, 67, 69, 70, 72, 73, 74, 75, 77, 78, 79, 82, 83, 84, 86, 87, 88, 89, 90, 91, 92, 93, 94, 95, 96, 97, 98, 99, 101, 103, 104, 106, 108, 111, 112, 113, 114, 115, 116, 117, 118, 120, 121, 123, 124, 131, 133, 135, 136, 140, 141, 142, 143, 145, 146, 148, 150, 151, 152, 153, 155, 156, 157, 158, 159, 161, 162, 165, 166, 169, 171, 172, 173, 174, 177, 178, 179, 181, 182, 184, 185, 186, 187, 188, 190, 191, 195, 196, 198, 199]"
Olaf,L0,middle,122,71,51,6,0.39,200,"[2, 4, 5, 6, 7, 8, 9, 11, 12, 13, 15, 16, 17, 18, 20, 22, 24, 26, 27, 29, 31, 32, 34, 37, 41, 42, 43, 45, 46, 49, 50, 52, 53, 54, 55, 56, 57, 58, 61, 63, 64, 65, 67, 68, 69, 71, 72, 73, 74, 75, 76, 81, 84, 88, 90, 91, 92, 93, 94, 95, 96, 97, 99, 100, 102, 104, 105, 107, 109, 110, 111, 112, 116, 119, 120, 122, 125, 126, 129, 131, 132, 134, 135, 136, 139, 140, 141, 142, 143, 144, 145, 147, 148, 149, 152, 158, 160, 161, 162, 164, 165, 168, 171, 173, 174, 176, 177, 178, 179, 180, 181, 182, 184, 185, 188, 191, 192, 193, 194, 195, 196, 198]"
Olaf,L0,middle,129,72,57,0,0.355,200,"[1, 2, 6, 9, 11, 12, 13, 15, 16, 17, 19, 20, 21, 22, 23, 24, 26, 27, 28, 32, 33, 34, 36, 37, 39, 40, 47, 48, 49, 50, 51, 52, 54, 55, 58, 59, 60, 61, 63, 64, 67, 68, 70, 71, 73, 74, 75, 77, 78, 79, 82, 84, 87, 89, 90, 92, 94, 95, 97, 99, 100, 101, 102, 104, 105, 106, 108, 109, 110, 111, 114, 115, 116, 118, 121, 122, 123, 124, 126, 127, 128, 129, 130, 131, 132, 133, 134, 135, 136, 138, 141, 142, 143, 144, 145, 147, 149, 150, 151, 153, 154, 157, 158, 163, 166, 167, 170, 171, 173, 174, 176, 177, 178, 179, 180, 181, 182, 183, 185, 186, 187, 188, 189, 190, 191, 194, 196, 198, 199]"
Olaf,L0,middle,130,72,58,8,0.35,200,"[0, 1, 6, 8, 9, 11, 12, 13, 14, 15, 16, 20, 24, 25, 27, 28, 29, 30, 31, 32, 34, 35, 36, 38, 39, 40, 41, 42, 44, 45, 46, 47, 48, 51, 53, 55, 58, 59, 63, 64, 65, 66, 67, 69, 70, 72, 73, 74, 75, 76, 80, 82, 86, 87, 88, 89, 91, 93, 94, 95, 96, 97, 98, 99, 103, 104, 105, 106, 107, 109, 110, 112, 114, 115, 117, 119, 124, 125, 126, 127, 128, 129, 130, 131, 132, 135, 136, 137, 138, 139, 140, 141, 142, 144, 146, 147, 148, 150, 152, 154, 155, 157, 159, 160, 161, 163, 165, 166, 169, 170, 171, 173, 174, 177, 178, 179, 183, 185, 186, 187, 188, 189, 190, 191, 192, 194, 195, 196, 197, 198]"
Olaf,L0,middle,138,55,83,1,0.31,200,"[3, 4, 5, 7, 8, 9, 10, 13, 14, 17, 19, 20, 22, 23, 24, 25, 26, 27, 28, 30, 31, 32, 33, 35, 38, 40, 41, 42, 43, 44, 45, 46, 47, 48, 49, 50, 53, 55, 56, 57, 58, 60, 61, 65, 66, 67, 69, 70, 71, 72, 73, 74, 78, 81, 82, 83, 84, 85, 86, 88, 89, 91, 93, 95, 97, 98, 99, 100, 101, 103, 104, 105, 106, 107, 108, 110, 111, 112, 113, 114, 115, 117, 118, 122, 123, 125, 126, 127, 128, 129, 130, 131, 132, 133, 134, 135, 137, 138, 139, 141, 142, 143, 144, 145, 149, 151, 152, 153, 154, 156, 157, 158, 162, 163, 164, 165, 167, 169, 171, 172, 175, 176, 177, 179, 180, 181, 182, 184, 185, 186, 187, 189, 190, 191, 194, 195, 196, 198]"
Olaf,L0,middle,134,59,75,3,0.33,200,"[2, 3, 4, 5, 8, 9, 11, 14, 15, 16, 17, 18, 19, 20, 22, 23, 25, 26, 31, 32, 33, 34, 35, 38, 40, 46, 48, 49, 50, 51, 53, 54, 56, 57, 58, 59, 60, 61, 64, 65, 66, 67, 68, 69, 70, 71, 74, 75, 76, 77, 78, 80, 82, 83, 84, 87, 90, 91, 94, 95, 96, 97, 99, 100, 101, 105, 106, 107, 108, 110, 111, 112, 113, 114, 115, 117, 118, 119, 120, 121, 122, 123, 124, 125, 126, 127, 128, 129, 130, 131, 132, 133, 134, 135, 136, 137, 138, 139, 140, 141, 142, 144, 145, 148, 149, 151, 153, 154, 155, 159, 163, 164, 165, 166, 167, 170, 172, 174, 176, 178, 180, 181, 182, 183, 184, 186, 188, 189, 190, 191, 192, 194, 195, 199]"
Olaf,L0,middle,118,57,61,1,0.41,200,"[1, 2, 3, 4, 6, 7, 8, 9, 10, 11, 15, 17, 18, 19, 20, 23, 25, 28, 29, 31, 32, 33, 34, 36, 39, 40, 42, 44, 48, 51, 53, 55, 56, 57, 58, 60, 62, 63, 65, 66, 68, 72, 77, 79, 81, 82, 83, 84, 86, 87, 88, 93, 95, 96, 98, 99, 101, 103, 105, 106, 109, 110, 111, 116, 117, 118, 120, 121, 123, 124, 125, 126, 127, 128, 129, 131, 132, 135, 136, 137, 139, 140, 141, 142, 143, 144, 146, 151, 152, 153, 154, 155, 158, 161, 162, 163, 164, 165, 167, 168, 169, 171, 173, 174, 177, 178, 180, 182, 183, 184, 186, 187, 190, 191, 192, 196, 197, 199]"
Olaf,L0,middle,137,63,74,2,0.315,200,"[0, 1, 2, 3, 4, 5, 7, 8, 10, 11, 12, 15, 16, 17, 18, 20, 22, 24, 26, 27, 28, 29, 30, 33, 34, 35, 36, 37, 39, 40, 42, 43, 45, 46, 47, 48, 50, 52, 55, 57, 58, 59, 60, 61, 63, 64, 67, 68, 70, 71, 72, 73, 74, 76, 77, 78, 80, 82, 83, 84, 85, 86, 88, 89, 90, 91, 92, 93, 94, 95, 96, 98, 99, 101, 102, 103, 104, 105, 107, 110, 111, 112, 113, 115, 117, 121, 122, 123, 124, 125, 126, 127, 130, 132, 133, 134, 135, 136, 137, 138, 139, 140, 142, 144, 151, 152, 153, 155, 156, 158, 159, 160, 161, 162, 164, 165, 166, 167, 168, 169, 171, 173, 175, 177, 178, 180, 181, 184, 186, 189, 190, 192, 194, 195, 196, 198, 199]"
Olaf,L0,middle,137,82,55,5,0.315,200,"[0, 2, 3, 4, 5, 6, 7, 8, 12, 13, 15, 16, 18, 19, 20, 21, 23, 25, 26, 27, 29, 30, 31, 32, 33, 34, 35, 37, 38, 39, 41, 42, 44, 45, 47, 48, 49, 50, 51, 52, 53, 54, 56, 57, 60, 62, 63, 64, 65, 66, 68, 70, 71, 73, 75, 77, 79, 81, 82, 83, 84, 85, 86, 87, 88, 89, 91, 93, 94, 95, 96, 98, 99, 100, 101, 102, 104, 106, 107, 109, 110, 111, 113, 114, 115, 116, 117, 122, 125, 126, 128, 129, 131, 132, 134, 136, 137, 139, 140, 142, 143, 144, 145, 146, 147, 148, 150, 151, 158, 159, 160, 161, 162, 165, 166, 167, 168, 169, 170, 171, 173, 176, 178, 180, 181, 182, 186, 187, 189, 190, 191, 192, 193, 194, 195, 196, 198]"
Olaf,L0,middle,136,71,65,4,0.32,200,"[0, 1, 2, 3, 5, 6, 7, 9, 10, 11, 15, 18, 19, 20, 21, 22, 24, 26, 27, 28, 29, 30, 31, 32, 34, 35, 36, 37, 40, 41, 44, 45, 46, 49, 51, 52, 53, 54, 57, 59, 60, 61, 62, 64, 66, 67, 68, 69, 70, 71, 72, 73, 76, 77, 79, 84, 86, 87, 88, 89, 90, 91, 93, 94, 96, 97, 99, 100, 102, 103, 104, 107, 108, 109, 110, 114, 116, 117, 118, 122, 124, 126, 127, 128, 130, 131, 132, 133, 134, 135, 136, 137, 138, 139, 144, 146, 147, 148, 149, 150, 151, 152, 154, 155, 156, 157, 158, 159, 160, 161, 162, 164, 167, 169, 170, 171, 172, 173, 174, 175, 176, 179, 180, 181, 182, 185, 186, 187, 189, 190, 191, 193, 194, 196, 197, 198]"
Olaf,L0,middle,130,59,71,4,0.35,200,"[0, 1, 2, 3, 4, 6, 9, 10, 12, 13, 16, 17, 18, 20, 21, 22, 23, 24, 26, 27, 29, 30, 33, 34, 36, 37, 38, 39, 40, 43, 44, 45, 46, 49, 50, 54, 55, 57, 58, 59, 60, 61, 64, 65, 66, 67, 68, 69, 73, 74, 75, 76, 78, 79, 81, 84, 86, 87, 88, 90, 91, 92, 93, 94, 98, 99, 100, 102, 103, 104, 105, 107, 108, 109, 115, 116, 117, 120, 121, 122, 124, 126, 127, 128, 129, 131, 132, 133, 134, 135, 137, 139, 140, 141, 143, 144, 149, 150, 153, 154, 155, 156, 157, 159, 160, 161, 162, 164, 165, 166, 167, 168, 169, 171, 173, 174, 175, 176, 177, 179, 180, 184, 189, 190, 191, 192, 193, 194, 195, 199]"
Olaf,L0,middle,138,64,74,2,0.31,200,"[0, 1, 4, 5, 6, 7, 8, 9, 11, 13, 16, 19, 20, 21, 24, 27, 28, 29, 31, 32, 33, 34, 36, 37, 38, 40, 41, 43, 45, 46, 48, 50, 51, 52, 53, 56, 57, 58, 61, 62, 63, 65, 67, 68, 69, 70, 71, 72, 74, 75, 76, 78, 79, 80, 82, 83, 85, 86, 88, 89, 90, 92, 93, 94, 95, 96, 97, 98, 100, 101, 102, 103, 104, 105, 106, 107, 108, 110, 111, 112, 113, 114, 115, 116, 117, 118, 119, 121, 123, 124, 128, 129, 133, 134, 137, 138, 140, 141, 142, 143, 145, 147, 148, 150, 151, 152, 153, 154, 155, 156, 157, 158, 159, 161, 162, 164, 165, 167, 169, 170, 171, 174, 176, 177, 178, 179, 180, 184, 185, 186, 188, 189, 190, 191, 196, 197, 198, 199]"
Olaf,L0,middle,131,71,60,4,0.345,200,"[0, 1, 2, 5, 9, 10, 13, 14, 17, 19, 20, 21, 23, 24, 25, 27, 28, 29, 31, 32, 33, 34, 36, 37, 38, 40, 43, 45, 47, 48, 51, 52, 53, 54, 56, 58, 59, 62, 63, 68, 69, 70, 71, 73, 74, 75, 77, 78, 79, 80, 81, 83, 85, 86, 87, 88, 89, 90, 92, 93, 95, 96, 97, 99, 100, 101, 102, 104, 105, 107, 108, 110, 111, 113, 115, 117, 118, 120, 121, 123, 124, 125, 126, 127, 128, 130, 132, 133, 134, 135, 136, 138, 140, 141, 142, 144, 145, 146, 149, 150, 151, 152, 153, 154, 155, 157, 158, 159, 160, 161, 163, 165, 167, 169, 172, 174, 176, 177, 179, 183, 184, 185, 186, 187, 188, 190, 192, 193, 194, 197, 198]"
Olaf,L0,middle,130,48,82,4,0.35,200,"[2, 3, 5, 6, 7, 8, 9, 13, 14, 15, 17, 18, 19, 22, 24, 28, 30, 31, 33, 34, 35, 36, 37, 38, 39, 40, 41, 42, 43, 44, 45, 47, 48, 49, 50, 51, 52, 53, 55, 56, 58, 59, 61, 63, 64, 65, 66, 67, 68, 70, 72, 74, 75, 76, 77, 78, 79, 80, 86, 88, 90, 92, 93, 95, 96, 98, 99, 101, 102, 105, 107, 111, 112, 115, 118, 119, 122, 123, 124, 125, 128, 129, 131, 133, 134, 135, 136, 139, 142, 144, 145, 146, 147, 151, 153, 155, 156, 159, 160, 162, 164, 165, 166, 167, 168, 169, 170, 171, 173, 174, 175, 177, 178, 179, 181, 182, 183, 184, 186, 189, 190, 191, 192, 193, 194, 195, 196, 197, 198, 199]"
Olaf,L0,middle,148,63,85,2,0.26,200,"[0, 2, 3, 5, 6, 7, 8, 9, 11, 12, 13, 16, 17, 18, 19, 20, 21, 22, 23, 24, 25, 26, 27, 28, 29, 30, 32, 33, 34, 35, 36, 37, 39, 40, 41, 42, 44, 46, 47, 51, 53, 54, 55, 56, 58, 59, 61, 62, 63, 65, 66, 67, 69, 70, 71, 72, 74, 75, 76, 77, 78, 79, 80, 83, 84, 85, 87, 88, 89, 90, 91, 92, 93, 94, 95, 97, 98, 99, 100, 101, 102, 103, 105, 106, 107, 109, 110, 112, 113, 114, 115, 118, 119, 120, 121, 122, 123, 124, 127, 129, 130, 131, 132, 134, 137, 138, 141, 142, 146, 147, 148, 149, 151, 152, 153, 155, 156, 157, 159, 160, 161, 162, 164, 165, 166, 167, 168, 169, 170, 171, 172, 173, 174, 175, 176, 177, 178, 179, 180, 181, 182, 183, 187, 192, 194, 195, 196, 198]"
Olaf,L0,middle,131,64,67,2,0.345,200,"[0, 2, 3, 4, 7, 9, 10, 11, 12, 14, 15, 16, 17, 18, 20, 21, 23, 24, 25, 30, 32, 33, 35, 40, 42, 43, 45, 48, 49, 51, 53, 54, 56, 57, 58, 59, 64, 67, 69, 70, 71, 72, 73, 74, 77, 78, 79, 80, 82, 84, 85, 86, 87, 88, 89, 90, 92, 96, 97, 98, 100, 101, 102, 103, 104, 106, 107, 108, 109, 110, 111, 114, 115, 116, 117, 118, 119, 120, 121, 122, 123, 124, 125, 126, 129, 130, 132, 135, 136, 137, 139, 141, 142, 147, 149, 150, 151, 152, 153, 154, 155, 156, 157, 159, 161, 162, 163, 164, 165, 166, 167, 169, 171, 173, 174, 175, 176, 178, 179, 182, 183, 184, 185, 186, 187, 189, 192, 193, 196, 198, 199]"
Olaf,L0,middle,133,71,62,0,0.335,200,"[0, 2, 3, 4, 5, 6, 8, 9, 10, 11, 13, 16, 17, 19, 21, 22, 24, 26, 28, 29, 30, 32, 33, 34, 35, 36, 37, 39, 41, 42, 43, 44, 45, 46, 47, 48, 51, 52, 53, 54, 55, 57, 58, 59, 61, 63, 65, 66, 67, 70, 71, 72, 73, 75, 76, 77, 78, 79, 82, 83, 85, 86, 87, 88, 89, 91, 92, 93, 96, 97, 98, 99, 100, 101, 102, 105, 106, 108, 109, 110, 112, 113, 114, 115, 116, 117, 118, 121, 123, 124, 125, 126, 127, 129, 131, 133, 134, 135, 138, 139, 141, 144, 146, 150, 152, 154, 155, 157, 158, 161, 162, 165, 167, 169, 170, 173, 174, 175, 178, 179, 181, 182, 183, 184, 185, 186, 190, 191, 195, 196, 197, 198, 199]"
Olaf,L0,middle,139,61,78,8,0.305,200,"[0, 1, 2, 4, 5, 6, 7, 8, 10, 12, 13, 14, 15, 17, 18, 20, 21, 22, 24, 25, 26, 27, 30, 32, 35, 38, 39, 40, 42, 43, 44, 45, 46, 47, 48, 49, 50, 51, 52, 53, 55, 56, 57, 58, 59, 61, 63, 65, 66, 67, 68, 69, 72, 73, 74, 75, 76, 77, 78, 80, 82, 83, 84, 85, 86, 88, 89, 90, 93, 95, 96, 97, 100, 102, 104, 105, 106, 108, 109, 110, 111, 113, 114, 116, 117, 118, 119, 120, 121, 122, 123, 124, 125, 126, 127, 130, 131, 134, 135, 138, 139, 141, 142, 147, 148, 149, 150, 151, 154, 155, 156, 158, 159, 160, 161, 165, 166, 167, 168, 169, 170, 171, 172, 173, 174, 175, 176, 177, 178, 179, 180, 184, 186, 189, 191, 195, 196, 197, 199]"
Olaf,L0,middle,136,67,69,2,0.32,200,"[0, 2, 3, 4, 5, 6, 7, 8, 9, 12, 13, 14, 15, 16, 17, 18, 19, 20, 21, 22, 23, 25, 26, 27, 28, 29, 30, 33, 34, 35, 37, 39, 40, 41, 43, 45, 48, 51, 52, 53, 54, 55, 56, 57, 58, 59, 60, 61, 63, 65, 66, 67, 72, 73, 75, 77, 78, 79, 82, 83, 84, 85, 86, 87, 88, 90, 92, 93, 94, 96, 97, 98, 100, 101, 102, 104, 105, 106, 110, 111, 113, 114, 118, 119, 121, 122, 123, 124, 126, 128, 132, 133, 134, 136, 137, 141, 142, 143, 144, 145, 146, 150, 152, 153, 154, 155, 156, 157, 159, 160, 162, 163, 164, 165, 166, 167, 168, 169, 173, 174, 175, 176, 177, 180, 182, 184, 186, 187, 188, 189, 191, 192, 193, 195, 196, 198]"
Olaf,L0,middle,140,55,85,1,0.3,200,"[0, 1, 2, 3, 4, 5, 6, 9, 10, 11, 12, 13, 14, 15, 16, 17, 18, 19, 20, 22, 23, 24, 27, 28, 29, 31, 32, 33, 34, 35, 36, 38, 39, 41, 42, 43, 45, 48, 50, 51, 52, 53, 54, 55, 56, 59, 60, 61, 62, 64, 65, 66, 67, 69, 70, 71, 72, 74, 76, 78, 79, 80, 81, 82, 85, 86, 87, 89, 90, 91, 92, 93, 96, 97, 98, 100, 101, 103, 104, 105, 106, 108, 111, 112, 113, 116, 117, 118, 119, 120, 121, 122, 124, 127, 130, 131, 134, 135, 136, 137, 139, 142, 143, 144, 145, 146, 147, 148, 152, 153, 154, 156, 158, 159, 160, 161, 162, 163, 166, 169, 170, 172, 173, 174, 175, 176, 177, 178, 179, 180, 181, 182, 184, 188, 190, 193, 195, 196, 197, 199]"
Olaf,L0,middle,141,59,82,3,0.295,200,"[1, 2, 3, 4, 6, 7, 9, 10, 12, 14, 15, 16, 18, 19, 20, 23, 27, 29, 30, 32, 34, 35, 36, 37, 39, 40, 41, 42, 45, 46, 47, 48, 49, 50, 52, 53, 54, 55, 56, 57, 59, 60, 61, 63, 64, 65, 66, 67, 68, 69, 70, 71, 74, 75, 77, 78, 79, 81, 85, 86, 87, 88, 89, 91, 93, 94, 96, 97, 98, 100, 101, 102, 103, 104, 105, 106, 107, 109, 110, 113, 114, 115, 116, 117, 118, 119, 120, 121, 123, 124, 125, 126, 127, 129, 130, 132, 133, 134, 137, 138, 139, 140, 142, 143, 144, 145, 146, 148, 149, 150, 151, 152, 153, 155, 156, 157, 158, 159, 160, 161, 163, 164, 165, 167, 169, 171, 174, 175, 177, 178, 179, 182, 185, 187, 188, 189, 191, 192, 195, 196, 199]"
Olaf,L0,middle,126,52,74,4,0.37,200,"[0, 1, 2, 3, 4, 5, 8, 9, 10, 13, 14, 16, 20, 21, 25, 26, 27, 28, 29, 32, 33, 34, 35, 37, 38, 39, 41, 45, 46, 47, 49, 53, 54, 55, 56, 57, 61, 62, 64, 65, 66, 67, 68, 69, 72, 74, 75, 80, 82, 83, 85, 88, 89, 90, 91, 92, 94, 95, 96, 98, 99, 101, 102, 106, 107, 109, 111, 114, 115, 118, 120, 121, 122, 123, 125, 126, 127, 128, 129, 130, 131, 133, 134, 135, 139, 140, 141, 142, 146, 147, 153, 155, 156, 157, 159, 161, 162, 163, 165, 166, 167, 168, 170, 172, 173, 175, 176, 179, 181, 182, 183, 184, 185, 186, 187, 188, 189, 190, 192, 193, 194, 195, 196, 197, 198, 199]"
Olaf,L0,middle,142,76,66,2,0.29,200,"[1, 3, 5, 6, 11, 12, 15, 16, 19, 20, 21, 22, 23, 25, 26, 29, 31, 32, 33, 34, 35, 36, 39, 40, 42, 43, 44, 45, 47, 49, 51, 52, 53, 54, 55, 56, 57, 58, 59, 60, 61, 62, 65, 66, 69, 71, 72, 73, 74, 75, 76, 77, 78, 80, 81, 83, 84, 86, 87, 88, 89, 90, 91, 92, 93, 94, 95, 96, 97, 98, 99, 100, 101, 102, 103, 105, 106, 108, 110, 112, 114, 115, 118, 119, 120, 121, 122, 124, 125, 127, 128, 133, 134, 135, 137, 138, 139, 142, 143, 144, 145, 146, 147, 149, 151, 152, 154, 156, 157, 159, 160, 161, 162, 164, 165, 168, 169, 170, 172, 173, 174, 177, 178, 179, 180, 181, 182, 183, 185, 186, 187, 188, 189, 190, 191, 193, 194, 195, 196, 197, 198, 199]"
Olaf,L0,middle,141,77,64,1,0.295,200,"[1, 2, 3, 5, 6, 8, 10, 11, 12, 14, 15, 16, 18, 19, 20, 22, 23, 24, 25, 29, 30, 31, 32, 34, 35, 36, 38, 39, 40, 41, 42, 43, 44, 45, 46, 48, 50, 51, 52, 54, 56, 57, 59, 60, 61, 62, 63, 64, 67, 71, 72, 73, 74, 75, 76, 77, 80, 81, 82, 84, 85, 86, 87, 88, 89, 91, 93, 94, 97, 98, 99, 100, 101, 102, 103, 104, 105, 106, 107, 108, 110, 111, 112, 113, 114, 116, 118, 123, 124, 127, 128, 131, 133, 134, 136, 138, 139, 140, 143, 145, 146, 147, 148, 149, 150, 151, 152, 153, 154, 157, 158, 159, 160, 161, 162, 163, 164, 165, 166, 167, 168, 169, 171, 172, 173, 174, 176, 177, 178, 179, 182, 183, 185, 186, 187, 189, 194, 195, 196, 198, 199]"
Olaf,L0,middle,133,68,65,3,0.335,200,"[1, 2, 3, 4, 6, 7, 8, 10, 12, 14, 15, 18, 19, 20, 21, 25, 26, 27, 29, 30, 31, 32, 33, 34, 35, 36, 38, 39, 40, 41, 42, 43, 46, 47, 48, 49, 50, 56, 57, 58, 59, 61, 62, 65, 67, 68, 69, 71, 72, 78, 79, 80, 83, 85, 86, 87, 88, 89, 90, 91, 92, 96, 97, 98, 99, 100, 102, 104, 106, 107, 108, 111, 112, 113, 114, 115, 117, 119, 120, 121, 122, 123, 126, 127, 130, 131, 132, 133, 134, 135, 136, 138, 140, 141, 143, 145, 146, 148, 149, 151, 152, 155, 156, 157, 158, 159, 161, 163, 165, 166, 170, 171, 172, 173, 175, 179, 180, 181, 183, 184, 185, 186, 187, 188, 189, 190, 191, 192, 193, 194, 195, 196, 198]"
Olaf,L0,middle,140,84,56,6,0.3,200,"[0, 2, 3, 5, 7, 9, 11, 12, 13, 14, 15, 16, 17, 18, 19, 20, 24, 25, 26, 27, 28, 29, 30, 35, 38, 40, 41, 42, 43, 44, 45, 48, 49, 50, 51, 53, 54, 55, 56, 57, 58, 59, 60, 61, 62, 64, 65, 66, 68, 71, 72, 73, 75, 76, 77, 79, 80, 82, 83, 85, 87, 89, 90, 92, 93, 94, 95, 96, 98, 100, 101, 102, 104, 105, 106, 107, 109, 110, 111, 112, 113, 114, 115, 118, 119, 121, 122, 124, 125, 126, 127, 128, 129, 130, 131, 132, 133, 134, 135, 136, 137, 138, 140, 142, 143, 144, 147, 148, 150, 151, 153, 154, 155, 156, 158, 159, 163, 164, 166, 167, 169, 170, 171, 175, 176, 178, 181, 183, 184, 185, 187, 188, 189, 191, 192, 194, 195, 196, 197, 198]"
Olaf,L0,middle,131,86,45,2,0.345,200,"[1, 2, 3, 4, 6, 10, 11, 12, 14, 15, 19, 22, 23, 25, 26, 27, 28, 30, 31, 33, 34, 35, 37, 38, 39, 41, 42, 43, 44, 45, 46, 47, 48, 50, 52, 53, 58, 60, 61, 63, 64, 65, 66, 68, 69, 72, 74, 76, 78, 79, 81, 84, 85, 86, 87, 93, 94, 96, 97, 99, 100, 101, 102, 104, 105, 106, 107, 108, 109, 110, 111, 112, 113, 114, 115, 120, 121, 122, 123, 124, 127, 128, 130, 131, 133, 135, 136, 137, 138, 140, 142, 143, 145, 146, 148, 150, 151, 153, 155, 156, 157, 158, 159, 160, 161, 162, 163, 164, 165, 166, 167, 168, 169, 171, 173, 176, 177, 178, 180, 181, 182, 184, 185, 186, 187, 188, 189, 191, 192, 194, 198]"
Olaf,L0,middle,137,62,75,5,0.315,200,"[2, 3, 6, 7, 9, 10, 11, 12, 14, 15, 17, 18, 21, 23, 24, 25, 26, 27, 28, 29, 31, 33, 34, 35, 36, 38, 39, 40, 41, 44, 47, 48, 49, 50, 51, 52, 53, 54, 55, 56, 57, 58, 61, 64, 65, 67, 68, 69, 70, 72, 73, 78, 80, 81, 82, 83, 87, 88, 90, 92, 94, 100, 101, 102, 104, 106, 107, 108, 109, 111, 112, 113, 115, 116, 117, 118, 119, 120, 123, 124, 125, 126, 127, 129, 130, 132, 133, 138, 139, 140, 141, 142, 144, 145, 146, 147, 149, 150, 152, 153, 154, 155, 156, 157, 158, 159, 160, 161, 162, 163, 164, 166, 168, 169, 170, 173, 174, 175, 177, 178, 179, 180, 181, 183, 184, 185, 187, 188, 189, 190, 191, 193, 194, 195, 197, 198, 199]"
Olaf,L0,middle,140,90,50,4,0.3,200,"[1, 2, 3, 5, 6, 8, 9, 10, 11, 13, 14, 15, 17, 18, 19, 20, 23, 24, 26, 27, 29, 30, 31, 32, 33, 34, 37, 38, 40, 41, 43, 44, 45, 46, 47, 48, 49, 50, 51, 52, 53, 54, 55, 56, 57, 62, 65, 66, 67, 68, 69, 70, 71, 73, 79, 80, 81, 82, 83, 84, 85, 88, 89, 92, 94, 95, 97, 99, 100, 101, 103, 104, 105, 107, 108, 109, 110, 111, 112, 115, 117, 119, 121, 123, 125, 126, 127, 128, 130, 131, 132, 134, 135, 136, 137, 138, 141, 142, 143, 144, 145, 146, 147, 148, 149, 150, 151, 152, 153, 154, 155, 158, 159, 161, 162, 163, 164, 167, 168, 170, 171, 172, 173, 175, 176, 177, 179, 180, 181, 183, 184, 188, 189, 190, 191, 192, 193, 194, 197, 198]"
Olaf,L0,middle,138,72,66,3,0.31,200,"[0, 1, 2, 3, 4, 5, 6, 8, 9, 12, 13, 14, 18, 19, 21, 22, 27, 28, 31, 32, 33, 34, 35, 36, 37, 38, 39, 40, 41, 42, 44, 45, 47, 48, 49, 50, 51, 52, 54, 55, 57, 58, 59, 60, 61, 62, 63, 64, 65, 68, 70, 71, 74, 75, 78, 81, 82, 84, 86, 88, 90, 91, 92, 93, 94, 95, 96, 97, 98, 99, 100, 102, 103, 104, 105, 106, 108, 109, 110, 112, 113, 115, 117, 119, 121, 122, 123, 124, 125, 126, 127, 128, 132, 134, 136, 137, 138, 140, 141, 142, 143, 147, 148, 149, 151, 153, 154, 155, 156, 157, 158, 161, 163, 164, 166, 169, 172, 174, 175, 176, 177, 180, 181, 182, 183, 185, 187, 188, 189, 190, 191, 192, 194, 195, 196, 197, 198, 199]"
Olaf,L0,middle,128,59,69,8,0.36,200,"[0, 1, 2, 3, 4, 8, 10, 12, 15, 16, 17, 20, 21, 22, 23, 24, 25, 26, 27, 29, 32, 33, 34, 35, 36, 37, 38, 40, 42, 43, 44, 45, 46, 48, 49, 51, 54, 55, 56, 58, 59, 60, 61, 62, 63, 64, 67, 68, 70, 71, 72, 73, 74, 76, 77, 79, 83, 84, 85, 86, 87, 90, 92, 93, 94, 97, 100, 101, 102, 103, 104, 105, 106, 108, 109, 111, 113, 116, 117, 118, 120, 122, 123, 124, 125, 126, 128, 129, 130, 131, 132, 136, 137, 140, 144, 145, 146, 149, 153, 156, 158, 159, 161, 162, 163, 164, 166, 167, 168, 169, 170, 172, 173, 174, 175, 178, 180, 181, 182, 184, 187, 189, 190, 192, 193, 194, 196, 198]"
Olaf,L0,middle,134,81,53,6,0.33,200,"[0, 1, 2, 7, 8, 9, 10, 12, 13, 17, 18, 19, 20, 21, 22, 23, 24, 25, 26, 27, 28, 29, 32, 33, 34, 36, 37, 39, 40, 41, 44, 45, 47, 48, 50, 51, 52, 53, 54, 55, 57, 59, 60, 62, 63, 64, 65, 66, 67, 68, 69, 70, 74, 75, 78, 79, 81, 82, 83, 84, 85, 86, 93, 94, 95, 96, 97, 98, 99, 100, 101, 103, 105, 110, 111, 112, 113, 115, 117, 118, 119, 120, 122, 123, 124, 125, 126, 127, 128, 129, 131, 135, 137, 138, 139, 140, 144, 145, 146, 147, 149, 150, 151, 152, 154, 155, 156, 158, 160, 162, 165, 166, 167, 168, 170, 172, 173, 174, 175, 177, 178, 179, 180, 181, 184, 185, 187, 188, 189, 192, 193, 194, 195, 198]"
Olaf,L0,middle,122,72,50,3,0.39,200,"[0, 2, 3, 7, 8, 9, 12, 13, 15, 16, 19, 20, 23, 24, 25, 28, 29, 31, 32, 34, 35, 37, 38, 39, 40, 41, 43, 44, 45, 46, 47, 49, 50, 51, 54, 55, 56, 58, 59, 60, 63, 64, 65, 66, 67, 70, 71, 72, 73, 74, 75, 77, 79, 80, 82, 88, 89, 90, 91, 92, 96, 97, 100, 101, 102, 104, 105, 108, 110, 112, 115, 116, 117, 118, 120, 122, 126, 130, 132, 133, 134, 138, 140, 143, 145, 146, 149, 153, 154, 155, 156, 159, 161, 162, 163, 164, 165, 166, 167, 168, 169, 171, 172, 173, 178, 180, 181, 182, 184, 186, 187, 188, 189, 190, 191, 192, 193, 194, 195, 196, 198, 199]"
Olaf,L0,middle,129,58,71,3,0.355,200,"[0, 2, 4, 5, 7, 9, 10, 12, 14, 15, 16, 17, 18, 19, 21, 22, 23, 24, 25, 26, 30, 31, 32, 33, 36, 37, 39, 40, 41, 42, 43, 44, 46, 47, 48, 51, 55, 57, 58, 60, 61, 63, 64, 65, 66, 67, 69, 70, 75, 79, 81, 82, 83, 84, 86, 87, 88, 89, 91, 92, 93, 96, 97, 98, 99, 101, 102, 104, 105, 107, 108, 110, 111, 113, 114, 115, 117, 118, 119, 122, 123, 125, 126, 127, 130, 131, 132, 133, 136, 137, 138, 139, 142, 144, 145, 147, 150, 153, 154, 155, 156, 157, 158, 160, 162, 163, 164, 165, 167, 169, 170, 171, 173, 174, 175, 176, 178, 179, 180, 181, 182, 183, 185, 188, 190, 192, 196, 197, 199]"
Olaf,L0,middle,133,73,60,1,0.335,200,"[0, 4, 5, 6, 9, 10, 11, 13, 14, 15, 16, 18, 19, 20, 22, 23, 24, 26, 28, 30, 33, 34, 35, 36, 37, 38, 40, 41, 42, 43, 45, 47, 49, 50, 51, 52, 54, 57, 58, 59, 60, 61, 62, 64, 65, 66, 75, 76, 77, 78, 80, 81, 82, 83, 84, 87, 88, 90, 91, 95, 96, 97, 98, 100, 101, 102, 103, 105, 106, 110, 111, 113, 114, 115, 116, 117, 118, 119, 122, 124, 125, 127, 130, 135, 136, 138, 139, 140, 141, 144, 145, 146, 148, 150, 153, 154, 155, 156, 157, 158, 159, 160, 161, 162, 163, 165, 166, 168, 169, 170, 172, 173, 174, 175, 176, 177, 178, 179, 180, 181, 182, 184, 186, 188, 189, 190, 191, 192, 193, 194, 195, 196, 199]"
Olaf,L50,middle,137,74,63,5,0.315,200,"[0, 1, 2, 3, 5, 7, 10, 11, 12, 14, 16, 17, 18, 19, 20, 22, 23, 24, 25, 27, 29, 30, 31, 32, 34, 35, 37, 38, 42, 44, 45, 50, 51, 52, 53, 55, 60, 61, 62, 63, 64, 65, 67, 68, 69, 70, 72, 74, 75, 76, 78, 79, 80, 81, 82, 86, 88, 89, 90, 91, 92, 93, 94, 96, 97, 98, 103, 104, 105, 107, 109, 110, 112, 114, 115, 117, 118, 119, 120, 121, 122, 123, 124, 128, 132, 133, 135, 137, 138, 139, 141, 142, 143, 144, 146, 148, 149, 150, 152, 153, 155, 156, 158, 159, 160, 161, 162, 163, 164, 165, 166, 167, 168, 169, 170, 171, 172, 175, 176, 177, 179, 180, 181, 182, 183, 185, 186, 187, 189, 190, 192, 193, 195, 196, 197, 198, 199]"
Olaf,L50,middle,144,68,76,3,0.28,200,"[0, 3, 4, 5, 6, 7, 8, 9, 10, 11, 12, 14, 15, 16, 17, 18, 19, 20, 21, 22, 23, 26, 27, 28, 29, 30, 32, 33, 34, 35, 37, 39, 40, 41, 42, 43, 44, 46, 47, 50, 51, 53, 54, 55, 56, 57, 59, 61, 63, 64, 65, 66, 67, 69, 70, 71, 72, 73, 74, 75, 76, 77, 78, 79, 80, 81, 83, 85, 88, 90, 92, 93, 95, 96, 97, 98, 100, 101, 102, 105, 106, 107, 108, 110, 111, 112, 113, 115, 116, 117, 118, 121, 123, 124, 125, 126, 129, 131, 132, 133, 134, 136, 137, 138, 139, 140, 141, 144, 145, 146, 148, 149, 152, 153, 154, 157, 158, 161, 162, 163, 164, 165, 166, 169, 170, 171, 174, 176, 178, 179, 180, 181, 183, 184, 186, 187, 188, 189, 190, 191, 193, 194, 198, 199]"
Olaf,L50,middle,141,81,60,4,0.295,200,"[0, 1, 2, 4, 5, 6, 7, 8, 12, 13, 14, 15, 16, 17, 19, 20, 21, 22, 23, 25, 26, 27, 28, 29, 32, 33, 34, 37, 38, 41, 43, 44, 47, 48, 49, 50, 52, 53, 54, 55, 58, 59, 60, 62, 63, 64, 66, 69, 70, 73, 74, 75, 76, 77, 78, 79, 80, 82, 83, 84, 85, 86, 87, 90, 91, 92, 93, 94, 96, 98, 99, 100, 102, 104, 105, 106, 107, 108, 109, 110, 113, 114, 117, 118, 120, 121, 122, 123, 125, 126, 127, 128, 129, 130, 132, 133, 134, 135, 136, 138, 140, 141, 144, 145, 147, 148, 150, 151, 153, 155, 156, 157, 158, 159, 160, 164, 165, 166, 167, 168, 170, 171, 172, 174, 175, 176, 179, 180, 181, 182, 183, 185, 188, 190, 191, 192, 193, 194, 196, 197, 199]"
Olaf,L50,middle,136,72,64,5,0.32,200,"[1, 2, 3, 7, 8, 10, 11, 13, 16, 17, 18, 19, 22, 26, 29, 30, 31, 35, 36, 38, 39, 41, 42, 44, 45, 47, 50, 52, 55, 56, 57, 58, 60, 61, 64, 65, 66, 70, 74, 75, 76, 77, 78, 81, 82, 83, 84, 85, 86, 88, 89, 91, 92, 94, 95, 96, 98, 99, 100, 101, 102, 103, 104, 106, 107, 108, 109, 110, 111, 112, 113, 115, 116, 117, 118, 119, 120, 121, 122, 123, 124, 126, 127, 128, 129, 130, 131, 134, 135, 136, 137, 140, 142, 145, 146, 147, 148, 149, 151, 152, 153, 155, 156, 157, 158, 159, 160, 162, 164, 166, 168, 169, 170, 171, 172, 173, 174, 175, 178, 179, 180, 182, 183, 184, 185, 186, 188, 189, 191, 192, 194, 195, 196, 197, 198, 199]"
Olaf,L50,middle,130,69,61,3,0.35,200,"[0, 3, 4, 5, 7, 8, 9, 11, 12, 13, 16, 18, 19, 20, 21, 22, 23, 24, 26, 27, 31, 33, 34, 35, 36, 38, 39, 40, 42, 43, 44, 45, 47, 49, 50, 52, 53, 54, 55, 56, 57, 60, 62, 63, 65, 67, 69, 71, 73, 74, 78, 79, 80, 81, 83, 86, 87, 90, 94, 95, 96, 97, 99, 100, 102, 103, 106, 107, 108, 110, 111, 113, 114, 115, 116, 120, 124, 125, 126, 127, 131, 135, 137, 138, 139, 141, 142, 143, 145, 146, 148, 149, 151, 152, 153, 154, 155, 157, 158, 159, 161, 162, 163, 164, 165, 166, 167, 168, 169, 171, 172, 173, 174, 175, 177, 178, 179, 180, 182, 183, 186, 187, 189, 190, 192, 195, 196, 197, 198, 199]"
Olaf,L50,middle,148,76,72,2,0.26,200,"[1, 2, 3, 4, 5, 9, 10, 11, 12, 13, 14, 15, 17, 18, 20, 21, 22, 23, 25, 26, 28, 29, 30, 32, 33, 34, 35, 36, 37, 40, 41, 42, 44, 46, 47, 48, 49, 52, 53, 54, 55, 57, 58, 59, 60, 61, 62, 66, 67, 68, 70, 71, 73, 75, 76, 77, 78, 79, 80, 81, 82, 83, 88, 89, 90, 91, 92, 94, 95, 96, 97, 99, 100, 101, 102, 103, 104, 105, 107, 109, 110, 111, 114, 115, 116, 119, 120, 121, 122, 124, 125, 126, 127, 128, 129, 130, 131, 132, 133, 134, 135, 136, 138, 139, 140, 141, 142, 143, 144, 147, 149, 150, 151, 152, 156, 158, 159, 160, 161, 162, 163, 165, 166, 167, 168, 169, 170, 171, 172, 173, 174, 175, 176, 177, 178, 179, 180, 181, 182, 183, 184, 188, 189, 190, 191, 193, 196, 198]"
Olaf,L50,middle,139,73,66,9,0.305,200,"[3, 4, 5, 6, 7, 8, 9, 10, 11, 12, 17, 18, 21, 22, 23, 24, 26, 28, 29, 30, 31, 32, 33, 34, 36, 37, 38, 40, 41, 42, 43, 46, 47, 48, 49, 50, 51, 53, 54, 58, 59, 60, 62, 63, 65, 66, 67, 68, 69, 72, 73, 74, 75, 77, 79, 81, 82, 83, 84, 85, 87, 88, 89, 90, 91, 92, 93, 94, 96, 97, 98, 99, 100, 102, 103, 105, 109, 113, 114, 115, 116, 118, 119, 120, 121, 123, 126, 127, 128, 129, 130, 131, 133, 134, 136, 137, 138, 142, 143, 148, 149, 151, 152, 153, 155, 156, 157, 158, 159, 160, 163, 164, 165, 168, 170, 171, 172, 173, 175, 176, 178, 179, 181, 182, 183, 185, 186, 187, 188, 189, 190, 191, 193, 194, 195, 196, 197, 198, 199]"
Olaf,L50,middle,131,69,62,4,0.345,200,"[1, 3, 4, 5, 6, 7, 8, 9, 12, 13, 14, 16, 17, 20, 21, 22, 23, 24, 25, 27, 28, 30, 31, 33, 35, 36, 37, 38, 39, 40, 41, 45, 46, 47, 48, 50, 54, 55, 56, 58, 59, 61, 62, 67, 68, 69, 70, 71, 72, 80, 81, 83, 86, 89, 91, 92, 93, 94, 95, 96, 97, 98, 99, 100, 101, 102, 103, 104, 105, 106, 108, 109, 110, 111, 115, 116, 117, 118, 120, 121, 122, 124, 126, 127, 128, 129, 130, 131, 136, 137, 139, 140, 143, 144, 145, 146, 147, 148, 150, 151, 152, 153, 154, 155, 156, 158, 160, 162, 163, 165, 167, 168, 169, 171, 172, 173, 174, 175, 177, 179, 181, 184, 185, 188, 190, 191, 193, 195, 196, 198, 199]"
Olaf,L50,middle,136,68,68,2,0.32,200,"[1, 3, 4, 5, 6, 8, 9, 11, 12, 13, 15, 16, 17, 21, 22, 23, 24, 25, 26, 27, 29, 30, 31, 32, 33, 35, 36, 39, 42, 43, 44, 45, 46, 48, 49, 50, 53, 54, 56, 58, 59, 60, 61, 62, 63, 64, 65, 67, 69, 70, 71, 72, 73, 75, 76, 78, 79, 80, 83, 85, 87, 88, 90, 91, 92, 93, 95, 96, 97, 98, 100, 102, 104, 112, 114, 115, 117, 119, 120, 121, 122, 123, 125, 126, 127, 130, 131, 132, 133, 135, 136, 137, 138, 140, 141, 142, 144, 145, 149, 151, 152, 153, 154, 155, 156, 158, 159, 160, 161, 162, 163, 165, 166, 167, 168, 169, 170, 174, 175, 176, 177, 178, 180, 181, 182, 183, 184, 186, 187, 188, 190, 193, 194, 197, 198, 199]"
Olaf,L50,middle,129,57,72,10,0.355,200,"[1, 2, 3, 5, 6, 7, 10, 11, 12, 15, 16, 17, 18, 19, 20, 22, 23, 24, 25, 26, 27, 28, 30, 33, 34, 35, 36, 37, 39, 41, 42, 46, 47, 52, 53, 54, 55, 57, 58, 60, 62, 63, 64, 65, 67, 69, 70, 71, 73, 74, 75, 77, 78, 80, 82, 83, 84, 86, 87, 88, 89, 90, 91, 92, 96, 97, 98, 99, 100, 101, 103, 108, 109, 112, 113, 114, 115, 116, 117, 119, 120, 122, 123, 125, 126, 127, 129, 134, 136, 137, 139, 140, 141, 143, 144, 148, 149, 150, 151, 152, 154, 160, 161, 163, 165, 167, 168, 169, 170, 172, 173, 174, 175, 176, 178, 179, 180, 183, 184, 185, 189, 191, 193, 194, 195, 196, 197, 198, 199]"
Olaf,L50,middle,136,53,83,7,0.32,200,"[0, 2, 3, 4, 5, 6, 7, 8, 10, 11, 12, 13, 14, 15, 16, 17, 18, 19, 21, 23, 25, 27, 29, 32, 33, 34, 36, 37, 38, 39, 40, 41, 42, 43, 44, 45, 46, 47, 48, 49, 50, 51, 52, 53, 55, 56, 57, 58, 59, 60, 61, 62, 65, 67, 69, 71, 72, 73, 74, 77, 79, 80, 84, 86, 87, 88, 90, 91, 92, 93, 94, 95, 97, 104, 105, 106, 107, 108, 109, 110, 111, 112, 114, 118, 119, 120, 121, 124, 125, 127, 131, 132, 133, 134, 135, 137, 138, 139, 141, 142, 143, 144, 145, 147, 148, 149, 150, 151, 153, 155, 160, 161, 164, 165, 166, 168, 169, 172, 173, 174, 178, 179, 180, 181, 185, 186, 187, 188, 189, 190, 191, 193, 194, 195, 198, 199]"
Olaf,L50,middle,144,67,77,5,0.28,200,"[0, 1, 4, 5, 7, 9, 10, 11, 13, 14, 15, 17, 18, 20, 21, 22, 23, 24, 25, 26, 28, 30, 31, 32, 33, 35, 36, 37, 38, 41, 42, 43, 45, 47, 49, 50, 52, 55, 58, 60, 61, 62, 63, 66, 67, 69, 72, 73, 74, 75, 76, 78, 80, 81, 83, 84, 85, 86, 87, 88, 90, 91, 93, 95, 98, 99, 100, 101, 102, 103, 104, 105, 106, 107, 108, 109, 110, 111, 112, 113, 114, 115, 117, 119, 120, 121, 122, 124, 126, 127, 128, 129, 134, 135, 137, 140, 142, 143, 144, 145, 146, 148, 149, 150, 152, 153, 154, 155, 156, 158, 159, 162, 163, 164, 166, 167, 168, 170, 171, 172, 173, 174, 175, 176, 177, 178, 179, 180, 182, 183, 185, 186, 187, 188, 189, 190, 191, 193, 194, 195, 196, 197, 198, 199]"
Olaf,L50,middle,134,77,57,7,0.33,200,"[2, 3, 5, 6, 9, 10, 11, 14, 15, 17, 18, 19, 20, 21, 22, 24, 26, 27, 30, 31, 32, 33, 35, 36, 38, 39, 41, 42, 44, 45, 46, 47, 48, 49, 51, 52, 53, 55, 59, 60, 61, 63, 64, 65, 67, 68, 69, 70, 71, 72, 73, 74, 76, 77, 79, 80, 81, 82, 84, 86, 88, 89, 90, 91, 92, 93, 94, 95, 97, 98, 100, 102, 105, 108, 110, 111, 112, 113, 114, 115, 116, 117, 119, 120, 121, 122, 123, 124, 125, 126, 127, 128, 129, 130, 131, 134, 135, 136, 137, 140, 142, 145, 146, 148, 150, 151, 152, 153, 154, 159, 160, 161, 164, 165, 166, 167, 168, 172, 173, 176, 178, 179, 181, 185, 186, 187, 188, 189, 190, 191, 193, 194, 195, 197]"
Olaf,L50,middle,143,59,84,1,0.285,200,"[0, 1, 2, 4, 5, 6, 7, 8, 10, 11, 12, 13, 14, 15, 16, 17, 19, 20, 22, 23, 26, 27, 28, 29, 30, 31, 35, 36, 37, 40, 41, 42, 43, 45, 46, 47, 48, 49, 50, 51, 53, 54, 55, 56, 57, 59, 60, 61, 62, 63, 64, 65, 66, 67, 68, 69, 70, 71, 72, 73, 74, 75, 76, 78, 79, 80, 81, 82, 83, 84, 86, 87, 88, 89, 91, 93, 95, 96, 98, 99, 100, 102, 103, 104, 105, 107, 108, 109, 112, 113, 114, 115, 116, 119, 120, 122, 123, 124, 127, 128, 130, 131, 132, 138, 139, 142, 144, 145, 147, 148, 149, 150, 152, 153, 155, 157, 159, 160, 161, 162, 163, 164, 165, 166, 168, 169, 170, 171, 173, 174, 176, 177, 178, 180, 181, 183, 185, 189, 191, 193, 194, 196, 198]"
Olaf,L50,middle,127,58,69,5,0.365,200,"[0, 1, 2, 3, 7, 8, 9, 10, 12, 13, 14, 16, 17, 21, 22, 23, 26, 27, 28, 29, 30, 31, 32, 33, 34, 36, 37, 40, 41, 42, 43, 44, 45, 46, 48, 49, 50, 51, 52, 53, 55, 56, 58, 59, 60, 61, 63, 65, 66, 67, 68, 70, 73, 74, 75, 76, 78, 80, 81, 82, 85, 87, 90, 92, 93, 94, 95, 96, 98, 100, 102, 103, 105, 107, 108, 109, 111, 112, 113, 115, 116, 117, 118, 122, 123, 129, 130, 133, 136, 137, 140, 142, 143, 147, 148, 149, 150, 151, 152, 153, 154, 155, 158, 160, 162, 163, 165, 166, 167, 168, 170, 172, 175, 178, 179, 180, 181, 182, 183, 184, 189, 191, 192, 193, 194, 196, 197]"
Olaf,L50,middle,135,77,58,9,0.325,200,"[0, 1, 2, 3, 4, 5, 6, 7, 8, 9, 10, 11, 12, 14, 15, 16, 17, 18, 20, 21, 23, 24, 25, 27, 28, 29, 31, 34, 37, 38, 39, 40, 42, 45, 48, 49, 50, 54, 56, 58, 59, 62, 63, 64, 67, 69, 73, 75, 76, 77, 78, 79, 81, 82, 83, 84, 86, 87, 88, 89, 90, 91, 92, 94, 95, 96, 97, 98, 99, 101, 102, 103, 104, 105, 106, 107, 108, 109, 110, 111, 112, 113, 114, 117, 118, 122, 123, 125, 126, 127, 128, 129, 130, 131, 132, 133, 135, 136, 138, 140, 145, 146, 147, 150, 152, 154, 158, 159, 160, 161, 163, 164, 165, 168, 169, 170, 171, 172, 173, 174, 175, 176, 178, 179, 180, 181, 184, 188, 190, 191, 192, 194, 195, 196, 198]"
Olaf,L50,middle,131,73,58,5,0.345,200,"[0, 2, 3, 4, 6, 7, 9, 10, 11, 14, 15, 16, 17, 18, 20, 21, 22, 23, 24, 25, 28, 29, 31, 32, 33, 37, 38, 42, 44, 45, 46, 48, 51, 52, 53, 55, 57, 60, 61, 63, 64, 66, 67, 68, 69, 71, 74, 75, 77, 78, 79, 80, 82, 83, 84, 85, 86, 87, 88, 90, 91, 92, 93, 94, 99, 101, 103, 104, 105, 106, 107, 108, 109, 110, 111, 112, 113, 114, 115, 117, 119, 120, 122, 124, 127, 128, 130, 131, 132, 133, 134, 136, 137, 139, 141, 143, 144, 145, 146, 147, 148, 149, 153, 155, 156, 157, 158, 165, 166, 167, 169, 170, 171, 172, 173, 174, 175, 176, 179, 180, 181, 184, 185, 186, 187, 188, 189, 191, 194, 195, 198]"
Olaf,L50,middle,138,64,74,5,0.31,200,"[1, 2, 5, 8, 9, 10, 11, 13, 14, 17, 20, 21, 22, 25, 27, 29, 30, 31, 32, 34, 35, 36, 37, 39, 41, 42, 43, 45, 46, 47, 48, 49, 50, 51, 52, 54, 55, 56, 57, 58, 61, 62, 63, 65, 66, 67, 69, 70, 71, 72, 73, 74, 76, 78, 79, 80, 81, 82, 84, 85, 87, 88, 89, 93, 94, 97, 98, 99, 100, 101, 102, 103, 104, 105, 106, 108, 110, 111, 112, 113, 114, 118, 119, 120, 121, 124, 125, 126, 128, 129, 130, 131, 132, 133, 134, 136, 137, 139, 140, 141, 143, 144, 145, 146, 147, 148, 150, 151, 152, 153, 155, 157, 159, 160, 161, 162, 163, 166, 167, 169, 171, 172, 173, 176, 181, 182, 183, 184, 185, 186, 189, 191, 193, 194, 195, 197, 198, 199]"
Olaf,L50,middle,133,94,39,2,0.335,200,"[0, 3, 6, 7, 8, 9, 10, 12, 13, 14, 15, 17, 18, 19, 20, 24, 25, 26, 31, 32, 33, 38, 39, 41, 42, 43, 46, 48, 50, 52, 56, 57, 59, 60, 61, 63, 64, 68, 70, 71, 72, 73, 74, 75, 76, 77, 78, 79, 80, 81, 82, 83, 84, 85, 87, 88, 90, 91, 92, 93, 96, 97, 98, 99, 104, 105, 106, 107, 109, 110, 111, 112, 113, 116, 117, 120, 121, 122, 123, 124, 125, 126, 127, 128, 131, 133, 134, 135, 136, 137, 140, 143, 144, 145, 146, 147, 148, 149, 150, 151, 152, 153, 154, 155, 156, 157, 161, 162, 163, 165, 166, 169, 170, 171, 175, 176, 177, 178, 180, 181, 183, 184, 185, 186, 187, 189, 190, 192, 193, 194, 195, 197, 199]"
Olaf,L50,middle,124,80,44,3,0.38,200,"[0, 1, 6, 7, 8, 9, 10, 12, 13, 14, 19, 20, 21, 23, 24, 25, 26, 29, 30, 35, 36, 38, 39, 41, 42, 43, 44, 45, 48, 49, 50, 51, 53, 54, 55, 56, 57, 58, 61, 62, 63, 64, 66, 67, 70, 75, 78, 80, 81, 82, 83, 84, 85, 86, 87, 88, 90, 92, 93, 96, 97, 98, 100, 101, 102, 105, 107, 109, 111, 113, 115, 116, 120, 121, 124, 125, 127, 128, 129, 131, 132, 134, 135, 137, 138, 139, 140, 143, 144, 146, 147, 148, 150, 152, 153, 155, 158, 159, 160, 161, 163, 164, 166, 167, 168, 169, 171, 172, 175, 178, 179, 182, 183, 185, 186, 188, 189, 190, 191, 195, 196, 197, 198, 199]"
Olaf,L50,middle,120,59,61,5,0.4,200,"[0, 2, 4, 6, 9, 11, 13, 14, 15, 16, 17, 18, 19, 21, 22, 24, 26, 27, 28, 29, 30, 32, 33, 36, 38, 40, 42, 44, 45, 46, 48, 51, 53, 54, 56, 59, 60, 62, 63, 64, 67, 74, 75, 76, 77, 82, 84, 85, 88, 89, 90, 91, 93, 94, 95, 98, 99, 100, 102, 105, 106, 109, 110, 112, 113, 114, 116, 117, 121, 122, 123, 124, 125, 126, 127, 129, 131, 132, 136, 137, 138, 141, 143, 144, 145, 146, 147, 150, 151, 152, 153, 154, 157, 159, 160, 162, 164, 165, 166, 167, 171, 172, 173, 174, 175, 176, 178, 181, 182, 184, 185, 188, 190, 191, 192, 194, 195, 196, 198, 199]"
Olaf,L50,middle,140,80,60,6,0.3,200,"[1, 2, 3, 4, 6, 7, 8, 9, 10, 12, 14, 15, 16, 17, 18, 19, 20, 21, 24, 26, 27, 28, 29, 32, 34, 35, 36, 37, 38, 39, 41, 44, 45, 47, 48, 49, 50, 51, 55, 57, 58, 60, 61, 63, 64, 65, 66, 67, 68, 69, 70, 71, 72, 74, 75, 76, 77, 78, 79, 81, 82, 84, 85, 86, 88, 89, 90, 91, 92, 93, 94, 95, 97, 98, 99, 100, 102, 104, 105, 107, 109, 111, 112, 113, 114, 116, 117, 119, 120, 121, 122, 123, 124, 125, 126, 127, 128, 129, 130, 131, 132, 133, 136, 137, 138, 140, 143, 144, 149, 150, 151, 152, 153, 154, 155, 156, 157, 158, 161, 162, 163, 164, 166, 168, 169, 171, 173, 177, 178, 180, 181, 182, 184, 186, 192, 194, 195, 196, 198, 199]"
Olaf,L50,middle,126,69,57,5,0.37,200,"[0, 1, 2, 3, 4, 5, 8, 9, 10, 11, 13, 14, 15, 16, 18, 20, 22, 23, 25, 26, 27, 28, 29, 30, 31, 32, 33, 35, 36, 37, 38, 42, 44, 45, 46, 47, 49, 50, 51, 53, 54, 57, 58, 59, 60, 61, 62, 63, 64, 67, 69, 73, 74, 75, 78, 79, 80, 81, 85, 86, 87, 89, 90, 92, 93, 94, 97, 98, 100, 101, 102, 104, 106, 107, 108, 109, 110, 111, 112, 113, 114, 115, 118, 119, 121, 124, 125, 126, 128, 129, 130, 131, 132, 137, 138, 139, 141, 143, 144, 146, 148, 157, 161, 162, 163, 164, 167, 168, 169, 171, 174, 175, 176, 177, 179, 180, 181, 184, 185, 187, 188, 189, 190, 191, 194, 195]"
Olaf,L50,middle,133,59,74,3,0.335,200,"[0, 2, 3, 4, 5, 6, 8, 9, 13, 14, 16, 17, 19, 20, 21, 23, 24, 25, 26, 27, 28, 29, 31, 32, 33, 34, 36, 37, 38, 39, 40, 42, 44, 45, 46, 49, 51, 52, 53, 55, 56, 59, 60, 61, 62, 63, 65, 66, 67, 70, 71, 74, 77, 78, 79, 81, 82, 83, 87, 88, 90, 91, 92, 93, 94, 95, 96, 101, 103, 104, 105, 107, 108, 109, 110, 111, 114, 115, 116, 120, 122, 123, 124, 125, 127, 128, 132, 133, 135, 136, 138, 139, 140, 141, 142, 143, 146, 148, 149, 151, 152, 153, 154, 155, 157, 158, 159, 160, 161, 162, 163, 165, 166, 167, 171, 172, 175, 179, 181, 183, 185, 187, 188, 190, 191, 192, 193, 194, 195, 196, 197, 198, 199]"
Olaf,L50,middle,134,80,54,4,0.33,200,"[0, 1, 3, 5, 6, 8, 9, 10, 11, 13, 14, 15, 18, 19, 24, 25, 29, 30, 31, 32, 33, 34, 36, 39, 41, 42, 43, 45, 46, 49, 50, 51, 52, 53, 54, 56, 58, 60, 61, 62, 63, 64, 65, 66, 68, 69, 72, 73, 74, 76, 77, 78, 79, 81, 82, 83, 84, 85, 86, 88, 89, 90, 95, 96, 97, 98, 99, 100, 102, 103, 106, 107, 108, 109, 110, 111, 112, 113, 114, 115, 116, 117, 118, 120, 121, 123, 125, 127, 129, 130, 131, 132, 133, 134, 135, 136, 139, 140, 142, 143, 144, 145, 146, 147, 148, 149, 151, 152, 153, 155, 157, 158, 159, 160, 161, 163, 165, 167, 168, 169, 171, 172, 173, 177, 178, 179, 181, 183, 184, 187, 189, 190, 192, 196]"
Olaf,L50,middle,133,76,57,3,0.335,200,"[0, 1, 2, 3, 4, 6, 11, 12, 15, 16, 17, 20, 24, 25, 27, 29, 31, 32, 33, 34, 37, 39, 40, 43, 47, 48, 49, 50, 53, 54, 55, 59, 60, 61, 62, 64, 65, 66, 67, 69, 73, 74, 75, 76, 77, 79, 81, 83, 84, 85, 86, 91, 92, 94, 97, 98, 99, 101, 103, 104, 105, 106, 108, 109, 111, 112, 113, 114, 115, 116, 118, 119, 120, 122, 123, 125, 127, 128, 130, 131, 133, 136, 137, 138, 139, 142, 144, 145, 146, 147, 148, 150, 151, 152, 153, 154, 155, 156, 158, 159, 160, 162, 163, 164, 167, 168, 169, 170, 171, 172, 173, 174, 176, 177, 178, 179, 180, 181, 182, 184, 185, 186, 187, 188, 189, 190, 191, 192, 193, 194, 195, 198, 199]"
Olaf,L50,middle,140,71,69,1,0.3,200,"[1, 2, 3, 5, 7, 8, 9, 10, 12, 13, 14, 16, 17, 18, 19, 20, 21, 24, 25, 27, 29, 30, 32, 33, 34, 35, 37, 39, 40, 41, 43, 44, 45, 46, 49, 51, 52, 53, 54, 55, 56, 59, 60, 61, 62, 63, 64, 66, 67, 69, 70, 72, 74, 75, 77, 79, 81, 82, 83, 85, 87, 88, 89, 90, 91, 92, 97, 98, 100, 101, 102, 103, 104, 105, 106, 107, 108, 110, 112, 116, 118, 119, 120, 121, 122, 123, 124, 125, 127, 129, 130, 131, 132, 135, 136, 137, 139, 141, 143, 144, 146, 147, 148, 150, 151, 152, 153, 154, 155, 156, 157, 158, 159, 160, 161, 163, 165, 166, 167, 168, 169, 170, 171, 172, 173, 174, 175, 178, 179, 181, 182, 183, 184, 186, 187, 190, 191, 192, 197, 198]"
Olaf,L50,middle,138,82,56,2,0.31,200,"[0, 1, 2, 3, 4, 5, 6, 11, 14, 16, 17, 19, 20, 22, 23, 26, 27, 30, 34, 35, 38, 39, 42, 43, 44, 45, 46, 47, 48, 49, 51, 52, 53, 54, 55, 56, 58, 59, 61, 63, 66, 69, 70, 71, 72, 73, 75, 76, 77, 78, 79, 80, 81, 82, 83, 84, 86, 87, 88, 89, 91, 92, 93, 94, 95, 97, 98, 99, 100, 101, 102, 103, 104, 106, 107, 109, 110, 111, 114, 117, 118, 119, 120, 121, 122, 123, 124, 126, 128, 129, 132, 133, 134, 135, 136, 137, 138, 139, 140, 142, 143, 144, 145, 147, 148, 150, 152, 155, 158, 159, 160, 161, 162, 163, 165, 168, 170, 172, 174, 175, 176, 177, 178, 179, 180, 181, 182, 183, 185, 186, 187, 188, 189, 191, 194, 196, 197, 198]"
Olaf,L50,middle,139,90,49,5,0.305,200,"[0, 1, 2, 3, 5, 6, 8, 10, 12, 14, 15, 16, 18, 20, 22, 23, 25, 27, 29, 31, 32, 33, 34, 35, 37, 38, 39, 40, 41, 42, 43, 44, 47, 48, 50, 52, 53, 54, 55, 57, 59, 61, 62, 63, 65, 66, 67, 68, 69, 70, 71, 73, 76, 77, 80, 81, 82, 83, 84, 87, 88, 89, 90, 91, 93, 95, 96, 102, 104, 105, 106, 107, 108, 110, 112, 113, 114, 115, 116, 119, 122, 123, 124, 126, 127, 129, 130, 131, 132, 133, 135, 136, 137, 138, 140, 142, 143, 144, 146, 147, 148, 150, 152, 153, 154, 156, 157, 160, 161, 162, 163, 164, 165, 166, 167, 168, 169, 170, 171, 172, 174, 175, 176, 177, 178, 179, 180, 181, 183, 184, 187, 188, 189, 192, 194, 195, 196, 197, 199]"
Olaf,L50,middle,135,79,56,7,0.325,200,"[1, 2, 3, 4, 5, 8, 9, 11, 13, 14, 16, 17, 18, 21, 22, 23, 24, 25, 26, 28, 30, 31, 33, 34, 37, 38, 39, 40, 41, 42, 43, 44, 45, 46, 48, 51, 52, 53, 54, 56, 57, 58, 59, 61, 64, 66, 67, 68, 69, 72, 73, 74, 75, 76, 78, 80, 81, 82, 83, 84, 86, 87, 90, 92, 93, 95, 98, 99, 102, 103, 104, 105, 108, 109, 110, 111, 112, 113, 114, 115, 116, 117, 119, 121, 124, 126, 127, 128, 129, 130, 131, 132, 133, 135, 136, 138, 139, 140, 141, 142, 145, 146, 147, 148, 149, 150, 152, 153, 154, 155, 156, 157, 158, 159, 160, 161, 163, 168, 169, 170, 171, 172, 174, 178, 180, 182, 184, 185, 187, 188, 189, 190, 191, 195, 199]"
Olaf,L50,middle,138,68,70,1,0.31,200,"[1, 2, 3, 4, 7, 8, 10, 12, 13, 15, 16, 17, 18, 20, 21, 22, 23, 24, 26, 28, 29, 31, 32, 33, 34, 36, 37, 38, 39, 40, 42, 43, 45, 46, 47, 48, 49, 50, 51, 53, 54, 55, 56, 59, 60, 63, 64, 65, 66, 67, 69, 70, 72, 73, 75, 76, 77, 78, 79, 80, 81, 82, 85, 88, 89, 90, 91, 92, 93, 96, 97, 99, 100, 101, 103, 106, 108, 111, 112, 113, 116, 117, 118, 119, 121, 124, 125, 126, 128, 130, 132, 133, 134, 136, 137, 139, 140, 141, 143, 145, 146, 148, 150, 151, 152, 153, 154, 155, 156, 161, 162, 163, 164, 166, 168, 169, 170, 172, 174, 175, 178, 179, 180, 181, 182, 183, 184, 186, 187, 188, 189, 190, 191, 192, 193, 194, 195, 197]"
Olaf,L50,middle,132,65,67,8,0.34,200,"[0, 2, 5, 7, 8, 9, 10, 11, 12, 14, 15, 17, 21, 22, 24, 26, 27, 28, 31, 33, 36, 37, 40, 41, 45, 46, 47, 48, 50, 51, 52, 55, 56, 57, 58, 60, 63, 64, 66, 67, 69, 70, 71, 72, 73, 74, 75, 76, 79, 80, 81, 83, 84, 86, 91, 93, 94, 95, 97, 98, 99, 100, 101, 102, 103, 108, 109, 111, 112, 113, 114, 115, 117, 119, 121, 122, 123, 124, 125, 127, 129, 130, 131, 133, 134, 137, 140, 141, 143, 144, 145, 147, 148, 150, 151, 153, 155, 156, 157, 158, 160, 162, 163, 164, 165, 167, 168, 169, 170, 171, 172, 173, 175, 176, 177, 178, 179, 181, 183, 184, 185, 187, 188, 190, 191, 192, 193, 194, 195, 197, 198, 199]"
Olaf,L50,middle,117,49,68,13,0.415,200,"[0, 3, 4, 5, 6, 7, 8, 9, 10, 11, 13, 15, 17, 19, 21, 22, 23, 24, 28, 34, 36, 37, 39, 41, 42, 43, 44, 46, 47, 48, 49, 51, 52, 53, 54, 56, 57, 60, 61, 62, 64, 66, 67, 68, 69, 70, 71, 72, 73, 74, 76, 78, 82, 83, 84, 85, 86, 87, 88, 89, 91, 94, 97, 99, 102, 103, 105, 106, 107, 108, 110, 111, 112, 116, 118, 119, 120, 122, 123, 125, 126, 127, 129, 131, 132, 133, 134, 135, 137, 140, 141, 143, 144, 147, 150, 154, 155, 159, 164, 165, 167, 169, 171, 173, 176, 179, 185, 186, 187, 189, 190, 192, 193, 194, 197, 198, 199]"
Olaf,L50,middle,135,58,77,7,0.325,200,"[0, 2, 3, 4, 6, 7, 8, 12, 13, 15, 16, 17, 18, 20, 21, 23, 24, 25, 26, 27, 28, 29, 32, 33, 34, 35, 36, 37, 39, 41, 42, 43, 44, 45, 46, 48, 49, 50, 52, 53, 54, 58, 60, 61, 63, 65, 66, 67, 70, 71, 72, 74, 76, 79, 83, 84, 86, 88, 89, 90, 91, 93, 95, 96, 97, 99, 101, 102, 103, 104, 105, 106, 108, 109, 110, 112, 113, 115, 116, 117, 118, 120, 121, 122, 126, 127, 128, 129, 130, 131, 136, 137, 138, 139, 140, 141, 142, 143, 144, 145, 147, 148, 149, 150, 151, 153, 157, 158, 159, 160, 162, 163, 168, 169, 171, 172, 173, 175, 176, 177, 180, 181, 182, 183, 184, 185, 186, 188, 191, 192, 193, 195, 196, 198, 199]"
Olaf,L50,middle,143,76,67,0,0.285,200,"[1, 5, 6, 7, 9, 10, 12, 13, 15, 16, 19, 20, 21, 23, 25, 26, 28, 30, 31, 32, 33, 34, 35, 38, 39, 40, 43, 45, 47, 50, 51, 52, 54, 55, 56, 58, 59, 60, 61, 62, 63, 65, 66, 69, 70, 73, 74, 75, 76, 77, 79, 80, 81, 82, 84, 85, 86, 87, 89, 90, 91, 92, 94, 95, 98, 99, 100, 101, 102, 103, 104, 108, 109, 110, 111, 112, 113, 114, 115, 117, 119, 121, 122, 123, 125, 126, 127, 128, 129, 130, 131, 132, 134, 136, 137, 138, 141, 142, 143, 144, 145, 147, 148, 149, 150, 151, 152, 153, 154, 156, 157, 158, 159, 160, 161, 162, 163, 164, 165, 166, 167, 169, 170, 171, 174, 175, 179, 180, 181, 183, 186, 187, 188, 189, 191, 192, 193, 194, 195, 196, 197, 198, 199]"
Olaf,L50,middle,120,73,47,7,0.4,200,"[0, 1, 2, 3, 5, 9, 10, 11, 13, 14, 16, 17, 18, 19, 20, 21, 23, 24, 25, 26, 29, 30, 31, 32, 33, 34, 35, 37, 42, 43, 46, 47, 48, 49, 51, 54, 55, 57, 58, 63, 64, 66, 68, 71, 73, 74, 77, 78, 79, 80, 81, 82, 85, 87, 89, 90, 91, 93, 94, 96, 97, 99, 100, 104, 106, 111, 113, 115, 116, 117, 119, 120, 123, 124, 125, 126, 131, 134, 139, 140, 141, 142, 143, 144, 146, 148, 150, 151, 153, 154, 155, 156, 157, 158, 159, 160, 161, 162, 163, 164, 165, 167, 168, 169, 173, 175, 177, 178, 179, 180, 181, 183, 184, 185, 187, 188, 196, 197, 198, 199]"
Olaf,L50,middle,145,81,64,5,0.275,200,"[0, 1, 3, 4, 6, 7, 8, 9, 10, 12, 13, 14, 15, 16, 19, 23, 26, 27, 29, 30, 31, 32, 34, 35, 36, 37, 39, 42, 43, 44, 46, 47, 48, 49, 50, 51, 52, 53, 54, 55, 56, 57, 58, 61, 62, 64, 66, 67, 69, 70, 71, 72, 73, 75, 77, 78, 79, 80, 83, 84, 86, 87, 88, 91, 93, 94, 95, 96, 97, 98, 100, 102, 103, 104, 105, 106, 107, 108, 109, 110, 111, 112, 113, 115, 116, 117, 118, 119, 120, 121, 122, 126, 128, 129, 130, 131, 132, 133, 134, 135, 136, 137, 139, 140, 141, 143, 145, 146, 147, 149, 150, 151, 155, 159, 160, 161, 162, 165, 166, 167, 168, 170, 171, 172, 173, 174, 175, 176, 177, 178, 179, 181, 182, 183, 184, 185, 186, 189, 190, 191, 194, 196, 197, 198, 199]"
Olaf,L50,middle,127,66,61,4,0.365,200,"[0, 1, 2, 3, 5, 6, 7, 9, 10, 11, 12, 14, 15, 16, 17, 18, 20, 22, 24, 28, 30, 31, 32, 33, 34, 36, 38, 39, 40, 41, 43, 44, 46, 47, 50, 52, 53, 54, 55, 56, 58, 59, 60, 61, 62, 63, 66, 67, 68, 69, 70, 71, 73, 75, 77, 78, 84, 87, 90, 92, 93, 96, 99, 100, 101, 104, 107, 108, 109, 110, 113, 114, 117, 118, 119, 121, 123, 125, 127, 128, 130, 133, 134, 137, 139, 140, 141, 142, 143, 144, 146, 148, 149, 150, 152, 158, 159, 160, 161, 164, 165, 169, 170, 171, 172, 173, 174, 175, 176, 178, 179, 180, 182, 183, 184, 185, 186, 188, 189, 190, 191, 192, 193, 194, 195, 196, 198]"
Olaf,L50,middle,142,77,65,2,0.29,200,"[0, 2, 3, 5, 6, 7, 8, 9, 10, 11, 14, 15, 16, 17, 18, 19, 20, 21, 23, 24, 25, 26, 28, 31, 32, 33, 34, 36, 38, 40, 41, 42, 43, 44, 46, 47, 48, 49, 50, 51, 52, 53, 54, 55, 56, 57, 58, 60, 61, 62, 66, 67, 68, 69, 72, 73, 74, 75, 76, 77, 78, 80, 81, 82, 83, 84, 85, 86, 88, 89, 90, 91, 92, 95, 98, 99, 100, 102, 103, 106, 107, 108, 109, 110, 111, 112, 113, 114, 115, 116, 117, 118, 119, 121, 122, 125, 131, 133, 134, 135, 136, 138, 139, 140, 141, 142, 143, 144, 145, 147, 148, 150, 152, 153, 154, 156, 157, 158, 160, 161, 164, 167, 168, 169, 170, 173, 176, 177, 180, 183, 186, 187, 188, 189, 192, 193, 194, 195, 196, 197, 198, 199]"
Olaf,L50,middle,130,56,74,1,0.35,200,"[0, 1, 3, 4, 5, 7, 9, 10, 12, 13, 15, 16, 17, 18, 20, 22, 23, 24, 27, 28, 29, 30, 34, 35, 37, 38, 39, 40, 42, 44, 51, 52, 53, 54, 55, 57, 59, 60, 61, 62, 64, 66, 67, 68, 74, 75, 77, 78, 82, 83, 88, 89, 90, 91, 92, 93, 94, 95, 97, 100, 101, 102, 103, 104, 105, 107, 113, 114, 118, 119, 120, 121, 122, 123, 125, 126, 129, 130, 131, 133, 134, 135, 136, 137, 138, 139, 141, 143, 144, 145, 146, 147, 149, 150, 152, 153, 154, 155, 156, 157, 158, 160, 161, 162, 164, 167, 168, 169, 170, 171, 172, 175, 176, 178, 180, 181, 182, 183, 185, 186, 187, 188, 190, 191, 192, 193, 194, 196, 198, 199]"
Olaf,L50,middle,142,75,67,4,0.29,200,"[2, 3, 6, 8, 11, 12, 14, 15, 16, 17, 18, 19, 20, 22, 24, 26, 27, 28, 29, 30, 31, 32, 33, 34, 35, 37, 39, 41, 42, 43, 45, 47, 48, 49, 50, 51, 52, 55, 56, 57, 58, 59, 60, 61, 64, 65, 66, 68, 69, 71, 74, 76, 77, 78, 79, 80, 81, 82, 83, 84, 85, 86, 87, 89, 91, 93, 94, 95, 96, 97, 98, 99, 100, 101, 102, 105, 107, 108, 109, 110, 111, 112, 114, 116, 117, 118, 119, 120, 122, 123, 124, 125, 126, 127, 129, 130, 131, 132, 133, 134, 135, 136, 137, 140, 141, 142, 144, 146, 148, 149, 150, 152, 153, 154, 155, 156, 157, 158, 161, 162, 164, 165, 166, 167, 168, 170, 175, 176, 178, 180, 181, 182, 183, 184, 185, 190, 191, 192, 193, 195, 197, 199]"
Olaf,L50,middle,137,65,72,5,0.315,200,"[0, 2, 4, 5, 6, 7, 8, 11, 12, 13, 14, 15, 17, 19, 21, 22, 24, 25, 29, 30, 31, 32, 36, 37, 39, 42, 43, 44, 46, 47, 48, 49, 51, 52, 55, 57, 58, 60, 61, 62, 63, 66, 67, 68, 69, 70, 73, 74, 76, 77, 80, 81, 82, 83, 84, 85, 87, 89, 90, 91, 92, 93, 94, 95, 96, 97, 99, 101, 102, 104, 105, 109, 110, 111, 113, 114, 115, 117, 118, 119, 120, 121, 122, 123, 124, 127, 130, 134, 136, 138, 139, 140, 141, 142, 143, 144, 145, 146, 147, 149, 150, 151, 154, 156, 158, 159, 160, 162, 165, 166, 167, 168, 169, 170, 171, 172, 173, 176, 177, 178, 179, 180, 181, 182, 183, 184, 185, 186, 188, 190, 191, 193, 194, 195, 197, 198, 199]"
Olaf,L50,middle,134,63,71,6,0.33,200,"[2, 5, 7, 8, 10, 11, 13, 14, 15, 16, 18, 19, 20, 21, 23, 24, 25, 26, 28, 29, 31, 33, 34, 37, 38, 39, 40, 41, 43, 44, 49, 50, 51, 53, 54, 55, 56, 57, 58, 61, 62, 64, 65, 66, 67, 68, 69, 72, 73, 74, 75, 79, 80, 82, 83, 84, 89, 90, 92, 95, 98, 99, 100, 101, 102, 104, 107, 108, 111, 112, 113, 114, 116, 118, 122, 123, 124, 126, 127, 129, 130, 131, 133, 134, 135, 136, 137, 138, 139, 141, 143, 144, 145, 147, 148, 150, 151, 152, 153, 154, 156, 157, 158, 160, 161, 162, 163, 165, 166, 168, 169, 172, 173, 174, 175, 176, 178, 179, 181, 182, 183, 185, 186, 188, 189, 190, 191, 192, 194, 195, 196, 197, 198, 199]"
Olaf,L50,middle,136,71,65,5,0.32,200,"[0, 1, 3, 4, 5, 6, 8, 9, 10, 11, 16, 17, 18, 19, 21, 23, 24, 26, 30, 31, 32, 33, 34, 35, 36, 40, 41, 42, 43, 44, 46, 47, 48, 49, 50, 51, 54, 55, 56, 57, 61, 63, 65, 67, 68, 69, 71, 73, 75, 76, 78, 79, 80, 81, 83, 85, 86, 88, 90, 91, 92, 93, 94, 95, 96, 97, 98, 99, 102, 103, 105, 108, 110, 111, 112, 114, 115, 116, 117, 119, 120, 121, 122, 123, 124, 125, 128, 131, 133, 134, 135, 138, 139, 141, 142, 145, 148, 150, 151, 153, 154, 155, 156, 157, 158, 159, 160, 163, 165, 166, 167, 168, 169, 170, 171, 172, 173, 174, 176, 177, 178, 179, 180, 181, 182, 183, 184, 185, 189, 191, 192, 193, 194, 195, 197, 198]"
Olaf,L50,middle,133,68,65,3,0.335,200,"[0, 1, 2, 3, 5, 6, 8, 9, 10, 14, 15, 16, 17, 19, 20, 21, 22, 24, 25, 26, 27, 30, 31, 33, 35, 38, 39, 40, 41, 42, 44, 46, 48, 50, 52, 55, 56, 57, 58, 59, 61, 63, 64, 65, 67, 68, 69, 70, 73, 80, 82, 86, 88, 89, 90, 91, 92, 93, 94, 95, 97, 98, 99, 101, 102, 104, 105, 106, 108, 110, 112, 113, 114, 115, 116, 117, 118, 121, 122, 123, 124, 125, 126, 127, 128, 130, 132, 134, 135, 136, 137, 138, 140, 141, 144, 145, 146, 150, 151, 154, 155, 156, 157, 158, 159, 160, 162, 164, 165, 166, 167, 168, 170, 172, 173, 175, 176, 177, 178, 179, 180, 181, 183, 184, 186, 187, 189, 190, 191, 195, 196, 197, 199]"
Olaf,L50,middle,130,76,54,5,0.35,200,"[0, 1, 3, 5, 9, 10, 11, 12, 15, 16, 17, 18, 19, 20, 21, 24, 25, 26, 27, 35, 36, 37, 38, 39, 41, 43, 44, 45, 46, 47, 48, 49, 50, 51, 52, 53, 54, 57, 58, 59, 60, 61, 63, 65, 67, 68, 69, 72, 73, 75, 76, 77, 81, 82, 83, 84, 85, 86, 89, 91, 92, 94, 95, 97, 99, 100, 101, 102, 103, 105, 108, 112, 114, 115, 116, 118, 120, 122, 123, 124, 125, 128, 129, 130, 132, 133, 135, 139, 140, 142, 146, 147, 148, 149, 150, 151, 152, 153, 154, 156, 157, 158, 160, 161, 162, 164, 165, 166, 168, 170, 171, 172, 173, 174, 177, 178, 179, 180, 181, 182, 184, 189, 191, 192, 193, 194, 195, 196, 197, 198]"
Olaf,L50,middle,121,51,70,5,0.395,200,"[0, 1, 2, 4, 6, 7, 8, 9, 11, 12, 13, 14, 15, 18, 19, 20, 21, 22, 24, 25, 27, 31, 33, 34, 36, 37, 38, 40, 41, 42, 44, 45, 46, 47, 50, 52, 53, 56, 57, 58, 59, 60, 64, 65, 66, 67, 68, 69, 70, 71, 73, 75, 81, 84, 85, 87, 88, 92, 93, 94, 95, 97, 98, 99, 100, 102, 105, 106, 107, 108, 109, 111, 116, 117, 118, 120, 121, 122, 123, 124, 128, 131, 133, 135, 137, 139, 140, 144, 146, 148, 149, 150, 151, 153, 154, 155, 156, 157, 158, 159, 160, 166, 169, 171, 179, 180, 181, 182, 183, 184, 185, 187, 191, 192, 193, 194, 195, 196, 197, 198, 199]"
Olaf,L50,middle,133,51,82,5,0.335,200,"[0, 1, 2, 4, 5, 6, 7, 9, 10, 11, 12, 13, 14, 15, 16, 17, 18, 19, 23, 26, 27, 29, 31, 33, 34, 35, 36, 37, 38, 39, 40, 41, 42, 44, 46, 48, 50, 52, 54, 56, 58, 59, 60, 62, 63, 64, 65, 66, 68, 69, 70, 71, 72, 73, 74, 75, 76, 77, 79, 81, 82, 84, 86, 89, 92, 95, 97, 98, 99, 100, 101, 102, 103, 106, 108, 109, 115, 117, 118, 119, 120, 123, 125, 126, 127, 128, 130, 131, 132, 133, 134, 135, 137, 138, 139, 140, 141, 142, 143, 144, 145, 147, 148, 151, 154, 155, 156, 157, 159, 160, 165, 166, 167, 168, 169, 170, 171, 174, 175, 177, 178, 180, 181, 182, 183, 184, 185, 186, 190, 194, 196, 197, 198]"
Olaf,L50,middle,139,65,74,7,0.305,200,"[1, 2, 4, 5, 6, 7, 12, 14, 15, 18, 20, 21, 22, 23, 24, 25, 26, 29, 30, 31, 32, 33, 35, 36, 37, 38, 42, 44, 45, 49, 50, 51, 52, 53, 54, 55, 57, 59, 60, 61, 62, 63, 68, 69, 70, 71, 72, 73, 75, 76, 77, 78, 80, 82, 83, 84, 86, 88, 89, 90, 91, 92, 93, 94, 95, 96, 97, 99, 100, 102, 103, 104, 106, 108, 110, 112, 113, 116, 117, 118, 119, 120, 122, 124, 126, 127, 128, 129, 131, 134, 136, 137, 139, 142, 143, 144, 145, 149, 150, 152, 153, 154, 155, 156, 158, 159, 161, 162, 163, 164, 165, 166, 167, 168, 169, 170, 171, 172, 173, 174, 175, 176, 178, 179, 180, 181, 182, 186, 188, 189, 190, 191, 192, 193, 195, 196, 197, 198, 199]"
Olaf,L50,middle,123,58,65,2,0.385,200,"[0, 2, 3, 4, 6, 8, 10, 11, 13, 15, 16, 18, 19, 20, 21, 23, 25, 26, 27, 29, 30, 34, 36, 37, 38, 41, 44, 45, 48, 50, 52, 54, 57, 58, 59, 60, 62, 63, 64, 65, 66, 67, 68, 69, 70, 71, 73, 74, 75, 76, 77, 78, 79, 80, 81, 87, 88, 93, 94, 95, 96, 97, 100, 101, 102, 103, 106, 107, 109, 110, 112, 114, 115, 116, 118, 119, 120, 121, 122, 124, 125, 128, 129, 130, 132, 133, 134, 140, 143, 144, 147, 150, 151, 152, 154, 155, 156, 157, 158, 160, 161, 163, 166, 167, 169, 171, 172, 174, 175, 178, 179, 181, 182, 187, 188, 189, 191, 192, 193, 195, 196, 198, 199]"
Olaf,L50,middle,123,60,63,6,0.385,200,"[1, 2, 4, 6, 9, 11, 12, 13, 14, 15, 17, 18, 19, 21, 22, 25, 28, 30, 35, 36, 38, 40, 43, 44, 45, 47, 48, 49, 50, 51, 53, 54, 55, 56, 58, 59, 60, 63, 66, 67, 68, 70, 72, 73, 74, 75, 76, 77, 81, 82, 83, 84, 85, 86, 87, 89, 90, 91, 94, 96, 99, 100, 101, 102, 103, 104, 105, 106, 108, 109, 110, 112, 113, 115, 117, 119, 120, 122, 123, 124, 126, 127, 130, 133, 134, 135, 136, 137, 138, 140, 142, 143, 145, 148, 149, 150, 153, 154, 155, 159, 160, 161, 162, 165, 168, 170, 172, 173, 175, 176, 178, 179, 185, 187, 188, 189, 191, 193, 194, 195, 197, 198, 199]"
Olaf,L50,middle,140,77,63,4,0.3,200,"[1, 3, 4, 5, 7, 8, 9, 10, 11, 12, 13, 14, 16, 17, 18, 19, 20, 21, 22, 23, 24, 25, 26, 27, 28, 29, 30, 31, 32, 34, 35, 37, 38, 39, 40, 41, 42, 43, 45, 46, 48, 49, 56, 57, 60, 61, 63, 65, 66, 68, 69, 70, 71, 72, 73, 75, 76, 77, 78, 79, 80, 81, 82, 83, 84, 86, 88, 89, 90, 91, 92, 94, 95, 97, 98, 100, 101, 103, 105, 106, 108, 109, 110, 111, 112, 113, 114, 116, 117, 118, 119, 120, 125, 126, 127, 129, 131, 132, 133, 134, 135, 136, 138, 139, 140, 142, 145, 147, 148, 151, 152, 153, 155, 156, 157, 163, 165, 166, 167, 168, 169, 170, 171, 172, 174, 175, 177, 178, 179, 180, 182, 183, 184, 185, 186, 187, 193, 196, 197, 198]"
Olaf,L50,middle,130,68,62,5,0.35,200,"[1, 2, 3, 5, 6, 9, 11, 12, 14, 15, 16, 18, 19, 21, 22, 23, 24, 27, 28, 29, 30, 32, 34, 35, 36, 37, 38, 39, 40, 41, 48, 50, 54, 55, 56, 57, 58, 60, 61, 64, 65, 68, 69, 70, 71, 73, 74, 79, 84, 85, 86, 87, 88, 90, 91, 92, 94, 95, 96, 98, 100, 101, 102, 103, 104, 105, 106, 107, 108, 110, 112, 113, 114, 115, 116, 117, 119, 120, 121, 122, 124, 125, 126, 127, 128, 129, 130, 131, 135, 136, 138, 139, 140, 143, 144, 145, 146, 147, 149, 155, 156, 157, 158, 159, 161, 162, 164, 165, 167, 168, 171, 172, 174, 175, 177, 178, 179, 181, 182, 183, 185, 186, 188, 189, 190, 191, 192, 193, 196, 197]"
Olaf,L50,middle,138,79,59,3,0.31,200,"[0, 1, 2, 4, 5, 7, 8, 11, 12, 13, 14, 16, 20, 21, 22, 23, 24, 25, 28, 29, 30, 31, 32, 33, 36, 37, 38, 39, 40, 42, 44, 46, 47, 48, 50, 51, 52, 53, 54, 55, 56, 57, 59, 61, 62, 64, 65, 66, 67, 68, 69, 70, 71, 72, 74, 75, 77, 79, 80, 82, 83, 85, 86, 87, 88, 91, 93, 95, 96, 97, 98, 100, 101, 102, 103, 104, 105, 107, 108, 110, 111, 113, 114, 115, 118, 119, 120, 121, 124, 125, 127, 129, 132, 133, 134, 136, 138, 139, 140, 141, 142, 145, 146, 147, 149, 152, 153, 154, 155, 157, 159, 160, 161, 162, 163, 164, 165, 167, 168, 169, 170, 171, 172, 174, 176, 178, 179, 180, 182, 187, 189, 191, 192, 193, 195, 196, 198, 199]"
Olaf,L50,middle,118,65,53,4,0.41,200,"[2, 4, 6, 7, 9, 10, 11, 12, 13, 16, 17, 19, 20, 21, 22, 23, 27, 29, 30, 32, 34, 35, 36, 37, 38, 39, 40, 41, 43, 44, 46, 49, 51, 52, 53, 54, 55, 56, 58, 59, 60, 63, 64, 69, 71, 72, 75, 78, 79, 80, 81, 83, 84, 86, 88, 90, 92, 93, 94, 96, 97, 98, 99, 100, 101, 102, 103, 104, 105, 106, 107, 108, 117, 119, 122, 127, 130, 131, 132, 133, 136, 137, 138, 139, 140, 143, 144, 146, 147, 151, 152, 154, 155, 156, 158, 159, 161, 162, 163, 164, 165, 166, 167, 169, 170, 173, 175, 176, 177, 185, 188, 189, 190, 191, 194, 195, 196, 197]"
Olaf,L50,middle,135,61,74,3,0.325,200,"[3, 9, 11, 13, 14, 15, 17, 18, 19, 20, 21, 23, 24, 26, 27, 28, 29, 30, 31, 32, 33, 35, 36, 37, 38, 40, 41, 43, 45, 46, 48, 49, 50, 51, 52, 53, 54, 55, 57, 59, 60, 61, 63, 65, 67, 69, 70, 71, 72, 73, 76, 77, 79, 80, 81, 82, 84, 86, 88, 89, 90, 91, 94, 96, 97, 99, 100, 103, 104, 105, 106, 109, 110, 111, 112, 115, 117, 120, 124, 127, 130, 131, 132, 134, 135, 136, 137, 138, 139, 140, 141, 142, 143, 145, 146, 147, 148, 149, 150, 152, 154, 155, 156, 157, 158, 160, 161, 164, 166, 169, 170, 171, 172, 173, 174, 175, 176, 177, 178, 179, 181, 184, 185, 186, 187, 188, 189, 190, 191, 192, 194, 195, 196, 197, 199]"
Olaf,L50,middle,132,82,50,2,0.34,200,"[0, 1, 3, 4, 5, 6, 7, 8, 10, 13, 14, 15, 16, 17, 18, 19, 21, 22, 24, 28, 34, 35, 37, 38, 39, 41, 42, 43, 44, 45, 48, 49, 52, 53, 55, 56, 58, 59, 61, 63, 64, 65, 66, 67, 69, 70, 72, 73, 74, 75, 76, 78, 79, 81, 82, 83, 84, 88, 90, 91, 92, 94, 95, 97, 99, 102, 103, 104, 106, 108, 109, 110, 111, 112, 113, 115, 120, 122, 124, 126, 127, 129, 130, 131, 132, 134, 137, 139, 143, 145, 146, 147, 149, 150, 151, 152, 153, 154, 155, 156, 158, 159, 161, 162, 163, 164, 165, 166, 168, 169, 170, 171, 172, 174, 176, 180, 181, 182, 183, 184, 185, 187, 188, 189, 190, 191, 192, 193, 196, 197, 198, 199]"
Olaf,L50,middle,133,78,55,3,0.335,200,"[2, 3, 6, 7, 9, 10, 12, 13, 16, 18, 19, 20, 22, 24, 26, 27, 30, 31, 32, 34, 37, 38, 40, 43, 44, 45, 46, 47, 48, 50, 51, 52, 53, 54, 55, 56, 57, 58, 60, 62, 63, 64, 65, 66, 67, 68, 69, 70, 72, 73, 74, 75, 77, 79, 80, 83, 84, 85, 86, 88, 89, 91, 93, 95, 96, 97, 98, 99, 100, 101, 102, 103, 106, 107, 109, 110, 114, 115, 117, 118, 119, 120, 121, 122, 126, 127, 129, 130, 132, 136, 138, 139, 140, 141, 142, 143, 144, 146, 148, 149, 151, 152, 153, 154, 156, 157, 158, 159, 160, 161, 162, 163, 164, 165, 167, 170, 171, 172, 174, 175, 179, 181, 182, 183, 184, 185, 188, 191, 192, 194, 195, 198, 199]"
Olaf,L50,middle,128,70,58,8,0.36,200,"[0, 1, 2, 3, 4, 5, 6, 7, 8, 9, 11, 13, 14, 16, 17, 21, 22, 23, 24, 25, 27, 30, 32, 33, 36, 37, 38, 39, 41, 43, 44, 45, 47, 48, 49, 50, 52, 53, 54, 55, 57, 58, 59, 61, 63, 65, 66, 68, 70, 71, 72, 73, 75, 78, 79, 82, 84, 85, 87, 89, 90, 91, 92, 94, 95, 96, 97, 98, 100, 102, 103, 104, 105, 106, 107, 109, 110, 111, 114, 115, 116, 117, 118, 121, 123, 129, 130, 131, 132, 133, 135, 136, 137, 141, 142, 143, 145, 147, 148, 149, 150, 153, 154, 156, 158, 159, 163, 164, 165, 166, 169, 172, 173, 174, 175, 177, 179, 183, 185, 186, 188, 190, 191, 194, 195, 196, 197, 198]"
Olaf,L50,middle,123,56,67,6,0.385,200,"[0, 1, 3, 5, 7, 8, 9, 13, 14, 15, 16, 17, 18, 19, 20, 21, 22, 24, 26, 27, 28, 29, 30, 33, 34, 35, 39, 40, 41, 44, 46, 47, 48, 49, 52, 53, 54, 55, 57, 58, 60, 61, 62, 63, 64, 65, 66, 67, 68, 70, 75, 77, 78, 79, 80, 81, 82, 83, 84, 87, 89, 92, 93, 94, 99, 100, 101, 105, 107, 109, 111, 114, 116, 117, 118, 119, 122, 123, 124, 126, 127, 128, 129, 135, 138, 140, 141, 143, 144, 146, 150, 151, 153, 154, 158, 161, 162, 163, 165, 166, 167, 168, 169, 174, 176, 177, 178, 179, 180, 181, 183, 184, 186, 187, 188, 190, 191, 192, 194, 196, 197, 198, 199]"
Olaf,L50,middle,144,71,73,2,0.28,200,"[0, 3, 4, 5, 6, 7, 11, 12, 13, 14, 16, 17, 19, 20, 21, 22, 23, 25, 26, 27, 29, 30, 33, 37, 38, 39, 40, 41, 43, 44, 45, 46, 47, 48, 49, 51, 52, 53, 55, 56, 57, 58, 59, 60, 61, 62, 64, 65, 66, 67, 68, 69, 70, 72, 73, 75, 76, 77, 78, 80, 81, 82, 83, 84, 85, 86, 88, 92, 93, 95, 96, 98, 99, 100, 101, 102, 103, 104, 105, 106, 108, 109, 110, 111, 113, 114, 115, 117, 118, 121, 122, 123, 124, 127, 128, 130, 131, 132, 133, 134, 135, 136, 137, 139, 140, 141, 142, 143, 144, 145, 146, 147, 148, 149, 150, 151, 152, 156, 160, 162, 163, 164, 168, 171, 172, 173, 174, 175, 176, 177, 180, 181, 182, 183, 184, 185, 187, 189, 191, 192, 193, 196, 197, 199]"
Olaf,L50,middle,135,81,54,1,0.325,200,"[1, 2, 3, 4, 5, 6, 7, 8, 10, 11, 12, 15, 16, 18, 19, 20, 23, 25, 27, 30, 35, 36, 37, 38, 39, 40, 41, 42, 43, 44, 45, 46, 47, 48, 49, 50, 51, 53, 54, 61, 62, 66, 67, 68, 69, 70, 71, 72, 73, 77, 78, 79, 80, 81, 83, 84, 85, 87, 90, 93, 94, 96, 98, 99, 101, 102, 103, 104, 107, 110, 111, 113, 115, 116, 117, 118, 120, 121, 122, 123, 124, 125, 126, 127, 128, 129, 131, 134, 135, 136, 140, 142, 143, 144, 145, 147, 148, 149, 150, 152, 153, 154, 156, 157, 158, 159, 160, 161, 162, 163, 164, 165, 168, 169, 170, 172, 173, 175, 177, 179, 180, 181, 182, 184, 185, 186, 187, 188, 193, 194, 195, 196, 197, 198, 199]"
Olaf,L50,middle,132,54,78,3,0.34,200,"[2, 4, 6, 7, 8, 9, 14, 15, 16, 17, 18, 20, 24, 26, 27, 30, 31, 34, 37, 38, 39, 40, 41, 42, 44, 45, 46, 53, 54, 55, 56, 58, 60, 61, 62, 64, 66, 67, 68, 69, 70, 72, 73, 74, 75, 76, 79, 81, 83, 84, 88, 89, 90, 91, 93, 94, 95, 97, 98, 99, 102, 103, 105, 106, 107, 108, 110, 111, 112, 113, 114, 115, 118, 120, 123, 124, 125, 126, 128, 129, 131, 132, 134, 136, 138, 139, 142, 144, 145, 147, 148, 149, 150, 151, 152, 153, 155, 156, 158, 159, 160, 161, 162, 163, 164, 166, 167, 168, 169, 171, 172, 173, 177, 179, 180, 181, 182, 183, 184, 185, 186, 188, 189, 190, 191, 192, 193, 194, 195, 196, 198, 199]"
Olaf,L50,middle,140,66,74,6,0.3,200,"[0, 1, 2, 3, 4, 5, 6, 9, 10, 11, 13, 14, 15, 16, 17, 18, 19, 20, 21, 22, 24, 26, 27, 29, 30, 31, 33, 34, 36, 37, 38, 39, 40, 42, 43, 45, 46, 49, 51, 53, 54, 55, 56, 57, 59, 62, 64, 65, 66, 69, 70, 71, 73, 74, 75, 76, 77, 78, 80, 81, 82, 83, 84, 85, 86, 88, 89, 90, 92, 93, 94, 95, 96, 97, 98, 99, 100, 102, 105, 106, 107, 108, 110, 112, 113, 115, 116, 117, 118, 119, 120, 124, 127, 128, 129, 130, 132, 135, 136, 137, 138, 139, 140, 141, 142, 143, 145, 146, 147, 148, 150, 151, 152, 154, 155, 156, 157, 160, 162, 163, 164, 165, 167, 168, 169, 170, 173, 174, 176, 177, 178, 180, 184, 187, 189, 190, 191, 193, 194, 197]"
Olaf,L50,middle,124,51,73,7,0.38,200,"[2, 3, 5, 6, 7, 9, 11, 13, 15, 18, 19, 20, 21, 25, 26, 27, 28, 30, 32, 33, 34, 35, 36, 37, 38, 39, 41, 43, 44, 47, 48, 49, 50, 52, 53, 56, 59, 60, 61, 63, 64, 66, 68, 69, 70, 74, 75, 76, 77, 78, 79, 80, 83, 84, 88, 90, 91, 92, 93, 95, 96, 98, 99, 100, 102, 103, 104, 105, 106, 108, 109, 110, 113, 114, 115, 117, 119, 120, 121, 122, 123, 124, 125, 127, 128, 130, 131, 132, 133, 134, 136, 139, 141, 142, 144, 145, 146, 149, 151, 153, 154, 155, 157, 158, 160, 161, 162, 166, 167, 168, 169, 170, 171, 172, 173, 174, 184, 185, 188, 189, 195, 196, 198, 199]"
Olaf,L50,middle,128,76,52,2,0.36,200,"[1, 2, 3, 4, 5, 8, 10, 11, 12, 13, 14, 15, 16, 17, 19, 21, 22, 25, 26, 31, 32, 33, 34, 35, 37, 38, 39, 40, 41, 43, 44, 45, 46, 47, 49, 50, 51, 52, 53, 55, 56, 59, 60, 61, 62, 63, 67, 68, 70, 72, 73, 74, 76, 77, 78, 79, 80, 83, 84, 85, 87, 93, 94, 96, 98, 99, 100, 102, 103, 105, 106, 107, 108, 109, 110, 113, 114, 115, 116, 117, 120, 121, 122, 123, 124, 125, 129, 131, 133, 134, 135, 137, 138, 141, 142, 143, 144, 145, 149, 151, 152, 154, 155, 157, 158, 159, 160, 161, 165, 166, 167, 168, 170, 172, 173, 176, 177, 178, 182, 183, 184, 185, 186, 190, 191, 194, 196, 197]"
Olaf,L50,middle,141,88,53,5,0.295,200,"[2, 3, 4, 5, 6, 7, 11, 12, 13, 14, 15, 16, 17, 18, 19, 20, 21, 22, 24, 26, 27, 28, 29, 32, 33, 34, 36, 37, 38, 39, 40, 42, 45, 46, 47, 48, 52, 53, 54, 55, 57, 58, 59, 60, 64, 65, 67, 69, 71, 72, 75, 76, 77, 78, 79, 83, 84, 85, 86, 87, 88, 89, 90, 91, 92, 93, 94, 95, 96, 98, 100, 102, 104, 105, 106, 108, 109, 111, 112, 113, 114, 116, 117, 118, 119, 120, 121, 124, 126, 127, 128, 129, 130, 131, 134, 135, 136, 137, 138, 139, 140, 141, 142, 143, 144, 146, 147, 151, 152, 154, 155, 156, 157, 158, 161, 163, 165, 166, 167, 168, 169, 170, 171, 172, 174, 175, 176, 177, 179, 180, 181, 182, 184, 185, 186, 190, 191, 195, 196, 197, 199]"
Olaf,L50,middle,125,68,57,6,0.375,200,"[1, 2, 3, 4, 5, 8, 9, 10, 11, 13, 15, 16, 17, 20, 21, 22, 23, 25, 27, 28, 32, 33, 34, 37, 38, 39, 41, 42, 43, 44, 48, 51, 53, 55, 57, 58, 60, 62, 63, 64, 65, 67, 68, 70, 72, 73, 74, 79, 80, 81, 83, 84, 86, 88, 89, 90, 91, 92, 93, 95, 96, 98, 99, 100, 101, 106, 110, 113, 114, 116, 117, 119, 120, 121, 122, 123, 127, 128, 129, 131, 132, 133, 137, 138, 140, 141, 142, 143, 144, 145, 146, 148, 150, 151, 153, 154, 155, 157, 159, 162, 164, 165, 166, 169, 170, 171, 173, 174, 175, 176, 177, 179, 181, 182, 183, 184, 185, 186, 190, 192, 194, 196, 197, 198, 199]"
Olaf,L50,middle,141,66,75,5,0.295,200,"[0, 1, 3, 5, 7, 8, 9, 11, 13, 14, 15, 17, 18, 19, 20, 22, 23, 24, 25, 26, 27, 28, 29, 30, 32, 33, 34, 35, 36, 38, 39, 40, 41, 42, 43, 44, 45, 47, 49, 55, 56, 58, 60, 62, 64, 65, 66, 67, 68, 69, 71, 72, 73, 74, 75, 76, 77, 79, 80, 81, 82, 83, 85, 87, 88, 89, 90, 92, 94, 95, 96, 98, 99, 101, 103, 104, 109, 110, 111, 112, 113, 115, 116, 118, 120, 121, 124, 125, 127, 128, 129, 130, 131, 132, 133, 134, 135, 136, 137, 138, 139, 140, 141, 143, 144, 145, 146, 147, 148, 149, 150, 151, 154, 155, 156, 157, 158, 159, 160, 164, 165, 166, 168, 173, 174, 175, 176, 178, 179, 180, 181, 182, 184, 186, 187, 189, 190, 192, 193, 197, 199]"
Olaf,L50,middle,139,66,73,4,0.305,200,"[0, 2, 5, 7, 8, 9, 10, 11, 13, 14, 16, 18, 19, 21, 22, 24, 25, 26, 27, 29, 30, 31, 32, 35, 36, 37, 41, 42, 43, 44, 45, 46, 48, 50, 52, 53, 54, 56, 57, 58, 59, 60, 61, 62, 64, 65, 66, 67, 70, 71, 72, 75, 78, 79, 80, 81, 82, 83, 84, 86, 87, 88, 90, 91, 92, 93, 95, 96, 97, 99, 100, 101, 103, 104, 105, 106, 107, 108, 109, 110, 111, 112, 113, 115, 117, 120, 121, 122, 124, 125, 126, 128, 129, 130, 133, 135, 136, 137, 139, 140, 142, 143, 144, 145, 146, 147, 148, 150, 151, 153, 155, 156, 157, 159, 160, 162, 165, 167, 168, 169, 171, 173, 175, 176, 177, 178, 179, 180, 181, 182, 183, 184, 185, 186, 187, 190, 192, 196, 199]"
Olaf,L50,middle,126,57,69,2,0.37,200,"[1, 4, 7, 8, 9, 10, 11, 12, 13, 15, 16, 19, 20, 21, 22, 24, 25, 26, 28, 29, 30, 33, 34, 35, 36, 38, 41, 42, 45, 46, 47, 48, 50, 53, 54, 57, 59, 60, 61, 62, 63, 69, 70, 73, 75, 76, 77, 78, 82, 83, 84, 85, 86, 88, 92, 93, 97, 98, 99, 101, 102, 103, 105, 106, 107, 108, 109, 110, 115, 116, 118, 119, 120, 121, 122, 123, 124, 125, 126, 127, 128, 130, 132, 133, 134, 135, 136, 138, 139, 141, 142, 145, 146, 148, 150, 151, 153, 155, 156, 157, 159, 161, 163, 165, 166, 167, 168, 169, 171, 172, 173, 174, 176, 177, 181, 182, 185, 186, 188, 190, 191, 192, 194, 195, 196, 199]"
Olaf,L50,middle,137,71,66,1,0.315,200,"[0, 1, 2, 3, 6, 7, 8, 9, 11, 12, 13, 15, 17, 19, 21, 22, 25, 26, 28, 29, 30, 31, 32, 33, 36, 37, 39, 40, 41, 42, 45, 46, 47, 48, 49, 50, 52, 53, 54, 56, 58, 60, 62, 63, 64, 65, 66, 68, 69, 70, 71, 72, 73, 74, 76, 77, 78, 79, 82, 83, 85, 86, 87, 88, 90, 95, 96, 97, 100, 101, 102, 103, 105, 106, 107, 108, 109, 115, 116, 117, 118, 119, 120, 121, 122, 123, 125, 126, 129, 130, 131, 132, 134, 135, 138, 139, 140, 141, 142, 143, 144, 146, 147, 149, 150, 151, 152, 153, 154, 155, 156, 157, 160, 162, 163, 164, 165, 168, 169, 170, 171, 172, 174, 175, 177, 179, 185, 186, 189, 190, 191, 192, 193, 195, 196, 197, 198]"
Olaf,L50,middle,128,73,55,9,0.36,200,"[0, 1, 2, 3, 5, 6, 8, 11, 12, 14, 15, 16, 17, 18, 21, 23, 24, 25, 26, 27, 28, 29, 30, 31, 32, 33, 36, 38, 39, 41, 44, 45, 46, 47, 48, 50, 52, 53, 54, 55, 57, 59, 60, 61, 62, 64, 66, 67, 68, 69, 72, 73, 75, 77, 78, 82, 83, 84, 85, 87, 89, 90, 91, 93, 95, 96, 97, 98, 102, 103, 104, 105, 106, 107, 108, 111, 112, 114, 115, 119, 121, 122, 123, 124, 127, 129, 130, 131, 132, 133, 134, 135, 136, 138, 139, 140, 142, 143, 144, 146, 149, 150, 152, 155, 157, 160, 161, 162, 163, 164, 165, 166, 167, 168, 169, 170, 173, 175, 176, 183, 185, 189, 190, 191, 192, 194, 195, 197]"
Olaf,L50,middle,137,76,61,2,0.315,200,"[0, 1, 2, 3, 5, 6, 9, 11, 13, 14, 16, 19, 20, 21, 23, 24, 31, 32, 34, 35, 36, 37, 40, 41, 42, 44, 45, 46, 47, 49, 50, 51, 52, 53, 54, 55, 56, 57, 58, 60, 62, 63, 64, 65, 66, 67, 69, 70, 71, 74, 75, 76, 77, 78, 79, 80, 81, 82, 84, 85, 86, 87, 88, 91, 94, 95, 96, 97, 102, 103, 104, 105, 108, 109, 110, 112, 114, 115, 117, 118, 119, 121, 122, 124, 128, 129, 131, 132, 133, 134, 135, 137, 138, 139, 140, 141, 143, 144, 145, 146, 147, 149, 150, 151, 153, 154, 155, 156, 158, 160, 161, 162, 163, 164, 165, 167, 168, 169, 170, 171, 172, 173, 175, 176, 179, 180, 182, 184, 185, 186, 188, 189, 190, 192, 194, 195, 197]"
Olaf,L50,middle,131,62,69,1,0.345,200,"[0, 2, 3, 7, 8, 9, 10, 11, 12, 14, 16, 17, 19, 20, 21, 22, 23, 28, 30, 31, 32, 33, 34, 35, 37, 38, 40, 41, 44, 47, 48, 49, 50, 51, 52, 53, 54, 55, 57, 58, 59, 60, 61, 63, 64, 67, 68, 69, 70, 71, 74, 75, 76, 79, 80, 81, 82, 83, 84, 85, 87, 88, 89, 91, 92, 94, 98, 99, 100, 101, 102, 103, 106, 108, 109, 110, 113, 114, 115, 116, 117, 119, 120, 121, 124, 126, 128, 130, 138, 139, 141, 142, 143, 146, 147, 148, 150, 151, 153, 155, 156, 157, 159, 160, 162, 166, 167, 168, 169, 170, 173, 174, 175, 176, 177, 179, 180, 181, 182, 183, 185, 186, 188, 189, 190, 192, 193, 194, 195, 198, 199]"
Olaf,L50,middle,139,90,49,3,0.305,200,"[1, 3, 4, 6, 7, 9, 12, 13, 15, 18, 19, 23, 26, 27, 28, 29, 31, 32, 34, 36, 38, 39, 40, 41, 42, 43, 44, 45, 47, 51, 52, 54, 55, 56, 57, 58, 60, 61, 62, 67, 68, 69, 72, 73, 74, 77, 79, 80, 81, 82, 83, 84, 85, 86, 87, 88, 89, 91, 93, 95, 96, 97, 98, 99, 100, 101, 102, 103, 104, 105, 106, 107, 109, 110, 111, 112, 116, 117, 118, 119, 120, 123, 125, 127, 129, 130, 131, 132, 134, 136, 137, 139, 141, 142, 143, 144, 146, 148, 149, 150, 151, 154, 155, 156, 157, 158, 159, 160, 161, 162, 163, 164, 166, 168, 169, 170, 172, 173, 174, 176, 177, 178, 179, 180, 181, 182, 183, 186, 188, 189, 191, 192, 193, 194, 195, 196, 197, 198, 199]"
Olaf,L50,middle,135,67,68,4,0.325,200,"[0, 1, 2, 3, 4, 5, 7, 9, 10, 11, 12, 13, 14, 15, 16, 17, 20, 23, 25, 26, 27, 28, 29, 31, 32, 33, 34, 35, 36, 37, 38, 39, 40, 42, 43, 45, 48, 49, 50, 52, 54, 57, 59, 62, 63, 64, 67, 68, 69, 70, 71, 72, 73, 75, 76, 77, 78, 80, 81, 82, 83, 85, 88, 90, 91, 92, 97, 98, 99, 101, 102, 103, 104, 106, 107, 109, 110, 112, 114, 115, 117, 119, 120, 122, 123, 124, 125, 126, 127, 128, 129, 131, 132, 135, 136, 137, 138, 139, 140, 141, 143, 148, 150, 151, 152, 156, 157, 160, 161, 162, 165, 166, 167, 169, 170, 171, 172, 173, 176, 177, 179, 180, 182, 183, 184, 185, 187, 188, 189, 190, 192, 194, 196, 198, 199]"
Olaf,L50,middle,129,74,55,2,0.355,200,"[0, 1, 2, 3, 4, 5, 6, 7, 9, 10, 11, 12, 13, 14, 16, 18, 19, 21, 23, 24, 25, 26, 27, 28, 33, 36, 39, 40, 41, 46, 47, 48, 51, 52, 53, 54, 55, 56, 57, 60, 61, 62, 63, 64, 65, 66, 67, 68, 69, 70, 71, 72, 76, 78, 81, 85, 86, 88, 89, 90, 91, 93, 94, 96, 97, 99, 100, 102, 103, 104, 105, 107, 109, 110, 112, 113, 115, 118, 119, 120, 121, 122, 124, 125, 126, 127, 129, 131, 132, 133, 136, 137, 138, 140, 142, 143, 144, 146, 147, 149, 153, 154, 155, 156, 157, 158, 159, 160, 163, 164, 167, 173, 175, 176, 177, 178, 179, 180, 181, 182, 183, 184, 185, 187, 188, 191, 193, 197, 199]"
Olaf,L50,middle,142,77,65,6,0.29,200,"[0, 1, 2, 3, 4, 6, 7, 10, 12, 13, 14, 15, 16, 17, 18, 19, 20, 21, 22, 26, 27, 28, 29, 30, 32, 33, 34, 35, 36, 40, 41, 43, 45, 46, 47, 48, 49, 50, 51, 52, 53, 54, 55, 58, 60, 62, 63, 64, 66, 67, 68, 69, 71, 72, 73, 74, 78, 80, 81, 82, 83, 86, 87, 89, 90, 92, 93, 94, 95, 96, 97, 99, 100, 101, 102, 105, 106, 107, 108, 109, 110, 112, 113, 115, 118, 119, 120, 123, 124, 125, 126, 127, 129, 130, 131, 133, 134, 135, 136, 137, 139, 140, 142, 144, 145, 148, 149, 152, 154, 155, 158, 159, 160, 163, 164, 165, 166, 167, 169, 170, 171, 172, 175, 176, 177, 178, 179, 182, 184, 185, 186, 187, 188, 189, 190, 191, 192, 193, 194, 197, 198, 199]"
Olaf,L50,middle,125,57,68,5,0.375,200,"[0, 1, 2, 4, 9, 10, 11, 13, 14, 15, 17, 18, 19, 20, 24, 25, 26, 27, 31, 32, 33, 34, 35, 37, 38, 41, 42, 43, 46, 47, 48, 51, 54, 55, 56, 58, 59, 60, 62, 63, 64, 65, 66, 67, 68, 70, 74, 75, 76, 77, 78, 79, 82, 83, 84, 85, 88, 89, 90, 92, 94, 95, 97, 98, 99, 102, 103, 104, 105, 107, 109, 112, 113, 116, 117, 118, 119, 120, 121, 122, 123, 124, 125, 126, 127, 128, 129, 130, 132, 136, 138, 140, 141, 142, 143, 145, 147, 151, 152, 153, 154, 155, 157, 158, 164, 165, 166, 171, 172, 173, 175, 177, 178, 179, 180, 183, 187, 188, 189, 190, 191, 193, 194, 196, 199]"
Olaf,L50,middle,131,69,62,6,0.345,200,"[0, 2, 4, 6, 7, 9, 10, 11, 12, 13, 14, 15, 16, 17, 18, 19, 20, 21, 22, 23, 30, 31, 33, 36, 37, 39, 40, 42, 43, 44, 46, 47, 48, 49, 51, 53, 54, 55, 56, 58, 62, 64, 66, 67, 68, 70, 71, 73, 74, 76, 81, 83, 84, 85, 87, 88, 89, 90, 93, 94, 95, 96, 97, 98, 99, 101, 103, 104, 105, 106, 107, 111, 112, 113, 114, 115, 116, 117, 120, 121, 123, 124, 125, 127, 129, 131, 132, 133, 134, 135, 136, 137, 138, 140, 141, 142, 143, 144, 145, 146, 147, 148, 149, 150, 152, 153, 155, 157, 159, 161, 163, 166, 167, 168, 169, 170, 172, 174, 176, 180, 181, 185, 186, 187, 188, 190, 191, 192, 193, 196, 198]"
Olaf,L50,middle,134,63,71,6,0.33,200,"[0, 2, 3, 5, 6, 7, 8, 9, 10, 11, 12, 14, 15, 21, 22, 23, 24, 26, 27, 28, 29, 31, 33, 34, 35, 36, 38, 39, 41, 44, 45, 50, 51, 52, 54, 56, 58, 60, 61, 64, 66, 68, 69, 70, 71, 72, 73, 75, 77, 78, 79, 80, 81, 82, 83, 84, 85, 86, 87, 89, 91, 93, 94, 95, 96, 98, 100, 101, 102, 107, 108, 109, 110, 111, 112, 113, 115, 116, 117, 118, 119, 120, 121, 122, 123, 125, 129, 130, 131, 133, 134, 135, 136, 137, 139, 141, 143, 145, 146, 147, 148, 149, 151, 153, 155, 157, 159, 160, 161, 162, 163, 164, 165, 167, 168, 169, 170, 176, 181, 182, 184, 186, 187, 188, 189, 190, 191, 192, 194, 195, 196, 197, 198, 199]"
Olaf,L50,middle,124,56,68,2,0.38,200,"[1, 2, 3, 4, 5, 6, 7, 9, 11, 12, 13, 14, 15, 16, 18, 19, 21, 24, 25, 28, 29, 30, 31, 32, 33, 34, 37, 39, 41, 43, 44, 46, 49, 52, 54, 56, 57, 58, 59, 60, 61, 62, 63, 66, 69, 71, 72, 74, 75, 76, 78, 79, 80, 83, 84, 85, 86, 87, 89, 90, 92, 95, 98, 99, 100, 102, 104, 106, 108, 109, 112, 115, 117, 119, 122, 124, 126, 127, 129, 131, 132, 135, 141, 142, 143, 144, 145, 147, 148, 149, 151, 153, 154, 155, 156, 158, 159, 160, 161, 165, 166, 167, 168, 171, 172, 174, 177, 178, 179, 180, 181, 182, 183, 184, 185, 187, 188, 189, 192, 193, 194, 196, 197, 198]"
Olaf,L50,middle,132,83,49,2,0.34,200,"[1, 2, 3, 4, 5, 6, 7, 8, 9, 12, 14, 19, 20, 23, 24, 26, 28, 29, 32, 33, 34, 35, 36, 38, 39, 40, 41, 43, 44, 45, 48, 49, 50, 53, 54, 55, 56, 57, 59, 60, 63, 64, 69, 71, 72, 73, 74, 75, 77, 78, 79, 80, 81, 82, 83, 85, 89, 90, 92, 93, 94, 96, 97, 98, 100, 101, 102, 103, 104, 105, 106, 107, 110, 111, 113, 118, 119, 120, 121, 123, 125, 129, 130, 131, 132, 133, 134, 137, 139, 141, 142, 144, 145, 146, 147, 148, 149, 151, 152, 153, 154, 155, 156, 157, 158, 161, 163, 164, 165, 166, 167, 168, 171, 172, 174, 175, 177, 180, 181, 182, 184, 185, 186, 187, 188, 190, 192, 195, 196, 197, 198, 199]"
Olaf,L50,middle,125,46,79,4,0.375,200,"[1, 2, 3, 5, 6, 7, 9, 10, 11, 14, 16, 17, 18, 19, 24, 26, 27, 30, 31, 32, 33, 34, 35, 36, 37, 38, 39, 40, 42, 43, 44, 45, 46, 47, 48, 49, 50, 51, 55, 59, 60, 64, 65, 66, 69, 71, 73, 75, 76, 77, 80, 81, 82, 84, 85, 86, 89, 90, 92, 93, 94, 95, 96, 97, 98, 100, 101, 102, 103, 104, 105, 106, 107, 108, 110, 111, 112, 113, 114, 115, 117, 119, 120, 121, 124, 126, 127, 128, 136, 137, 139, 141, 142, 143, 145, 147, 148, 151, 152, 153, 154, 155, 158, 159, 162, 163, 165, 166, 167, 170, 171, 177, 178, 179, 180, 182, 183, 184, 185, 186, 187, 189, 190, 193, 194]"
Olaf,L50,middle,140,71,69,4,0.3,200,"[0, 1, 3, 4, 5, 6, 7, 9, 10, 11, 13, 14, 15, 16, 17, 18, 19, 20, 21, 23, 27, 28, 30, 32, 33, 34, 35, 38, 39, 40, 41, 42, 43, 44, 45, 46, 47, 48, 50, 52, 54, 56, 58, 59, 60, 61, 63, 64, 66, 68, 70, 71, 72, 73, 74, 75, 76, 77, 78, 79, 80, 81, 82, 83, 84, 85, 86, 87, 89, 90, 92, 94, 96, 98, 99, 100, 101, 102, 103, 104, 108, 111, 114, 115, 120, 121, 124, 125, 126, 127, 129, 130, 131, 132, 133, 134, 135, 136, 137, 140, 142, 144, 146, 147, 148, 149, 150, 152, 153, 154, 156, 158, 159, 160, 161, 162, 164, 165, 166, 167, 170, 171, 173, 174, 175, 176, 177, 178, 179, 180, 181, 183, 184, 187, 188, 189, 190, 191, 194, 199]"
Olaf,L50,middle,129,68,61,4,0.355,200,"[1, 3, 4, 6, 7, 8, 10, 12, 14, 15, 16, 18, 19, 21, 22, 23, 24, 27, 29, 31, 32, 33, 34, 35, 37, 39, 40, 42, 44, 49, 52, 56, 57, 58, 61, 62, 63, 65, 66, 67, 69, 71, 72, 75, 80, 81, 82, 84, 86, 89, 91, 93, 94, 95, 96, 98, 99, 100, 102, 103, 105, 106, 107, 109, 110, 111, 112, 117, 118, 122, 123, 124, 125, 127, 128, 129, 130, 131, 133, 134, 135, 137, 138, 139, 140, 141, 142, 143, 144, 145, 146, 147, 151, 153, 154, 155, 156, 157, 158, 159, 160, 161, 163, 164, 169, 171, 172, 174, 176, 177, 178, 180, 181, 182, 183, 185, 186, 187, 188, 189, 191, 192, 193, 194, 195, 196, 197, 198, 199]"
Olaf,L50,middle,134,66,68,3,0.33,200,"[0, 1, 2, 3, 4, 6, 7, 8, 10, 12, 13, 14, 15, 16, 17, 18, 21, 22, 23, 24, 25, 26, 28, 29, 30, 33, 35, 39, 40, 42, 43, 44, 46, 47, 48, 49, 51, 52, 53, 54, 56, 57, 59, 61, 62, 63, 64, 66, 69, 70, 72, 73, 75, 77, 79, 80, 81, 82, 83, 84, 85, 87, 88, 89, 91, 92, 93, 94, 95, 96, 98, 99, 101, 102, 103, 104, 105, 109, 110, 111, 112, 114, 116, 117, 118, 119, 120, 121, 122, 123, 124, 125, 128, 130, 131, 132, 134, 137, 139, 141, 142, 143, 144, 146, 149, 153, 155, 157, 158, 159, 161, 162, 164, 165, 167, 168, 169, 170, 172, 174, 175, 178, 179, 182, 184, 185, 188, 189, 191, 192, 193, 196, 198, 199]"
Olaf,L50,middle,135,38,97,4,0.325,200,"[5, 7, 8, 10, 11, 12, 13, 14, 15, 16, 17, 18, 19, 23, 25, 27, 28, 30, 32, 33, 34, 35, 36, 38, 39, 40, 41, 42, 43, 44, 46, 48, 49, 51, 53, 54, 55, 57, 59, 62, 64, 67, 72, 73, 74, 76, 77, 78, 79, 80, 81, 82, 83, 84, 85, 87, 89, 91, 93, 94, 96, 98, 101, 102, 104, 105, 107, 109, 110, 111, 113, 114, 115, 116, 118, 119, 121, 122, 123, 124, 125, 127, 128, 130, 131, 132, 133, 134, 135, 137, 138, 139, 140, 141, 143, 144, 146, 147, 148, 149, 150, 153, 156, 157, 159, 160, 161, 162, 163, 164, 166, 167, 168, 169, 172, 173, 174, 178, 179, 181, 182, 183, 184, 185, 186, 187, 188, 189, 190, 191, 192, 193, 194, 195, 197]"
Olaf,L50,middle,129,81,48,6,0.355,200,"[0, 2, 3, 7, 8, 9, 10, 12, 13, 14, 16, 17, 18, 19, 22, 23, 25, 26, 28, 29, 30, 32, 33, 34, 35, 36, 37, 39, 40, 41, 43, 44, 45, 46, 48, 49, 51, 52, 53, 54, 56, 57, 58, 59, 60, 61, 62, 63, 64, 65, 67, 68, 69, 70, 71, 73, 74, 76, 77, 78, 80, 81, 83, 84, 88, 89, 93, 95, 97, 98, 100, 103, 104, 105, 106, 110, 111, 113, 114, 119, 123, 124, 126, 127, 129, 130, 132, 134, 135, 137, 138, 139, 141, 142, 143, 144, 146, 147, 148, 151, 152, 153, 154, 155, 158, 160, 162, 163, 167, 170, 171, 172, 173, 174, 177, 180, 184, 185, 186, 187, 189, 192, 193, 194, 195, 196, 197, 198, 199]"
Olaf,L50,middle,134,87,47,3,0.33,200,"[0, 1, 2, 3, 4, 5, 6, 8, 9, 10, 13, 14, 15, 17, 18, 19, 20, 21, 23, 24, 25, 26, 27, 28, 29, 30, 31, 34, 38, 40, 44, 45, 47, 48, 49, 51, 52, 54, 55, 56, 57, 58, 59, 60, 61, 64, 65, 66, 67, 68, 69, 70, 72, 74, 75, 76, 77, 78, 79, 80, 82, 83, 84, 85, 86, 87, 88, 89, 91, 93, 95, 96, 97, 99, 105, 107, 109, 110, 111, 115, 116, 118, 121, 122, 124, 125, 126, 127, 129, 130, 132, 133, 134, 135, 137, 139, 141, 142, 143, 144, 148, 149, 151, 152, 153, 154, 156, 160, 161, 162, 163, 166, 167, 168, 170, 171, 172, 174, 175, 177, 179, 180, 181, 183, 185, 186, 187, 188, 189, 190, 192, 196, 198, 199]"
Olaf,L50,middle,130,58,72,2,0.35,200,"[5, 6, 7, 9, 11, 12, 14, 16, 17, 21, 22, 23, 24, 25, 26, 28, 29, 30, 31, 32, 33, 35, 36, 37, 38, 43, 44, 47, 48, 51, 52, 53, 54, 56, 57, 59, 60, 62, 63, 64, 65, 66, 67, 68, 69, 70, 71, 72, 73, 74, 76, 77, 78, 83, 84, 85, 88, 90, 91, 92, 93, 94, 97, 98, 99, 100, 101, 104, 105, 106, 108, 109, 110, 113, 115, 116, 117, 119, 122, 124, 125, 127, 129, 133, 134, 135, 136, 137, 138, 140, 145, 146, 147, 148, 149, 150, 154, 155, 156, 157, 158, 159, 161, 162, 163, 164, 165, 166, 168, 171, 172, 173, 174, 175, 176, 179, 180, 181, 182, 184, 186, 187, 188, 189, 190, 191, 192, 193, 196, 199]"
Olaf,L50,middle,140,58,82,4,0.3,200,"[0, 1, 2, 4, 5, 8, 9, 11, 13, 14, 15, 18, 20, 21, 23, 24, 25, 26, 27, 28, 30, 32, 33, 34, 35, 36, 37, 39, 41, 42, 44, 46, 47, 51, 53, 56, 57, 58, 59, 61, 63, 64, 65, 66, 67, 68, 70, 72, 73, 74, 77, 78, 80, 81, 82, 83, 85, 86, 87, 88, 89, 91, 93, 94, 95, 96, 99, 100, 102, 103, 104, 105, 107, 109, 110, 112, 114, 115, 116, 117, 118, 119, 120, 121, 122, 124, 125, 126, 127, 128, 129, 130, 131, 132, 133, 134, 136, 137, 138, 139, 142, 143, 144, 145, 146, 147, 150, 153, 154, 155, 156, 157, 158, 159, 160, 161, 162, 164, 166, 167, 168, 170, 172, 174, 175, 176, 177, 178, 179, 181, 183, 184, 185, 186, 188, 190, 191, 193, 194, 198]"
Olaf,L50,middle,146,90,56,7,0.27,200,"[0, 1, 3, 5, 6, 7, 9, 11, 12, 13, 14, 15, 17, 18, 19, 20, 21, 22, 24, 25, 26, 27, 28, 29, 31, 32, 33, 35, 36, 37, 38, 40, 41, 42, 43, 44, 45, 46, 47, 48, 49, 51, 54, 55, 56, 58, 59, 62, 64, 65, 66, 67, 68, 71, 72, 73, 75, 76, 77, 78, 80, 81, 84, 85, 86, 87, 88, 89, 90, 92, 93, 94, 96, 97, 100, 101, 102, 103, 104, 106, 107, 108, 109, 110, 111, 113, 114, 115, 117, 120, 121, 122, 123, 124, 125, 127, 128, 129, 134, 135, 137, 142, 143, 144, 145, 146, 147, 148, 149, 150, 151, 152, 153, 154, 157, 159, 160, 161, 162, 163, 164, 166, 167, 168, 169, 170, 171, 172, 174, 176, 177, 179, 181, 182, 183, 184, 185, 186, 187, 188, 191, 192, 194, 195, 197, 199]"
Olaf,L50,middle,121,67,54,6,0.395,200,"[0, 1, 2, 3, 4, 7, 10, 12, 13, 15, 16, 19, 20, 21, 22, 24, 25, 27, 28, 29, 30, 32, 33, 35, 36, 37, 38, 40, 44, 46, 48, 49, 50, 52, 54, 56, 57, 58, 60, 62, 63, 64, 65, 66, 67, 68, 69, 70, 71, 74, 75, 76, 77, 78, 79, 80, 81, 83, 84, 88, 89, 90, 91, 92, 93, 94, 98, 99, 103, 105, 107, 109, 111, 113, 115, 117, 119, 120, 122, 124, 125, 126, 128, 129, 133, 135, 136, 137, 138, 139, 140, 145, 147, 148, 150, 151, 152, 155, 159, 160, 161, 162, 163, 164, 166, 171, 173, 175, 177, 178, 181, 184, 185, 186, 189, 190, 191, 192, 193, 194, 197]"
Olaf,L50,middle,117,57,60,9,0.415,200,"[1, 2, 5, 8, 11, 14, 15, 16, 17, 18, 19, 20, 23, 24, 25, 26, 29, 30, 33, 34, 35, 36, 45, 49, 52, 53, 54, 55, 56, 58, 61, 62, 63, 65, 67, 68, 69, 72, 73, 74, 75, 76, 79, 81, 82, 83, 85, 86, 87, 89, 90, 91, 92, 93, 94, 95, 96, 97, 98, 100, 101, 103, 107, 108, 109, 110, 112, 113, 115, 117, 121, 126, 127, 128, 130, 132, 133, 135, 138, 139, 140, 144, 146, 148, 149, 150, 151, 152, 154, 155, 156, 157, 158, 159, 160, 161, 162, 167, 168, 170, 171, 172, 173, 175, 180, 183, 184, 185, 187, 189, 190, 191, 194, 195, 196, 197, 199]"
Olaf,L50,middle,142,93,49,5,0.29,200,"[0, 1, 2, 3, 4, 7, 8, 9, 10, 11, 12, 14, 15, 16, 17, 20, 21, 22, 23, 24, 26, 29, 30, 31, 32, 33, 35, 36, 37, 38, 39, 40, 41, 42, 43, 44, 46, 49, 50, 51, 52, 53, 54, 55, 56, 57, 59, 60, 61, 62, 63, 67, 68, 70, 71, 73, 75, 76, 77, 78, 79, 80, 81, 83, 84, 85, 87, 88, 89, 92, 94, 95, 96, 97, 100, 102, 104, 105, 106, 107, 108, 110, 111, 112, 113, 114, 115, 118, 119, 120, 121, 124, 125, 126, 127, 130, 131, 132, 134, 135, 136, 138, 139, 141, 142, 143, 144, 145, 146, 147, 148, 151, 152, 153, 154, 155, 156, 157, 159, 160, 161, 162, 163, 167, 168, 169, 170, 173, 176, 178, 180, 181, 183, 184, 186, 189, 190, 191, 192, 194, 196, 199]"
Olaf,L50,middle,130,71,59,6,0.35,200,"[3, 4, 5, 6, 8, 9, 10, 11, 12, 16, 19, 21, 23, 24, 25, 26, 27, 28, 29, 30, 31, 32, 33, 35, 36, 37, 38, 40, 41, 42, 43, 45, 47, 48, 50, 51, 53, 54, 55, 56, 58, 59, 63, 64, 65, 68, 69, 70, 71, 72, 73, 74, 76, 77, 78, 82, 83, 90, 92, 93, 94, 95, 97, 98, 99, 100, 101, 103, 105, 106, 107, 109, 112, 113, 114, 115, 116, 117, 118, 119, 120, 122, 124, 126, 127, 128, 130, 131, 136, 137, 139, 140, 141, 142, 144, 147, 148, 149, 150, 151, 153, 154, 155, 156, 160, 161, 163, 166, 167, 168, 170, 172, 173, 174, 175, 176, 177, 179, 180, 181, 182, 184, 187, 188, 190, 191, 195, 197, 198, 199]"
Olaf,L50,middle,130,64,66,8,0.35,200,"[1, 3, 5, 6, 7, 8, 9, 11, 12, 13, 14, 15, 16, 17, 18, 19, 20, 21, 23, 24, 25, 26, 28, 29, 31, 32, 33, 36, 39, 44, 45, 47, 48, 50, 52, 53, 55, 56, 57, 59, 63, 64, 66, 68, 69, 74, 75, 76, 77, 78, 79, 80, 81, 84, 85, 86, 88, 89, 91, 93, 98, 99, 100, 101, 102, 103, 104, 106, 107, 109, 110, 111, 112, 113, 114, 115, 116, 118, 121, 122, 124, 125, 128, 130, 131, 134, 136, 137, 138, 139, 141, 142, 143, 146, 148, 149, 150, 151, 153, 154, 155, 156, 157, 159, 160, 161, 163, 167, 169, 170, 171, 172, 175, 176, 177, 178, 179, 182, 183, 184, 185, 188, 189, 190, 191, 193, 194, 195, 198, 199]"
Olaf,L50,middle,144,73,71,2,0.28,200,"[1, 2, 3, 4, 6, 7, 9, 10, 11, 12, 14, 16, 17, 18, 19, 20, 21, 24, 25, 26, 27, 29, 32, 33, 34, 35, 36, 37, 39, 40, 42, 43, 44, 45, 47, 52, 54, 55, 56, 57, 58, 60, 61, 62, 63, 64, 65, 68, 69, 70, 71, 72, 77, 78, 79, 80, 81, 82, 84, 85, 86, 87, 89, 90, 91, 94, 96, 97, 98, 99, 100, 101, 102, 103, 104, 105, 106, 107, 109, 110, 111, 112, 114, 116, 117, 118, 119, 120, 121, 122, 124, 126, 127, 128, 129, 131, 132, 133, 134, 135, 137, 138, 139, 140, 142, 143, 146, 148, 150, 151, 153, 155, 156, 158, 159, 160, 161, 162, 167, 168, 169, 170, 171, 173, 176, 177, 180, 181, 182, 183, 184, 185, 186, 188, 190, 191, 192, 193, 194, 195, 196, 197, 198, 199]"
Olaf,L100,middle,133,71,62,2,0.335,200,"[0, 2, 3, 5, 8, 9, 10, 11, 12, 13, 14, 15, 16, 18, 19, 22, 25, 27, 28, 29, 30, 31, 32, 34, 35, 36, 37, 39, 40, 41, 42, 44, 46, 47, 48, 49, 50, 51, 53, 55, 56, 57, 60, 62, 63, 64, 65, 66, 67, 68, 69, 70, 72, 73, 74, 77, 78, 79, 82, 83, 84, 85, 86, 88, 89, 90, 92, 95, 96, 98, 99, 100, 101, 102, 103, 104, 107, 108, 110, 113, 116, 119, 122, 125, 126, 127, 130, 131, 132, 133, 134, 138, 139, 141, 142, 143, 144, 146, 147, 148, 149, 150, 152, 153, 155, 156, 157, 159, 160, 163, 164, 165, 166, 167, 168, 169, 170, 171, 173, 175, 177, 178, 182, 186, 188, 189, 191, 192, 193, 195, 196, 197, 199]"
Olaf,L100,middle,129,76,53,7,0.355,200,"[1, 4, 5, 7, 8, 9, 10, 12, 13, 14, 15, 18, 22, 23, 26, 27, 28, 30, 34, 35, 36, 37, 38, 40, 42, 43, 45, 47, 50, 52, 54, 55, 56, 58, 61, 62, 63, 65, 66, 67, 68, 70, 72, 73, 74, 75, 76, 78, 79, 80, 81, 82, 83, 84, 86, 87, 88, 89, 90, 95, 96, 97, 98, 100, 101, 102, 103, 105, 106, 107, 108, 111, 112, 113, 114, 115, 116, 119, 120, 121, 122, 123, 126, 127, 128, 129, 131, 133, 134, 136, 137, 138, 139, 141, 142, 144, 146, 147, 149, 151, 152, 154, 155, 156, 159, 160, 161, 162, 164, 165, 166, 168, 169, 170, 173, 175, 176, 177, 179, 182, 184, 186, 187, 190, 191, 193, 194, 197, 198]"
Olaf,L100,middle,135,74,61,5,0.325,200,"[0, 4, 6, 7, 9, 10, 12, 13, 15, 16, 20, 21, 22, 23, 24, 26, 27, 29, 31, 32, 33, 35, 38, 39, 40, 41, 42, 43, 44, 45, 47, 48, 49, 51, 52, 54, 57, 61, 63, 64, 65, 67, 69, 70, 72, 73, 74, 76, 78, 79, 80, 83, 84, 85, 86, 87, 89, 90, 92, 93, 95, 96, 97, 98, 100, 101, 102, 103, 104, 107, 109, 110, 111, 113, 114, 115, 116, 117, 119, 121, 122, 124, 125, 126, 127, 129, 130, 131, 132, 133, 134, 136, 138, 140, 141, 142, 145, 147, 148, 149, 150, 151, 152, 153, 155, 156, 158, 159, 160, 161, 163, 166, 168, 169, 171, 173, 174, 176, 177, 178, 179, 180, 182, 183, 185, 186, 187, 188, 189, 190, 192, 193, 197, 198, 199]"
Olaf,L100,middle,135,73,62,5,0.325,200,"[0, 2, 3, 5, 7, 9, 11, 12, 13, 14, 15, 17, 18, 19, 20, 21, 22, 23, 26, 28, 29, 31, 33, 34, 36, 37, 40, 42, 43, 44, 46, 49, 51, 52, 54, 55, 56, 57, 59, 60, 62, 63, 64, 65, 67, 68, 69, 70, 71, 73, 74, 78, 79, 82, 83, 84, 85, 86, 87, 89, 90, 91, 92, 93, 94, 95, 97, 98, 100, 101, 103, 104, 105, 107, 109, 110, 111, 112, 114, 116, 117, 118, 119, 120, 121, 122, 123, 124, 125, 126, 128, 129, 130, 132, 133, 135, 136, 140, 142, 143, 144, 145, 146, 147, 148, 151, 152, 153, 154, 156, 157, 159, 164, 166, 167, 168, 169, 170, 171, 172, 173, 174, 175, 176, 177, 180, 181, 182, 184, 189, 192, 193, 194, 198, 199]"
Olaf,L100,middle,147,67,80,3,0.265,200,"[0, 1, 2, 3, 4, 6, 9, 10, 11, 12, 13, 14, 15, 16, 17, 18, 19, 20, 22, 24, 25, 26, 27, 29, 30, 31, 32, 33, 34, 35, 36, 37, 38, 41, 43, 44, 46, 47, 49, 50, 51, 52, 53, 54, 55, 57, 58, 59, 60, 61, 63, 65, 67, 68, 69, 70, 71, 72, 73, 74, 75, 77, 78, 79, 81, 82, 83, 84, 85, 86, 87, 88, 90, 91, 94, 95, 98, 100, 101, 102, 103, 105, 108, 109, 110, 111, 114, 115, 116, 118, 119, 120, 121, 122, 123, 124, 125, 126, 127, 128, 129, 130, 131, 133, 134, 135, 136, 138, 140, 141, 142, 143, 144, 147, 149, 150, 151, 156, 158, 160, 161, 163, 164, 167, 168, 170, 171, 172, 174, 175, 176, 177, 178, 180, 181, 182, 183, 184, 185, 186, 189, 191, 192, 194, 195, 197, 199]"
Olaf,L100,middle,136,67,69,2,0.32,200,"[0, 1, 4, 5, 6, 8, 9, 10, 11, 14, 16, 17, 18, 19, 20, 23, 24, 27, 28, 30, 31, 32, 33, 34, 35, 37, 38, 39, 40, 42, 45, 46, 48, 51, 52, 53, 54, 55, 56, 57, 58, 59, 60, 61, 63, 64, 65, 69, 70, 71, 77, 78, 80, 81, 83, 84, 85, 86, 88, 89, 92, 93, 97, 98, 99, 101, 102, 103, 105, 106, 111, 112, 113, 114, 115, 117, 119, 120, 121, 122, 123, 124, 125, 127, 128, 129, 130, 131, 132, 133, 136, 137, 141, 142, 143, 145, 146, 149, 150, 151, 152, 153, 154, 156, 158, 159, 160, 161, 162, 163, 164, 165, 167, 168, 169, 171, 172, 173, 174, 176, 177, 178, 179, 180, 184, 186, 190, 191, 192, 193, 194, 195, 196, 197, 198, 199]"
Olaf,L100,middle,143,72,71,2,0.285,200,"[2, 5, 7, 8, 9, 11, 14, 16, 17, 18, 19, 20, 21, 22, 24, 26, 27, 28, 30, 31, 32, 33, 34, 35, 37, 39, 40, 43, 45, 46, 47, 48, 50, 51, 54, 56, 57, 58, 60, 61, 62, 63, 64, 67, 68, 69, 70, 71, 72, 73, 75, 77, 79, 80, 81, 83, 84, 85, 86, 87, 88, 89, 90, 91, 97, 98, 101, 102, 103, 104, 105, 106, 107, 108, 109, 110, 113, 114, 118, 121, 123, 124, 125, 126, 127, 130, 131, 132, 133, 135, 136, 137, 138, 139, 140, 141, 142, 143, 144, 145, 146, 147, 148, 149, 150, 151, 152, 153, 157, 158, 159, 160, 162, 163, 164, 165, 166, 167, 168, 169, 170, 172, 173, 174, 175, 176, 177, 179, 180, 181, 183, 185, 187, 189, 190, 192, 193, 194, 195, 196, 197, 198, 199]"
Olaf,L100,middle,128,85,43,6,0.36,200,"[0, 1, 2, 3, 5, 6, 7, 8, 9, 10, 13, 15, 16, 17, 22, 27, 29, 30, 31, 32, 33, 34, 35, 36, 37, 38, 40, 41, 44, 46, 47, 49, 53, 54, 56, 58, 59, 60, 61, 62, 64, 65, 66, 68, 72, 73, 74, 75, 76, 77, 78, 79, 81, 82, 83, 85, 89, 90, 91, 94, 97, 98, 99, 100, 105, 106, 107, 110, 111, 112, 113, 114, 115, 116, 117, 118, 120, 122, 123, 124, 125, 127, 128, 130, 131, 133, 134, 135, 136, 138, 140, 141, 143, 144, 145, 148, 149, 150, 151, 152, 153, 154, 155, 157, 159, 163, 164, 168, 169, 170, 171, 172, 173, 175, 177, 178, 181, 184, 185, 186, 188, 190, 191, 192, 193, 195, 196, 197]"
Olaf,L100,middle,127,68,59,7,0.365,200,"[0, 1, 2, 7, 8, 9, 10, 14, 15, 16, 17, 18, 19, 20, 21, 23, 24, 25, 28, 30, 31, 32, 33, 35, 38, 39, 42, 43, 47, 48, 50, 51, 52, 53, 54, 55, 57, 62, 63, 64, 65, 67, 68, 69, 70, 73, 74, 75, 77, 79, 80, 82, 83, 86, 87, 89, 92, 95, 97, 100, 101, 103, 106, 108, 109, 110, 112, 114, 115, 116, 117, 118, 119, 122, 124, 126, 127, 128, 129, 130, 131, 132, 134, 136, 137, 138, 139, 140, 141, 142, 143, 145, 146, 148, 149, 150, 151, 153, 156, 158, 159, 162, 163, 165, 166, 167, 170, 172, 173, 174, 175, 176, 178, 180, 181, 183, 184, 185, 190, 191, 192, 193, 195, 196, 197, 198, 199]"
Olaf,L100,middle,129,63,66,5,0.355,200,"[1, 2, 3, 5, 7, 8, 9, 14, 15, 20, 22, 26, 27, 28, 30, 31, 32, 33, 35, 36, 37, 38, 39, 40, 41, 43, 44, 45, 46, 48, 50, 54, 55, 60, 63, 64, 66, 68, 69, 71, 72, 73, 74, 75, 78, 81, 82, 83, 84, 85, 86, 88, 91, 93, 94, 95, 98, 99, 100, 101, 102, 105, 106, 107, 110, 112, 113, 115, 116, 117, 118, 119, 120, 121, 122, 124, 126, 127, 128, 130, 133, 134, 135, 136, 138, 139, 140, 142, 144, 145, 146, 147, 148, 149, 151, 153, 154, 155, 156, 157, 158, 159, 160, 161, 163, 164, 167, 168, 171, 172, 174, 175, 176, 177, 180, 184, 186, 187, 188, 189, 190, 191, 192, 193, 194, 195, 196, 197, 198]"
Olaf,L100,middle,123,72,51,4,0.385,200,"[0, 4, 5, 7, 9, 10, 11, 12, 14, 15, 16, 17, 19, 21, 22, 24, 25, 26, 28, 29, 30, 33, 34, 36, 37, 38, 39, 40, 42, 43, 46, 48, 51, 53, 54, 55, 57, 59, 60, 62, 63, 66, 67, 68, 69, 70, 71, 74, 76, 77, 78, 80, 82, 84, 86, 87, 88, 89, 90, 92, 93, 95, 98, 99, 100, 101, 103, 105, 106, 109, 110, 114, 117, 121, 122, 124, 125, 126, 128, 129, 131, 133, 134, 135, 136, 137, 139, 140, 142, 143, 145, 146, 150, 151, 152, 153, 155, 156, 157, 158, 159, 161, 164, 165, 167, 169, 170, 171, 174, 176, 180, 183, 185, 186, 187, 188, 189, 191, 192, 193, 194, 196, 199]"
Olaf,L100,middle,133,76,57,7,0.335,200,"[0, 1, 2, 4, 5, 6, 8, 9, 10, 13, 14, 15, 16, 17, 23, 24, 26, 33, 35, 36, 37, 38, 39, 40, 41, 44, 46, 47, 48, 49, 50, 51, 52, 53, 54, 55, 56, 57, 59, 60, 61, 62, 63, 64, 66, 67, 68, 69, 70, 71, 73, 74, 75, 77, 79, 81, 84, 85, 87, 89, 90, 92, 93, 96, 97, 99, 101, 103, 104, 105, 107, 109, 110, 115, 117, 118, 119, 120, 122, 123, 124, 125, 126, 127, 131, 132, 133, 136, 137, 141, 144, 145, 147, 148, 149, 150, 151, 152, 153, 154, 155, 156, 158, 160, 161, 162, 163, 164, 166, 168, 169, 171, 172, 173, 174, 175, 177, 179, 180, 181, 182, 183, 185, 186, 187, 188, 190, 191, 193, 194, 195, 197, 199]"
Olaf,L100,middle,117,54,63,9,0.415,200,"[0, 1, 2, 3, 4, 5, 8, 10, 12, 13, 14, 15, 16, 19, 20, 24, 26, 27, 28, 34, 36, 40, 43, 44, 46, 47, 49, 50, 52, 53, 54, 55, 57, 58, 61, 63, 64, 66, 71, 73, 74, 75, 77, 78, 80, 82, 84, 85, 87, 89, 91, 94, 95, 96, 98, 99, 100, 101, 102, 103, 105, 107, 109, 110, 111, 112, 113, 114, 117, 120, 121, 122, 126, 127, 129, 130, 131, 132, 133, 135, 136, 138, 139, 141, 143, 144, 145, 146, 147, 150, 152, 153, 155, 156, 158, 160, 161, 162, 164, 166, 168, 170, 171, 173, 175, 177, 179, 180, 184, 187, 188, 189, 191, 193, 197, 198, 199]"
Olaf,L100,middle,140,64,76,11,0.3,200,"[0, 2, 3, 4, 5, 6, 7, 8, 9, 11, 12, 13, 16, 18, 20, 21, 24, 25, 26, 28, 29, 30, 31, 34, 35, 36, 37, 38, 40, 43, 44, 45, 46, 47, 51, 52, 53, 54, 55, 56, 57, 59, 60, 63, 64, 65, 66, 67, 68, 69, 70, 71, 73, 74, 75, 77, 78, 79, 81, 82, 84, 86, 87, 89, 91, 93, 94, 95, 96, 97, 100, 101, 102, 104, 108, 110, 111, 112, 113, 114, 115, 116, 117, 118, 119, 120, 122, 124, 125, 126, 127, 129, 130, 131, 133, 134, 135, 136, 137, 138, 139, 140, 141, 143, 148, 149, 150, 153, 154, 155, 156, 157, 158, 159, 161, 162, 165, 166, 167, 168, 170, 174, 175, 176, 177, 179, 180, 182, 183, 184, 187, 189, 190, 191, 192, 193, 195, 196, 197, 198]"
Olaf,L100,middle,146,57,89,1,0.27,200,"[2, 3, 5, 6, 7, 8, 10, 12, 14, 15, 16, 18, 19, 21, 22, 25, 26, 27, 30, 31, 32, 33, 39, 41, 42, 43, 44, 45, 46, 47, 49, 50, 52, 54, 55, 60, 62, 63, 64, 65, 66, 68, 69, 70, 71, 72, 73, 75, 76, 78, 79, 80, 81, 82, 85, 87, 88, 89, 91, 92, 95, 96, 97, 99, 101, 102, 104, 106, 107, 108, 109, 110, 111, 112, 113, 114, 115, 116, 117, 119, 122, 123, 124, 125, 127, 128, 129, 130, 131, 132, 133, 136, 137, 138, 139, 141, 142, 144, 145, 146, 149, 150, 151, 152, 153, 154, 155, 156, 157, 158, 160, 161, 162, 163, 164, 165, 166, 168, 169, 170, 171, 172, 173, 174, 175, 176, 177, 178, 180, 181, 182, 183, 184, 185, 186, 187, 189, 190, 191, 192, 193, 194, 196, 197, 198, 199]"
Olaf,L100,middle,140,63,77,4,0.3,200,"[0, 1, 2, 3, 4, 5, 6, 10, 11, 14, 16, 17, 19, 20, 21, 22, 24, 25, 28, 29, 30, 31, 32, 34, 35, 36, 37, 38, 39, 41, 43, 44, 45, 46, 47, 48, 50, 51, 52, 56, 59, 60, 61, 62, 63, 66, 67, 68, 70, 71, 72, 73, 75, 76, 77, 78, 81, 82, 83, 85, 88, 89, 90, 91, 92, 94, 95, 96, 98, 99, 101, 102, 103, 104, 105, 107, 108, 109, 112, 113, 116, 117, 121, 122, 123, 124, 125, 126, 127, 128, 130, 131, 134, 135, 136, 137, 139, 141, 142, 144, 146, 147, 149, 150, 152, 154, 155, 157, 158, 160, 161, 162, 163, 164, 166, 168, 169, 170, 172, 173, 174, 175, 177, 178, 179, 181, 182, 184, 185, 186, 187, 188, 189, 190, 191, 192, 193, 194, 195, 197]"
Olaf,L100,middle,144,64,80,1,0.28,200,"[1, 4, 5, 6, 8, 9, 11, 13, 15, 16, 17, 18, 19, 20, 21, 23, 24, 25, 26, 28, 30, 32, 33, 34, 35, 36, 38, 39, 40, 43, 44, 46, 47, 49, 50, 52, 53, 55, 56, 57, 58, 59, 60, 63, 64, 65, 66, 67, 68, 69, 70, 71, 72, 73, 74, 77, 78, 80, 82, 83, 84, 85, 86, 87, 89, 91, 92, 93, 94, 97, 98, 101, 102, 103, 104, 106, 107, 109, 110, 111, 113, 114, 116, 117, 119, 121, 122, 124, 125, 126, 127, 129, 130, 132, 135, 138, 139, 140, 141, 142, 144, 146, 147, 148, 150, 152, 155, 157, 159, 160, 161, 162, 163, 164, 165, 166, 167, 168, 169, 170, 171, 172, 173, 174, 175, 176, 178, 181, 183, 184, 185, 186, 187, 188, 189, 191, 192, 193, 194, 195, 196, 197, 198, 199]"
Olaf,L100,middle,132,75,57,3,0.34,200,"[2, 3, 4, 5, 6, 7, 8, 10, 11, 13, 15, 16, 17, 18, 21, 23, 24, 25, 26, 27, 28, 30, 31, 32, 34, 36, 37, 38, 39, 40, 41, 42, 44, 45, 46, 51, 52, 54, 57, 58, 59, 60, 61, 62, 64, 65, 66, 69, 71, 72, 74, 75, 77, 79, 81, 84, 85, 86, 89, 90, 92, 93, 94, 95, 96, 98, 101, 102, 103, 112, 113, 114, 115, 118, 119, 120, 122, 125, 128, 129, 131, 133, 134, 135, 136, 137, 138, 139, 141, 142, 143, 145, 147, 148, 150, 151, 152, 153, 154, 156, 157, 159, 160, 162, 163, 164, 165, 167, 168, 169, 170, 171, 172, 173, 175, 176, 177, 178, 179, 182, 185, 186, 187, 188, 189, 191, 193, 194, 195, 196, 198, 199]"
Olaf,L100,middle,142,77,65,4,0.29,200,"[0, 1, 2, 4, 5, 6, 9, 12, 13, 14, 15, 16, 22, 23, 24, 25, 26, 27, 29, 31, 33, 34, 35, 37, 38, 39, 41, 42, 43, 44, 45, 46, 47, 49, 50, 51, 52, 53, 54, 55, 56, 57, 58, 59, 60, 61, 68, 69, 70, 71, 72, 73, 74, 76, 77, 78, 79, 80, 81, 84, 85, 86, 87, 88, 89, 90, 92, 93, 94, 95, 96, 98, 99, 100, 102, 103, 105, 106, 108, 110, 111, 112, 116, 118, 119, 120, 121, 122, 125, 129, 130, 132, 136, 137, 138, 139, 140, 142, 143, 144, 145, 146, 147, 148, 149, 150, 151, 152, 153, 155, 156, 159, 161, 162, 163, 164, 166, 167, 168, 169, 170, 172, 173, 174, 175, 176, 178, 179, 180, 181, 183, 187, 188, 189, 191, 192, 193, 194, 196, 197, 198, 199]"
Olaf,L100,middle,139,94,45,10,0.305,200,"[0, 1, 2, 3, 4, 5, 6, 7, 9, 10, 11, 12, 13, 15, 16, 18, 19, 21, 22, 23, 24, 25, 27, 28, 30, 32, 35, 37, 38, 39, 40, 41, 44, 45, 46, 47, 48, 49, 50, 51, 52, 53, 55, 56, 57, 58, 59, 60, 62, 63, 64, 65, 66, 67, 69, 71, 72, 73, 74, 75, 76, 79, 80, 85, 87, 88, 90, 91, 92, 96, 98, 99, 100, 101, 104, 106, 108, 109, 110, 111, 112, 113, 114, 116, 118, 119, 120, 122, 123, 124, 125, 126, 127, 128, 129, 131, 133, 134, 135, 137, 139, 140, 142, 143, 144, 150, 151, 153, 156, 157, 158, 159, 161, 162, 163, 164, 165, 166, 167, 168, 169, 170, 171, 174, 176, 177, 178, 179, 180, 181, 182, 183, 187, 190, 191, 193, 194, 197, 199]"
Olaf,L100,middle,137,68,69,7,0.315,200,"[0, 2, 5, 6, 7, 11, 12, 13, 14, 15, 16, 19, 21, 23, 24, 25, 27, 28, 29, 30, 32, 33, 34, 36, 37, 38, 39, 40, 42, 44, 45, 47, 48, 50, 51, 53, 54, 55, 56, 57, 58, 60, 61, 64, 65, 67, 69, 70, 71, 72, 74, 75, 77, 78, 79, 83, 84, 85, 86, 87, 88, 89, 90, 91, 92, 93, 94, 95, 96, 97, 100, 102, 103, 104, 106, 107, 108, 110, 112, 113, 114, 115, 116, 117, 119, 121, 122, 124, 125, 126, 127, 129, 130, 131, 133, 134, 135, 136, 139, 140, 142, 144, 145, 146, 147, 149, 150, 151, 152, 153, 154, 156, 158, 159, 160, 161, 163, 164, 166, 167, 168, 169, 170, 173, 174, 176, 179, 180, 181, 184, 185, 187, 188, 191, 194, 197, 198]"
Olaf,L100,middle,142,63,79,1,0.29,200,"[0, 1, 3, 4, 5, 7, 9, 10, 11, 12, 14, 17, 18, 19, 20, 21, 22, 23, 24, 25, 27, 28, 29, 30, 31, 32, 36, 37, 38, 39, 40, 41, 42, 43, 44, 45, 47, 49, 50, 51, 52, 53, 54, 56, 58, 59, 62, 64, 66, 67, 68, 69, 70, 73, 75, 76, 79, 81, 82, 83, 85, 88, 90, 92, 93, 94, 95, 96, 97, 98, 100, 101, 102, 103, 105, 106, 107, 108, 110, 112, 113, 116, 120, 121, 122, 123, 125, 126, 128, 129, 130, 131, 132, 133, 134, 135, 137, 138, 139, 140, 141, 143, 144, 145, 146, 149, 150, 151, 152, 154, 155, 157, 158, 159, 160, 161, 162, 163, 165, 166, 167, 168, 170, 171, 173, 174, 176, 177, 179, 180, 181, 183, 184, 187, 189, 190, 191, 193, 194, 195, 196, 197]"
Olaf,L100,middle,138,65,73,2,0.31,200,"[1, 2, 3, 4, 7, 8, 9, 10, 11, 13, 15, 18, 20, 21, 22, 23, 24, 25, 26, 27, 29, 30, 31, 32, 33, 34, 35, 38, 40, 41, 42, 43, 44, 45, 46, 48, 49, 51, 52, 53, 54, 55, 57, 59, 61, 62, 63, 64, 65, 66, 68, 69, 70, 71, 73, 74, 75, 77, 79, 81, 82, 83, 84, 85, 86, 87, 88, 89, 90, 95, 96, 97, 98, 99, 100, 102, 103, 104, 105, 108, 110, 111, 112, 113, 115, 117, 121, 122, 123, 124, 126, 127, 128, 130, 133, 135, 136, 137, 141, 142, 143, 146, 148, 149, 150, 151, 154, 155, 156, 157, 158, 159, 160, 162, 163, 164, 167, 168, 169, 171, 172, 173, 174, 176, 178, 180, 181, 182, 183, 184, 185, 189, 191, 192, 193, 196, 198, 199]"
Olaf,L100,middle,128,64,64,7,0.36,200,"[1, 2, 3, 4, 6, 7, 8, 9, 10, 11, 12, 14, 15, 16, 17, 20, 22, 25, 26, 32, 33, 34, 36, 39, 40, 41, 43, 45, 48, 51, 52, 53, 54, 55, 56, 57, 58, 59, 61, 62, 63, 67, 68, 69, 70, 72, 75, 80, 81, 82, 83, 84, 85, 87, 88, 89, 90, 91, 94, 95, 96, 97, 98, 100, 101, 102, 103, 104, 105, 107, 109, 110, 111, 113, 114, 115, 117, 118, 121, 122, 123, 124, 126, 127, 128, 129, 130, 131, 135, 137, 138, 139, 140, 142, 144, 146, 147, 149, 150, 151, 153, 154, 155, 159, 163, 164, 167, 168, 169, 173, 175, 178, 179, 180, 181, 182, 183, 184, 185, 187, 188, 191, 193, 194, 195, 196, 197, 199]"
Olaf,L100,middle,128,71,57,3,0.36,200,"[1, 2, 3, 4, 5, 6, 8, 9, 10, 11, 13, 15, 17, 19, 20, 21, 22, 24, 26, 28, 31, 33, 35, 36, 37, 39, 40, 42, 43, 44, 45, 47, 48, 49, 51, 55, 56, 57, 58, 59, 62, 64, 65, 66, 68, 69, 70, 71, 72, 73, 77, 78, 79, 80, 82, 83, 84, 87, 88, 90, 91, 94, 95, 96, 99, 101, 102, 104, 106, 107, 108, 109, 110, 113, 114, 115, 117, 118, 120, 122, 124, 125, 127, 128, 129, 130, 131, 132, 134, 135, 136, 137, 139, 140, 142, 143, 146, 150, 152, 153, 156, 157, 158, 160, 161, 163, 164, 170, 171, 172, 173, 176, 177, 178, 179, 180, 181, 182, 183, 184, 186, 187, 188, 191, 193, 196, 197, 199]"
Olaf,L100,middle,139,69,70,3,0.305,200,"[0, 1, 2, 3, 5, 7, 8, 9, 10, 13, 14, 15, 17, 19, 20, 21, 22, 23, 25, 26, 28, 29, 31, 32, 34, 35, 36, 37, 38, 40, 42, 43, 47, 48, 49, 52, 53, 54, 55, 56, 58, 60, 61, 62, 64, 65, 66, 68, 69, 72, 74, 76, 78, 80, 81, 82, 83, 84, 85, 87, 90, 92, 93, 94, 95, 96, 97, 99, 100, 101, 102, 103, 106, 107, 108, 109, 110, 112, 114, 115, 116, 119, 121, 123, 124, 126, 127, 128, 130, 131, 133, 134, 135, 136, 137, 138, 139, 141, 142, 143, 144, 145, 146, 147, 148, 149, 150, 151, 154, 155, 156, 158, 159, 160, 162, 164, 165, 166, 167, 169, 170, 171, 172, 174, 176, 177, 179, 184, 186, 187, 188, 191, 192, 193, 195, 196, 197, 198, 199]"
Olaf,L100,middle,141,86,55,5,0.295,200,"[0, 1, 2, 3, 4, 5, 6, 7, 8, 9, 10, 12, 13, 14, 15, 18, 19, 20, 21, 22, 23, 25, 26, 28, 29, 30, 32, 33, 34, 35, 37, 38, 39, 40, 41, 42, 44, 45, 46, 48, 49, 50, 51, 53, 54, 55, 57, 58, 60, 62, 63, 65, 69, 72, 75, 76, 80, 82, 83, 85, 86, 87, 89, 90, 91, 92, 94, 95, 96, 99, 101, 102, 105, 106, 107, 108, 109, 110, 111, 112, 114, 115, 116, 117, 119, 120, 122, 123, 124, 125, 126, 127, 129, 130, 131, 133, 134, 136, 137, 138, 140, 142, 143, 144, 145, 146, 147, 149, 152, 153, 155, 156, 157, 158, 160, 161, 162, 163, 166, 167, 168, 169, 170, 171, 172, 173, 178, 180, 181, 182, 183, 185, 186, 187, 190, 192, 193, 194, 196, 197, 198]"
Olaf,L100,middle,128,71,57,6,0.36,200,"[1, 2, 3, 4, 5, 6, 8, 9, 10, 11, 12, 13, 14, 15, 16, 20, 28, 29, 31, 32, 33, 34, 35, 36, 38, 39, 40, 43, 47, 48, 49, 50, 52, 54, 57, 58, 59, 61, 62, 63, 65, 66, 67, 69, 70, 71, 76, 79, 81, 82, 83, 85, 87, 89, 92, 93, 96, 98, 99, 100, 101, 102, 107, 108, 109, 111, 112, 113, 114, 115, 116, 118, 121, 122, 125, 126, 127, 128, 129, 131, 132, 133, 135, 136, 137, 138, 139, 141, 142, 144, 145, 148, 152, 153, 154, 155, 156, 158, 159, 160, 161, 162, 163, 164, 165, 166, 167, 168, 169, 170, 173, 178, 179, 180, 181, 182, 183, 184, 185, 186, 188, 190, 192, 193, 194, 195, 198, 199]"
Olaf,L100,middle,132,70,62,5,0.34,200,"[0, 1, 6, 7, 9, 11, 12, 13, 17, 18, 19, 20, 24, 26, 28, 29, 31, 32, 33, 34, 36, 37, 38, 39, 41, 42, 43, 45, 46, 47, 50, 51, 53, 54, 57, 58, 61, 65, 66, 67, 72, 73, 74, 75, 76, 78, 79, 80, 81, 83, 84, 85, 86, 87, 89, 90, 92, 95, 96, 97, 99, 100, 103, 104, 105, 106, 107, 108, 110, 111, 112, 113, 114, 115, 116, 118, 119, 120, 121, 123, 124, 125, 126, 127, 128, 129, 131, 132, 133, 136, 138, 139, 141, 142, 145, 146, 147, 148, 149, 150, 151, 153, 156, 159, 161, 162, 163, 165, 166, 170, 171, 172, 173, 174, 175, 177, 178, 179, 181, 182, 183, 184, 185, 187, 189, 191, 192, 193, 194, 195, 197, 199]"
Olaf,L100,middle,138,101,37,7,0.31,200,"[0, 1, 2, 3, 4, 5, 8, 11, 12, 13, 14, 17, 18, 19, 20, 21, 23, 25, 27, 28, 29, 30, 31, 32, 33, 34, 35, 39, 40, 41, 44, 45, 46, 49, 50, 51, 52, 54, 55, 56, 57, 58, 60, 63, 65, 67, 69, 70, 71, 72, 73, 74, 75, 76, 78, 79, 80, 81, 82, 83, 84, 85, 86, 87, 88, 89, 91, 92, 93, 94, 97, 98, 100, 101, 102, 103, 104, 105, 106, 107, 109, 112, 113, 114, 115, 117, 118, 119, 120, 121, 122, 127, 129, 130, 132, 133, 134, 137, 138, 139, 140, 142, 144, 147, 148, 149, 150, 152, 153, 154, 155, 156, 157, 158, 159, 160, 161, 162, 166, 167, 168, 171, 172, 173, 174, 177, 179, 180, 181, 182, 183, 184, 185, 188, 189, 190, 197, 198]"
Olaf,L100,middle,141,71,70,2,0.295,200,"[0, 2, 3, 5, 6, 7, 8, 9, 11, 12, 13, 14, 16, 18, 21, 22, 25, 26, 27, 28, 29, 30, 31, 32, 33, 34, 35, 36, 37, 38, 39, 40, 41, 42, 43, 45, 46, 47, 49, 51, 53, 55, 56, 57, 58, 59, 60, 61, 62, 64, 65, 66, 67, 69, 72, 73, 76, 77, 78, 79, 81, 83, 84, 85, 86, 87, 88, 89, 91, 94, 95, 96, 98, 99, 100, 102, 103, 105, 106, 110, 112, 113, 114, 116, 117, 118, 119, 122, 123, 125, 126, 127, 128, 129, 131, 132, 133, 137, 138, 140, 142, 143, 144, 147, 148, 151, 152, 153, 154, 155, 156, 157, 158, 159, 160, 162, 163, 164, 168, 169, 173, 174, 175, 176, 177, 178, 179, 180, 181, 182, 184, 185, 187, 188, 189, 190, 192, 193, 194, 196, 198]"
Olaf,L100,middle,122,57,65,9,0.39,200,"[1, 2, 3, 4, 5, 9, 10, 11, 13, 14, 15, 16, 20, 22, 24, 25, 26, 27, 28, 29, 30, 31, 32, 34, 35, 36, 37, 39, 44, 45, 48, 49, 50, 51, 53, 55, 56, 59, 60, 65, 68, 70, 71, 72, 73, 75, 78, 79, 82, 83, 85, 87, 88, 89, 90, 91, 94, 95, 96, 99, 105, 106, 108, 109, 111, 113, 119, 121, 122, 125, 126, 128, 131, 132, 133, 134, 138, 140, 141, 142, 143, 144, 148, 150, 151, 153, 154, 155, 157, 158, 160, 161, 162, 163, 164, 165, 167, 168, 169, 171, 172, 173, 174, 175, 176, 178, 179, 180, 181, 184, 185, 186, 187, 188, 189, 190, 191, 192, 193, 196, 197, 198]"
Olaf,L100,middle,142,80,62,2,0.29,200,"[0, 1, 2, 3, 4, 5, 6, 9, 10, 11, 12, 14, 15, 16, 18, 19, 20, 22, 25, 27, 28, 29, 30, 32, 34, 36, 41, 42, 43, 44, 45, 47, 48, 49, 51, 55, 56, 57, 58, 59, 60, 61, 62, 63, 64, 65, 67, 69, 70, 71, 72, 73, 75, 76, 77, 78, 79, 80, 82, 84, 85, 87, 88, 89, 90, 91, 93, 94, 95, 96, 97, 99, 101, 104, 106, 107, 108, 109, 110, 112, 113, 114, 115, 116, 117, 118, 119, 122, 123, 124, 125, 127, 128, 129, 130, 131, 132, 133, 134, 135, 136, 138, 139, 141, 142, 143, 144, 145, 146, 149, 150, 151, 154, 155, 156, 157, 158, 159, 161, 162, 163, 164, 167, 168, 171, 174, 177, 178, 179, 180, 182, 184, 185, 189, 190, 192, 193, 194, 195, 196, 197, 198]"
Olaf,L100,middle,132,58,74,9,0.34,200,"[0, 2, 3, 4, 5, 6, 7, 8, 9, 10, 11, 12, 13, 15, 16, 17, 18, 19, 20, 21, 25, 26, 27, 28, 31, 32, 33, 36, 37, 38, 40, 41, 42, 44, 45, 46, 47, 52, 53, 55, 58, 60, 61, 64, 65, 68, 69, 71, 74, 76, 77, 78, 79, 80, 82, 83, 86, 87, 89, 90, 91, 95, 96, 100, 101, 103, 108, 109, 110, 111, 112, 113, 114, 116, 118, 120, 121, 123, 124, 125, 126, 128, 129, 130, 131, 132, 133, 134, 136, 137, 138, 139, 140, 141, 142, 143, 144, 145, 146, 149, 151, 153, 154, 155, 156, 157, 158, 161, 163, 165, 166, 167, 169, 170, 171, 174, 175, 176, 178, 179, 181, 183, 185, 186, 187, 191, 193, 194, 195, 196, 197, 199]"
Olaf,L100,middle,127,86,41,2,0.365,200,"[0, 1, 2, 3, 4, 5, 7, 8, 11, 14, 15, 16, 17, 19, 22, 23, 24, 26, 27, 29, 30, 31, 32, 35, 37, 38, 39, 40, 41, 42, 43, 44, 45, 48, 49, 50, 51, 52, 53, 55, 56, 57, 58, 59, 60, 61, 64, 66, 67, 69, 70, 71, 73, 74, 75, 76, 77, 78, 80, 82, 86, 88, 89, 90, 92, 93, 95, 96, 97, 98, 99, 103, 104, 105, 106, 107, 109, 112, 117, 118, 119, 121, 122, 125, 126, 128, 129, 131, 135, 137, 138, 139, 140, 142, 144, 145, 150, 153, 155, 156, 157, 158, 162, 165, 166, 167, 169, 170, 172, 173, 174, 175, 177, 178, 179, 180, 182, 184, 186, 187, 188, 189, 190, 191, 194, 198, 199]"
Olaf,L100,middle,139,74,65,1,0.305,200,"[0, 1, 2, 3, 4, 6, 8, 13, 14, 15, 18, 19, 20, 22, 24, 25, 26, 27, 28, 31, 32, 33, 34, 36, 37, 38, 39, 40, 41, 43, 44, 45, 46, 48, 49, 50, 51, 56, 57, 58, 60, 61, 64, 66, 67, 68, 69, 72, 73, 77, 78, 79, 80, 81, 82, 83, 84, 87, 88, 89, 91, 92, 94, 95, 96, 97, 98, 99, 101, 102, 104, 106, 110, 111, 114, 116, 117, 118, 120, 121, 123, 124, 126, 129, 130, 131, 132, 133, 134, 135, 136, 137, 138, 140, 141, 143, 144, 145, 147, 148, 149, 150, 151, 152, 154, 155, 156, 157, 158, 159, 164, 165, 166, 167, 169, 170, 171, 173, 174, 176, 177, 179, 180, 183, 185, 186, 187, 188, 189, 190, 191, 192, 193, 194, 195, 196, 197, 198, 199]"
Olaf,L100,middle,126,64,62,9,0.37,200,"[0, 1, 3, 4, 5, 6, 7, 9, 11, 12, 14, 15, 18, 19, 20, 22, 24, 25, 29, 30, 31, 35, 36, 37, 39, 42, 43, 45, 46, 47, 48, 52, 53, 54, 55, 57, 58, 60, 61, 63, 66, 67, 68, 69, 71, 72, 73, 75, 76, 77, 78, 79, 83, 84, 85, 87, 89, 91, 92, 93, 94, 96, 98, 99, 100, 102, 104, 105, 106, 108, 111, 114, 116, 118, 119, 120, 121, 122, 124, 125, 128, 129, 130, 133, 134, 135, 136, 137, 138, 139, 142, 143, 144, 145, 147, 150, 151, 152, 155, 157, 158, 159, 161, 162, 167, 169, 171, 173, 176, 177, 178, 179, 180, 182, 184, 187, 188, 189, 190, 191, 192, 193, 194, 195, 196, 197]"
Olaf,L100,middle,130,68,62,5,0.35,200,"[1, 4, 5, 6, 7, 8, 10, 12, 13, 15, 16, 17, 19, 20, 21, 22, 25, 26, 27, 28, 30, 31, 33, 34, 37, 38, 40, 42, 44, 45, 47, 48, 49, 50, 56, 57, 59, 60, 61, 63, 64, 65, 66, 67, 68, 70, 71, 73, 74, 76, 77, 81, 82, 83, 84, 85, 86, 87, 89, 92, 96, 97, 99, 100, 102, 104, 105, 108, 109, 110, 111, 112, 113, 114, 115, 116, 117, 118, 119, 120, 121, 122, 124, 126, 127, 128, 130, 131, 132, 133, 134, 137, 138, 140, 141, 142, 144, 145, 147, 148, 149, 150, 151, 152, 153, 155, 156, 158, 159, 161, 163, 166, 172, 174, 176, 179, 180, 181, 182, 184, 185, 187, 188, 189, 190, 191, 192, 193, 194, 196]"
Olaf,L100,middle,138,43,95,3,0.31,200,"[0, 3, 4, 6, 10, 11, 13, 14, 15, 16, 17, 18, 19, 21, 22, 23, 25, 27, 28, 30, 31, 32, 33, 34, 35, 36, 37, 38, 39, 42, 43, 46, 48, 49, 50, 54, 55, 56, 57, 60, 61, 62, 63, 65, 67, 68, 69, 70, 71, 72, 73, 74, 75, 77, 80, 81, 82, 84, 88, 90, 91, 92, 93, 94, 95, 98, 99, 100, 101, 102, 103, 104, 105, 106, 107, 109, 111, 113, 114, 115, 116, 120, 121, 122, 123, 124, 127, 128, 129, 130, 131, 133, 134, 135, 136, 137, 138, 140, 141, 142, 143, 144, 145, 146, 148, 150, 152, 153, 154, 156, 157, 160, 161, 162, 164, 165, 166, 167, 168, 169, 171, 172, 173, 176, 177, 179, 180, 181, 182, 185, 186, 190, 191, 192, 193, 197, 198, 199]"
Olaf,L100,middle,145,91,54,5,0.275,200,"[0, 1, 5, 6, 8, 11, 12, 13, 15, 18, 20, 21, 22, 23, 25, 26, 27, 28, 29, 30, 31, 32, 33, 34, 35, 36, 38, 39, 41, 43, 44, 45, 46, 47, 48, 50, 52, 53, 54, 55, 56, 57, 58, 59, 60, 61, 62, 63, 64, 65, 66, 68, 70, 72, 73, 74, 75, 77, 79, 80, 81, 82, 83, 85, 86, 87, 90, 91, 92, 93, 94, 95, 96, 98, 99, 100, 101, 102, 104, 105, 107, 110, 111, 114, 116, 117, 118, 120, 121, 122, 124, 126, 128, 129, 131, 135, 137, 138, 139, 140, 141, 142, 143, 144, 145, 146, 147, 148, 149, 150, 151, 152, 153, 154, 155, 160, 161, 162, 163, 164, 167, 168, 169, 170, 171, 173, 175, 176, 177, 178, 181, 183, 184, 185, 186, 187, 188, 189, 190, 191, 194, 195, 196, 197, 198]"
Olaf,L100,middle,136,64,72,1,0.32,200,"[0, 1, 2, 3, 4, 6, 7, 9, 10, 11, 12, 13, 15, 16, 17, 19, 20, 21, 22, 24, 26, 27, 29, 33, 34, 35, 36, 37, 38, 39, 41, 42, 44, 45, 46, 47, 48, 49, 50, 51, 52, 54, 56, 58, 59, 60, 62, 63, 67, 68, 69, 71, 72, 74, 75, 76, 77, 78, 79, 80, 81, 82, 84, 85, 86, 87, 89, 90, 94, 95, 96, 100, 101, 102, 104, 106, 107, 108, 110, 112, 113, 114, 116, 117, 118, 119, 120, 121, 122, 123, 126, 127, 128, 129, 131, 132, 134, 137, 138, 139, 141, 144, 145, 148, 150, 151, 152, 153, 154, 157, 159, 160, 161, 162, 165, 167, 170, 172, 173, 177, 178, 180, 181, 183, 184, 186, 188, 189, 190, 191, 192, 194, 195, 196, 198, 199]"
Olaf,L100,middle,130,74,56,7,0.35,200,"[3, 5, 7, 9, 11, 12, 13, 14, 16, 17, 19, 20, 21, 22, 23, 25, 26, 27, 30, 32, 34, 38, 44, 45, 46, 48, 49, 50, 53, 55, 57, 58, 60, 61, 62, 63, 64, 65, 66, 68, 70, 71, 72, 73, 74, 75, 77, 79, 80, 81, 83, 84, 86, 87, 90, 91, 93, 94, 95, 96, 97, 99, 100, 103, 104, 105, 106, 108, 110, 111, 114, 115, 116, 118, 119, 120, 121, 123, 124, 125, 126, 127, 128, 129, 130, 132, 134, 136, 137, 138, 139, 140, 144, 147, 148, 149, 150, 156, 157, 159, 160, 161, 162, 163, 164, 165, 166, 167, 168, 169, 170, 172, 173, 174, 175, 176, 177, 178, 181, 182, 183, 184, 185, 186, 189, 194, 195, 197, 198, 199]"
Olaf,L100,middle,123,73,50,4,0.385,200,"[0, 1, 2, 3, 4, 5, 8, 10, 12, 13, 14, 15, 16, 17, 19, 21, 24, 25, 26, 31, 32, 33, 34, 39, 40, 41, 43, 44, 45, 46, 47, 48, 49, 50, 51, 53, 54, 56, 57, 58, 59, 60, 61, 62, 64, 65, 67, 69, 70, 71, 73, 76, 77, 78, 79, 80, 82, 83, 84, 88, 91, 92, 93, 94, 95, 99, 101, 102, 103, 105, 106, 108, 109, 110, 113, 117, 121, 124, 126, 127, 129, 130, 132, 133, 137, 138, 141, 146, 148, 149, 150, 151, 152, 153, 155, 158, 159, 160, 161, 162, 163, 165, 166, 167, 169, 170, 171, 173, 174, 175, 177, 179, 180, 181, 184, 186, 188, 191, 192, 194, 196, 197, 199]"
Olaf,L100,middle,133,66,67,3,0.335,200,"[2, 3, 4, 5, 8, 9, 11, 12, 13, 14, 15, 18, 19, 20, 21, 22, 24, 26, 28, 33, 34, 35, 36, 37, 38, 40, 42, 43, 44, 45, 46, 50, 51, 52, 55, 56, 58, 59, 60, 61, 62, 64, 65, 66, 67, 68, 71, 72, 75, 77, 78, 80, 81, 82, 85, 88, 90, 91, 92, 93, 95, 98, 99, 100, 101, 103, 104, 105, 106, 107, 108, 110, 111, 112, 113, 114, 116, 118, 121, 123, 124, 125, 127, 131, 132, 133, 134, 135, 136, 137, 138, 139, 140, 141, 142, 143, 144, 145, 146, 147, 148, 149, 150, 152, 154, 155, 156, 157, 158, 159, 160, 162, 163, 165, 166, 167, 173, 175, 176, 177, 179, 180, 181, 182, 184, 185, 188, 190, 192, 194, 195, 196, 197]"
Olaf,L100,middle,139,83,56,7,0.305,200,"[0, 1, 3, 6, 7, 8, 10, 11, 12, 13, 14, 15, 16, 17, 19, 20, 22, 24, 25, 26, 28, 29, 30, 31, 32, 34, 35, 36, 37, 38, 39, 41, 42, 44, 45, 46, 47, 48, 49, 51, 52, 54, 57, 58, 59, 60, 61, 62, 63, 65, 66, 67, 68, 70, 71, 72, 73, 74, 75, 76, 78, 79, 80, 82, 84, 85, 86, 87, 88, 89, 91, 94, 95, 96, 97, 98, 99, 100, 101, 102, 103, 104, 105, 108, 111, 112, 113, 115, 116, 117, 120, 122, 124, 126, 127, 129, 131, 133, 134, 136, 138, 140, 141, 143, 144, 145, 149, 150, 152, 153, 154, 156, 158, 160, 164, 166, 167, 169, 170, 171, 172, 173, 174, 175, 177, 178, 179, 183, 185, 186, 187, 188, 191, 193, 194, 195, 196, 197, 199]"
Olaf,L100,middle,131,88,43,2,0.345,200,"[0, 1, 6, 9, 10, 11, 13, 14, 16, 17, 18, 19, 20, 21, 22, 26, 27, 30, 31, 32, 33, 34, 35, 36, 40, 41, 44, 45, 47, 48, 49, 50, 52, 53, 54, 55, 57, 58, 59, 60, 61, 62, 64, 65, 66, 68, 69, 70, 71, 74, 75, 80, 81, 82, 83, 84, 87, 89, 93, 94, 96, 98, 99, 102, 104, 105, 107, 108, 109, 110, 113, 114, 115, 117, 118, 119, 120, 121, 123, 124, 125, 127, 130, 131, 132, 137, 138, 139, 140, 141, 143, 145, 146, 147, 148, 149, 150, 152, 153, 154, 155, 157, 158, 159, 160, 162, 163, 164, 165, 166, 167, 168, 169, 170, 171, 172, 174, 175, 177, 179, 180, 181, 182, 184, 186, 187, 190, 191, 192, 197, 198]"
Olaf,L100,middle,127,60,67,8,0.365,200,"[0, 1, 2, 3, 5, 6, 7, 9, 10, 11, 12, 14, 16, 18, 19, 22, 23, 27, 28, 29, 30, 31, 32, 33, 34, 35, 37, 39, 43, 44, 45, 48, 49, 51, 53, 55, 56, 57, 62, 63, 66, 67, 68, 69, 70, 72, 74, 75, 76, 77, 80, 81, 82, 83, 84, 85, 86, 87, 91, 92, 93, 94, 97, 99, 100, 102, 103, 105, 106, 108, 110, 111, 112, 114, 116, 117, 118, 122, 126, 128, 129, 130, 131, 132, 133, 134, 135, 136, 137, 139, 140, 141, 142, 143, 144, 145, 147, 148, 150, 153, 154, 155, 156, 157, 158, 159, 161, 164, 166, 167, 169, 170, 172, 173, 176, 179, 183, 184, 186, 187, 188, 189, 191, 192, 197, 198, 199]"
Olaf,L100,middle,138,61,77,3,0.31,200,"[0, 2, 4, 6, 8, 9, 11, 13, 14, 15, 17, 18, 22, 23, 24, 25, 29, 30, 31, 32, 33, 35, 36, 37, 40, 41, 42, 44, 49, 50, 53, 55, 56, 57, 58, 60, 61, 62, 63, 64, 65, 66, 67, 68, 69, 70, 72, 73, 74, 75, 76, 77, 78, 79, 80, 81, 83, 84, 89, 90, 94, 95, 96, 98, 99, 101, 102, 103, 105, 106, 107, 108, 109, 111, 112, 113, 114, 115, 116, 117, 118, 119, 120, 121, 122, 127, 129, 131, 132, 133, 135, 136, 137, 138, 139, 141, 146, 147, 148, 149, 150, 151, 152, 153, 157, 158, 159, 160, 161, 162, 163, 165, 166, 167, 168, 169, 170, 172, 173, 174, 175, 176, 177, 178, 180, 181, 182, 183, 184, 185, 187, 189, 190, 191, 192, 193, 198, 199]"
Olaf,L100,middle,142,69,73,5,0.29,200,"[0, 3, 4, 5, 6, 7, 8, 9, 10, 11, 12, 15, 17, 18, 19, 20, 22, 23, 26, 29, 30, 31, 33, 34, 35, 37, 40, 41, 42, 43, 44, 47, 48, 49, 50, 52, 53, 55, 56, 57, 59, 63, 64, 65, 66, 69, 70, 71, 72, 74, 75, 76, 77, 78, 79, 80, 81, 83, 84, 85, 87, 88, 90, 91, 92, 93, 100, 101, 102, 104, 105, 106, 110, 111, 112, 113, 114, 115, 116, 117, 118, 121, 123, 124, 125, 126, 128, 130, 131, 132, 133, 134, 135, 137, 138, 139, 141, 142, 143, 145, 147, 148, 149, 150, 151, 152, 154, 156, 157, 158, 159, 160, 162, 163, 164, 167, 168, 169, 172, 173, 174, 176, 178, 179, 180, 181, 182, 183, 184, 185, 187, 188, 189, 190, 191, 192, 193, 194, 195, 196, 197, 199]"
Olaf,L100,middle,147,69,78,2,0.265,200,"[0, 2, 3, 4, 5, 7, 8, 9, 10, 11, 12, 16, 17, 18, 19, 21, 22, 23, 24, 25, 27, 28, 30, 32, 34, 35, 36, 37, 38, 39, 40, 41, 42, 43, 44, 45, 47, 48, 49, 52, 53, 56, 57, 59, 63, 64, 65, 66, 67, 68, 69, 70, 71, 72, 73, 75, 77, 79, 82, 83, 84, 86, 87, 88, 89, 90, 91, 92, 93, 94, 95, 96, 97, 98, 99, 100, 101, 102, 104, 106, 109, 110, 114, 116, 117, 118, 120, 121, 122, 123, 124, 125, 126, 127, 128, 129, 130, 131, 132, 133, 135, 136, 140, 141, 142, 145, 146, 147, 148, 149, 151, 152, 153, 155, 156, 157, 159, 161, 162, 163, 164, 165, 166, 167, 169, 170, 171, 173, 174, 176, 178, 179, 180, 181, 182, 183, 185, 186, 188, 189, 190, 191, 192, 193, 194, 195, 198]"
Olaf,L100,middle,140,69,71,2,0.3,200,"[0, 1, 2, 3, 4, 6, 7, 8, 12, 14, 16, 17, 18, 19, 20, 23, 25, 26, 27, 28, 29, 31, 33, 34, 36, 37, 38, 40, 41, 42, 43, 44, 45, 46, 47, 48, 52, 53, 54, 56, 57, 58, 59, 60, 63, 64, 65, 67, 68, 72, 76, 77, 78, 79, 81, 83, 85, 86, 87, 89, 94, 95, 96, 97, 98, 99, 100, 101, 102, 103, 104, 105, 106, 107, 108, 109, 112, 113, 115, 116, 117, 118, 119, 120, 122, 123, 126, 127, 128, 131, 132, 133, 134, 135, 136, 137, 138, 139, 140, 141, 143, 144, 145, 146, 147, 151, 152, 154, 155, 159, 160, 162, 163, 164, 165, 166, 167, 169, 170, 171, 173, 174, 175, 176, 177, 178, 179, 180, 182, 185, 186, 187, 190, 191, 193, 194, 195, 196, 198, 199]"
Olaf,L100,middle,134,80,54,2,0.33,200,"[0, 1, 2, 3, 4, 5, 7, 8, 9, 13, 14, 17, 18, 21, 22, 23, 24, 25, 28, 29, 30, 31, 32, 33, 37, 39, 40, 41, 42, 44, 46, 48, 49, 50, 51, 53, 54, 56, 57, 58, 59, 60, 62, 63, 68, 69, 71, 73, 74, 78, 80, 83, 84, 85, 87, 88, 89, 90, 91, 92, 94, 95, 96, 97, 99, 101, 102, 103, 105, 106, 108, 110, 111, 113, 117, 118, 120, 121, 124, 125, 128, 129, 130, 131, 132, 133, 134, 135, 136, 138, 140, 141, 143, 145, 147, 148, 149, 151, 152, 153, 154, 155, 159, 160, 161, 162, 163, 164, 165, 168, 170, 171, 172, 173, 174, 175, 176, 177, 181, 182, 183, 185, 186, 187, 188, 190, 191, 193, 194, 195, 196, 197, 198, 199]"
Olaf,L100,middle,128,67,61,10,0.36,200,"[1, 2, 3, 5, 6, 7, 9, 10, 11, 12, 13, 14, 15, 17, 18, 19, 20, 22, 25, 26, 27, 30, 31, 34, 35, 37, 38, 40, 41, 42, 44, 45, 48, 49, 50, 51, 53, 54, 55, 56, 58, 60, 62, 63, 66, 71, 72, 73, 74, 75, 76, 77, 78, 79, 81, 83, 84, 86, 87, 88, 90, 92, 93, 94, 95, 96, 99, 107, 110, 112, 113, 114, 116, 117, 119, 120, 123, 124, 125, 126, 127, 128, 129, 130, 131, 134, 135, 136, 137, 138, 139, 140, 141, 143, 144, 147, 149, 150, 151, 154, 155, 156, 159, 164, 165, 169, 170, 171, 172, 175, 176, 177, 178, 180, 181, 183, 184, 185, 186, 190, 192, 193, 194, 195, 196, 197, 198, 199]"
Olaf,L100,middle,123,71,52,3,0.385,200,"[0, 2, 3, 7, 8, 9, 10, 11, 13, 16, 18, 19, 20, 21, 27, 28, 30, 32, 35, 36, 37, 39, 40, 41, 42, 44, 45, 46, 47, 48, 51, 52, 53, 54, 55, 56, 59, 60, 62, 63, 64, 65, 67, 73, 74, 75, 76, 77, 78, 79, 80, 81, 83, 84, 85, 86, 87, 89, 91, 92, 94, 96, 97, 101, 102, 103, 105, 107, 108, 111, 113, 114, 115, 117, 118, 119, 124, 125, 127, 128, 129, 130, 131, 134, 135, 137, 138, 139, 140, 141, 142, 143, 144, 145, 146, 147, 150, 153, 155, 156, 158, 159, 162, 164, 165, 167, 168, 169, 170, 174, 178, 180, 181, 183, 186, 187, 189, 190, 191, 194, 195, 196, 198]"
Olaf,L100,middle,132,57,75,5,0.34,200,"[0, 2, 3, 6, 8, 9, 10, 15, 18, 19, 20, 21, 22, 23, 26, 27, 28, 29, 30, 32, 33, 35, 36, 37, 38, 39, 41, 42, 43, 44, 45, 46, 47, 49, 50, 51, 54, 55, 57, 58, 59, 60, 61, 62, 63, 64, 65, 68, 71, 73, 74, 75, 76, 77, 78, 81, 83, 84, 86, 87, 88, 89, 91, 92, 95, 96, 98, 99, 100, 101, 102, 104, 105, 107, 108, 109, 110, 111, 112, 114, 115, 116, 120, 122, 123, 124, 125, 127, 129, 130, 131, 133, 134, 135, 136, 137, 140, 142, 143, 151, 152, 155, 158, 159, 162, 166, 167, 168, 169, 172, 173, 174, 175, 176, 177, 178, 179, 180, 183, 184, 185, 186, 188, 189, 190, 191, 193, 194, 195, 196, 197, 199]"
Olaf,L100,middle,134,51,83,3,0.33,200,"[0, 1, 2, 3, 4, 5, 8, 9, 11, 12, 15, 17, 18, 19, 20, 21, 22, 23, 24, 29, 31, 32, 37, 38, 39, 40, 41, 42, 43, 44, 45, 48, 50, 52, 54, 55, 56, 57, 58, 60, 62, 63, 64, 66, 67, 69, 70, 71, 73, 74, 77, 78, 81, 83, 84, 85, 86, 88, 89, 92, 93, 94, 96, 97, 98, 100, 101, 103, 105, 107, 108, 109, 112, 113, 115, 116, 117, 118, 120, 121, 122, 123, 125, 129, 130, 131, 132, 133, 135, 136, 137, 138, 140, 141, 143, 144, 147, 148, 149, 150, 153, 154, 155, 156, 157, 159, 160, 161, 162, 163, 164, 165, 166, 168, 170, 171, 172, 173, 174, 175, 179, 180, 183, 184, 185, 187, 188, 189, 190, 191, 192, 194, 196, 197]"
Olaf,L100,middle,130,54,76,4,0.35,200,"[0, 2, 3, 4, 5, 6, 7, 8, 10, 11, 13, 15, 17, 20, 21, 22, 23, 24, 25, 27, 28, 30, 32, 33, 34, 36, 37, 38, 39, 40, 42, 43, 44, 45, 46, 48, 49, 51, 53, 55, 56, 58, 60, 62, 65, 67, 68, 69, 70, 71, 74, 75, 76, 77, 78, 79, 80, 81, 84, 86, 87, 88, 89, 93, 94, 96, 97, 98, 99, 100, 101, 102, 103, 104, 105, 106, 107, 108, 109, 110, 111, 114, 115, 116, 120, 122, 125, 127, 128, 131, 133, 134, 135, 137, 138, 139, 140, 141, 145, 146, 150, 151, 152, 153, 154, 157, 158, 159, 162, 163, 166, 167, 168, 171, 173, 176, 180, 183, 185, 186, 187, 188, 190, 191, 194, 195, 196, 197, 198, 199]"
Olaf,L100,middle,128,63,65,3,0.36,200,"[0, 3, 4, 6, 8, 9, 10, 11, 12, 14, 16, 17, 18, 19, 20, 21, 22, 23, 24, 26, 28, 29, 30, 31, 32, 33, 37, 38, 40, 42, 43, 44, 45, 46, 48, 52, 55, 56, 57, 59, 61, 62, 64, 67, 68, 70, 71, 72, 73, 74, 75, 76, 79, 81, 82, 84, 85, 86, 89, 90, 91, 92, 93, 94, 96, 98, 99, 100, 102, 103, 104, 106, 107, 108, 113, 114, 115, 117, 118, 119, 120, 121, 123, 125, 127, 128, 130, 131, 133, 135, 136, 139, 141, 143, 144, 146, 148, 150, 153, 154, 155, 156, 157, 158, 163, 164, 165, 166, 169, 170, 171, 174, 175, 176, 177, 178, 182, 183, 184, 185, 186, 189, 191, 193, 196, 197, 198, 199]"
Olaf,L100,middle,137,67,70,1,0.315,200,"[1, 2, 3, 6, 7, 8, 9, 10, 11, 14, 15, 16, 17, 18, 19, 20, 21, 22, 23, 24, 25, 26, 27, 29, 30, 31, 33, 34, 35, 37, 38, 39, 41, 42, 43, 44, 46, 47, 48, 50, 51, 52, 53, 54, 55, 56, 57, 58, 60, 62, 63, 65, 68, 69, 72, 73, 74, 76, 77, 79, 80, 83, 86, 88, 90, 92, 93, 94, 95, 96, 101, 103, 105, 106, 107, 108, 109, 110, 113, 114, 117, 118, 120, 122, 123, 124, 125, 126, 128, 129, 131, 136, 138, 139, 140, 141, 142, 143, 145, 146, 147, 148, 150, 152, 153, 154, 155, 157, 160, 161, 163, 164, 165, 166, 167, 169, 170, 171, 173, 175, 176, 177, 178, 180, 182, 183, 185, 187, 188, 189, 190, 194, 195, 196, 197, 198, 199]"
Olaf,L100,middle,125,73,52,9,0.375,200,"[0, 1, 2, 3, 4, 5, 7, 8, 10, 11, 12, 16, 17, 18, 22, 23, 25, 26, 27, 28, 31, 32, 35, 36, 38, 41, 44, 45, 46, 47, 49, 52, 55, 56, 57, 59, 61, 62, 63, 64, 65, 66, 67, 68, 69, 70, 72, 75, 76, 77, 80, 81, 82, 83, 84, 85, 86, 88, 89, 91, 93, 94, 95, 96, 97, 99, 100, 101, 102, 104, 107, 108, 109, 111, 114, 116, 117, 118, 119, 121, 122, 127, 129, 130, 131, 132, 133, 134, 135, 138, 139, 140, 141, 143, 146, 147, 148, 149, 150, 151, 152, 153, 155, 157, 159, 160, 163, 165, 166, 168, 170, 171, 172, 173, 174, 176, 178, 180, 182, 184, 185, 192, 195, 197, 199]"
Olaf,L100,middle,124,56,68,11,0.38,200,"[0, 2, 3, 5, 6, 7, 8, 9, 10, 11, 12, 13, 14, 18, 23, 24, 25, 26, 28, 30, 31, 33, 35, 36, 37, 38, 40, 42, 44, 47, 48, 49, 52, 53, 54, 55, 56, 57, 58, 59, 60, 61, 63, 64, 68, 69, 73, 74, 75, 76, 78, 82, 85, 86, 87, 88, 89, 91, 92, 93, 94, 95, 97, 98, 99, 101, 103, 107, 110, 111, 112, 117, 118, 121, 122, 125, 126, 127, 128, 130, 131, 132, 133, 134, 137, 138, 139, 141, 143, 146, 148, 150, 151, 153, 155, 156, 157, 159, 160, 161, 162, 163, 164, 166, 167, 168, 169, 171, 173, 174, 176, 177, 178, 181, 183, 184, 187, 188, 189, 191, 192, 195, 197, 199]"
Olaf,L100,middle,136,53,83,2,0.32,200,"[0, 2, 3, 4, 6, 7, 8, 9, 10, 11, 12, 13, 14, 16, 17, 18, 19, 21, 25, 26, 28, 29, 31, 32, 34, 35, 36, 37, 39, 41, 43, 45, 46, 48, 49, 51, 53, 56, 57, 61, 62, 63, 64, 65, 66, 67, 68, 69, 70, 72, 74, 75, 76, 77, 79, 80, 82, 83, 84, 85, 86, 88, 89, 92, 93, 94, 95, 96, 98, 99, 100, 101, 102, 103, 104, 105, 106, 109, 112, 114, 115, 118, 123, 124, 125, 126, 128, 129, 130, 131, 132, 133, 134, 135, 136, 138, 139, 140, 141, 142, 143, 144, 146, 148, 150, 151, 154, 155, 156, 157, 159, 160, 163, 165, 167, 170, 172, 174, 176, 177, 179, 181, 183, 184, 185, 186, 188, 189, 191, 192, 194, 195, 196, 197, 198, 199]"
Olaf,L100,middle,134,69,65,4,0.33,200,"[0, 2, 3, 4, 6, 7, 8, 9, 11, 13, 14, 15, 16, 17, 18, 19, 20, 21, 22, 24, 25, 28, 29, 30, 31, 32, 34, 37, 39, 40, 41, 42, 45, 46, 47, 48, 49, 52, 53, 54, 56, 57, 58, 59, 60, 62, 63, 64, 66, 67, 68, 69, 70, 71, 72, 73, 76, 77, 79, 82, 85, 88, 89, 91, 93, 94, 95, 96, 99, 100, 104, 105, 106, 107, 108, 110, 111, 113, 114, 115, 116, 119, 120, 121, 122, 123, 127, 128, 129, 130, 132, 133, 135, 137, 140, 141, 142, 143, 145, 147, 148, 150, 151, 153, 154, 155, 157, 158, 159, 160, 162, 163, 165, 166, 168, 170, 171, 172, 173, 175, 176, 178, 181, 182, 184, 185, 186, 191, 192, 193, 194, 195, 196, 198]"
Olaf,L100,middle,128,59,69,9,0.36,200,"[0, 1, 3, 5, 6, 7, 8, 9, 11, 12, 14, 15, 16, 17, 18, 20, 21, 22, 25, 26, 27, 28, 29, 30, 33, 34, 35, 37, 39, 40, 41, 43, 45, 46, 47, 48, 49, 50, 51, 52, 53, 54, 55, 58, 59, 60, 61, 62, 63, 66, 67, 69, 70, 71, 75, 78, 82, 83, 84, 86, 89, 91, 92, 94, 97, 98, 100, 101, 102, 103, 104, 105, 106, 107, 109, 110, 112, 113, 115, 118, 121, 122, 123, 124, 125, 127, 130, 131, 132, 141, 144, 146, 147, 149, 150, 152, 153, 154, 157, 159, 161, 162, 163, 165, 166, 167, 169, 170, 171, 172, 173, 176, 177, 178, 179, 180, 182, 183, 188, 189, 190, 191, 193, 194, 195, 196, 197, 199]"
Olaf,L100,middle,137,68,69,5,0.315,200,"[2, 3, 4, 5, 8, 9, 11, 12, 13, 14, 15, 16, 17, 19, 20, 21, 22, 23, 26, 27, 28, 29, 30, 31, 32, 33, 35, 37, 39, 42, 43, 44, 45, 47, 48, 49, 50, 52, 54, 59, 60, 61, 62, 63, 65, 67, 69, 71, 72, 74, 76, 78, 79, 82, 83, 86, 88, 89, 90, 91, 92, 93, 95, 99, 100, 102, 103, 105, 107, 108, 109, 110, 111, 115, 116, 117, 119, 120, 121, 122, 126, 127, 128, 131, 132, 134, 135, 136, 137, 138, 139, 140, 141, 142, 143, 144, 146, 147, 148, 149, 150, 151, 152, 153, 154, 155, 156, 157, 158, 159, 160, 161, 166, 167, 169, 170, 171, 173, 174, 175, 176, 177, 178, 179, 181, 182, 183, 185, 186, 187, 188, 189, 190, 195, 196, 198, 199]"
Olaf,L100,middle,131,55,76,3,0.345,200,"[0, 1, 2, 4, 5, 6, 7, 8, 9, 10, 11, 12, 13, 14, 16, 17, 19, 20, 21, 22, 26, 27, 30, 31, 37, 38, 39, 41, 42, 43, 44, 45, 46, 48, 49, 50, 51, 52, 53, 54, 55, 58, 60, 62, 63, 64, 66, 68, 69, 70, 71, 72, 73, 76, 78, 79, 80, 81, 82, 86, 87, 88, 89, 94, 95, 96, 97, 98, 100, 103, 104, 105, 106, 107, 109, 113, 114, 115, 116, 117, 119, 120, 123, 124, 125, 127, 128, 131, 133, 135, 136, 138, 139, 140, 141, 142, 144, 145, 146, 147, 149, 150, 153, 154, 156, 157, 161, 162, 163, 164, 165, 166, 167, 168, 169, 171, 172, 174, 177, 180, 181, 182, 183, 184, 188, 191, 192, 193, 194, 196, 197]"
Olaf,L100,middle,136,79,57,6,0.32,200,"[0, 1, 2, 5, 6, 7, 8, 9, 11, 12, 13, 15, 17, 18, 21, 22, 23, 25, 26, 28, 30, 31, 32, 34, 35, 36, 39, 40, 41, 42, 44, 45, 46, 47, 49, 51, 52, 54, 55, 56, 57, 58, 59, 60, 61, 62, 63, 64, 65, 66, 67, 69, 70, 71, 73, 74, 76, 78, 80, 84, 85, 86, 87, 88, 92, 93, 95, 96, 98, 100, 102, 104, 106, 108, 109, 110, 112, 113, 114, 115, 116, 117, 120, 121, 124, 125, 126, 127, 130, 132, 135, 136, 137, 140, 141, 144, 147, 148, 149, 151, 152, 153, 154, 155, 156, 157, 158, 161, 162, 164, 165, 168, 171, 172, 174, 175, 177, 178, 179, 180, 181, 182, 183, 184, 185, 186, 188, 189, 190, 191, 193, 194, 195, 196, 198, 199]"
Olaf,L100,middle,126,84,42,3,0.37,200,"[0, 1, 2, 3, 4, 5, 6, 9, 11, 13, 15, 16, 17, 18, 19, 20, 22, 23, 25, 27, 28, 29, 31, 33, 36, 38, 40, 42, 43, 46, 48, 51, 53, 55, 57, 58, 61, 62, 63, 64, 65, 68, 71, 72, 73, 74, 75, 78, 80, 81, 82, 83, 84, 85, 86, 88, 89, 90, 92, 93, 94, 95, 96, 99, 100, 101, 105, 106, 107, 108, 109, 111, 112, 114, 115, 116, 120, 121, 122, 124, 125, 126, 128, 129, 130, 135, 137, 138, 139, 142, 144, 145, 147, 148, 150, 152, 153, 155, 156, 159, 160, 161, 162, 163, 164, 166, 167, 168, 169, 172, 173, 176, 180, 181, 182, 184, 185, 186, 190, 192, 193, 194, 195, 196, 198, 199]"
Olaf,L100,middle,135,93,42,0,0.325,200,"[0, 2, 3, 4, 5, 6, 7, 8, 9, 10, 11, 14, 16, 17, 18, 19, 21, 22, 23, 26, 27, 28, 29, 30, 31, 33, 34, 35, 36, 37, 39, 40, 42, 43, 46, 47, 48, 49, 50, 51, 52, 53, 54, 56, 58, 61, 63, 64, 66, 68, 70, 71, 72, 73, 74, 76, 77, 78, 79, 80, 81, 82, 84, 88, 89, 90, 91, 94, 95, 97, 100, 101, 104, 106, 107, 109, 114, 116, 117, 118, 122, 123, 124, 126, 127, 129, 130, 131, 132, 133, 134, 136, 137, 140, 142, 143, 144, 146, 148, 151, 152, 153, 155, 156, 158, 160, 161, 162, 163, 164, 165, 166, 167, 168, 169, 171, 172, 173, 174, 175, 176, 178, 179, 180, 181, 184, 185, 187, 189, 190, 191, 195, 197, 198, 199]"
Olaf,L100,middle,124,60,64,10,0.38,200,"[1, 3, 4, 5, 6, 7, 8, 9, 10, 11, 12, 13, 14, 16, 17, 19, 20, 21, 23, 24, 25, 27, 31, 33, 34, 35, 37, 38, 39, 40, 41, 42, 44, 45, 46, 47, 50, 51, 54, 55, 56, 58, 59, 60, 61, 64, 66, 67, 68, 72, 73, 74, 78, 82, 84, 85, 89, 90, 91, 92, 95, 96, 97, 98, 99, 100, 101, 102, 104, 105, 106, 108, 109, 111, 113, 114, 115, 118, 120, 121, 127, 130, 131, 132, 133, 135, 136, 137, 139, 140, 141, 144, 145, 146, 148, 149, 151, 154, 155, 156, 157, 158, 159, 160, 162, 163, 166, 167, 168, 170, 171, 172, 173, 174, 175, 176, 179, 181, 182, 185, 187, 189, 193, 194]"
Olaf,L100,middle,143,80,63,2,0.285,200,"[1, 3, 4, 6, 7, 10, 11, 12, 13, 16, 17, 20, 21, 22, 23, 24, 25, 26, 28, 29, 31, 34, 35, 36, 39, 40, 41, 42, 43, 45, 46, 48, 49, 50, 51, 52, 53, 54, 55, 56, 58, 59, 60, 61, 63, 64, 66, 67, 68, 69, 70, 71, 72, 73, 74, 77, 78, 80, 83, 84, 85, 86, 88, 89, 90, 91, 92, 95, 96, 97, 99, 101, 102, 103, 104, 105, 106, 108, 109, 112, 117, 118, 119, 120, 121, 122, 123, 124, 125, 126, 127, 128, 129, 130, 131, 132, 133, 135, 136, 138, 140, 142, 143, 144, 146, 147, 148, 150, 151, 154, 155, 157, 159, 160, 161, 162, 164, 166, 167, 169, 171, 172, 173, 174, 175, 176, 177, 178, 183, 184, 185, 186, 187, 189, 190, 192, 193, 194, 195, 196, 197, 198, 199]"
Olaf,L100,middle,126,57,69,4,0.37,200,"[0, 1, 2, 3, 5, 7, 8, 9, 10, 14, 15, 17, 19, 20, 22, 26, 27, 29, 31, 32, 33, 37, 39, 42, 43, 45, 46, 48, 49, 50, 51, 54, 56, 57, 60, 61, 63, 66, 67, 69, 70, 71, 72, 73, 74, 75, 79, 80, 81, 84, 85, 87, 88, 89, 90, 91, 94, 97, 98, 101, 102, 103, 104, 107, 109, 111, 112, 113, 116, 117, 118, 120, 121, 122, 124, 125, 126, 127, 129, 130, 132, 133, 135, 137, 138, 142, 143, 145, 146, 147, 148, 149, 150, 151, 152, 157, 158, 159, 160, 161, 164, 165, 166, 168, 169, 171, 172, 173, 175, 177, 178, 180, 182, 184, 185, 186, 187, 188, 190, 192, 194, 195, 196, 197, 198, 199]"
Olaf,L100,middle,121,58,63,6,0.395,200,"[0, 1, 2, 3, 4, 6, 7, 9, 11, 12, 15, 16, 18, 19, 20, 22, 23, 24, 25, 27, 29, 30, 33, 35, 39, 40, 43, 44, 45, 47, 49, 50, 51, 52, 53, 55, 56, 58, 61, 62, 63, 64, 65, 66, 69, 70, 73, 74, 76, 78, 79, 80, 87, 89, 92, 97, 98, 102, 103, 104, 105, 106, 108, 109, 110, 111, 112, 113, 115, 122, 124, 125, 127, 130, 131, 133, 134, 136, 137, 138, 139, 140, 141, 143, 144, 146, 147, 148, 150, 151, 152, 154, 155, 157, 158, 159, 160, 161, 164, 165, 168, 170, 171, 174, 176, 177, 178, 179, 180, 182, 183, 185, 186, 188, 189, 191, 192, 194, 195, 197, 198]"
Olaf,L100,middle,139,84,55,6,0.305,200,"[1, 2, 3, 4, 5, 8, 10, 11, 12, 13, 14, 15, 16, 17, 19, 20, 21, 22, 23, 24, 25, 29, 30, 31, 32, 33, 34, 36, 38, 39, 41, 43, 44, 47, 48, 50, 51, 52, 54, 55, 57, 59, 60, 62, 64, 66, 67, 69, 70, 71, 72, 74, 75, 77, 78, 79, 80, 81, 82, 83, 85, 86, 88, 89, 90, 91, 94, 95, 98, 99, 100, 102, 103, 104, 105, 107, 108, 109, 110, 111, 113, 114, 115, 116, 119, 121, 122, 124, 126, 127, 128, 129, 130, 131, 133, 134, 136, 137, 138, 139, 140, 141, 143, 146, 147, 148, 149, 150, 152, 153, 154, 156, 158, 159, 161, 162, 165, 168, 170, 172, 175, 176, 179, 180, 181, 182, 184, 186, 187, 188, 189, 191, 192, 193, 194, 196, 197, 198, 199]"
Olaf,L100,middle,136,75,61,1,0.32,200,"[0, 1, 2, 3, 4, 5, 6, 7, 13, 15, 16, 19, 20, 25, 26, 27, 28, 29, 30, 31, 33, 34, 35, 37, 39, 40, 42, 43, 44, 45, 47, 48, 49, 50, 52, 54, 56, 57, 58, 59, 60, 61, 63, 65, 66, 68, 69, 70, 71, 72, 74, 75, 76, 79, 80, 81, 82, 83, 84, 91, 92, 93, 95, 97, 99, 101, 103, 104, 106, 108, 110, 111, 112, 113, 114, 115, 116, 117, 118, 119, 120, 121, 122, 124, 125, 127, 128, 129, 132, 133, 135, 138, 139, 140, 141, 142, 143, 144, 145, 146, 147, 148, 149, 150, 151, 152, 153, 154, 155, 156, 157, 161, 162, 163, 165, 166, 167, 169, 170, 171, 172, 173, 174, 176, 179, 180, 182, 184, 186, 188, 190, 191, 194, 195, 196, 197]"
Olaf,L100,middle,135,49,86,8,0.325,200,"[1, 3, 4, 5, 6, 7, 9, 10, 11, 12, 13, 16, 17, 19, 20, 23, 24, 25, 27, 28, 30, 31, 32, 35, 36, 37, 38, 39, 40, 41, 44, 46, 47, 48, 51, 52, 53, 54, 55, 56, 57, 58, 59, 61, 62, 63, 64, 66, 67, 69, 70, 71, 72, 73, 75, 77, 78, 83, 84, 85, 86, 87, 89, 90, 91, 92, 93, 94, 95, 97, 100, 101, 103, 107, 108, 110, 111, 112, 113, 114, 115, 116, 117, 118, 122, 123, 125, 128, 129, 130, 131, 133, 134, 135, 136, 137, 139, 140, 141, 142, 143, 146, 147, 149, 150, 151, 152, 153, 154, 155, 156, 158, 165, 167, 170, 172, 173, 174, 176, 177, 179, 180, 181, 184, 185, 186, 188, 190, 191, 192, 193, 195, 196, 197, 198]"
Olaf,L100,middle,137,60,77,6,0.315,200,"[0, 1, 3, 4, 5, 6, 7, 8, 9, 10, 11, 12, 15, 16, 17, 18, 20, 21, 23, 24, 26, 27, 30, 34, 35, 37, 38, 39, 40, 41, 42, 44, 45, 46, 47, 48, 50, 51, 52, 53, 54, 55, 56, 57, 58, 60, 61, 62, 63, 66, 67, 68, 70, 71, 72, 73, 75, 77, 78, 79, 83, 86, 87, 88, 90, 92, 93, 94, 98, 99, 100, 102, 103, 104, 105, 106, 107, 109, 110, 111, 113, 114, 116, 117, 118, 120, 121, 124, 125, 126, 128, 129, 132, 133, 134, 135, 136, 137, 138, 142, 146, 147, 149, 150, 151, 152, 153, 154, 155, 156, 157, 158, 162, 163, 164, 166, 167, 168, 169, 170, 172, 173, 175, 176, 177, 179, 180, 182, 183, 184, 185, 187, 188, 190, 192, 197, 199]"
Olaf,L100,middle,134,60,74,3,0.33,200,"[0, 2, 5, 6, 7, 8, 9, 10, 11, 13, 15, 16, 18, 20, 22, 24, 28, 31, 32, 33, 34, 36, 37, 38, 41, 42, 43, 44, 46, 48, 50, 51, 52, 53, 55, 56, 58, 59, 60, 61, 62, 63, 65, 67, 68, 69, 70, 72, 73, 75, 76, 77, 78, 79, 80, 82, 85, 87, 88, 90, 92, 93, 94, 95, 96, 97, 98, 100, 101, 103, 104, 106, 107, 108, 109, 113, 114, 116, 117, 120, 121, 122, 123, 124, 125, 127, 128, 129, 130, 131, 132, 133, 134, 142, 143, 144, 145, 147, 148, 149, 150, 151, 152, 153, 154, 155, 156, 157, 158, 160, 162, 163, 165, 166, 168, 169, 171, 174, 175, 176, 177, 180, 182, 183, 184, 185, 187, 189, 190, 191, 192, 195, 196, 197]"
Olaf,L100,middle,143,71,72,0,0.285,200,"[0, 1, 4, 5, 6, 8, 9, 10, 12, 17, 18, 19, 20, 21, 23, 24, 25, 26, 27, 29, 30, 32, 34, 35, 36, 37, 39, 40, 41, 43, 45, 46, 47, 48, 49, 50, 51, 53, 54, 55, 56, 58, 60, 61, 62, 64, 65, 66, 67, 68, 70, 71, 72, 73, 74, 75, 76, 78, 79, 80, 81, 82, 83, 85, 87, 88, 91, 92, 96, 99, 100, 101, 103, 105, 106, 107, 109, 111, 112, 115, 116, 117, 118, 120, 121, 122, 124, 126, 128, 130, 131, 132, 134, 136, 137, 141, 142, 143, 144, 145, 146, 150, 151, 154, 155, 156, 157, 158, 159, 160, 161, 162, 163, 164, 165, 167, 168, 169, 170, 171, 172, 175, 176, 177, 178, 180, 181, 182, 183, 184, 185, 186, 187, 188, 189, 190, 192, 193, 194, 195, 197, 198, 199]"
Olaf,L100,middle,133,87,46,3,0.335,200,"[0, 1, 2, 3, 4, 5, 6, 7, 8, 9, 10, 11, 12, 13, 14, 16, 17, 19, 20, 21, 24, 25, 26, 28, 29, 31, 33, 34, 37, 38, 39, 43, 44, 45, 46, 49, 50, 52, 56, 58, 59, 60, 61, 62, 64, 65, 66, 67, 71, 72, 73, 76, 78, 81, 82, 83, 84, 85, 87, 89, 90, 91, 92, 93, 94, 95, 98, 100, 101, 102, 103, 104, 106, 107, 108, 110, 112, 113, 115, 116, 117, 118, 121, 122, 123, 124, 129, 131, 132, 133, 134, 135, 136, 137, 138, 139, 140, 141, 142, 144, 145, 146, 147, 148, 151, 155, 157, 158, 159, 160, 162, 163, 164, 166, 167, 168, 173, 174, 176, 177, 178, 180, 182, 183, 184, 185, 186, 188, 192, 194, 195, 196, 199]"
Olaf,L100,middle,128,57,71,3,0.36,200,"[0, 1, 2, 4, 5, 6, 7, 8, 10, 11, 14, 20, 21, 22, 23, 27, 28, 29, 30, 32, 34, 35, 36, 37, 39, 41, 44, 45, 47, 48, 49, 50, 53, 54, 56, 57, 59, 60, 61, 62, 63, 64, 66, 67, 69, 70, 72, 73, 74, 78, 80, 82, 86, 87, 88, 90, 91, 92, 93, 94, 95, 96, 97, 98, 100, 102, 104, 106, 107, 108, 109, 110, 111, 112, 113, 116, 117, 118, 119, 120, 121, 123, 124, 125, 129, 130, 131, 133, 134, 136, 140, 141, 143, 145, 146, 147, 148, 152, 154, 156, 157, 158, 160, 161, 162, 163, 164, 165, 167, 171, 172, 173, 174, 176, 177, 178, 180, 182, 186, 187, 189, 190, 191, 192, 193, 194, 195, 196]"
Olaf,L100,middle,129,53,76,6,0.355,200,"[0, 3, 4, 5, 6, 7, 8, 9, 10, 12, 14, 16, 18, 21, 23, 25, 27, 29, 32, 33, 34, 35, 36, 37, 39, 41, 42, 43, 44, 45, 46, 48, 49, 50, 51, 52, 53, 55, 56, 57, 58, 60, 61, 62, 66, 67, 68, 70, 72, 74, 76, 77, 79, 80, 81, 83, 85, 87, 88, 89, 90, 91, 92, 93, 94, 95, 96, 98, 99, 100, 102, 108, 110, 112, 114, 115, 117, 118, 119, 120, 123, 124, 126, 127, 128, 129, 130, 132, 133, 134, 136, 137, 138, 142, 143, 144, 145, 147, 150, 152, 155, 156, 157, 159, 163, 164, 165, 166, 168, 169, 172, 173, 174, 175, 176, 177, 179, 180, 182, 183, 184, 186, 188, 189, 190, 191, 194, 195, 199]"
Olaf,L100,middle,137,75,62,5,0.315,200,"[1, 2, 3, 4, 7, 8, 9, 10, 13, 14, 15, 16, 17, 18, 20, 26, 28, 31, 33, 35, 36, 37, 38, 40, 42, 43, 44, 45, 47, 48, 51, 52, 53, 54, 56, 57, 58, 59, 60, 61, 62, 63, 65, 66, 67, 68, 69, 70, 72, 73, 74, 75, 76, 77, 78, 79, 81, 82, 86, 88, 89, 90, 91, 92, 93, 94, 95, 96, 98, 99, 100, 101, 102, 103, 104, 106, 109, 111, 113, 115, 116, 117, 118, 119, 121, 122, 123, 124, 125, 126, 128, 129, 130, 132, 133, 134, 135, 136, 137, 138, 139, 141, 142, 143, 145, 146, 147, 148, 149, 150, 151, 153, 154, 159, 160, 162, 166, 169, 170, 171, 172, 174, 175, 177, 178, 179, 180, 183, 184, 186, 188, 190, 192, 193, 194, 196, 199]"
Olaf,L100,middle,139,86,53,2,0.305,200,"[0, 1, 2, 3, 4, 6, 10, 11, 12, 13, 14, 17, 18, 19, 20, 21, 22, 25, 27, 28, 29, 30, 31, 32, 33, 34, 35, 37, 40, 42, 43, 44, 46, 48, 49, 50, 51, 52, 53, 54, 55, 57, 58, 59, 60, 61, 63, 64, 65, 67, 68, 70, 73, 75, 76, 78, 80, 82, 83, 84, 85, 86, 88, 89, 90, 91, 94, 95, 96, 97, 98, 99, 100, 101, 102, 103, 104, 105, 106, 107, 108, 109, 110, 113, 114, 115, 117, 118, 119, 121, 122, 123, 125, 127, 128, 129, 130, 131, 133, 134, 135, 137, 139, 140, 141, 142, 144, 146, 150, 151, 153, 154, 156, 157, 158, 160, 161, 162, 164, 165, 166, 169, 171, 172, 173, 174, 175, 176, 180, 182, 183, 184, 186, 187, 189, 191, 192, 195, 199]"
Olaf,L100,middle,129,72,57,5,0.355,200,"[0, 2, 3, 4, 5, 6, 8, 9, 11, 12, 15, 16, 17, 18, 19, 20, 21, 23, 26, 30, 31, 32, 34, 35, 36, 37, 38, 40, 42, 44, 45, 46, 47, 50, 51, 53, 54, 56, 60, 61, 62, 63, 64, 65, 66, 71, 74, 76, 78, 80, 81, 82, 83, 84, 85, 87, 89, 90, 91, 92, 93, 97, 99, 102, 104, 105, 107, 108, 110, 111, 113, 114, 116, 117, 118, 119, 121, 122, 123, 124, 125, 127, 131, 133, 134, 138, 141, 143, 144, 146, 147, 148, 150, 151, 152, 156, 157, 159, 160, 161, 164, 165, 166, 167, 168, 169, 171, 172, 173, 174, 175, 176, 179, 180, 181, 183, 184, 185, 187, 188, 189, 191, 192, 193, 194, 195, 197, 198, 199]"
Olaf,L100,middle,135,81,54,9,0.325,200,"[0, 2, 3, 4, 5, 6, 7, 8, 9, 10, 12, 13, 15, 16, 17, 18, 19, 21, 22, 24, 28, 29, 30, 31, 32, 33, 35, 36, 37, 38, 39, 42, 44, 46, 48, 49, 50, 51, 52, 53, 55, 56, 58, 59, 62, 63, 64, 65, 68, 69, 71, 73, 74, 75, 80, 81, 83, 84, 85, 87, 89, 90, 91, 93, 95, 96, 97, 98, 99, 101, 102, 103, 104, 107, 108, 109, 110, 113, 115, 116, 121, 123, 124, 127, 128, 129, 130, 131, 133, 134, 135, 136, 138, 139, 141, 143, 145, 146, 149, 150, 151, 153, 154, 155, 157, 158, 159, 161, 162, 163, 164, 165, 167, 170, 171, 172, 173, 174, 175, 176, 177, 178, 179, 180, 182, 186, 187, 188, 189, 190, 191, 192, 194, 198, 199]"
Olaf,L100,middle,132,74,58,4,0.34,200,"[0, 3, 4, 6, 10, 12, 13, 14, 15, 16, 17, 18, 20, 21, 22, 27, 28, 29, 30, 31, 33, 35, 36, 38, 40, 41, 42, 43, 44, 45, 46, 47, 48, 49, 50, 51, 54, 56, 58, 59, 61, 63, 68, 70, 71, 72, 73, 74, 78, 79, 80, 81, 82, 83, 84, 87, 88, 90, 91, 94, 95, 96, 101, 104, 107, 109, 110, 111, 115, 118, 119, 120, 121, 122, 126, 127, 130, 132, 133, 134, 135, 137, 138, 139, 141, 142, 143, 144, 146, 147, 149, 150, 151, 152, 153, 154, 155, 156, 159, 160, 161, 162, 163, 164, 165, 166, 167, 168, 169, 170, 171, 172, 173, 174, 175, 178, 179, 180, 181, 183, 184, 185, 186, 187, 188, 190, 191, 192, 193, 196, 197, 198]"
Olaf,L100,middle,129,73,56,9,0.355,200,"[0, 1, 3, 5, 7, 9, 14, 15, 16, 17, 19, 20, 21, 22, 23, 24, 25, 26, 27, 28, 31, 32, 34, 35, 37, 40, 41, 42, 43, 44, 45, 46, 47, 50, 52, 53, 56, 58, 61, 62, 64, 65, 66, 68, 70, 72, 73, 74, 75, 76, 78, 79, 82, 83, 84, 88, 91, 92, 94, 95, 96, 97, 98, 99, 101, 103, 104, 106, 107, 111, 115, 116, 117, 118, 119, 120, 121, 122, 123, 124, 125, 129, 131, 133, 135, 136, 137, 138, 139, 142, 143, 144, 145, 146, 147, 148, 150, 152, 154, 156, 157, 159, 160, 161, 162, 163, 164, 165, 166, 168, 169, 170, 172, 173, 174, 175, 177, 179, 180, 185, 186, 187, 190, 191, 192, 193, 195, 196, 197]"
Olaf,L100,middle,129,63,66,1,0.355,200,"[0, 1, 2, 4, 5, 7, 8, 10, 11, 13, 14, 15, 16, 18, 19, 21, 22, 24, 25, 26, 31, 33, 34, 35, 37, 38, 40, 41, 42, 43, 44, 45, 48, 49, 50, 51, 53, 55, 57, 59, 60, 61, 62, 63, 64, 65, 66, 68, 69, 70, 71, 72, 73, 75, 79, 80, 81, 83, 84, 85, 86, 88, 93, 95, 100, 101, 103, 104, 106, 107, 108, 109, 110, 112, 113, 114, 115, 117, 119, 122, 124, 125, 126, 129, 131, 134, 136, 138, 139, 140, 142, 143, 144, 146, 150, 151, 152, 153, 154, 155, 156, 160, 161, 162, 163, 164, 165, 166, 168, 172, 173, 174, 175, 176, 177, 178, 179, 180, 181, 182, 183, 184, 185, 189, 190, 191, 195, 196, 198]"
Olaf,L100,middle,134,76,58,2,0.33,200,"[0, 2, 3, 4, 6, 7, 9, 12, 13, 14, 15, 16, 19, 20, 22, 23, 24, 25, 29, 31, 36, 37, 40, 41, 43, 44, 45, 48, 49, 50, 51, 52, 53, 54, 55, 57, 58, 61, 62, 64, 65, 66, 67, 68, 69, 70, 71, 72, 73, 74, 75, 77, 78, 79, 80, 81, 82, 83, 84, 85, 87, 90, 92, 93, 94, 95, 96, 98, 99, 100, 103, 104, 107, 109, 110, 112, 113, 114, 115, 116, 118, 120, 121, 124, 126, 127, 128, 129, 132, 133, 134, 137, 138, 139, 142, 143, 144, 145, 146, 147, 149, 150, 151, 153, 154, 156, 158, 159, 160, 162, 163, 164, 167, 168, 169, 170, 171, 172, 173, 174, 175, 176, 177, 179, 180, 185, 186, 187, 188, 192, 193, 196, 197, 198]"
Olaf,L100,middle,133,81,52,5,0.335,200,"[2, 5, 6, 8, 9, 12, 13, 14, 16, 18, 22, 23, 24, 26, 27, 28, 30, 32, 35, 36, 37, 38, 39, 40, 41, 44, 45, 46, 48, 50, 51, 52, 53, 54, 55, 57, 59, 62, 63, 65, 66, 67, 68, 71, 72, 74, 75, 76, 77, 78, 79, 80, 82, 87, 89, 91, 92, 93, 94, 95, 96, 97, 98, 99, 101, 104, 105, 106, 108, 109, 110, 111, 113, 114, 117, 118, 120, 121, 122, 123, 124, 125, 128, 130, 131, 132, 133, 134, 135, 136, 138, 140, 141, 142, 143, 144, 145, 146, 147, 148, 149, 150, 151, 152, 154, 156, 159, 161, 162, 163, 164, 165, 166, 168, 169, 171, 173, 176, 177, 178, 180, 182, 184, 185, 189, 190, 191, 193, 194, 196, 197, 198, 199]"
Olaf,L100,middle,139,84,55,4,0.305,200,"[0, 3, 4, 5, 7, 8, 9, 10, 11, 12, 14, 15, 16, 18, 19, 20, 22, 23, 24, 25, 26, 27, 28, 32, 33, 35, 36, 38, 39, 40, 41, 42, 43, 44, 45, 46, 47, 49, 50, 51, 52, 53, 54, 55, 56, 57, 58, 59, 60, 62, 64, 65, 68, 69, 70, 71, 72, 73, 74, 75, 76, 78, 79, 80, 83, 84, 85, 87, 89, 90, 91, 92, 93, 96, 97, 98, 102, 103, 105, 108, 109, 111, 113, 115, 116, 118, 119, 120, 122, 124, 125, 127, 130, 132, 133, 134, 136, 137, 138, 139, 140, 141, 143, 144, 145, 146, 147, 148, 149, 150, 151, 152, 153, 155, 156, 159, 164, 166, 167, 169, 171, 172, 173, 174, 176, 177, 178, 179, 180, 181, 182, 183, 184, 185, 186, 187, 193, 198, 199]"
Olaf,L100,middle,141,40,101,5,0.295,200,"[1, 2, 3, 5, 6, 7, 8, 11, 14, 15, 16, 17, 18, 19, 20, 23, 24, 25, 28, 29, 30, 31, 33, 34, 35, 36, 38, 39, 42, 43, 45, 46, 47, 48, 49, 50, 52, 55, 57, 58, 59, 60, 62, 64, 65, 67, 68, 69, 70, 71, 73, 74, 75, 76, 78, 80, 81, 82, 83, 84, 85, 86, 87, 88, 90, 93, 95, 97, 98, 99, 103, 105, 107, 109, 110, 112, 114, 115, 116, 117, 118, 119, 121, 122, 124, 125, 127, 128, 129, 131, 132, 133, 134, 135, 136, 137, 138, 139, 140, 142, 143, 144, 145, 146, 147, 148, 149, 150, 151, 152, 154, 155, 156, 160, 161, 166, 167, 168, 169, 170, 171, 172, 174, 177, 179, 180, 183, 184, 186, 188, 189, 190, 191, 192, 193, 194, 195, 196, 197, 198, 199]"
Olaf,L100,middle,140,56,84,3,0.3,200,"[0, 1, 2, 3, 4, 8, 9, 14, 16, 17, 20, 21, 22, 23, 24, 25, 27, 28, 29, 31, 32, 33, 34, 35, 38, 39, 40, 41, 42, 43, 45, 48, 50, 51, 53, 54, 56, 59, 60, 61, 63, 64, 65, 66, 67, 68, 70, 71, 72, 73, 74, 76, 79, 80, 83, 85, 86, 87, 88, 91, 92, 93, 94, 95, 96, 97, 98, 99, 101, 102, 103, 105, 107, 109, 110, 111, 112, 113, 115, 116, 117, 121, 124, 125, 126, 127, 129, 130, 131, 132, 134, 135, 137, 138, 139, 140, 142, 143, 144, 145, 146, 147, 148, 149, 150, 151, 152, 153, 154, 155, 156, 157, 158, 159, 160, 161, 163, 166, 167, 168, 170, 173, 175, 177, 179, 180, 181, 182, 183, 184, 185, 186, 187, 188, 189, 192, 195, 196, 198, 199]"
Olaf,L100,middle,136,65,71,4,0.32,200,"[0, 1, 2, 3, 4, 7, 11, 12, 13, 15, 16, 18, 19, 20, 24, 25, 26, 27, 28, 29, 30, 32, 33, 34, 35, 36, 37, 39, 40, 41, 42, 45, 48, 49, 51, 53, 54, 55, 57, 60, 61, 64, 65, 66, 67, 68, 69, 70, 71, 73, 74, 78, 79, 80, 82, 83, 84, 86, 87, 89, 90, 91, 92, 93, 94, 96, 99, 101, 102, 105, 107, 108, 109, 110, 111, 112, 114, 116, 117, 118, 120, 122, 123, 124, 125, 126, 128, 130, 131, 132, 133, 135, 137, 138, 143, 144, 145, 146, 147, 150, 151, 152, 154, 155, 156, 157, 159, 161, 162, 163, 165, 167, 168, 169, 170, 171, 172, 174, 175, 177, 178, 179, 180, 181, 182, 183, 184, 185, 186, 190, 191, 192, 194, 197, 198, 199]"
Olaf,L100,middle,121,60,61,9,0.395,200,"[1, 2, 3, 4, 6, 8, 9, 10, 12, 13, 17, 20, 21, 22, 23, 24, 25, 29, 31, 32, 33, 34, 36, 37, 38, 39, 40, 41, 43, 45, 46, 47, 50, 51, 52, 54, 55, 56, 61, 64, 65, 66, 69, 71, 72, 74, 75, 76, 78, 80, 81, 85, 87, 89, 91, 92, 93, 94, 96, 102, 105, 106, 108, 109, 112, 113, 116, 117, 118, 119, 120, 122, 123, 124, 126, 127, 128, 129, 132, 133, 135, 136, 137, 139, 140, 142, 145, 146, 149, 153, 154, 155, 157, 158, 159, 161, 162, 163, 164, 166, 167, 168, 170, 171, 173, 174, 177, 178, 179, 182, 184, 185, 187, 188, 190, 191, 192, 193, 196, 197, 198]"
Olaf,L100,middle,140,64,76,5,0.3,200,"[1, 2, 10, 11, 12, 14, 15, 17, 18, 19, 20, 21, 22, 23, 24, 26, 27, 28, 30, 33, 34, 36, 38, 39, 40, 41, 42, 44, 45, 46, 48, 49, 50, 51, 52, 53, 54, 55, 57, 58, 59, 60, 61, 63, 66, 67, 69, 70, 71, 72, 73, 74, 76, 79, 80, 81, 82, 83, 84, 87, 88, 91, 93, 94, 95, 96, 98, 99, 102, 104, 105, 106, 107, 108, 109, 110, 112, 113, 114, 115, 118, 119, 120, 121, 124, 125, 126, 130, 131, 132, 135, 140, 141, 142, 143, 144, 145, 147, 148, 149, 151, 152, 153, 155, 156, 157, 158, 159, 160, 161, 162, 163, 164, 165, 169, 170, 171, 172, 173, 174, 177, 178, 179, 180, 181, 182, 183, 184, 185, 186, 187, 188, 189, 190, 191, 192, 194, 196, 197, 199]"
Olaf,L100,middle,139,71,68,3,0.305,200,"[0, 1, 2, 3, 4, 5, 6, 7, 8, 10, 11, 12, 13, 14, 15, 16, 17, 18, 20, 21, 23, 25, 29, 30, 31, 35, 36, 37, 38, 39, 40, 41, 42, 44, 45, 46, 47, 49, 51, 52, 54, 56, 58, 60, 62, 64, 66, 67, 68, 69, 70, 71, 72, 73, 76, 77, 78, 79, 80, 81, 82, 83, 88, 91, 92, 93, 94, 95, 97, 98, 101, 102, 103, 104, 105, 106, 107, 108, 109, 110, 113, 114, 116, 117, 120, 121, 123, 124, 128, 130, 132, 133, 135, 136, 138, 139, 140, 141, 142, 145, 146, 147, 148, 149, 151, 153, 154, 158, 159, 161, 162, 163, 164, 165, 166, 168, 171, 172, 173, 174, 175, 176, 177, 179, 180, 181, 182, 185, 186, 187, 188, 189, 190, 193, 195, 196, 197, 198, 199]"
Olaf,L100,middle,133,69,64,6,0.335,200,"[0, 1, 3, 5, 7, 8, 9, 11, 12, 15, 16, 17, 19, 20, 21, 22, 23, 25, 26, 28, 29, 30, 31, 32, 33, 34, 35, 37, 38, 39, 41, 43, 44, 45, 47, 48, 49, 51, 52, 55, 56, 58, 60, 61, 64, 66, 67, 68, 71, 73, 74, 75, 76, 78, 79, 80, 83, 84, 86, 87, 89, 90, 92, 93, 96, 97, 98, 99, 100, 101, 104, 105, 108, 109, 112, 113, 114, 115, 117, 118, 121, 125, 128, 130, 132, 133, 134, 135, 136, 137, 139, 141, 142, 143, 144, 145, 146, 147, 148, 150, 153, 154, 156, 158, 159, 160, 161, 164, 166, 167, 168, 170, 172, 173, 174, 175, 176, 177, 178, 179, 182, 183, 184, 186, 189, 190, 192, 193, 194, 195, 197, 198, 199]"
Olaf,L100,middle,124,49,75,8,0.38,200,"[3, 4, 5, 6, 8, 9, 10, 11, 12, 13, 15, 16, 18, 19, 21, 22, 23, 25, 27, 29, 30, 32, 33, 34, 35, 36, 37, 41, 42, 44, 46, 47, 49, 50, 51, 54, 55, 56, 57, 59, 60, 61, 62, 63, 67, 70, 71, 72, 73, 74, 75, 76, 78, 79, 80, 81, 83, 84, 85, 86, 90, 91, 92, 93, 94, 96, 97, 98, 100, 101, 102, 105, 106, 107, 110, 112, 114, 115, 116, 121, 123, 124, 125, 128, 130, 133, 134, 135, 136, 137, 138, 141, 142, 148, 149, 150, 151, 152, 153, 154, 156, 159, 161, 162, 163, 164, 165, 167, 170, 173, 174, 178, 179, 180, 182, 183, 184, 188, 190, 192, 195, 196, 197, 199]"
Olaf,L0,long,79,47,32,2,0.5587,179,"[16, 25, 28, 30, 44, 49, 51, 52, 54, 55, 56, 57, 59, 61, 74, 77, 79, 80, 83, 84, 85, 86, 87, 88, 89, 90, 98, 101, 102, 103, 104, 106, 109, 110, 112, 113, 114, 115, 116, 119, 121, 125, 128, 129, 131, 132, 133, 138, 140, 141, 142, 143, 144, 145, 146, 147, 148, 149, 150, 151, 152, 153, 154, 155, 156, 157, 158, 159, 164, 165, 166, 167, 169, 172, 173, 174, 175, 176, 177]"
Olaf,L0,long,65,44,21,4,0.6061,165,"[15, 29, 43, 50, 52, 53, 55, 56, 59, 61, 71, 75, 76, 77, 78, 79, 80, 81, 82, 86, 87, 89, 90, 97, 100, 101, 102, 103, 104, 105, 106, 107, 108, 109, 110, 111, 112, 113, 114, 115, 117, 118, 120, 124, 127, 128, 131, 134, 137, 138, 139, 140, 141, 144, 145, 147, 150, 155, 156, 157, 158, 160, 161, 162, 163]"
Olaf,L0,long,69,37,32,5,0.5917,169,"[14, 26, 35, 48, 54, 57, 58, 61, 73, 75, 78, 79, 80, 81, 82, 83, 84, 85, 88, 89, 91, 96, 98, 99, 100, 101, 102, 103, 105, 106, 108, 109, 110, 112, 113, 115, 116, 120, 121, 123, 126, 127, 128, 130, 131, 132, 134, 135, 137, 139, 140, 141, 142, 143, 144, 145, 148, 150, 151, 152, 154, 156, 158, 159, 161, 162, 163, 165, 166]"
Olaf,L0,long,77,39,38,3,0.565,177,"[16, 25, 28, 31, 34, 48, 55, 57, 58, 60, 61, 62, 64, 75, 79, 80, 82, 83, 84, 85, 86, 87, 88, 89, 91, 92, 93, 95, 101, 104, 105, 106, 107, 108, 111, 113, 114, 115, 116, 118, 119, 121, 122, 123, 124, 130, 131, 132, 134, 135, 138, 139, 140, 142, 143, 144, 145, 146, 147, 149, 150, 152, 154, 155, 156, 157, 158, 159, 160, 161, 162, 163, 165, 169, 170, 173, 175]"
Olaf,L0,long,103,33,70,6,0.485,200,"[14, 28, 33, 47, 52, 55, 56, 58, 61, 75, 76, 77, 78, 79, 80, 81, 82, 84, 85, 86, 87, 88, 90, 97, 99, 100, 101, 102, 105, 106, 107, 108, 109, 111, 112, 113, 114, 115, 117, 118, 119, 120, 121, 124, 125, 127, 128, 131, 132, 135, 136, 137, 139, 140, 142, 143, 146, 147, 148, 149, 150, 151, 152, 153, 154, 155, 156, 157, 158, 159, 160, 162, 163, 164, 165, 166, 167, 168, 169, 170, 171, 173, 174, 176, 177, 178, 179, 180, 181, 182, 183, 184, 185, 187, 189, 190, 191, 193, 194, 195, 197, 198, 199]"
Olaf,L0,long,69,37,32,3,0.5917,169,"[14, 26, 34, 48, 53, 56, 57, 58, 59, 60, 61, 62, 72, 80, 81, 82, 83, 85, 86, 88, 89, 90, 91, 92, 98, 100, 102, 103, 104, 105, 110, 111, 112, 114, 115, 116, 117, 119, 120, 121, 123, 126, 127, 128, 129, 131, 133, 134, 137, 139, 140, 141, 142, 143, 144, 146, 148, 149, 150, 151, 153, 157, 158, 159, 161, 163, 164, 166, 167]"
Olaf,L0,long,81,47,34,1,0.5525,181,"[16, 25, 30, 48, 53, 54, 55, 61, 71, 75, 77, 79, 80, 85, 86, 87, 88, 89, 90, 95, 96, 97, 98, 99, 101, 102, 103, 104, 105, 106, 107, 108, 109, 110, 112, 114, 117, 119, 120, 121, 122, 124, 125, 126, 127, 130, 133, 134, 135, 136, 137, 139, 140, 141, 142, 143, 144, 145, 148, 149, 150, 151, 152, 153, 154, 155, 156, 161, 162, 163, 164, 165, 167, 169, 170, 171, 173, 174, 175, 176, 177]"
Olaf,L0,long,81,29,52,1,0.5525,181,"[16, 26, 29, 43, 48, 50, 51, 52, 53, 54, 55, 58, 59, 60, 72, 76, 78, 80, 81, 82, 83, 84, 85, 87, 88, 89, 90, 98, 100, 102, 103, 104, 107, 109, 110, 113, 114, 115, 116, 117, 118, 119, 120, 124, 126, 127, 128, 129, 130, 132, 133, 134, 135, 136, 138, 141, 142, 143, 144, 145, 147, 149, 150, 151, 153, 154, 156, 157, 158, 159, 160, 162, 165, 167, 168, 170, 171, 175, 176, 178, 179]"
Olaf,L0,long,67,32,35,1,0.5988,167,"[18, 25, 29, 44, 48, 52, 53, 54, 55, 56, 57, 58, 59, 73, 76, 77, 78, 79, 80, 81, 82, 83, 85, 87, 88, 89, 91, 99, 101, 104, 105, 107, 108, 110, 114, 115, 117, 118, 119, 120, 121, 122, 125, 126, 127, 128, 133, 134, 136, 137, 138, 139, 140, 142, 143, 144, 147, 148, 151, 152, 154, 155, 156, 157, 158, 162, 164]"
Olaf,L0,long,61,26,35,10,0.6211,161,"[17, 29, 35, 48, 56, 57, 59, 60, 61, 62, 63, 74, 78, 81, 84, 87, 90, 91, 92, 95, 98, 100, 102, 105, 106, 107, 108, 109, 110, 112, 113, 114, 115, 116, 117, 118, 120, 121, 122, 123, 124, 127, 128, 130, 132, 133, 134, 135, 137, 139, 140, 141, 142, 143, 145, 149, 150, 151, 152, 156, 159]"
Olaf,L0,long,82,30,52,6,0.5495,182,"[14, 26, 33, 47, 52, 55, 56, 57, 58, 59, 70, 74, 75, 76, 77, 79, 80, 81, 83, 84, 85, 86, 87, 88, 90, 91, 100, 101, 103, 105, 107, 108, 111, 112, 113, 115, 118, 119, 122, 123, 126, 127, 128, 129, 130, 132, 133, 134, 135, 136, 138, 139, 141, 143, 144, 148, 149, 150, 151, 152, 153, 155, 156, 157, 158, 159, 160, 161, 163, 164, 165, 167, 168, 171, 173, 174, 175, 176, 177, 178, 179, 180]"
Olaf,L0,long,67,29,38,3,0.5988,167,"[16, 26, 31, 45, 51, 53, 55, 58, 59, 70, 74, 75, 78, 81, 82, 83, 84, 85, 86, 87, 88, 90, 97, 99, 102, 103, 106, 107, 111, 112, 113, 114, 117, 118, 119, 120, 121, 123, 125, 126, 127, 129, 132, 133, 134, 135, 136, 138, 139, 142, 144, 145, 146, 147, 148, 149, 150, 151, 152, 153, 154, 155, 156, 157, 158, 161, 163]"
Olaf,L0,long,70,30,40,4,0.5882,170,"[14, 26, 33, 47, 52, 55, 57, 58, 60, 70, 74, 77, 78, 80, 81, 83, 84, 86, 89, 90, 91, 96, 98, 99, 100, 102, 103, 106, 107, 111, 112, 114, 117, 120, 121, 122, 123, 124, 125, 127, 128, 129, 130, 131, 132, 133, 134, 137, 138, 140, 141, 142, 144, 145, 147, 148, 149, 151, 152, 153, 154, 155, 156, 157, 159, 162, 163, 165, 166, 168]"
Olaf,L0,long,72,37,35,4,0.5814,172,"[15, 29, 43, 50, 53, 54, 55, 56, 58, 61, 72, 75, 77, 79, 80, 81, 82, 83, 84, 87, 88, 89, 90, 91, 93, 100, 102, 106, 107, 109, 111, 112, 113, 116, 117, 118, 119, 120, 121, 123, 124, 125, 126, 127, 128, 131, 132, 133, 134, 135, 137, 139, 140, 142, 143, 146, 147, 148, 149, 150, 151, 152, 154, 155, 157, 158, 159, 161, 162, 166, 167, 169]"
Olaf,L0,long,72,36,36,5,0.5814,172,"[14, 28, 33, 47, 52, 55, 56, 57, 60, 71, 74, 76, 77, 78, 80, 81, 82, 89, 92, 97, 98, 99, 102, 103, 104, 106, 108, 109, 110, 112, 114, 116, 117, 118, 120, 121, 122, 124, 125, 127, 128, 129, 130, 131, 132, 133, 134, 136, 138, 141, 143, 145, 147, 148, 149, 150, 151, 153, 154, 155, 156, 158, 159, 160, 161, 162, 164, 165, 167, 168, 169, 170]"
Olaf,L0,long,93,48,45,9,0.5181,193,"[14, 26, 33, 48, 53, 55, 56, 57, 58, 60, 71, 75, 76, 77, 78, 79, 80, 81, 82, 84, 85, 86, 87, 88, 90, 92, 100, 102, 103, 104, 106, 107, 108, 109, 110, 111, 114, 115, 116, 117, 119, 126, 127, 128, 129, 130, 131, 132, 133, 134, 135, 136, 139, 141, 142, 143, 145, 147, 148, 149, 151, 152, 153, 154, 155, 156, 157, 158, 159, 160, 161, 162, 163, 165, 169, 170, 171, 172, 173, 174, 175, 176, 178, 180, 181, 182, 183, 184, 185, 186, 187, 189, 191]"
Olaf,L0,long,74,28,46,2,0.5747,174,"[16, 26, 29, 43, 48, 51, 52, 53, 54, 55, 57, 58, 59, 71, 77, 79, 80, 82, 85, 88, 89, 94, 97, 99, 100, 102, 103, 105, 111, 112, 113, 114, 115, 116, 117, 118, 119, 122, 123, 124, 125, 127, 128, 129, 130, 132, 136, 137, 138, 139, 140, 141, 142, 143, 145, 146, 147, 148, 149, 150, 152, 153, 154, 155, 157, 160, 162, 163, 165, 166, 167, 169, 170, 171]"
Olaf,L0,long,65,37,28,6,0.6061,165,"[14, 26, 36, 50, 56, 58, 60, 62, 72, 75, 78, 79, 80, 81, 84, 85, 86, 87, 89, 90, 91, 96, 99, 100, 101, 103, 105, 107, 108, 109, 110, 114, 115, 117, 118, 119, 120, 122, 123, 125, 127, 128, 130, 131, 132, 133, 135, 139, 140, 141, 142, 144, 145, 146, 147, 149, 150, 151, 152, 153, 155, 156, 158, 159, 161]"
Olaf,L0,long,69,28,41,8,0.5917,169,"[14, 26, 34, 48, 53, 57, 58, 59, 60, 71, 75, 76, 78, 82, 83, 84, 85, 86, 88, 89, 90, 94, 99, 101, 102, 103, 104, 105, 107, 108, 109, 110, 111, 112, 113, 114, 115, 116, 117, 118, 119, 120, 122, 125, 127, 128, 131, 132, 133, 134, 135, 137, 139, 140, 141, 144, 145, 146, 147, 148, 150, 151, 152, 154, 155, 156, 160, 161, 166]"
Olaf,L0,long,59,21,38,11,0.6289,159,"[14, 26, 33, 49, 53, 57, 65, 75, 77, 78, 81, 82, 83, 86, 89, 91, 94, 96, 97, 98, 99, 100, 102, 103, 105, 109, 110, 111, 114, 115, 116, 118, 120, 121, 123, 125, 126, 128, 130, 132, 135, 136, 137, 138, 139, 140, 141, 142, 143, 144, 145, 146, 147, 148, 151, 152, 154, 155, 157]"
Olaf,L0,long,58,30,28,3,0.6329,158,"[16, 25, 30, 44, 49, 51, 52, 54, 56, 58, 59, 71, 75, 78, 80, 81, 82, 84, 85, 88, 89, 96, 99, 100, 102, 103, 104, 105, 106, 109, 110, 114, 115, 116, 117, 118, 120, 123, 124, 126, 127, 129, 130, 131, 132, 133, 134, 136, 137, 139, 141, 142, 144, 145, 146, 148, 149, 151]"
Olaf,L0,long,55,28,27,6,0.6452,155,"[16, 26, 30, 43, 51, 52, 53, 56, 57, 58, 61, 72, 76, 79, 80, 81, 82, 83, 85, 86, 88, 89, 95, 100, 101, 102, 104, 105, 106, 107, 109, 110, 111, 112, 114, 115, 116, 121, 124, 125, 129, 130, 131, 133, 134, 137, 138, 139, 140, 143, 144, 146, 148, 150, 152]"
Olaf,L0,long,60,36,24,2,0.625,160,"[16, 25, 30, 43, 48, 52, 53, 54, 56, 57, 58, 60, 72, 77, 79, 81, 84, 85, 87, 88, 91, 92, 99, 100, 101, 102, 104, 105, 109, 111, 112, 113, 114, 118, 123, 124, 125, 127, 128, 129, 130, 131, 132, 133, 135, 136, 137, 138, 140, 141, 142, 144, 145, 149, 151, 152, 153, 154, 155, 157]"
Olaf,L0,long,61,28,33,4,0.6211,161,"[14, 29, 43, 51, 52, 53, 58, 61, 73, 75, 76, 77, 78, 79, 80, 82, 84, 85, 86, 88, 89, 90, 92, 98, 100, 101, 103, 106, 107, 108, 109, 110, 111, 113, 114, 116, 117, 118, 121, 123, 125, 127, 128, 129, 131, 133, 136, 137, 138, 139, 140, 141, 143, 145, 147, 148, 153, 155, 156, 157, 159]"
Olaf,L0,long,64,23,41,2,0.6098,164,"[15, 31, 47, 54, 55, 56, 58, 59, 69, 74, 75, 76, 78, 80, 81, 82, 83, 84, 85, 86, 87, 89, 96, 98, 100, 101, 102, 103, 105, 106, 107, 108, 110, 114, 115, 119, 121, 122, 124, 126, 127, 128, 129, 130, 131, 132, 133, 136, 138, 139, 140, 141, 143, 147, 148, 149, 150, 151, 153, 155, 158, 159, 160, 162]"
Olaf,L0,long,79,40,39,3,0.5587,179,"[18, 26, 29, 30, 32, 46, 52, 55, 56, 57, 58, 59, 61, 63, 75, 78, 80, 82, 83, 85, 86, 87, 88, 89, 91, 93, 101, 104, 105, 106, 107, 109, 110, 111, 112, 113, 114, 115, 117, 119, 120, 123, 125, 127, 128, 132, 133, 134, 135, 136, 137, 138, 140, 141, 142, 143, 144, 145, 146, 147, 149, 150, 152, 153, 154, 157, 159, 160, 161, 162, 163, 164, 165, 171, 172, 173, 174, 176, 177]"
Olaf,L0,long,76,40,36,1,0.5682,176,"[17, 25, 30, 43, 48, 51, 52, 53, 54, 57, 59, 72, 76, 77, 78, 79, 80, 81, 84, 85, 86, 87, 89, 95, 99, 101, 102, 104, 106, 108, 109, 111, 112, 113, 117, 118, 119, 121, 122, 123, 124, 125, 126, 127, 128, 129, 130, 131, 132, 134, 135, 136, 137, 138, 141, 143, 147, 148, 149, 154, 155, 156, 157, 160, 162, 163, 164, 165, 166, 167, 168, 169, 170, 171, 173, 174]"
Olaf,L0,long,65,31,34,6,0.6061,165,"[14, 26, 33, 48, 53, 56, 58, 59, 61, 72, 76, 78, 79, 80, 81, 83, 85, 86, 87, 88, 89, 90, 92, 94, 99, 102, 105, 106, 108, 109, 111, 113, 116, 118, 120, 121, 122, 124, 126, 128, 129, 130, 131, 133, 135, 136, 137, 138, 140, 141, 142, 144, 146, 147, 148, 149, 151, 152, 153, 154, 155, 156, 158, 159, 160]"
Olaf,L0,long,83,48,35,1,0.5464,183,"[18, 27, 29, 31, 32, 33, 48, 52, 54, 55, 56, 57, 58, 60, 61, 63, 64, 77, 82, 83, 86, 89, 91, 92, 93, 94, 95, 103, 104, 106, 107, 109, 113, 117, 120, 121, 122, 123, 126, 127, 128, 129, 131, 132, 133, 134, 136, 137, 140, 141, 143, 144, 146, 147, 149, 150, 151, 152, 153, 155, 156, 157, 158, 159, 160, 161, 162, 163, 164, 165, 166, 167, 168, 169, 172, 173, 174, 176, 177, 178, 179, 180, 181]"
Olaf,L0,long,61,30,31,3,0.6211,161,"[16, 30, 45, 51, 53, 54, 55, 56, 57, 58, 60, 72, 75, 77, 78, 81, 82, 84, 85, 86, 88, 89, 97, 98, 99, 100, 103, 105, 109, 110, 111, 112, 113, 118, 120, 122, 125, 126, 127, 129, 130, 131, 133, 134, 136, 137, 138, 139, 140, 142, 145, 149, 150, 151, 152, 153, 154, 155, 156, 158, 159]"
Olaf,L0,long,59,25,34,2,0.6289,159,"[16, 25, 28, 30, 46, 50, 52, 53, 56, 57, 59, 72, 78, 80, 81, 83, 84, 89, 95, 97, 98, 99, 101, 102, 105, 107, 110, 111, 112, 113, 115, 116, 117, 118, 120, 121, 122, 123, 124, 125, 126, 127, 128, 129, 130, 131, 133, 134, 136, 137, 138, 139, 142, 144, 145, 150, 153, 155, 156]"
Olaf,L0,long,63,33,30,1,0.6135,163,"[16, 25, 28, 30, 45, 50, 52, 54, 55, 56, 57, 58, 60, 61, 73, 78, 81, 82, 83, 84, 85, 87, 90, 91, 97, 100, 102, 103, 105, 106, 107, 108, 111, 112, 113, 115, 118, 119, 121, 122, 123, 124, 126, 127, 128, 129, 130, 131, 132, 136, 138, 139, 144, 147, 149, 150, 153, 154, 156, 157, 158, 159, 161]"
Olaf,L0,long,59,35,24,4,0.6289,159,"[14, 26, 33, 47, 55, 58, 60, 61, 72, 74, 75, 76, 80, 81, 82, 83, 84, 85, 86, 88, 91, 97, 102, 104, 106, 107, 108, 110, 112, 113, 114, 115, 117, 118, 119, 120, 121, 124, 125, 126, 129, 130, 135, 137, 139, 140, 141, 144, 145, 146, 147, 148, 150, 151, 152, 153, 154, 155, 157]"
Olaf,L0,long,72,40,32,6,0.5814,172,"[14, 26, 33, 47, 52, 55, 56, 57, 58, 59, 70, 74, 75, 76, 78, 82, 83, 85, 86, 88, 91, 96, 98, 99, 101, 103, 104, 105, 106, 107, 108, 109, 114, 117, 118, 120, 121, 122, 125, 127, 128, 129, 130, 132, 133, 134, 135, 136, 137, 138, 139, 140, 141, 143, 145, 147, 148, 149, 151, 152, 153, 154, 156, 159, 160, 162, 164, 165, 166, 167, 168, 169]"
Olaf,L0,long,48,30,18,4,0.6757,148,"[14, 26, 33, 47, 52, 56, 57, 58, 61, 63, 75, 78, 81, 83, 85, 87, 88, 93, 96, 97, 100, 102, 103, 104, 105, 107, 108, 111, 112, 113, 114, 115, 116, 117, 119, 121, 122, 123, 125, 127, 128, 132, 134, 135, 137, 138, 142, 143]"
Olaf,L0,long,65,32,33,4,0.6061,165,"[15, 29, 43, 50, 52, 53, 54, 56, 60, 61, 62, 64, 78, 79, 80, 81, 85, 86, 87, 88, 89, 91, 95, 101, 102, 103, 104, 106, 107, 108, 109, 110, 114, 116, 117, 118, 119, 120, 122, 123, 125, 127, 129, 130, 132, 133, 134, 136, 138, 139, 145, 146, 147, 148, 149, 151, 152, 153, 154, 155, 156, 157, 158, 159, 162]"
Olaf,L0,long,87,41,46,3,0.5348,187,"[14, 26, 33, 47, 52, 55, 57, 58, 59, 61, 63, 74, 78, 79, 80, 81, 82, 83, 84, 85, 87, 89, 92, 98, 100, 101, 102, 103, 104, 105, 106, 107, 109, 110, 111, 114, 116, 117, 120, 121, 122, 124, 127, 128, 129, 133, 134, 136, 137, 138, 139, 140, 142, 143, 144, 145, 146, 147, 148, 149, 151, 152, 153, 154, 155, 157, 158, 159, 160, 162, 163, 164, 165, 167, 168, 169, 170, 172, 175, 176, 177, 178, 180, 182, 183, 184, 185]"
Olaf,L0,long,56,28,28,7,0.641,156,"[14, 26, 34, 48, 54, 57, 59, 61, 72, 75, 76, 77, 78, 80, 81, 82, 83, 84, 85, 86, 87, 89, 90, 97, 99, 101, 103, 104, 107, 108, 111, 112, 113, 114, 115, 116, 117, 118, 121, 123, 125, 127, 130, 134, 135, 137, 138, 142, 144, 145, 146, 148, 150, 151, 153, 154]"
Olaf,L0,long,74,38,36,2,0.5747,174,"[16, 25, 28, 30, 45, 49, 52, 53, 55, 56, 57, 59, 71, 75, 76, 77, 78, 79, 81, 84, 86, 88, 89, 96, 100, 101, 102, 103, 104, 105, 106, 110, 111, 113, 114, 116, 118, 119, 120, 121, 122, 125, 126, 128, 129, 130, 131, 134, 135, 136, 137, 138, 140, 144, 146, 147, 148, 150, 151, 152, 153, 154, 155, 156, 158, 159, 161, 162, 165, 166, 167, 168, 171, 172]"
Olaf,L0,long,71,42,29,7,0.5848,171,"[14, 26, 33, 48, 53, 55, 57, 58, 59, 60, 63, 74, 77, 78, 79, 81, 83, 85, 86, 87, 88, 89, 95, 101, 104, 105, 106, 107, 108, 109, 110, 111, 113, 114, 115, 116, 117, 119, 120, 122, 123, 125, 126, 127, 130, 131, 133, 134, 136, 137, 138, 139, 140, 141, 142, 144, 145, 147, 149, 150, 151, 152, 153, 155, 156, 159, 162, 163, 166, 168, 169]"
Olaf,L0,long,78,43,35,6,0.5618,178,"[14, 26, 33, 47, 52, 55, 56, 58, 60, 71, 76, 77, 78, 80, 82, 83, 84, 85, 86, 87, 90, 97, 98, 99, 100, 101, 102, 103, 104, 105, 107, 108, 112, 113, 114, 118, 119, 121, 122, 123, 124, 127, 128, 129, 131, 132, 133, 135, 136, 137, 138, 139, 142, 143, 144, 145, 146, 148, 150, 151, 152, 153, 154, 156, 158, 159, 160, 161, 162, 165, 166, 167, 169, 172, 173, 174, 175, 176]"
Olaf,L0,long,58,24,34,2,0.6329,158,"[16, 26, 30, 43, 50, 52, 54, 55, 57, 59, 60, 61, 72, 76, 78, 79, 80, 81, 82, 86, 87, 88, 89, 90, 91, 99, 101, 102, 105, 106, 108, 111, 114, 115, 116, 122, 123, 124, 125, 126, 127, 128, 129, 130, 131, 133, 135, 136, 137, 139, 140, 142, 143, 145, 147, 148, 153, 155]"
Olaf,L0,long,73,35,38,1,0.578,173,"[15, 29, 44, 50, 53, 54, 56, 58, 59, 69, 74, 76, 77, 81, 82, 83, 87, 89, 94, 96, 97, 98, 100, 104, 105, 107, 108, 110, 111, 112, 113, 114, 115, 116, 118, 121, 124, 125, 126, 128, 129, 130, 132, 133, 134, 135, 136, 138, 139, 141, 142, 143, 144, 145, 146, 148, 149, 150, 151, 152, 154, 155, 156, 157, 158, 160, 161, 162, 163, 164, 169, 170, 171]"
Olaf,L0,long,78,44,34,2,0.5618,178,"[18, 25, 31, 44, 49, 53, 54, 55, 56, 58, 59, 71, 75, 76, 77, 78, 80, 83, 84, 85, 87, 89, 99, 100, 101, 104, 106, 107, 109, 110, 111, 112, 113, 118, 119, 120, 121, 122, 123, 124, 125, 127, 129, 130, 131, 132, 134, 136, 137, 138, 139, 140, 141, 144, 145, 146, 147, 149, 151, 152, 153, 155, 156, 157, 158, 159, 160, 161, 162, 165, 167, 169, 170, 171, 172, 173, 175, 176]"
Olaf,L0,long,47,23,24,0,0.6803,147,"[17, 26, 29, 43, 49, 51, 53, 54, 58, 59, 70, 75, 76, 77, 79, 81, 83, 84, 85, 87, 88, 89, 96, 98, 99, 103, 106, 107, 108, 109, 111, 114, 117, 119, 120, 122, 124, 126, 128, 132, 133, 134, 136, 141, 142, 143, 145]"
Olaf,L0,long,62,26,36,4,0.6173,162,"[16, 25, 28, 30, 32, 45, 52, 56, 59, 61, 72, 76, 78, 80, 81, 83, 84, 85, 86, 88, 89, 90, 92, 98, 100, 103, 104, 105, 106, 107, 110, 112, 115, 117, 120, 122, 123, 124, 125, 126, 127, 128, 132, 133, 134, 135, 137, 138, 140, 141, 143, 144, 145, 146, 147, 148, 150, 152, 153, 154, 159, 160]"
Olaf,L0,long,69,34,35,4,0.5917,169,"[14, 28, 35, 50, 55, 57, 59, 61, 72, 74, 76, 77, 79, 80, 83, 84, 85, 86, 87, 88, 89, 90, 91, 98, 101, 102, 103, 104, 106, 107, 108, 109, 110, 111, 112, 113, 115, 117, 118, 120, 121, 124, 125, 126, 128, 129, 130, 131, 132, 135, 137, 139, 140, 143, 144, 145, 149, 150, 151, 155, 156, 159, 160, 161, 162, 164, 165, 166, 167]"
Olaf,L0,long,60,37,23,2,0.625,160,"[17, 25, 28, 30, 44, 50, 52, 54, 57, 59, 60, 61, 65, 78, 81, 85, 87, 89, 91, 92, 95, 100, 103, 107, 108, 109, 110, 111, 113, 114, 115, 116, 117, 120, 123, 125, 126, 127, 129, 132, 134, 135, 136, 139, 140, 141, 142, 143, 144, 145, 147, 148, 149, 150, 151, 152, 153, 155, 157, 158]"
Olaf,L0,long,85,50,35,3,0.5405,185,"[16, 25, 30, 43, 48, 51, 53, 54, 55, 56, 57, 59, 72, 75, 76, 77, 78, 79, 83, 84, 85, 86, 88, 90, 96, 99, 100, 103, 106, 107, 110, 111, 112, 113, 114, 116, 117, 118, 119, 121, 124, 125, 126, 127, 129, 130, 133, 135, 136, 137, 138, 139, 140, 141, 142, 143, 145, 146, 147, 148, 150, 151, 152, 154, 155, 156, 157, 160, 161, 162, 165, 166, 167, 168, 169, 170, 172, 173, 174, 175, 177, 178, 180, 182, 183]"
Olaf,L0,long,44,37,7,0,0.6944,144,"[16, 27, 29, 43, 49, 51, 54, 55, 56, 57, 59, 71, 75, 77, 78, 79, 80, 81, 82, 83, 84, 87, 89, 96, 100, 102, 103, 104, 108, 110, 111, 112, 113, 114, 115, 120, 121, 122, 123, 124, 129, 130, 131, 142]"
Olaf,L0,long,65,30,35,9,0.6061,165,"[14, 28, 34, 48, 54, 56, 58, 60, 71, 76, 77, 79, 80, 81, 83, 84, 85, 86, 90, 95, 98, 103, 104, 105, 106, 107, 109, 111, 113, 114, 115, 116, 117, 118, 120, 121, 122, 123, 124, 125, 126, 129, 131, 132, 133, 136, 137, 140, 143, 144, 145, 146, 147, 148, 149, 150, 151, 154, 155, 156, 157, 158, 160, 162, 163]"
Olaf,L0,long,86,38,48,5,0.5376,186,"[14, 28, 33, 49, 58, 59, 70, 72, 73, 74, 75, 76, 77, 80, 82, 83, 84, 86, 87, 88, 91, 92, 97, 100, 101, 102, 103, 104, 106, 107, 109, 110, 112, 113, 115, 116, 118, 119, 120, 121, 122, 124, 125, 126, 127, 128, 129, 130, 131, 134, 136, 137, 138, 139, 140, 141, 142, 145, 146, 147, 148, 149, 150, 151, 152, 153, 154, 155, 156, 157, 158, 162, 163, 167, 168, 169, 170, 171, 172, 173, 174, 177, 180, 181, 183, 184]"
Olaf,L0,long,61,39,22,0,0.6211,161,"[16, 25, 29, 44, 48, 50, 51, 53, 59, 60, 61, 72, 76, 78, 79, 81, 84, 85, 86, 87, 88, 92, 98, 99, 101, 104, 105, 106, 108, 112, 118, 120, 122, 124, 125, 127, 128, 129, 130, 132, 133, 134, 136, 137, 138, 141, 142, 143, 144, 145, 147, 148, 149, 150, 151, 152, 154, 155, 157, 158, 159]"
Olaf,L0,long,94,51,43,3,0.5155,194,"[16, 26, 29, 43, 48, 53, 54, 55, 56, 58, 61, 72, 78, 79, 81, 84, 85, 86, 87, 89, 90, 99, 100, 101, 102, 103, 104, 105, 106, 108, 109, 110, 111, 113, 114, 115, 116, 117, 118, 119, 120, 123, 124, 127, 128, 129, 130, 131, 132, 133, 134, 135, 139, 140, 141, 142, 143, 144, 145, 146, 148, 151, 152, 154, 156, 157, 158, 160, 161, 162, 163, 164, 165, 166, 167, 168, 169, 171, 172, 173, 174, 176, 177, 178, 181, 182, 183, 184, 185, 186, 188, 190, 191, 192]"
Olaf,L0,long,89,35,54,1,0.5291,189,"[17, 25, 28, 30, 45, 49, 52, 53, 54, 55, 56, 57, 58, 59, 60, 61, 62, 74, 79, 84, 85, 86, 87, 88, 90, 91, 92, 93, 100, 102, 103, 105, 107, 109, 110, 111, 112, 113, 115, 116, 118, 120, 121, 122, 123, 127, 129, 130, 132, 133, 134, 136, 137, 139, 140, 142, 143, 144, 145, 147, 148, 150, 153, 154, 155, 156, 157, 158, 159, 160, 161, 162, 163, 165, 167, 168, 169, 171, 172, 173, 175, 176, 179, 180, 182, 183, 184, 185, 187]"
Olaf,L0,long,69,28,41,3,0.5917,169,"[14, 26, 33, 47, 52, 55, 56, 57, 59, 60, 62, 73, 77, 79, 80, 82, 86, 87, 88, 90, 92, 97, 99, 101, 103, 104, 105, 106, 107, 108, 109, 110, 114, 116, 117, 119, 121, 122, 123, 125, 127, 129, 131, 132, 133, 134, 137, 139, 140, 141, 144, 147, 148, 149, 150, 152, 153, 154, 155, 157, 158, 159, 160, 161, 162, 164, 165, 166, 167]"
Olaf,L0,long,85,46,39,8,0.5405,185,"[14, 28, 33, 47, 52, 55, 58, 59, 62, 74, 77, 78, 79, 81, 83, 84, 85, 86, 87, 89, 91, 97, 101, 103, 104, 105, 106, 107, 109, 110, 111, 113, 114, 115, 116, 117, 118, 120, 122, 123, 124, 125, 126, 127, 128, 129, 130, 131, 133, 134, 135, 136, 137, 138, 139, 140, 142, 144, 145, 146, 147, 148, 149, 150, 151, 152, 153, 154, 155, 158, 160, 161, 163, 164, 165, 167, 168, 169, 172, 174, 175, 178, 179, 180, 181]"
Olaf,L0,long,50,22,28,5,0.6667,150,"[14, 26, 34, 50, 56, 58, 60, 61, 62, 66, 75, 79, 80, 81, 82, 84, 88, 90, 91, 92, 93, 94, 102, 103, 106, 107, 109, 110, 111, 114, 117, 118, 120, 123, 125, 126, 127, 131, 132, 133, 134, 135, 136, 138, 139, 142, 145, 146, 147, 148]"
Olaf,L0,long,53,22,31,5,0.6536,153,"[14, 32, 46, 51, 55, 57, 58, 60, 71, 74, 76, 77, 79, 80, 81, 82, 83, 84, 86, 88, 91, 96, 98, 99, 102, 103, 105, 107, 108, 111, 112, 113, 114, 115, 116, 118, 119, 122, 124, 125, 127, 129, 130, 131, 132, 136, 137, 140, 141, 145, 146, 147, 150]"
Olaf,L0,long,76,29,47,3,0.5682,176,"[17, 26, 30, 43, 48, 51, 53, 54, 55, 57, 58, 61, 72, 77, 80, 81, 82, 83, 84, 85, 86, 87, 90, 91, 92, 93, 96, 104, 107, 108, 109, 110, 111, 112, 113, 114, 116, 117, 119, 120, 121, 122, 124, 126, 127, 128, 129, 131, 132, 134, 135, 137, 138, 139, 140, 142, 143, 144, 145, 146, 147, 149, 150, 152, 153, 155, 156, 157, 159, 160, 161, 165, 166, 167, 168, 172]"
Olaf,L0,long,64,37,27,1,0.6098,164,"[14, 28, 33, 35, 49, 56, 58, 60, 61, 62, 63, 64, 65, 76, 79, 80, 81, 82, 83, 86, 88, 92, 93, 94, 95, 96, 98, 99, 106, 107, 110, 112, 113, 114, 116, 119, 120, 121, 123, 124, 125, 126, 128, 129, 130, 135, 137, 140, 141, 142, 143, 145, 146, 148, 149, 150, 151, 153, 154, 156, 157, 158, 160, 162]"
Olaf,L0,long,66,25,41,4,0.6024,166,"[14, 26, 33, 49, 55, 56, 57, 62, 63, 65, 74, 78, 82, 83, 86, 88, 89, 91, 92, 95, 98, 100, 101, 102, 103, 104, 105, 106, 109, 110, 112, 113, 114, 115, 118, 120, 121, 123, 124, 125, 126, 127, 129, 130, 133, 135, 136, 138, 139, 142, 143, 144, 145, 146, 147, 148, 149, 150, 151, 154, 155, 157, 158, 161, 162, 163]"
Olaf,L0,long,83,28,55,1,0.5464,183,"[16, 25, 28, 30, 44, 49, 52, 54, 55, 56, 57, 59, 60, 74, 77, 78, 79, 80, 81, 82, 84, 87, 88, 89, 90, 97, 100, 101, 104, 105, 106, 108, 109, 111, 112, 114, 115, 116, 118, 119, 120, 123, 125, 126, 127, 128, 129, 131, 134, 135, 136, 137, 140, 141, 142, 144, 145, 147, 149, 150, 152, 155, 156, 157, 158, 159, 160, 161, 162, 163, 165, 166, 168, 169, 171, 172, 174, 175, 176, 178, 179, 180, 181]"
Olaf,L0,long,67,25,42,4,0.5988,167,"[16, 25, 28, 30, 47, 50, 54, 55, 56, 57, 60, 72, 75, 77, 78, 79, 82, 88, 89, 92, 96, 98, 100, 101, 102, 103, 104, 106, 107, 108, 109, 110, 111, 115, 116, 117, 118, 121, 125, 126, 128, 129, 130, 131, 132, 134, 136, 137, 138, 139, 140, 141, 142, 143, 145, 147, 149, 151, 152, 153, 154, 155, 157, 158, 159, 162, 163]"
Olaf,L0,long,82,34,48,3,0.5495,182,"[16, 25, 28, 31, 45, 50, 52, 56, 58, 60, 63, 77, 78, 79, 80, 81, 82, 83, 84, 85, 86, 87, 88, 89, 90, 91, 98, 100, 101, 102, 104, 106, 107, 108, 109, 110, 111, 112, 114, 115, 116, 117, 120, 121, 125, 131, 132, 133, 134, 135, 136, 137, 138, 139, 142, 143, 144, 145, 146, 149, 150, 152, 154, 155, 156, 157, 158, 160, 161, 162, 163, 165, 166, 169, 170, 171, 172, 175, 176, 177, 178, 180]"
Olaf,L0,long,69,22,47,8,0.5917,169,"[14, 26, 33, 48, 53, 56, 57, 58, 59, 62, 74, 77, 79, 82, 84, 85, 86, 87, 90, 95, 97, 99, 105, 106, 108, 109, 111, 112, 113, 114, 117, 119, 122, 123, 124, 125, 126, 127, 128, 130, 131, 132, 133, 134, 137, 139, 140, 141, 142, 145, 146, 147, 149, 150, 152, 153, 155, 156, 157, 158, 159, 160, 161, 162, 163, 164, 165, 166, 167]"
Olaf,L0,long,66,36,30,2,0.6024,166,"[16, 25, 28, 32, 44, 51, 55, 57, 59, 60, 61, 72, 79, 81, 82, 84, 86, 87, 89, 91, 92, 93, 99, 102, 103, 107, 108, 109, 112, 113, 116, 117, 118, 119, 120, 123, 124, 125, 126, 128, 129, 130, 131, 132, 133, 134, 135, 136, 138, 139, 144, 146, 147, 149, 150, 151, 152, 153, 155, 156, 157, 159, 160, 161, 162, 163]"
Olaf,L0,long,59,18,41,5,0.6289,159,"[14, 26, 33, 47, 52, 56, 57, 58, 59, 70, 74, 75, 76, 82, 83, 85, 88, 90, 96, 97, 98, 99, 101, 102, 103, 104, 105, 108, 109, 111, 115, 118, 119, 120, 121, 122, 123, 124, 125, 126, 127, 132, 133, 134, 138, 139, 140, 141, 142, 144, 146, 147, 149, 150, 152, 153, 154, 155, 157]"
Olaf,L0,long,93,43,50,3,0.5181,193,"[16, 25, 28, 31, 44, 49, 52, 53, 54, 55, 56, 57, 58, 59, 60, 72, 77, 80, 81, 84, 85, 86, 87, 88, 89, 91, 98, 100, 101, 102, 104, 105, 106, 107, 108, 109, 110, 111, 112, 113, 114, 115, 117, 118, 119, 120, 121, 122, 127, 130, 131, 133, 135, 136, 138, 140, 144, 145, 146, 148, 149, 150, 151, 152, 154, 155, 156, 159, 160, 161, 162, 163, 164, 165, 166, 167, 168, 170, 173, 174, 175, 176, 177, 178, 179, 182, 183, 184, 186, 187, 188, 190, 191]"
Olaf,L0,long,75,44,31,2,0.5714,175,"[16, 26, 30, 43, 48, 51, 52, 54, 56, 57, 58, 61, 72, 76, 78, 79, 80, 81, 82, 89, 91, 92, 98, 99, 100, 101, 107, 108, 109, 110, 111, 113, 115, 117, 118, 119, 120, 122, 123, 129, 130, 131, 132, 133, 134, 135, 136, 137, 138, 140, 142, 143, 144, 145, 146, 147, 148, 149, 150, 151, 154, 155, 156, 157, 158, 159, 161, 162, 164, 166, 167, 168, 169, 171, 172]"
Olaf,L0,long,50,23,27,2,0.6667,150,"[16, 25, 28, 31, 46, 50, 52, 53, 54, 55, 56, 57, 58, 59, 73, 76, 79, 80, 82, 83, 88, 89, 90, 91, 97, 101, 102, 105, 107, 108, 109, 110, 113, 114, 115, 117, 118, 120, 122, 125, 127, 128, 131, 135, 137, 139, 141, 143, 145, 147]"
Olaf,L0,long,79,48,31,0,0.5587,179,"[15, 30, 45, 51, 53, 54, 55, 56, 57, 58, 59, 61, 72, 77, 79, 80, 82, 83, 84, 86, 88, 90, 91, 92, 93, 94, 101, 103, 105, 106, 107, 108, 109, 111, 113, 115, 116, 117, 119, 120, 122, 123, 124, 126, 129, 130, 131, 132, 133, 134, 135, 136, 137, 139, 141, 146, 147, 148, 153, 154, 155, 156, 158, 159, 160, 161, 162, 163, 164, 165, 167, 169, 170, 171, 172, 173, 174, 176, 177]"
Olaf,L0,long,68,37,31,0,0.5952,168,"[18, 26, 29, 45, 49, 53, 54, 55, 56, 57, 58, 59, 72, 75, 77, 78, 79, 80, 81, 82, 84, 85, 87, 88, 90, 98, 100, 101, 102, 103, 106, 107, 108, 109, 110, 112, 113, 117, 119, 121, 123, 124, 127, 128, 129, 130, 131, 132, 134, 135, 136, 141, 142, 143, 145, 150, 151, 152, 153, 155, 156, 157, 159, 160, 161, 162, 164, 165]"
Olaf,L0,long,58,28,30,1,0.6329,158,"[16, 29, 44, 52, 55, 58, 59, 60, 72, 74, 76, 77, 78, 81, 82, 83, 84, 85, 90, 91, 96, 98, 99, 100, 101, 104, 105, 111, 112, 114, 116, 117, 119, 122, 123, 125, 126, 127, 128, 129, 130, 131, 132, 134, 135, 136, 137, 138, 139, 141, 145, 146, 147, 148, 149, 151, 153, 155]"
Olaf,L0,long,79,40,39,3,0.5587,179,"[16, 25, 28, 30, 44, 49, 52, 53, 54, 55, 57, 59, 72, 75, 76, 77, 78, 79, 82, 84, 85, 86, 89, 90, 97, 100, 101, 102, 103, 104, 107, 108, 109, 110, 114, 115, 116, 117, 122, 124, 127, 128, 129, 130, 131, 132, 133, 134, 135, 136, 138, 140, 141, 142, 143, 145, 148, 149, 150, 151, 153, 154, 155, 156, 157, 158, 159, 160, 161, 162, 164, 166, 167, 168, 169, 173, 174, 176, 177]"
Olaf,L0,long,65,30,35,3,0.6061,165,"[16, 25, 28, 30, 45, 49, 51, 52, 54, 55, 56, 57, 58, 59, 71, 76, 79, 81, 82, 84, 85, 86, 88, 91, 97, 100, 101, 102, 103, 105, 107, 108, 109, 112, 114, 118, 119, 120, 121, 123, 124, 125, 126, 129, 130, 131, 132, 134, 135, 138, 139, 140, 143, 146, 148, 149, 150, 151, 154, 155, 159, 160, 161, 162, 163]"
Olaf,L0,long,52,30,22,1,0.6579,152,"[16, 26, 29, 30, 45, 49, 51, 52, 54, 55, 56, 58, 61, 73, 78, 80, 81, 83, 84, 85, 86, 90, 91, 96, 100, 103, 104, 105, 112, 113, 114, 115, 116, 117, 118, 119, 121, 122, 126, 130, 133, 135, 137, 138, 140, 141, 143, 145, 146, 147, 148, 150]"
Olaf,L0,long,61,40,21,8,0.6211,161,"[14, 28, 35, 48, 54, 57, 58, 59, 69, 73, 75, 76, 83, 84, 86, 87, 88, 90, 93, 97, 98, 101, 103, 106, 107, 108, 109, 110, 112, 114, 115, 116, 120, 121, 122, 123, 124, 125, 126, 128, 129, 130, 131, 132, 133, 134, 140, 143, 145, 146, 147, 148, 149, 150, 152, 153, 154, 155, 156, 157, 159]"
Olaf,L0,long,87,37,50,5,0.5348,187,"[17, 25, 28, 31, 35, 49, 54, 56, 57, 58, 59, 60, 61, 62, 64, 75, 80, 81, 82, 83, 84, 85, 87, 88, 89, 90, 91, 93, 94, 101, 103, 106, 109, 110, 112, 113, 114, 115, 116, 117, 119, 120, 121, 122, 123, 125, 126, 129, 130, 131, 132, 133, 135, 136, 138, 141, 143, 144, 145, 146, 147, 151, 152, 153, 155, 157, 158, 159, 160, 162, 165, 166, 167, 168, 169, 171, 174, 175, 177, 178, 179, 180, 181, 182, 183, 184, 185]"
Olaf,L0,long,51,38,13,4,0.6623,151,"[17, 27, 29, 44, 52, 53, 54, 55, 56, 57, 58, 60, 61, 73, 79, 80, 81, 82, 83, 86, 88, 89, 90, 94, 102, 105, 111, 112, 114, 115, 118, 119, 122, 123, 124, 128, 129, 133, 134, 135, 136, 137, 138, 139, 140, 141, 143, 144, 147, 148, 149]"
Olaf,L0,long,58,32,26,2,0.6329,158,"[15, 30, 45, 51, 56, 58, 59, 62, 72, 78, 82, 83, 86, 87, 88, 91, 94, 95, 96, 97, 99, 100, 102, 103, 105, 111, 113, 114, 115, 116, 118, 119, 120, 121, 122, 124, 125, 126, 128, 129, 132, 133, 134, 135, 136, 137, 138, 139, 141, 144, 145, 146, 147, 149, 151, 153, 155, 156]"
Olaf,L0,long,71,47,24,5,0.5848,171,"[14, 28, 33, 47, 54, 56, 57, 58, 60, 71, 74, 75, 76, 77, 78, 80, 83, 85, 86, 87, 90, 96, 98, 99, 102, 105, 106, 107, 108, 109, 111, 112, 113, 114, 115, 116, 120, 121, 122, 123, 124, 126, 127, 128, 129, 130, 131, 132, 133, 134, 135, 136, 137, 138, 141, 142, 143, 145, 148, 150, 151, 152, 153, 155, 156, 158, 161, 162, 163, 165, 169]"
Olaf,L0,long,66,29,37,4,0.6024,166,"[16, 25, 28, 30, 44, 50, 52, 53, 55, 56, 59, 61, 72, 77, 81, 83, 85, 86, 87, 88, 89, 91, 97, 102, 103, 104, 105, 106, 108, 109, 113, 117, 118, 119, 121, 122, 123, 125, 127, 128, 131, 132, 133, 135, 137, 138, 140, 141, 142, 143, 144, 145, 148, 149, 150, 152, 153, 154, 155, 156, 158, 159, 160, 161, 162, 164]"
Olaf,L0,long,70,33,37,3,0.5882,170,"[16, 26, 31, 43, 49, 52, 54, 55, 56, 57, 59, 71, 75, 76, 77, 79, 83, 84, 85, 86, 87, 89, 95, 99, 100, 102, 106, 110, 111, 112, 113, 115, 116, 118, 119, 120, 121, 122, 123, 124, 125, 126, 128, 130, 131, 133, 136, 137, 138, 139, 141, 142, 144, 146, 148, 149, 150, 152, 153, 154, 155, 156, 157, 158, 159, 160, 163, 166, 167, 168]"
Olaf,L0,long,82,30,52,2,0.5495,182,"[16, 25, 28, 30, 32, 45, 50, 53, 54, 55, 56, 57, 58, 60, 61, 76, 78, 80, 81, 82, 83, 85, 86, 87, 90, 91, 98, 101, 102, 103, 104, 106, 107, 109, 110, 112, 114, 115, 116, 117, 118, 119, 121, 125, 126, 128, 129, 131, 133, 135, 136, 139, 140, 143, 144, 145, 147, 148, 149, 151, 152, 153, 154, 155, 157, 158, 160, 162, 164, 165, 166, 167, 168, 170, 172, 173, 174, 176, 177, 178, 179, 180]"
Olaf,L0,long,61,35,26,5,0.6211,161,"[20, 33, 49, 54, 56, 57, 58, 59, 60, 70, 74, 75, 76, 77, 78, 79, 81, 82, 84, 86, 87, 89, 91, 98, 101, 102, 103, 104, 106, 109, 110, 111, 112, 113, 114, 116, 119, 120, 122, 124, 125, 127, 128, 130, 131, 135, 136, 137, 138, 139, 140, 141, 142, 144, 145, 150, 151, 152, 154, 155, 156]"
Olaf,L0,long,78,55,23,4,0.5618,178,"[14, 26, 33, 47, 53, 55, 58, 59, 61, 73, 77, 79, 80, 81, 82, 84, 85, 86, 87, 89, 90, 91, 97, 99, 100, 101, 102, 103, 104, 105, 106, 107, 108, 109, 110, 111, 112, 113, 114, 119, 120, 121, 123, 127, 133, 134, 135, 138, 140, 141, 142, 144, 145, 146, 147, 148, 149, 150, 151, 152, 154, 155, 157, 159, 160, 161, 163, 165, 166, 167, 168, 169, 170, 172, 173, 174, 175, 176]"
Olaf,L0,long,68,38,30,3,0.5952,168,"[14, 26, 33, 47, 56, 57, 58, 59, 62, 63, 64, 76, 78, 80, 82, 83, 84, 85, 86, 87, 88, 90, 91, 92, 93, 96, 105, 106, 107, 109, 110, 113, 114, 118, 119, 120, 122, 123, 124, 125, 126, 127, 128, 130, 131, 133, 134, 135, 136, 137, 143, 144, 145, 147, 148, 150, 152, 153, 154, 155, 157, 158, 159, 161, 162, 163, 164, 165]"
Olaf,L0,long,81,41,40,7,0.5525,181,"[14, 26, 33, 47, 53, 55, 56, 58, 59, 60, 72, 76, 77, 78, 81, 82, 83, 85, 86, 87, 88, 89, 90, 98, 99, 100, 101, 102, 103, 104, 106, 107, 108, 109, 110, 111, 112, 113, 114, 115, 116, 117, 118, 121, 125, 126, 127, 128, 130, 131, 132, 133, 134, 135, 137, 139, 140, 141, 142, 143, 144, 145, 148, 154, 155, 156, 158, 159, 161, 163, 164, 166, 167, 168, 170, 172, 174, 175, 176, 178, 179]"
Olaf,L0,long,59,18,41,5,0.6289,159,"[17, 25, 28, 30, 45, 50, 52, 53, 54, 58, 60, 71, 75, 76, 80, 82, 83, 85, 87, 89, 90, 96, 101, 104, 105, 107, 108, 109, 112, 113, 114, 116, 117, 119, 120, 121, 122, 123, 124, 126, 127, 128, 129, 130, 131, 132, 133, 134, 135, 139, 141, 142, 143, 146, 148, 149, 153, 154, 157]"
Olaf,L0,long,88,49,39,6,0.5319,188,"[16, 25, 29, 32, 46, 53, 54, 55, 56, 58, 64, 74, 78, 79, 81, 82, 83, 84, 87, 90, 91, 93, 99, 101, 102, 103, 107, 109, 110, 111, 113, 115, 116, 117, 119, 120, 121, 123, 124, 125, 126, 127, 129, 130, 131, 133, 134, 136, 137, 138, 139, 140, 141, 143, 144, 147, 148, 150, 152, 154, 155, 156, 157, 159, 160, 161, 162, 163, 164, 165, 166, 167, 168, 169, 171, 172, 173, 174, 175, 176, 177, 178, 179, 181, 182, 184, 185, 186]"
Olaf,L0,long,60,29,31,6,0.625,160,"[16, 26, 29, 43, 48, 50, 53, 55, 56, 58, 59, 71, 77, 78, 79, 80, 86, 87, 89, 90, 93, 97, 99, 100, 101, 102, 103, 105, 106, 107, 108, 109, 110, 111, 113, 114, 115, 116, 117, 118, 119, 125, 127, 129, 131, 132, 134, 137, 138, 139, 140, 142, 145, 147, 149, 151, 152, 153, 155, 157]"
Olaf,L0,long,61,30,31,4,0.6211,161,"[15, 29, 34, 49, 54, 58, 59, 60, 61, 62, 63, 64, 76, 80, 81, 83, 84, 85, 88, 89, 91, 92, 93, 94, 100, 103, 104, 106, 108, 109, 110, 113, 115, 116, 118, 120, 122, 123, 124, 125, 126, 127, 129, 130, 131, 133, 134, 135, 136, 138, 141, 142, 143, 149, 151, 152, 153, 154, 155, 158, 159]"
Olaf,L0,long,99,51,48,4,0.5025,199,"[16, 25, 28, 30, 44, 49, 53, 55, 57, 58, 60, 72, 76, 78, 79, 81, 82, 83, 84, 85, 86, 87, 88, 89, 90, 98, 100, 102, 103, 104, 105, 106, 107, 108, 109, 110, 111, 113, 114, 116, 117, 119, 122, 125, 126, 128, 129, 130, 132, 133, 134, 135, 136, 137, 138, 139, 140, 142, 144, 146, 148, 151, 152, 153, 154, 156, 158, 159, 160, 161, 162, 163, 164, 166, 167, 168, 169, 170, 171, 172, 173, 174, 176, 177, 179, 180, 181, 182, 183, 184, 185, 187, 188, 190, 191, 192, 193, 194, 196]"
Olaf,L0,long,69,35,34,3,0.5917,169,"[16, 25, 28, 30, 44, 49, 51, 52, 53, 54, 57, 59, 77, 78, 79, 80, 82, 84, 85, 86, 87, 89, 91, 92, 99, 102, 103, 104, 105, 106, 109, 110, 111, 112, 114, 115, 119, 122, 124, 125, 126, 127, 128, 129, 132, 133, 134, 136, 137, 138, 140, 141, 142, 144, 147, 149, 151, 152, 154, 155, 156, 157, 161, 162, 163, 164, 165, 166, 167]"
Olaf,L0,long,77,38,39,4,0.565,177,"[14, 26, 33, 48, 53, 55, 56, 58, 59, 69, 74, 75, 76, 77, 78, 80, 81, 82, 83, 84, 87, 89, 96, 100, 102, 103, 104, 105, 106, 108, 109, 110, 112, 116, 118, 119, 123, 124, 125, 126, 127, 128, 132, 133, 135, 136, 137, 138, 140, 141, 142, 143, 144, 145, 146, 147, 148, 149, 150, 151, 152, 153, 156, 157, 158, 160, 161, 162, 163, 164, 166, 167, 168, 169, 171, 173, 175]"
Olaf,L0,long,53,27,26,0,0.6536,153,"[17, 25, 28, 30, 47, 50, 54, 56, 57, 58, 60, 72, 77, 80, 84, 87, 88, 90, 91, 95, 97, 99, 100, 101, 103, 104, 105, 106, 108, 109, 111, 112, 113, 114, 115, 116, 117, 120, 121, 122, 124, 125, 127, 134, 138, 139, 140, 141, 143, 144, 145, 146, 147]"
Olaf,L0,long,68,33,35,5,0.5952,168,"[16, 29, 35, 48, 55, 57, 59, 61, 72, 74, 75, 76, 77, 78, 79, 80, 83, 86, 88, 89, 92, 98, 99, 101, 103, 104, 105, 106, 107, 108, 109, 110, 112, 114, 115, 117, 118, 119, 120, 121, 122, 123, 124, 125, 126, 129, 130, 131, 133, 134, 139, 140, 141, 142, 144, 145, 146, 147, 150, 152, 154, 155, 156, 158, 160, 163, 164, 166]"
Olaf,L0,long,88,35,53,1,0.5319,188,"[16, 27, 29, 44, 48, 50, 52, 53, 54, 56, 57, 60, 73, 76, 77, 80, 81, 82, 85, 88, 89, 98, 100, 101, 102, 104, 105, 106, 107, 108, 111, 112, 114, 115, 117, 118, 119, 120, 121, 122, 123, 124, 126, 127, 129, 130, 131, 132, 133, 134, 135, 137, 138, 139, 140, 141, 144, 146, 147, 148, 149, 150, 151, 152, 155, 156, 157, 158, 162, 163, 164, 165, 168, 170, 171, 172, 174, 175, 176, 177, 178, 179, 180, 181, 182, 183, 185, 186]"
Olaf,L0,long,68,44,24,5,0.5952,168,"[16, 29, 35, 50, 55, 57, 58, 59, 60, 70, 74, 75, 77, 81, 82, 84, 85, 86, 88, 89, 90, 96, 98, 99, 100, 101, 102, 103, 105, 107, 109, 111, 113, 114, 115, 116, 118, 119, 120, 121, 123, 124, 125, 129, 131, 132, 134, 135, 136, 137, 138, 140, 142, 143, 144, 145, 147, 148, 151, 152, 153, 154, 155, 156, 160, 161, 162, 164]"
Olaf,L50,long,86,39,47,4,0.5376,186,"[16, 29, 42, 47, 49, 50, 51, 52, 53, 57, 58, 60, 72, 80, 81, 82, 83, 84, 85, 86, 87, 88, 89, 99, 100, 101, 102, 103, 106, 107, 108, 109, 110, 113, 114, 115, 116, 117, 118, 120, 125, 126, 127, 129, 130, 131, 132, 133, 134, 136, 137, 138, 139, 140, 141, 142, 143, 144, 145, 147, 149, 150, 152, 154, 155, 156, 157, 159, 161, 162, 163, 164, 165, 167, 168, 169, 170, 171, 172, 173, 175, 176, 178, 180, 182, 184]"
Olaf,L50,long,60,17,43,3,0.625,160,"[16, 24, 28, 29, 44, 52, 53, 55, 56, 57, 58, 59, 60, 72, 76, 78, 79, 80, 83, 84, 85, 86, 88, 90, 91, 95, 102, 105, 107, 111, 112, 113, 115, 118, 119, 121, 122, 123, 124, 125, 127, 128, 129, 130, 131, 135, 137, 138, 139, 140, 144, 147, 148, 151, 152, 153, 155, 156, 157, 158]"
Olaf,L50,long,64,34,30,0,0.6098,164,"[16, 25, 27, 30, 45, 52, 53, 54, 55, 59, 60, 71, 75, 78, 80, 83, 84, 85, 86, 87, 88, 90, 98, 102, 103, 104, 105, 106, 107, 109, 110, 113, 114, 115, 116, 118, 119, 120, 123, 125, 127, 128, 129, 131, 132, 136, 137, 139, 141, 145, 146, 147, 149, 150, 151, 152, 153, 154, 155, 156, 157, 158, 160, 162]"
Olaf,L50,long,64,45,19,1,0.6098,164,"[15, 30, 43, 48, 52, 53, 54, 57, 58, 59, 60, 71, 76, 77, 78, 79, 80, 81, 82, 83, 84, 85, 86, 87, 88, 89, 91, 100, 104, 106, 110, 113, 115, 116, 120, 122, 123, 124, 126, 127, 128, 129, 130, 132, 133, 136, 137, 139, 140, 142, 143, 145, 146, 147, 148, 151, 152, 153, 154, 155, 157, 158, 159, 161]"
Olaf,L50,long,53,23,30,6,0.6536,153,"[15, 29, 36, 48, 53, 56, 58, 60, 61, 62, 63, 75, 79, 80, 81, 85, 86, 87, 88, 91, 92, 93, 100, 101, 102, 106, 107, 110, 111, 113, 114, 115, 116, 118, 119, 121, 122, 123, 124, 126, 127, 128, 131, 132, 134, 139, 140, 142, 143, 145, 148, 149, 151]"
Olaf,L50,long,66,33,33,4,0.6024,166,"[18, 24, 27, 28, 31, 47, 52, 54, 55, 57, 58, 59, 60, 72, 76, 80, 82, 87, 88, 89, 90, 91, 98, 101, 102, 103, 104, 105, 106, 107, 109, 110, 112, 113, 114, 116, 117, 118, 119, 120, 121, 122, 126, 127, 129, 130, 131, 132, 134, 135, 138, 139, 141, 142, 145, 146, 148, 149, 151, 154, 156, 157, 160, 162, 163, 164]"
Olaf,L50,long,75,53,22,0,0.5714,175,"[14, 29, 42, 47, 49, 50, 51, 54, 56, 57, 58, 59, 72, 78, 80, 81, 83, 84, 86, 87, 89, 90, 96, 99, 100, 101, 103, 104, 105, 106, 107, 111, 113, 114, 115, 116, 118, 119, 120, 124, 125, 128, 131, 134, 136, 137, 138, 140, 141, 142, 143, 144, 145, 146, 148, 149, 150, 151, 153, 154, 157, 158, 159, 160, 161, 162, 163, 164, 165, 166, 167, 169, 170, 171, 172]"
Olaf,L50,long,68,26,42,2,0.5952,168,"[16, 24, 27, 29, 44, 51, 53, 54, 55, 56, 58, 59, 71, 75, 77, 79, 80, 81, 85, 86, 89, 97, 99, 101, 103, 106, 107, 108, 110, 115, 116, 117, 118, 119, 120, 122, 123, 124, 125, 126, 127, 128, 129, 130, 131, 132, 133, 134, 136, 139, 140, 141, 142, 144, 147, 151, 152, 153, 154, 155, 156, 157, 159, 160, 161, 163, 165, 166]"
Olaf,L50,long,67,30,37,3,0.5988,167,"[16, 25, 29, 44, 51, 52, 53, 56, 59, 60, 63, 74, 79, 80, 81, 83, 84, 85, 87, 88, 89, 90, 92, 99, 101, 102, 103, 105, 108, 109, 111, 112, 113, 114, 116, 117, 119, 121, 122, 124, 125, 126, 128, 130, 131, 132, 133, 137, 138, 139, 142, 144, 146, 147, 148, 149, 150, 151, 152, 153, 154, 155, 156, 157, 159, 162, 165]"
Olaf,L50,long,74,31,43,1,0.5747,174,"[14, 29, 43, 48, 54, 55, 56, 57, 59, 71, 76, 77, 78, 82, 83, 86, 88, 89, 95, 96, 98, 99, 100, 103, 104, 105, 109, 110, 111, 112, 114, 115, 117, 118, 120, 125, 126, 127, 128, 129, 130, 131, 132, 133, 134, 135, 136, 137, 138, 139, 140, 141, 143, 144, 146, 147, 148, 149, 150, 151, 152, 153, 154, 155, 159, 160, 161, 163, 164, 165, 167, 168, 171, 172]"
Olaf,L50,long,63,32,31,0,0.6135,163,"[16, 25, 29, 45, 50, 52, 53, 55, 56, 57, 58, 59, 71, 75, 81, 82, 87, 88, 90, 92, 94, 96, 102, 103, 105, 106, 108, 109, 110, 111, 113, 114, 117, 118, 119, 120, 121, 123, 124, 126, 127, 128, 129, 130, 131, 133, 134, 136, 140, 141, 142, 143, 147, 148, 149, 151, 152, 153, 155, 156, 157, 158, 161]"
Olaf,L50,long,71,40,31,5,0.5848,171,"[18, 24, 28, 29, 44, 51, 53, 56, 57, 58, 59, 71, 76, 78, 81, 83, 84, 85, 86, 87, 88, 89, 91, 101, 102, 105, 106, 107, 109, 112, 115, 116, 117, 118, 119, 123, 124, 125, 126, 127, 131, 133, 134, 137, 138, 141, 142, 143, 144, 145, 146, 148, 149, 151, 152, 153, 154, 155, 156, 158, 159, 160, 161, 162, 163, 164, 165, 166, 167, 168, 169]"
Olaf,L50,long,76,39,37,1,0.5682,176,"[14, 29, 43, 48, 51, 52, 54, 55, 58, 61, 73, 77, 78, 79, 80, 81, 83, 84, 85, 86, 87, 88, 89, 90, 97, 100, 101, 103, 104, 105, 106, 107, 108, 114, 115, 116, 117, 118, 119, 120, 124, 125, 126, 127, 128, 130, 131, 138, 139, 140, 142, 144, 145, 146, 148, 149, 150, 151, 153, 154, 155, 156, 157, 158, 160, 161, 162, 163, 164, 165, 166, 167, 170, 171, 172, 173]"
Olaf,L50,long,58,28,30,6,0.6329,158,"[14, 29, 35, 47, 52, 55, 57, 58, 61, 73, 77, 80, 81, 82, 83, 84, 85, 86, 89, 90, 91, 93, 98, 100, 101, 102, 103, 104, 110, 111, 112, 113, 116, 119, 120, 122, 124, 125, 126, 128, 132, 136, 137, 138, 139, 140, 141, 142, 144, 146, 148, 149, 150, 151, 152, 153, 154, 155]"
Olaf,L50,long,85,44,41,1,0.5405,185,"[14, 30, 43, 48, 51, 55, 56, 57, 58, 59, 70, 75, 77, 79, 80, 81, 82, 83, 84, 85, 89, 90, 97, 99, 101, 103, 105, 106, 107, 108, 109, 111, 112, 115, 117, 120, 121, 122, 123, 124, 125, 127, 128, 130, 131, 133, 134, 135, 136, 137, 138, 141, 145, 146, 147, 148, 149, 150, 151, 152, 153, 154, 155, 156, 157, 158, 159, 160, 161, 162, 164, 166, 167, 169, 170, 173, 174, 176, 177, 178, 179, 180, 181, 182, 183]"
Olaf,L50,long,49,22,27,6,0.6711,149,"[18, 25, 27, 28, 29, 30, 46, 55, 57, 59, 60, 65, 76, 80, 81, 82, 83, 84, 85, 87, 88, 91, 98, 100, 101, 104, 108, 110, 111, 112, 115, 118, 121, 122, 125, 126, 128, 129, 130, 133, 134, 135, 137, 140, 141, 143, 144, 146, 147]"
Olaf,L50,long,69,45,24,2,0.5917,169,"[14, 30, 44, 51, 53, 54, 56, 58, 59, 70, 75, 77, 79, 80, 82, 87, 89, 95, 96, 98, 101, 102, 103, 104, 105, 106, 109, 110, 111, 113, 114, 115, 116, 117, 118, 119, 120, 122, 123, 124, 125, 126, 129, 130, 133, 135, 136, 137, 138, 141, 142, 143, 145, 146, 147, 148, 150, 153, 154, 155, 156, 157, 158, 159, 160, 162, 164, 165, 167]"
Olaf,L50,long,52,25,27,2,0.6579,152,"[16, 24, 27, 28, 29, 46, 52, 53, 54, 55, 56, 57, 59, 70, 75, 78, 79, 80, 82, 84, 85, 86, 87, 89, 91, 93, 101, 103, 109, 110, 113, 115, 116, 117, 120, 122, 123, 126, 127, 129, 130, 131, 133, 134, 135, 136, 137, 139, 140, 141, 147, 149]"
Olaf,L50,long,51,15,36,2,0.6623,151,"[16, 27, 31, 46, 53, 56, 59, 60, 74, 75, 76, 77, 78, 79, 80, 83, 84, 88, 89, 90, 97, 100, 101, 104, 106, 107, 111, 114, 115, 116, 117, 118, 119, 120, 121, 123, 125, 127, 128, 129, 131, 134, 136, 138, 139, 140, 141, 142, 143, 145, 147]"
Olaf,L50,long,65,31,34,2,0.6061,165,"[14, 29, 44, 48, 51, 52, 54, 56, 58, 61, 76, 78, 79, 84, 86, 89, 93, 95, 96, 98, 100, 102, 103, 104, 108, 109, 110, 112, 113, 114, 115, 117, 118, 119, 121, 125, 126, 128, 129, 130, 132, 133, 134, 135, 136, 138, 139, 140, 141, 142, 144, 146, 147, 148, 149, 151, 152, 154, 156, 157, 158, 159, 160, 162, 163]"
Olaf,L50,long,43,25,18,1,0.6993,143,"[18, 24, 29, 45, 54, 55, 56, 57, 59, 71, 74, 76, 78, 82, 86, 88, 90, 97, 98, 99, 102, 103, 104, 105, 108, 109, 110, 112, 113, 119, 120, 123, 124, 126, 127, 128, 129, 130, 131, 135, 136, 137, 138]"
Olaf,L50,long,59,36,23,0,0.6289,159,"[16, 24, 27, 28, 30, 46, 53, 57, 58, 59, 60, 71, 76, 77, 78, 79, 80, 81, 86, 87, 88, 90, 98, 100, 101, 102, 103, 104, 106, 107, 108, 109, 111, 112, 114, 116, 117, 118, 121, 123, 125, 127, 129, 130, 131, 132, 135, 136, 138, 139, 141, 142, 144, 145, 146, 151, 152, 153, 154]"
Olaf,L50,long,73,41,32,3,0.578,173,"[16, 24, 27, 28, 31, 46, 53, 55, 57, 58, 59, 61, 72, 78, 80, 81, 82, 83, 86, 87, 89, 90, 100, 101, 102, 103, 105, 107, 108, 109, 110, 111, 112, 113, 114, 115, 116, 117, 118, 119, 120, 122, 125, 126, 127, 128, 129, 130, 132, 134, 135, 138, 139, 140, 141, 146, 147, 148, 150, 151, 153, 154, 155, 158, 159, 160, 161, 162, 164, 166, 167, 168, 170]"
Olaf,L50,long,43,28,15,2,0.6993,143,"[14, 31, 46, 52, 53, 54, 55, 56, 57, 59, 60, 61, 73, 82, 84, 86, 88, 89, 90, 91, 96, 105, 106, 107, 108, 109, 112, 113, 114, 117, 119, 121, 122, 123, 126, 127, 128, 130, 131, 132, 133, 140, 141]"
Olaf,L50,long,70,36,34,1,0.5882,170,"[16, 24, 27, 28, 29, 30, 31, 32, 48, 54, 56, 57, 58, 59, 60, 62, 75, 80, 82, 83, 84, 85, 86, 87, 89, 91, 92, 100, 104, 105, 106, 110, 111, 112, 115, 119, 121, 123, 124, 125, 126, 127, 128, 129, 130, 131, 134, 136, 137, 139, 140, 141, 142, 144, 147, 148, 151, 152, 154, 155, 156, 157, 158, 159, 160, 161, 164, 165, 166, 168]"
Olaf,L50,long,59,34,25,1,0.6289,159,"[14, 29, 42, 47, 49, 51, 52, 55, 56, 57, 59, 71, 77, 78, 79, 80, 81, 82, 84, 85, 86, 88, 90, 97, 99, 101, 103, 104, 106, 107, 110, 111, 112, 115, 116, 119, 121, 122, 125, 126, 127, 129, 131, 134, 135, 139, 140, 141, 142, 143, 144, 145, 148, 149, 150, 151, 152, 153, 154]"
Olaf,L50,long,64,33,31,2,0.6098,164,"[14, 29, 42, 47, 50, 52, 53, 54, 55, 56, 57, 58, 59, 73, 78, 79, 80, 81, 83, 84, 85, 87, 88, 89, 97, 99, 100, 101, 103, 104, 105, 107, 108, 109, 111, 112, 114, 115, 118, 120, 125, 127, 129, 130, 133, 134, 135, 136, 137, 138, 139, 142, 144, 146, 148, 149, 151, 154, 155, 156, 157, 159, 160, 161]"
Olaf,L50,long,79,45,34,2,0.5587,179,"[14, 30, 44, 51, 52, 54, 55, 57, 59, 70, 74, 77, 78, 79, 82, 83, 84, 86, 87, 88, 90, 91, 97, 99, 100, 103, 104, 106, 108, 110, 111, 112, 113, 114, 115, 116, 117, 118, 119, 120, 121, 122, 124, 127, 128, 129, 130, 133, 134, 137, 138, 139, 140, 141, 142, 143, 144, 146, 148, 149, 151, 152, 156, 157, 158, 159, 161, 164, 165, 166, 168, 169, 170, 171, 172, 174, 175, 176, 177]"
Olaf,L50,long,70,37,33,0,0.5882,170,"[16, 24, 29, 44, 52, 54, 55, 58, 59, 71, 74, 77, 79, 81, 82, 83, 86, 87, 88, 89, 97, 100, 101, 102, 103, 104, 105, 106, 107, 110, 111, 112, 113, 114, 115, 117, 118, 120, 122, 123, 124, 125, 126, 127, 128, 129, 130, 132, 135, 136, 137, 138, 139, 141, 142, 144, 145, 147, 148, 151, 152, 153, 155, 156, 157, 159, 161, 162, 164, 167]"
Olaf,L50,long,69,39,30,3,0.5917,169,"[17, 24, 27, 29, 44, 52, 54, 56, 57, 58, 59, 60, 72, 76, 77, 78, 79, 81, 83, 86, 87, 89, 90, 93, 101, 104, 106, 107, 112, 113, 114, 115, 116, 117, 118, 119, 120, 121, 122, 124, 125, 127, 128, 129, 131, 135, 136, 137, 140, 141, 142, 143, 145, 146, 148, 149, 150, 151, 153, 154, 155, 156, 159, 160, 161, 163, 165, 166, 167]"
Olaf,L50,long,61,25,36,2,0.6211,161,"[16, 29, 42, 47, 49, 50, 51, 52, 53, 55, 56, 57, 60, 72, 79, 80, 81, 82, 85, 86, 87, 88, 89, 91, 98, 100, 101, 102, 103, 107, 108, 109, 110, 111, 112, 115, 121, 123, 125, 126, 127, 128, 129, 130, 131, 133, 134, 135, 136, 137, 140, 141, 142, 143, 147, 148, 150, 151, 152, 153, 157]"
Olaf,L50,long,69,29,40,3,0.5917,169,"[14, 30, 44, 53, 54, 55, 56, 57, 59, 61, 73, 78, 79, 81, 82, 83, 89, 90, 95, 97, 98, 99, 100, 102, 104, 105, 108, 109, 110, 111, 112, 113, 114, 115, 116, 120, 123, 124, 126, 127, 130, 132, 134, 135, 137, 138, 139, 140, 141, 142, 143, 144, 145, 146, 147, 148, 149, 151, 152, 153, 154, 155, 156, 157, 159, 160, 161, 164, 166]"
Olaf,L50,long,69,34,35,5,0.5917,169,"[14, 30, 43, 48, 52, 53, 54, 55, 58, 62, 74, 78, 79, 80, 81, 84, 85, 88, 89, 91, 97, 98, 99, 101, 102, 104, 105, 107, 108, 109, 110, 111, 112, 113, 115, 117, 119, 120, 122, 124, 125, 127, 128, 129, 130, 135, 136, 137, 138, 139, 140, 142, 143, 146, 148, 151, 153, 154, 155, 156, 157, 158, 160, 161, 162, 163, 164, 166, 167]"
Olaf,L50,long,63,32,31,2,0.6135,163,"[15, 29, 42, 47, 49, 50, 51, 52, 53, 55, 56, 57, 58, 59, 61, 62, 63, 77, 81, 82, 84, 86, 87, 88, 89, 91, 92, 93, 94, 101, 104, 105, 106, 108, 111, 112, 113, 114, 115, 116, 117, 119, 120, 121, 122, 123, 125, 131, 132, 136, 137, 140, 141, 144, 146, 148, 149, 151, 153, 154, 156, 157, 158]"
Olaf,L50,long,78,28,50,1,0.5618,178,"[15, 29, 42, 49, 51, 52, 53, 55, 56, 58, 59, 71, 75, 78, 80, 81, 82, 83, 85, 86, 87, 89, 96, 98, 102, 103, 105, 108, 109, 110, 112, 113, 114, 115, 116, 117, 118, 119, 121, 123, 125, 126, 127, 130, 132, 134, 135, 136, 138, 139, 141, 142, 143, 144, 146, 147, 150, 151, 153, 154, 155, 157, 158, 160, 161, 162, 163, 165, 166, 167, 168, 169, 170, 171, 172, 173, 175, 176]"
Olaf,L50,long,73,42,31,1,0.578,173,"[16, 29, 42, 47, 49, 50, 54, 56, 57, 58, 59, 71, 77, 78, 80, 81, 82, 83, 85, 86, 87, 88, 90, 97, 99, 100, 101, 103, 105, 106, 108, 109, 110, 113, 115, 116, 118, 119, 122, 123, 124, 125, 126, 127, 128, 129, 130, 134, 135, 138, 139, 141, 142, 144, 145, 146, 147, 148, 149, 150, 153, 155, 156, 159, 160, 161, 162, 163, 164, 166, 167, 168, 170]"
Olaf,L50,long,60,20,40,5,0.625,160,"[14, 29, 42, 49, 55, 56, 57, 58, 61, 75, 77, 78, 79, 80, 81, 82, 83, 84, 85, 88, 89, 93, 98, 101, 102, 105, 106, 107, 109, 110, 112, 113, 114, 115, 117, 118, 119, 120, 121, 123, 127, 128, 130, 132, 133, 134, 135, 137, 138, 139, 140, 141, 142, 143, 145, 147, 150, 151, 154, 157]"
Olaf,L50,long,64,33,31,1,0.6098,164,"[16, 24, 29, 30, 45, 51, 57, 59, 60, 61, 64, 77, 79, 80, 81, 82, 84, 85, 86, 87, 88, 90, 91, 93, 101, 105, 106, 107, 109, 110, 111, 113, 114, 117, 118, 120, 121, 122, 123, 125, 126, 127, 129, 130, 131, 132, 134, 135, 137, 139, 140, 141, 143, 146, 147, 148, 149, 150, 152, 153, 154, 155, 157, 158]"
Olaf,L50,long,73,34,39,5,0.578,173,"[20, 25, 27, 31, 46, 53, 55, 56, 57, 59, 60, 71, 75, 79, 80, 82, 83, 84, 86, 87, 89, 90, 98, 101, 102, 104, 105, 106, 107, 109, 111, 112, 115, 116, 117, 118, 119, 120, 121, 122, 123, 125, 127, 128, 130, 131, 133, 137, 138, 139, 140, 142, 143, 144, 145, 148, 149, 150, 151, 152, 153, 157, 158, 159, 160, 161, 162, 164, 165, 167, 168, 170, 171]"
Olaf,L50,long,70,35,35,3,0.5882,170,"[16, 24, 28, 30, 46, 51, 54, 56, 57, 58, 59, 62, 74, 77, 79, 80, 81, 83, 85, 86, 87, 88, 89, 90, 99, 101, 102, 103, 104, 105, 109, 110, 112, 115, 116, 118, 119, 121, 123, 124, 126, 127, 129, 130, 132, 133, 134, 136, 137, 138, 139, 140, 142, 143, 144, 145, 146, 147, 150, 152, 153, 157, 158, 159, 160, 161, 164, 165, 166, 167]"
Olaf,L50,long,80,44,36,0,0.5556,180,"[16, 24, 27, 30, 45, 51, 54, 55, 56, 58, 59, 60, 72, 77, 79, 81, 82, 83, 85, 86, 87, 88, 89, 90, 91, 93, 101, 104, 106, 109, 110, 112, 116, 117, 118, 119, 120, 121, 122, 123, 124, 125, 126, 130, 131, 132, 133, 134, 135, 138, 139, 140, 141, 142, 143, 145, 148, 149, 152, 153, 154, 155, 156, 157, 158, 160, 161, 163, 164, 165, 166, 167, 168, 169, 170, 173, 174, 176, 177, 178]"
Olaf,L50,long,73,36,37,0,0.578,173,"[15, 29, 42, 47, 49, 50, 52, 53, 54, 55, 56, 57, 59, 72, 76, 79, 82, 83, 84, 85, 86, 87, 89, 90, 99, 100, 101, 103, 108, 109, 110, 111, 112, 113, 114, 115, 117, 118, 119, 120, 124, 125, 126, 127, 129, 130, 131, 132, 133, 135, 136, 138, 139, 141, 142, 143, 145, 146, 147, 149, 150, 151, 155, 156, 158, 160, 164, 165, 166, 167, 168, 169, 170]"
Olaf,L50,long,66,32,34,2,0.6024,166,"[16, 24, 28, 29, 30, 31, 33, 49, 54, 57, 59, 60, 61, 62, 74, 78, 80, 81, 84, 87, 88, 90, 92, 99, 101, 102, 103, 104, 106, 108, 109, 110, 113, 116, 117, 119, 120, 121, 122, 123, 124, 126, 128, 129, 131, 132, 134, 137, 138, 139, 140, 142, 143, 144, 145, 148, 149, 150, 151, 152, 153, 155, 156, 157, 158, 160]"
Olaf,L50,long,77,37,40,3,0.565,177,"[16, 24, 27, 28, 30, 46, 55, 56, 57, 58, 60, 73, 78, 86, 87, 88, 89, 91, 97, 99, 100, 103, 105, 108, 110, 111, 112, 113, 114, 115, 117, 118, 119, 120, 121, 122, 123, 124, 125, 128, 129, 130, 131, 132, 133, 134, 135, 136, 137, 139, 140, 141, 142, 143, 144, 145, 146, 147, 148, 150, 153, 154, 155, 156, 157, 158, 159, 160, 161, 163, 164, 165, 168, 169, 171, 173, 174]"
Olaf,L50,long,75,43,32,6,0.5714,175,"[16, 24, 27, 28, 30, 48, 53, 54, 56, 59, 60, 61, 65, 76, 80, 85, 87, 88, 89, 90, 92, 93, 95, 101, 103, 104, 105, 106, 108, 109, 110, 112, 113, 114, 115, 118, 119, 120, 125, 126, 129, 130, 131, 132, 133, 134, 135, 136, 137, 138, 140, 143, 144, 145, 147, 148, 149, 150, 151, 152, 153, 154, 155, 159, 160, 161, 162, 163, 164, 168, 169, 170, 171, 172, 173]"
Olaf,L50,long,76,39,37,1,0.5682,176,"[17, 24, 27, 28, 29, 30, 48, 53, 55, 56, 57, 58, 59, 61, 73, 77, 79, 80, 81, 82, 84, 85, 86, 87, 88, 89, 90, 101, 103, 104, 105, 106, 111, 113, 115, 117, 118, 121, 122, 124, 126, 127, 128, 129, 130, 132, 133, 134, 135, 136, 139, 140, 141, 143, 146, 147, 148, 149, 151, 152, 153, 154, 155, 156, 157, 158, 159, 160, 161, 163, 165, 166, 168, 170, 171, 173]"
Olaf,L50,long,58,21,37,3,0.6329,158,"[14, 29, 42, 47, 50, 53, 54, 55, 58, 59, 70, 77, 78, 80, 82, 85, 87, 88, 90, 95, 98, 100, 101, 103, 106, 107, 109, 110, 111, 112, 113, 114, 115, 117, 121, 124, 128, 130, 131, 134, 135, 136, 137, 138, 139, 140, 141, 143, 144, 146, 147, 148, 150, 151, 153, 154, 155, 156]"
Olaf,L50,long,59,21,38,8,0.6289,159,"[16, 24, 28, 32, 47, 53, 56, 57, 59, 60, 72, 75, 77, 79, 80, 81, 83, 84, 85, 88, 89, 90, 92, 99, 103, 106, 108, 110, 111, 112, 113, 120, 121, 122, 123, 124, 125, 126, 127, 129, 130, 131, 133, 134, 135, 137, 139, 140, 142, 143, 144, 145, 146, 147, 148, 149, 150, 156, 157]"
Olaf,L50,long,82,34,48,3,0.5495,182,"[17, 25, 28, 30, 46, 51, 53, 54, 55, 57, 58, 59, 71, 75, 78, 80, 82, 83, 84, 85, 86, 89, 92, 93, 95, 97, 98, 99, 102, 110, 111, 113, 114, 115, 116, 117, 118, 120, 121, 123, 124, 125, 126, 127, 128, 130, 131, 132, 135, 136, 137, 139, 140, 141, 143, 145, 146, 147, 148, 149, 151, 152, 154, 155, 157, 159, 160, 161, 162, 164, 166, 167, 168, 170, 171, 173, 174, 175, 177, 178, 179, 180]"
Olaf,L50,long,55,26,29,5,0.6452,155,"[16, 24, 28, 29, 31, 47, 53, 56, 58, 59, 60, 71, 75, 77, 78, 79, 80, 83, 84, 85, 87, 89, 90, 98, 104, 105, 106, 107, 108, 109, 111, 112, 113, 115, 116, 117, 124, 125, 127, 128, 130, 131, 132, 134, 135, 136, 137, 139, 141, 142, 145, 146, 147, 150, 152]"
Olaf,L50,long,61,28,33,1,0.6211,161,"[17, 24, 27, 28, 29, 30, 31, 48, 54, 55, 56, 57, 62, 73, 78, 79, 81, 82, 88, 89, 91, 93, 99, 102, 103, 106, 107, 108, 110, 111, 112, 113, 114, 115, 117, 119, 120, 123, 125, 126, 127, 128, 130, 132, 134, 136, 137, 140, 142, 143, 144, 145, 146, 148, 149, 151, 152, 153, 154, 156, 157]"
Olaf,L50,long,76,32,44,1,0.5682,176,"[16, 24, 28, 29, 46, 51, 53, 55, 58, 59, 60, 71, 76, 77, 78, 79, 80, 81, 82, 85, 86, 87, 88, 89, 91, 100, 103, 104, 106, 107, 109, 111, 112, 113, 114, 115, 116, 118, 120, 123, 125, 126, 127, 128, 130, 131, 132, 133, 135, 136, 137, 138, 140, 141, 142, 143, 144, 146, 148, 150, 151, 152, 154, 160, 162, 163, 164, 166, 167, 168, 169, 170, 171, 172, 173, 174]"
Olaf,L50,long,51,38,13,2,0.6623,151,"[16, 24, 29, 44, 50, 52, 53, 54, 56, 57, 58, 59, 61, 73, 78, 79, 80, 83, 88, 91, 98, 105, 106, 107, 108, 109, 111, 112, 113, 114, 115, 116, 117, 118, 119, 120, 121, 122, 123, 124, 127, 130, 131, 133, 136, 138, 139, 142, 144, 145, 148]"
Olaf,L50,long,67,33,34,1,0.5988,167,"[16, 24, 27, 28, 31, 46, 52, 54, 56, 57, 59, 60, 61, 63, 74, 80, 81, 82, 83, 84, 85, 86, 87, 88, 90, 91, 93, 102, 104, 106, 109, 110, 111, 112, 113, 115, 116, 117, 120, 122, 123, 125, 127, 129, 130, 131, 133, 134, 135, 137, 139, 142, 143, 144, 145, 147, 150, 151, 152, 153, 154, 156, 157, 159, 160, 162, 163]"
Olaf,L50,long,76,32,44,2,0.5682,176,"[18, 24, 27, 28, 29, 45, 51, 53, 54, 56, 57, 58, 60, 72, 77, 78, 80, 81, 83, 84, 87, 89, 98, 100, 101, 103, 104, 105, 106, 107, 109, 112, 113, 114, 115, 117, 119, 123, 124, 125, 126, 128, 129, 130, 132, 133, 134, 135, 137, 138, 140, 142, 143, 144, 146, 148, 150, 151, 152, 154, 155, 156, 157, 159, 160, 161, 163, 164, 165, 167, 168, 169, 170, 171, 173, 174]"
Olaf,L50,long,74,41,33,2,0.5747,174,"[14, 29, 43, 48, 51, 52, 53, 55, 58, 60, 71, 80, 81, 84, 85, 86, 87, 88, 89, 90, 92, 94, 99, 100, 101, 102, 103, 106, 108, 109, 111, 113, 114, 116, 117, 120, 121, 122, 123, 124, 125, 126, 127, 128, 129, 130, 131, 133, 134, 138, 141, 142, 143, 146, 147, 148, 149, 151, 153, 154, 155, 156, 157, 158, 159, 161, 163, 164, 165, 166, 167, 168, 171, 172]"
Olaf,L50,long,81,52,29,2,0.5525,181,"[16, 24, 27, 30, 32, 48, 53, 56, 57, 58, 59, 60, 61, 62, 65, 76, 80, 82, 83, 86, 87, 89, 91, 93, 95, 103, 105, 106, 107, 108, 109, 110, 111, 112, 113, 114, 116, 117, 118, 119, 120, 121, 122, 123, 124, 125, 127, 132, 134, 135, 137, 139, 140, 142, 143, 144, 145, 146, 148, 149, 152, 153, 154, 156, 157, 158, 162, 163, 165, 166, 167, 168, 169, 170, 171, 172, 173, 175, 176, 178, 179]"
Olaf,L50,long,54,36,18,6,0.6494,154,"[14, 32, 46, 51, 53, 54, 55, 57, 59, 70, 74, 77, 78, 81, 84, 86, 87, 89, 90, 95, 97, 98, 99, 100, 101, 102, 105, 106, 108, 110, 112, 113, 114, 117, 119, 124, 125, 126, 127, 129, 132, 133, 135, 136, 137, 138, 140, 141, 144, 146, 147, 148, 149, 152]"
Olaf,L50,long,65,22,43,4,0.6061,165,"[14, 29, 35, 48, 54, 56, 57, 59, 60, 61, 73, 78, 79, 80, 81, 82, 83, 84, 85, 86, 87, 88, 89, 91, 98, 100, 101, 102, 103, 104, 107, 108, 111, 114, 115, 116, 118, 120, 121, 123, 124, 126, 127, 128, 129, 130, 131, 132, 135, 136, 138, 141, 142, 148, 149, 150, 151, 152, 153, 154, 158, 159, 160, 162, 163]"
Olaf,L50,long,62,33,29,4,0.6173,162,"[14, 29, 42, 48, 52, 53, 54, 55, 57, 58, 59, 63, 76, 80, 81, 82, 83, 85, 86, 87, 88, 90, 92, 98, 100, 103, 104, 105, 106, 107, 108, 111, 112, 114, 115, 118, 119, 122, 123, 124, 125, 127, 128, 130, 132, 134, 135, 136, 138, 140, 141, 142, 143, 146, 148, 149, 151, 153, 154, 157, 158, 160]"
Olaf,L50,long,65,25,40,8,0.6061,165,"[14, 29, 37, 50, 55, 58, 60, 61, 62, 73, 78, 79, 80, 83, 84, 85, 86, 88, 90, 91, 92, 93, 98, 100, 102, 103, 104, 105, 107, 108, 111, 113, 114, 115, 117, 118, 121, 122, 123, 124, 125, 126, 127, 129, 130, 131, 133, 134, 135, 137, 140, 141, 143, 144, 145, 147, 148, 150, 152, 153, 155, 158, 160, 161, 163]"
Olaf,L50,long,71,41,30,8,0.5848,171,"[14, 29, 44, 48, 51, 52, 54, 55, 56, 57, 60, 71, 76, 77, 79, 80, 81, 82, 84, 86, 88, 89, 96, 101, 104, 105, 106, 109, 112, 113, 114, 115, 116, 117, 118, 120, 122, 124, 125, 126, 127, 128, 129, 131, 133, 140, 141, 142, 143, 144, 146, 147, 148, 149, 150, 151, 152, 153, 154, 156, 157, 158, 159, 161, 162, 163, 164, 165, 166, 168, 169]"
Olaf,L50,long,89,48,41,3,0.5291,189,"[16, 24, 27, 30, 46, 51, 53, 54, 56, 57, 58, 59, 60, 72, 79, 80, 81, 82, 83, 85, 86, 87, 88, 89, 90, 98, 103, 104, 105, 106, 108, 109, 111, 112, 113, 114, 115, 116, 117, 118, 119, 120, 123, 124, 125, 126, 127, 129, 130, 131, 133, 134, 136, 137, 138, 139, 140, 141, 142, 144, 145, 146, 150, 151, 152, 154, 155, 158, 160, 161, 162, 163, 164, 165, 166, 168, 170, 171, 172, 173, 174, 176, 178, 179, 180, 183, 185, 186, 187]"
Olaf,L50,long,78,29,49,12,0.5618,178,"[14, 29, 36, 49, 54, 57, 62, 73, 76, 77, 78, 83, 84, 86, 87, 88, 92, 97, 100, 101, 102, 103, 104, 105, 106, 107, 109, 110, 111, 112, 113, 115, 116, 117, 118, 119, 120, 121, 123, 124, 125, 126, 127, 128, 129, 130, 132, 134, 135, 136, 137, 138, 142, 143, 144, 146, 147, 148, 152, 153, 154, 155, 156, 157, 159, 160, 161, 162, 163, 166, 168, 169, 170, 171, 172, 173, 175, 176]"
Olaf,L50,long,61,28,33,5,0.6211,161,"[16, 29, 43, 48, 51, 54, 55, 56, 57, 59, 61, 72, 76, 80, 81, 82, 83, 84, 85, 86, 87, 88, 91, 97, 99, 100, 102, 103, 106, 107, 109, 112, 114, 117, 118, 120, 121, 122, 124, 125, 126, 127, 128, 129, 131, 133, 134, 135, 136, 137, 138, 139, 140, 143, 144, 146, 147, 148, 151, 153, 154]"
Olaf,L50,long,53,28,25,3,0.6536,153,"[14, 31, 47, 51, 52, 53, 54, 55, 56, 58, 60, 61, 76, 80, 81, 82, 85, 92, 97, 98, 99, 100, 101, 102, 106, 107, 109, 111, 112, 113, 114, 118, 120, 121, 122, 123, 124, 127, 129, 130, 131, 133, 134, 135, 136, 137, 139, 143, 145, 146, 149, 150, 151]"
Olaf,L50,long,55,35,20,11,0.6452,155,"[15, 30, 39, 51, 57, 59, 64, 75, 77, 78, 79, 80, 81, 84, 86, 88, 89, 90, 92, 96, 100, 102, 103, 104, 105, 107, 108, 110, 111, 112, 113, 115, 116, 117, 118, 121, 122, 123, 124, 125, 127, 129, 130, 132, 136, 137, 139, 141, 142, 145, 146, 147, 148, 149, 153]"
Olaf,L50,long,48,23,25,6,0.6757,148,"[14, 34, 46, 52, 55, 56, 57, 60, 73, 76, 80, 82, 84, 85, 86, 87, 89, 94, 95, 98, 100, 102, 103, 105, 106, 107, 109, 110, 113, 115, 116, 118, 119, 120, 122, 124, 125, 127, 132, 134, 137, 138, 139, 140, 143, 144, 145, 146]"
Olaf,L50,long,74,27,47,3,0.5747,174,"[17, 24, 27, 29, 31, 47, 52, 55, 56, 57, 59, 62, 73, 77, 79, 80, 81, 82, 83, 84, 87, 88, 89, 90, 100, 101, 104, 105, 106, 111, 113, 114, 115, 116, 117, 119, 120, 121, 123, 124, 126, 127, 128, 129, 130, 131, 132, 134, 135, 136, 137, 139, 142, 143, 144, 146, 147, 148, 149, 150, 152, 153, 154, 155, 158, 159, 163, 165, 166, 167, 168, 169, 171, 172]"
Olaf,L50,long,69,30,39,1,0.5917,169,"[18, 24, 27, 28, 29, 45, 53, 54, 55, 56, 57, 58, 59, 70, 75, 77, 79, 80, 81, 83, 84, 86, 87, 89, 90, 92, 101, 103, 104, 105, 107, 108, 110, 115, 116, 118, 119, 121, 122, 124, 127, 128, 129, 130, 131, 132, 134, 135, 136, 137, 138, 139, 141, 142, 144, 145, 147, 148, 149, 151, 152, 154, 156, 158, 159, 160, 162, 165, 166]"
Olaf,L50,long,65,22,43,2,0.6061,165,"[16, 25, 28, 30, 45, 51, 53, 54, 55, 58, 59, 60, 75, 77, 80, 86, 89, 91, 97, 99, 102, 104, 105, 106, 108, 109, 111, 113, 115, 116, 117, 118, 119, 120, 121, 122, 123, 124, 125, 127, 128, 129, 130, 133, 134, 135, 136, 138, 139, 140, 141, 142, 144, 145, 146, 147, 150, 151, 152, 153, 157, 158, 161, 162, 163]"
Olaf,L50,long,82,35,47,3,0.5495,182,"[14, 31, 45, 50, 53, 54, 55, 56, 58, 59, 70, 75, 76, 77, 78, 80, 81, 82, 83, 84, 89, 95, 98, 99, 102, 103, 104, 105, 110, 111, 112, 114, 115, 116, 117, 118, 119, 121, 123, 124, 125, 127, 129, 130, 131, 132, 133, 134, 135, 136, 137, 138, 140, 141, 142, 143, 144, 145, 148, 150, 151, 152, 153, 154, 155, 156, 157, 158, 159, 162, 163, 164, 165, 166, 167, 168, 172, 175, 176, 177, 178, 180]"
Olaf,L50,long,80,36,44,3,0.5556,180,"[15, 30, 43, 48, 51, 54, 56, 57, 58, 60, 73, 76, 77, 80, 81, 82, 83, 84, 85, 90, 95, 97, 98, 99, 100, 101, 102, 104, 108, 109, 110, 111, 112, 113, 114, 115, 116, 118, 119, 120, 121, 122, 126, 127, 128, 129, 130, 134, 135, 138, 139, 141, 142, 143, 144, 145, 149, 152, 153, 154, 157, 160, 161, 162, 163, 164, 165, 166, 167, 168, 169, 170, 171, 172, 173, 174, 175, 176, 177, 178]"
Olaf,L50,long,78,43,35,0,0.5618,178,"[14, 29, 42, 47, 49, 50, 52, 53, 56, 57, 60, 71, 77, 79, 80, 82, 83, 85, 86, 87, 92, 93, 98, 100, 102, 104, 105, 107, 108, 110, 112, 114, 115, 117, 118, 120, 121, 123, 124, 128, 129, 130, 131, 132, 133, 134, 135, 136, 137, 138, 140, 142, 143, 145, 146, 147, 150, 151, 153, 154, 155, 156, 157, 158, 159, 160, 162, 163, 164, 165, 166, 168, 170, 171, 172, 173, 174, 175]"
Olaf,L50,long,69,46,23,0,0.5917,169,"[16, 24, 28, 29, 44, 51, 54, 56, 58, 59, 60, 74, 76, 77, 78, 79, 80, 81, 82, 83, 84, 85, 86, 88, 91, 100, 103, 104, 105, 106, 107, 108, 109, 110, 111, 112, 113, 114, 115, 121, 124, 126, 127, 128, 129, 130, 133, 134, 137, 138, 139, 140, 141, 142, 145, 146, 147, 148, 150, 152, 154, 157, 158, 160, 162, 163, 164, 166, 167]"
Olaf,L50,long,56,29,27,1,0.641,156,"[14, 30, 43, 48, 54, 56, 58, 59, 61, 75, 77, 78, 80, 81, 83, 85, 86, 87, 88, 90, 95, 97, 98, 106, 108, 109, 110, 111, 112, 113, 115, 117, 118, 119, 120, 123, 125, 126, 127, 128, 129, 130, 132, 133, 136, 137, 138, 141, 142, 145, 148, 149, 150, 152, 153, 154]"
Olaf,L50,long,59,32,27,0,0.6289,159,"[17, 27, 28, 29, 46, 51, 54, 56, 59, 70, 75, 76, 77, 78, 79, 81, 83, 84, 85, 86, 88, 89, 97, 100, 101, 102, 103, 105, 107, 110, 113, 114, 117, 119, 120, 121, 124, 125, 126, 127, 128, 129, 130, 131, 134, 135, 137, 138, 139, 141, 143, 145, 146, 149, 150, 151, 152, 153, 157]"
Olaf,L50,long,71,51,20,1,0.5848,171,"[16, 25, 29, 44, 51, 52, 53, 54, 56, 57, 58, 59, 60, 74, 82, 83, 84, 85, 86, 87, 88, 89, 90, 91, 99, 101, 102, 103, 104, 106, 107, 109, 110, 111, 112, 113, 116, 117, 119, 122, 124, 125, 126, 128, 129, 130, 132, 134, 137, 138, 139, 141, 143, 144, 146, 148, 149, 150, 151, 152, 153, 154, 155, 159, 160, 161, 162, 164, 166, 167, 169]"
Olaf,L50,long,50,28,22,4,0.6667,150,"[16, 25, 27, 28, 29, 45, 52, 53, 54, 56, 57, 61, 72, 76, 79, 80, 81, 82, 84, 87, 88, 90, 98, 100, 101, 102, 103, 104, 105, 107, 108, 111, 112, 114, 116, 117, 118, 119, 121, 125, 127, 129, 130, 131, 134, 137, 141, 146, 147, 148]"
Olaf,L50,long,52,30,22,2,0.6579,152,"[14, 30, 43, 48, 51, 53, 55, 56, 57, 58, 59, 71, 75, 78, 79, 81, 82, 86, 87, 88, 89, 95, 97, 98, 101, 102, 103, 104, 105, 106, 109, 111, 113, 116, 119, 121, 126, 127, 128, 130, 134, 135, 136, 137, 139, 141, 142, 144, 145, 146, 148, 150]"
Olaf,L50,long,43,20,23,3,0.6993,143,"[14, 29, 42, 47, 50, 53, 54, 56, 58, 61, 73, 77, 78, 79, 81, 82, 83, 84, 88, 90, 95, 98, 99, 100, 101, 103, 104, 106, 107, 108, 110, 111, 117, 118, 120, 123, 126, 131, 134, 135, 137, 138, 141]"
Olaf,L50,long,90,52,38,3,0.5263,190,"[16, 25, 27, 29, 44, 51, 54, 60, 73, 76, 77, 78, 79, 81, 82, 83, 84, 86, 88, 91, 97, 100, 102, 103, 104, 105, 106, 107, 108, 110, 111, 112, 113, 114, 115, 116, 117, 118, 119, 120, 123, 124, 125, 126, 127, 129, 130, 131, 132, 135, 137, 138, 139, 140, 142, 143, 147, 148, 149, 150, 151, 153, 154, 156, 157, 158, 159, 160, 162, 163, 164, 165, 167, 168, 169, 170, 171, 172, 173, 174, 176, 177, 178, 179, 181, 182, 183, 185, 186, 187]"
Olaf,L50,long,64,39,25,3,0.6098,164,"[16, 25, 27, 28, 29, 32, 47, 53, 56, 57, 58, 62, 73, 77, 80, 81, 83, 84, 85, 87, 88, 89, 90, 91, 99, 101, 102, 104, 105, 106, 108, 109, 110, 111, 112, 113, 114, 116, 118, 119, 121, 124, 125, 127, 130, 132, 135, 136, 137, 138, 139, 140, 142, 143, 146, 147, 149, 151, 153, 155, 156, 157, 159, 160]"
Olaf,L50,long,55,24,31,8,0.6452,155,"[17, 26, 29, 30, 46, 51, 54, 56, 57, 60, 65, 75, 81, 83, 87, 89, 90, 91, 96, 100, 103, 105, 106, 107, 108, 110, 112, 113, 114, 116, 117, 119, 120, 121, 122, 124, 125, 127, 129, 131, 132, 134, 137, 138, 139, 140, 141, 142, 143, 144, 147, 149, 150, 151, 153]"
Olaf,L50,long,67,35,32,4,0.5988,167,"[16, 24, 30, 32, 47, 54, 56, 57, 59, 60, 62, 73, 77, 78, 79, 80, 81, 82, 83, 85, 86, 87, 89, 90, 93, 102, 104, 105, 106, 107, 108, 109, 111, 113, 114, 115, 120, 123, 124, 125, 127, 129, 131, 133, 134, 136, 138, 139, 140, 141, 143, 144, 145, 146, 148, 149, 150, 151, 152, 155, 157, 158, 159, 160, 161, 162, 164]"
Olaf,L50,long,66,34,32,3,0.6024,166,"[16, 25, 27, 28, 29, 47, 52, 53, 56, 57, 59, 71, 76, 77, 78, 82, 83, 84, 87, 90, 96, 99, 100, 102, 103, 104, 105, 106, 111, 112, 114, 115, 116, 117, 120, 123, 124, 125, 128, 129, 133, 134, 135, 136, 137, 138, 139, 140, 142, 143, 144, 146, 147, 148, 151, 152, 153, 154, 155, 157, 158, 159, 160, 161, 162, 164]"
Olaf,L50,long,61,28,33,2,0.6211,161,"[14, 30, 43, 50, 52, 53, 54, 55, 59, 60, 72, 75, 77, 78, 79, 81, 82, 84, 86, 88, 89, 90, 96, 98, 100, 101, 102, 103, 104, 106, 107, 111, 113, 115, 116, 117, 118, 119, 120, 125, 128, 129, 132, 134, 136, 137, 140, 142, 143, 144, 145, 146, 147, 148, 150, 153, 155, 156, 157, 158, 159]"
Olaf,L50,long,79,34,45,5,0.5587,179,"[18, 24, 32, 48, 54, 55, 56, 57, 59, 62, 73, 77, 78, 79, 80, 81, 82, 83, 84, 88, 90, 97, 99, 102, 103, 104, 107, 108, 109, 110, 113, 115, 116, 117, 120, 121, 122, 123, 124, 125, 127, 128, 129, 130, 131, 132, 133, 134, 135, 136, 137, 139, 140, 141, 142, 145, 147, 149, 150, 151, 152, 153, 154, 155, 157, 158, 161, 163, 164, 165, 166, 167, 168, 169, 170, 171, 175, 176, 177]"
Olaf,L50,long,59,18,41,5,0.6289,159,"[16, 24, 28, 30, 45, 51, 54, 55, 61, 72, 77, 79, 81, 83, 84, 86, 87, 92, 99, 100, 101, 104, 106, 110, 111, 112, 114, 115, 116, 117, 118, 121, 122, 123, 125, 126, 127, 128, 129, 130, 132, 133, 136, 137, 138, 139, 140, 141, 142, 143, 144, 145, 147, 148, 152, 153, 154, 155, 156]"
Olaf,L50,long,68,27,41,0,0.5952,168,"[14, 29, 44, 48, 51, 53, 54, 56, 57, 59, 60, 71, 76, 77, 79, 80, 81, 82, 83, 86, 87, 89, 91, 92, 98, 101, 103, 104, 106, 107, 108, 112, 115, 118, 119, 121, 122, 124, 125, 128, 130, 131, 132, 134, 135, 136, 137, 138, 139, 140, 141, 142, 143, 144, 145, 146, 147, 148, 149, 151, 152, 154, 160, 161, 162, 163, 164, 165]"
Olaf,L50,long,59,37,22,1,0.6289,159,"[14, 29, 42, 47, 49, 50, 52, 53, 54, 55, 58, 59, 60, 62, 63, 75, 81, 83, 87, 88, 89, 90, 91, 93, 94, 96, 102, 105, 108, 109, 110, 111, 113, 115, 116, 117, 119, 121, 122, 123, 124, 125, 127, 128, 131, 136, 137, 138, 139, 140, 143, 144, 148, 150, 151, 152, 153, 155, 156]"
Olaf,L50,long,64,30,34,0,0.6098,164,"[17, 25, 27, 28, 29, 30, 46, 53, 54, 56, 57, 58, 59, 60, 73, 78, 79, 81, 83, 84, 86, 87, 88, 90, 99, 101, 102, 103, 105, 106, 107, 109, 112, 113, 114, 116, 117, 118, 120, 121, 122, 125, 126, 127, 129, 130, 132, 134, 136, 142, 143, 145, 147, 148, 149, 150, 151, 152, 153, 154, 155, 156, 157, 158]"
Olaf,L50,long,55,25,30,4,0.6452,155,"[15, 29, 42, 47, 49, 51, 52, 53, 54, 55, 56, 58, 59, 72, 76, 78, 79, 80, 83, 84, 85, 86, 87, 88, 89, 98, 100, 101, 102, 106, 109, 111, 113, 114, 115, 116, 119, 121, 123, 125, 128, 130, 132, 133, 135, 136, 139, 140, 141, 143, 144, 145, 147, 148, 153]"
Olaf,L50,long,56,34,22,3,0.641,156,"[16, 24, 28, 29, 32, 47, 53, 58, 60, 70, 74, 76, 77, 79, 81, 82, 84, 85, 87, 88, 90, 98, 102, 104, 105, 107, 109, 110, 111, 113, 114, 115, 116, 117, 118, 119, 121, 126, 127, 128, 130, 131, 132, 133, 136, 137, 138, 139, 144, 146, 147, 148, 150, 151, 153, 154]"
Olaf,L50,long,56,33,23,3,0.641,156,"[17, 30, 44, 52, 53, 54, 55, 56, 57, 58, 59, 60, 73, 80, 81, 83, 85, 86, 87, 88, 91, 97, 99, 100, 101, 102, 104, 105, 107, 108, 109, 111, 112, 113, 114, 117, 121, 122, 123, 124, 127, 129, 130, 133, 135, 138, 141, 142, 143, 144, 145, 146, 147, 148, 153, 154]"
Olaf,L50,long,73,16,57,4,0.578,173,"[14, 30, 44, 50, 53, 55, 56, 57, 58, 59, 70, 75, 77, 79, 80, 82, 83, 84, 86, 87, 89, 95, 97, 98, 99, 100, 105, 106, 109, 110, 111, 112, 114, 116, 118, 121, 123, 127, 128, 129, 130, 131, 132, 133, 134, 135, 136, 137, 138, 139, 141, 142, 144, 147, 149, 152, 153, 155, 156, 157, 158, 159, 160, 161, 162, 163, 164, 165, 166, 167, 169, 170, 171]"
Olaf,L50,long,73,29,44,2,0.578,173,"[16, 24, 27, 28, 29, 46, 52, 53, 54, 55, 56, 59, 71, 75, 77, 78, 79, 80, 81, 82, 86, 87, 88, 90, 100, 101, 102, 103, 104, 108, 112, 114, 115, 116, 117, 118, 119, 121, 124, 125, 126, 127, 128, 130, 132, 133, 134, 135, 136, 137, 138, 140, 142, 143, 144, 145, 146, 147, 150, 151, 152, 153, 154, 155, 156, 159, 160, 161, 163, 164, 166, 168, 171]"
Olaf,L50,long,63,38,25,4,0.6135,163,"[15, 29, 42, 47, 50, 53, 54, 55, 56, 57, 58, 60, 73, 78, 79, 80, 81, 83, 84, 87, 90, 92, 94, 98, 104, 106, 107, 108, 109, 111, 113, 114, 115, 117, 118, 119, 121, 122, 123, 124, 125, 126, 127, 130, 131, 132, 133, 134, 136, 137, 138, 141, 142, 144, 145, 149, 151, 152, 154, 155, 156, 159, 160]"
Olaf,L50,long,62,24,38,3,0.6173,162,"[15, 31, 45, 50, 52, 55, 56, 57, 58, 60, 74, 76, 78, 79, 80, 82, 83, 84, 85, 86, 87, 88, 89, 97, 99, 102, 103, 104, 105, 106, 110, 111, 112, 115, 117, 118, 119, 121, 122, 126, 128, 129, 130, 133, 134, 135, 136, 138, 140, 142, 143, 145, 146, 147, 149, 150, 151, 153, 154, 155, 156, 158]"
Olaf,L50,long,53,34,19,3,0.6536,153,"[18, 24, 27, 28, 29, 45, 51, 55, 57, 59, 71, 75, 76, 77, 78, 80, 81, 82, 84, 87, 88, 89, 98, 100, 104, 106, 107, 110, 111, 112, 113, 115, 116, 119, 120, 122, 124, 125, 126, 127, 128, 129, 132, 133, 134, 135, 136, 140, 141, 143, 144, 146, 148]"
Olaf,L100,long,62,28,34,2,0.6173,162,"[17, 24, 28, 29, 47, 53, 55, 56, 57, 58, 59, 61, 72, 75, 76, 77, 78, 79, 80, 81, 82, 84, 85, 86, 87, 89, 91, 99, 104, 105, 108, 110, 112, 114, 116, 119, 120, 121, 123, 125, 126, 128, 132, 133, 136, 137, 139, 140, 142, 143, 144, 146, 147, 148, 149, 150, 152, 153, 155, 156, 157, 160]"
Olaf,L100,long,46,24,22,5,0.6849,146,"[17, 33, 48, 53, 55, 56, 60, 64, 77, 82, 84, 85, 88, 89, 90, 91, 92, 95, 97, 100, 102, 103, 104, 105, 107, 110, 112, 113, 115, 116, 120, 122, 125, 126, 127, 128, 129, 130, 131, 132, 133, 134, 135, 138, 141, 143]"
Olaf,L100,long,61,22,39,4,0.6211,161,"[17, 25, 28, 29, 30, 31, 47, 54, 56, 57, 58, 59, 60, 65, 75, 78, 79, 80, 81, 83, 86, 87, 89, 90, 91, 92, 103, 104, 106, 107, 109, 111, 112, 114, 116, 117, 118, 119, 120, 121, 122, 123, 124, 125, 128, 130, 131, 133, 134, 136, 139, 144, 146, 147, 148, 150, 151, 152, 153, 154, 157]"
Olaf,L100,long,49,21,28,8,0.6711,149,"[16, 32, 49, 53, 54, 58, 63, 76, 81, 82, 84, 85, 86, 87, 90, 92, 93, 99, 101, 102, 103, 104, 106, 108, 109, 112, 113, 116, 119, 120, 121, 122, 123, 124, 126, 128, 129, 130, 131, 133, 134, 135, 136, 137, 139, 140, 143, 144, 145]"
Olaf,L100,long,61,29,32,3,0.6211,161,"[17, 24, 29, 45, 52, 54, 55, 56, 57, 58, 60, 75, 76, 77, 78, 79, 80, 82, 85, 86, 88, 89, 91, 99, 101, 102, 104, 105, 110, 112, 113, 115, 116, 118, 121, 122, 123, 125, 126, 127, 128, 130, 132, 133, 134, 136, 140, 141, 142, 143, 144, 145, 146, 147, 150, 153, 154, 155, 156, 158, 159]"
Olaf,L100,long,79,54,25,1,0.5587,179,"[17, 25, 28, 30, 48, 54, 59, 60, 69, 72, 74, 76, 77, 78, 82, 83, 88, 89, 90, 91, 96, 100, 101, 104, 105, 106, 107, 108, 109, 110, 113, 115, 116, 117, 118, 119, 120, 121, 122, 124, 125, 126, 128, 130, 132, 133, 134, 135, 136, 137, 138, 139, 142, 143, 144, 145, 147, 149, 150, 151, 153, 154, 155, 156, 157, 158, 159, 161, 162, 163, 164, 165, 166, 167, 168, 169, 171, 175, 176]"
Olaf,L100,long,59,39,20,7,0.6289,159,"[16, 33, 50, 56, 61, 73, 75, 79, 80, 81, 85, 87, 89, 90, 91, 92, 93, 94, 95, 96, 97, 98, 101, 102, 104, 105, 106, 107, 108, 109, 114, 116, 117, 118, 121, 123, 124, 125, 128, 134, 136, 137, 138, 139, 140, 143, 145, 146, 147, 148, 149, 150, 151, 152, 153, 154, 155, 156, 157]"
Olaf,L100,long,70,31,39,5,0.5882,170,"[16, 32, 47, 52, 54, 57, 58, 61, 77, 79, 82, 83, 84, 85, 86, 89, 92, 93, 94, 96, 97, 100, 101, 102, 103, 104, 105, 106, 107, 108, 109, 110, 111, 113, 114, 116, 119, 120, 122, 125, 126, 127, 129, 130, 132, 133, 134, 135, 136, 137, 139, 140, 142, 147, 148, 149, 150, 151, 153, 154, 155, 156, 157, 158, 159, 161, 162, 163, 166, 168]"
Olaf,L100,long,85,45,40,5,0.5405,185,"[17, 24, 28, 29, 30, 34, 51, 58, 63, 72, 76, 80, 81, 82, 83, 85, 86, 87, 89, 90, 91, 97, 99, 101, 102, 103, 104, 105, 107, 109, 110, 111, 112, 113, 114, 115, 117, 118, 122, 123, 125, 126, 127, 128, 129, 131, 132, 134, 138, 139, 141, 143, 144, 145, 146, 147, 148, 149, 150, 151, 152, 153, 154, 155, 157, 158, 160, 161, 162, 163, 164, 165, 166, 167, 169, 170, 172, 173, 174, 176, 177, 179, 180, 181, 183]"
Olaf,L100,long,44,21,23,8,0.6944,144,"[16, 32, 48, 52, 54, 56, 58, 59, 60, 74, 78, 83, 86, 87, 90, 91, 94, 95, 97, 98, 99, 101, 102, 104, 107, 108, 110, 111, 112, 113, 114, 117, 118, 121, 126, 129, 130, 131, 132, 133, 134, 135, 136, 140]"
Olaf,L100,long,68,24,44,2,0.5952,168,"[17, 24, 28, 29, 46, 52, 56, 57, 58, 59, 61, 71, 74, 76, 77, 78, 83, 84, 85, 87, 89, 90, 91, 99, 101, 102, 105, 106, 107, 108, 109, 110, 112, 113, 114, 115, 116, 119, 121, 122, 123, 124, 125, 127, 128, 129, 130, 131, 133, 134, 136, 137, 138, 139, 140, 142, 144, 147, 150, 153, 154, 155, 158, 161, 163, 164, 165, 166]"
Olaf,L100,long,70,34,36,11,0.5882,170,"[16, 38, 52, 56, 59, 70, 78, 80, 81, 82, 83, 84, 87, 90, 91, 92, 93, 94, 95, 96, 97, 98, 100, 101, 102, 103, 104, 106, 108, 109, 110, 111, 115, 116, 117, 118, 119, 121, 123, 124, 125, 126, 127, 128, 129, 130, 132, 133, 136, 139, 140, 141, 142, 144, 145, 148, 150, 151, 152, 153, 154, 155, 156, 157, 158, 160, 164, 165, 167, 168]"
Olaf,L100,long,60,26,34,9,0.625,160,"[18, 34, 50, 57, 59, 70, 74, 76, 77, 78, 79, 80, 81, 82, 84, 85, 86, 88, 89, 95, 101, 102, 104, 107, 108, 110, 112, 113, 114, 115, 116, 117, 118, 119, 120, 121, 123, 124, 125, 126, 129, 130, 131, 132, 133, 134, 136, 137, 138, 139, 141, 143, 144, 145, 148, 149, 151, 155, 156, 158]"
Olaf,L100,long,57,31,26,6,0.6369,157,"[17, 33, 47, 55, 56, 58, 60, 72, 77, 78, 79, 80, 82, 83, 84, 85, 87, 90, 91, 94, 96, 99, 102, 105, 107, 108, 109, 111, 112, 113, 114, 115, 116, 118, 119, 120, 121, 122, 123, 124, 126, 128, 129, 130, 131, 135, 136, 138, 140, 143, 147, 148, 150, 151, 152, 153, 154]"
Olaf,L100,long,71,40,31,6,0.5848,171,"[21, 27, 28, 29, 45, 54, 55, 56, 58, 59, 70, 74, 75, 77, 78, 79, 80, 81, 82, 83, 84, 86, 87, 88, 89, 97, 102, 103, 104, 106, 108, 109, 110, 111, 112, 113, 115, 116, 117, 120, 121, 122, 123, 125, 126, 127, 128, 129, 130, 131, 132, 133, 135, 137, 138, 139, 140, 141, 144, 146, 147, 148, 154, 156, 157, 158, 159, 160, 161, 162, 165]"
Olaf,L100,long,63,44,19,6,0.6135,163,"[18, 25, 28, 33, 53, 57, 58, 59, 60, 70, 75, 77, 78, 79, 80, 82, 85, 86, 87, 88, 90, 97, 102, 105, 109, 110, 111, 112, 113, 114, 115, 116, 119, 124, 127, 128, 129, 130, 132, 133, 134, 136, 138, 139, 140, 141, 142, 143, 144, 145, 146, 147, 148, 149, 150, 151, 152, 154, 155, 156, 158, 159, 160]"
Olaf,L100,long,61,32,29,0,0.6211,161,"[17, 24, 28, 29, 46, 52, 54, 55, 56, 57, 58, 59, 71, 75, 77, 78, 79, 80, 81, 83, 84, 86, 88, 89, 97, 101, 103, 104, 107, 113, 114, 116, 117, 118, 119, 120, 121, 123, 124, 125, 128, 129, 131, 132, 133, 134, 135, 140, 142, 143, 145, 146, 147, 148, 149, 150, 151, 153, 155, 157, 158]"
Olaf,L100,long,67,28,39,2,0.5988,167,"[17, 24, 29, 46, 54, 55, 57, 58, 59, 69, 72, 74, 76, 77, 78, 79, 80, 82, 83, 84, 85, 87, 88, 89, 99, 102, 103, 106, 108, 109, 114, 115, 116, 117, 118, 119, 122, 123, 125, 128, 130, 131, 132, 133, 134, 135, 137, 138, 139, 141, 142, 143, 147, 148, 149, 150, 152, 153, 155, 157, 158, 160, 161, 162, 163, 164, 165]"
Olaf,L100,long,57,26,31,1,0.6369,157,"[17, 24, 28, 29, 46, 53, 55, 58, 59, 61, 71, 78, 79, 80, 84, 85, 89, 91, 98, 99, 100, 101, 103, 104, 107, 109, 111, 113, 114, 117, 118, 119, 121, 122, 123, 124, 125, 126, 127, 128, 130, 132, 136, 137, 138, 140, 142, 145, 146, 148, 149, 150, 151, 152, 153, 154, 155]"
Olaf,L100,long,78,43,35,1,0.5618,178,"[17, 27, 28, 29, 45, 53, 56, 57, 59, 60, 61, 72, 76, 78, 79, 80, 81, 82, 83, 84, 85, 86, 87, 88, 90, 92, 99, 103, 105, 106, 108, 110, 112, 114, 116, 117, 119, 121, 122, 123, 124, 127, 128, 130, 131, 132, 133, 136, 137, 138, 139, 141, 142, 143, 144, 147, 148, 149, 150, 152, 153, 154, 155, 160, 161, 162, 163, 164, 166, 167, 168, 169, 170, 172, 173, 174, 175, 176]"
Olaf,L100,long,61,32,29,6,0.6211,161,"[16, 33, 48, 56, 58, 59, 61, 74, 76, 77, 81, 83, 85, 86, 87, 88, 89, 90, 93, 95, 97, 98, 104, 105, 106, 108, 110, 111, 112, 115, 118, 121, 122, 123, 124, 125, 126, 127, 130, 131, 133, 134, 135, 136, 137, 138, 139, 140, 141, 142, 144, 145, 146, 147, 149, 150, 151, 152, 153, 156, 159]"
Olaf,L100,long,62,38,24,6,0.6173,162,"[16, 32, 47, 52, 54, 55, 57, 58, 61, 74, 78, 79, 80, 81, 82, 83, 85, 87, 90, 95, 96, 98, 100, 101, 102, 105, 107, 108, 109, 111, 112, 113, 116, 117, 120, 121, 122, 123, 124, 125, 126, 128, 129, 131, 132, 133, 134, 138, 140, 141, 142, 143, 144, 145, 146, 148, 151, 154, 155, 156, 157, 159]"
Olaf,L100,long,57,36,21,4,0.6369,157,"[16, 32, 47, 52, 56, 57, 58, 60, 61, 73, 79, 80, 81, 82, 84, 89, 92, 96, 98, 100, 101, 102, 103, 104, 105, 106, 108, 110, 112, 113, 115, 116, 117, 120, 121, 123, 124, 125, 129, 130, 132, 134, 136, 137, 138, 139, 140, 141, 143, 144, 145, 148, 149, 150, 151, 154, 155]"
Olaf,L100,long,73,40,33,5,0.578,173,"[17, 25, 31, 47, 53, 57, 58, 61, 70, 73, 74, 75, 76, 79, 81, 82, 85, 86, 87, 88, 89, 97, 98, 100, 101, 102, 103, 105, 106, 107, 108, 109, 111, 112, 113, 114, 115, 116, 117, 118, 120, 123, 124, 125, 126, 127, 130, 131, 134, 135, 142, 144, 145, 146, 147, 148, 149, 150, 151, 152, 153, 154, 157, 158, 159, 161, 162, 163, 167, 168, 169, 170, 171]"
Olaf,L100,long,93,54,39,1,0.5181,193,"[17, 24, 28, 29, 45, 53, 55, 56, 57, 58, 59, 70, 73, 75, 77, 78, 79, 81, 82, 83, 85, 87, 89, 90, 91, 92, 93, 104, 105, 106, 107, 108, 110, 111, 112, 113, 116, 117, 118, 119, 120, 121, 122, 124, 125, 127, 128, 131, 132, 133, 134, 135, 136, 137, 138, 139, 141, 142, 143, 144, 145, 146, 148, 149, 151, 152, 153, 154, 155, 156, 157, 158, 159, 160, 162, 163, 164, 166, 167, 168, 169, 170, 171, 172, 174, 175, 176, 177, 178, 181, 183, 186, 187]"
Olaf,L100,long,63,41,22,1,0.6135,163,"[18, 26, 28, 29, 30, 46, 53, 56, 57, 58, 60, 72, 74, 75, 76, 79, 80, 82, 84, 86, 87, 88, 89, 91, 101, 102, 103, 105, 107, 110, 113, 116, 117, 118, 119, 120, 121, 124, 125, 127, 128, 129, 131, 132, 133, 134, 135, 136, 137, 138, 139, 140, 141, 143, 144, 145, 148, 149, 151, 155, 156, 157, 159]"
Olaf,L100,long,63,29,34,3,0.6135,163,"[16, 33, 48, 53, 55, 56, 58, 59, 60, 61, 74, 80, 81, 83, 84, 85, 86, 87, 88, 89, 90, 91, 95, 97, 100, 101, 103, 104, 105, 106, 107, 110, 111, 112, 113, 114, 115, 117, 119, 120, 121, 124, 126, 127, 131, 133, 134, 135, 138, 141, 142, 143, 146, 147, 148, 149, 151, 152, 153, 154, 158, 159, 160]"
Olaf,L100,long,89,53,36,4,0.5291,189,"[18, 25, 28, 30, 46, 53, 55, 56, 58, 59, 61, 71, 75, 76, 77, 78, 79, 80, 81, 83, 85, 86, 88, 92, 102, 103, 104, 105, 106, 107, 110, 111, 112, 113, 114, 115, 116, 118, 119, 120, 121, 122, 123, 124, 126, 127, 128, 129, 130, 133, 134, 135, 136, 137, 138, 139, 142, 143, 144, 145, 146, 147, 149, 151, 152, 153, 154, 155, 157, 158, 159, 160, 163, 164, 166, 167, 168, 169, 170, 171, 172, 173, 175, 176, 177, 181, 182, 184, 186]"
Olaf,L100,long,82,56,26,2,0.5495,182,"[17, 24, 28, 29, 45, 53, 56, 57, 60, 70, 73, 74, 75, 78, 79, 80, 84, 85, 87, 89, 97, 98, 99, 100, 101, 102, 103, 104, 106, 107, 111, 113, 114, 116, 117, 118, 119, 121, 122, 123, 124, 125, 129, 130, 132, 134, 135, 137, 139, 140, 142, 144, 145, 146, 147, 148, 149, 150, 151, 153, 156, 157, 158, 159, 160, 161, 162, 163, 164, 165, 166, 167, 169, 170, 171, 172, 173, 174, 175, 177, 179, 180]"
Olaf,L100,long,77,41,36,4,0.565,177,"[17, 33, 47, 53, 55, 57, 58, 59, 73, 78, 79, 80, 81, 82, 84, 85, 86, 88, 89, 91, 95, 96, 98, 99, 100, 101, 106, 108, 109, 111, 114, 115, 117, 118, 119, 120, 121, 122, 124, 125, 126, 127, 128, 129, 131, 132, 133, 134, 135, 137, 138, 140, 142, 143, 144, 145, 146, 147, 149, 150, 151, 152, 153, 156, 157, 158, 159, 160, 161, 162, 163, 164, 168, 172, 173, 174, 175]"
Olaf,L100,long,42,23,19,8,0.7042,142,"[20, 36, 50, 55, 57, 59, 60, 72, 80, 81, 83, 85, 90, 91, 92, 93, 94, 98, 100, 103, 105, 106, 107, 110, 111, 112, 113, 115, 116, 117, 118, 122, 123, 124, 125, 127, 128, 129, 130, 131, 135, 137]"
Olaf,L100,long,69,41,28,3,0.5917,169,"[16, 32, 47, 54, 55, 56, 57, 58, 60, 73, 78, 84, 85, 86, 87, 88, 89, 90, 93, 95, 96, 99, 100, 101, 102, 103, 104, 106, 110, 111, 112, 116, 118, 120, 121, 122, 123, 124, 127, 130, 131, 133, 134, 135, 136, 137, 138, 139, 141, 142, 143, 144, 145, 146, 147, 148, 149, 150, 151, 152, 153, 154, 156, 158, 160, 162, 163, 164, 166]"
Olaf,L100,long,66,31,35,4,0.6024,166,"[16, 33, 47, 52, 54, 55, 56, 57, 58, 59, 76, 78, 79, 80, 81, 83, 84, 85, 86, 87, 88, 89, 97, 98, 99, 100, 101, 103, 104, 107, 108, 109, 110, 111, 112, 115, 116, 117, 118, 119, 120, 125, 126, 127, 130, 131, 133, 134, 136, 137, 138, 142, 143, 144, 145, 147, 148, 149, 150, 151, 152, 155, 156, 158, 162, 163]"
Olaf,L100,long,61,42,19,3,0.6211,161,"[17, 24, 28, 32, 48, 55, 57, 58, 59, 69, 72, 75, 77, 78, 79, 80, 81, 83, 87, 88, 89, 97, 98, 99, 101, 103, 105, 108, 109, 110, 111, 115, 116, 117, 119, 120, 122, 123, 125, 126, 127, 129, 131, 132, 133, 134, 136, 139, 140, 141, 143, 146, 148, 149, 150, 152, 153, 154, 155, 157, 159]"
Olaf,L100,long,56,35,21,11,0.641,156,"[16, 35, 50, 54, 56, 60, 74, 76, 77, 79, 81, 83, 84, 85, 86, 87, 88, 89, 93, 95, 97, 98, 99, 100, 101, 102, 103, 105, 109, 110, 111, 112, 113, 115, 117, 122, 124, 125, 126, 127, 131, 132, 133, 134, 135, 136, 138, 139, 140, 144, 146, 147, 150, 151, 153, 154]"
Olaf,L100,long,69,36,33,3,0.5917,169,"[16, 32, 47, 52, 57, 59, 72, 75, 76, 77, 78, 80, 81, 82, 83, 85, 86, 90, 94, 95, 97, 99, 100, 103, 105, 106, 107, 108, 110, 112, 113, 114, 115, 116, 120, 121, 123, 124, 126, 127, 128, 129, 131, 133, 135, 136, 137, 138, 140, 142, 143, 145, 146, 150, 151, 152, 153, 154, 155, 156, 158, 160, 161, 162, 163, 164, 165, 166, 167]"
Olaf,L100,long,53,30,23,6,0.6536,153,"[16, 34, 49, 55, 56, 57, 58, 61, 74, 77, 83, 87, 88, 89, 91, 94, 95, 96, 98, 104, 105, 106, 107, 108, 109, 110, 111, 113, 114, 115, 119, 120, 121, 122, 123, 125, 126, 127, 128, 129, 131, 132, 134, 136, 138, 139, 140, 141, 142, 143, 145, 147, 149]"
Olaf,L100,long,74,26,48,10,0.5747,174,"[16, 34, 51, 56, 57, 58, 63, 76, 79, 80, 81, 82, 86, 87, 89, 90, 92, 93, 94, 95, 96, 97, 99, 102, 104, 105, 106, 107, 110, 111, 112, 113, 114, 115, 116, 118, 122, 123, 124, 125, 126, 127, 129, 130, 131, 132, 134, 135, 136, 137, 138, 140, 142, 143, 145, 146, 147, 148, 149, 150, 153, 156, 157, 158, 159, 160, 164, 165, 166, 168, 169, 170, 171, 172]"
Olaf,L100,long,49,32,17,2,0.6711,149,"[16, 32, 48, 52, 55, 56, 58, 59, 60, 74, 79, 80, 81, 82, 83, 84, 89, 90, 91, 93, 96, 97, 98, 99, 101, 102, 103, 104, 108, 112, 113, 114, 115, 116, 117, 118, 120, 121, 122, 123, 130, 131, 134, 137, 138, 142, 143, 144, 146]"
Olaf,L100,long,62,29,33,11,0.6173,162,"[18, 34, 49, 54, 56, 58, 62, 76, 79, 81, 82, 84, 85, 86, 89, 91, 92, 94, 95, 96, 98, 99, 100, 102, 103, 104, 105, 106, 107, 109, 110, 113, 114, 115, 118, 119, 120, 124, 125, 127, 128, 129, 130, 131, 133, 134, 136, 137, 138, 139, 143, 146, 147, 148, 149, 150, 151, 154, 156, 158, 159, 160]"
Olaf,L100,long,63,40,23,6,0.6135,163,"[16, 32, 47, 52, 54, 56, 57, 59, 61, 62, 74, 79, 82, 84, 86, 87, 88, 89, 90, 91, 92, 94, 99, 102, 104, 106, 107, 108, 109, 112, 113, 115, 117, 118, 119, 120, 123, 124, 125, 126, 127, 128, 129, 133, 134, 136, 137, 139, 140, 141, 142, 143, 145, 146, 147, 148, 149, 150, 153, 156, 157, 159, 160]"
Olaf,L100,long,69,40,29,7,0.5917,169,"[18, 34, 50, 54, 55, 58, 60, 72, 77, 78, 80, 82, 83, 85, 86, 87, 88, 91, 94, 95, 97, 98, 99, 102, 103, 104, 105, 106, 108, 109, 110, 111, 112, 116, 117, 118, 119, 120, 122, 125, 126, 128, 129, 130, 132, 133, 135, 136, 137, 140, 142, 143, 144, 145, 146, 147, 148, 149, 151, 153, 154, 155, 158, 159, 160, 161, 162, 165, 166]"
Olaf,L100,long,75,41,34,3,0.5714,175,"[17, 33, 48, 53, 55, 56, 57, 58, 59, 61, 62, 75, 80, 81, 83, 84, 85, 86, 87, 88, 90, 91, 92, 96, 98, 99, 102, 106, 107, 108, 109, 110, 111, 113, 115, 116, 119, 123, 125, 127, 129, 130, 133, 135, 136, 138, 141, 143, 144, 145, 146, 148, 149, 150, 151, 152, 153, 154, 155, 156, 157, 158, 159, 160, 162, 164, 165, 166, 167, 168, 169, 170, 171, 172, 173]"
Olaf,L100,long,61,24,37,6,0.6211,161,"[18, 25, 32, 48, 54, 57, 58, 59, 68, 72, 73, 74, 75, 79, 80, 81, 82, 83, 84, 85, 87, 88, 89, 96, 100, 104, 111, 112, 114, 115, 118, 119, 121, 123, 124, 125, 126, 127, 129, 130, 131, 132, 133, 134, 135, 136, 137, 138, 139, 141, 142, 143, 144, 145, 146, 147, 148, 149, 150, 154, 156]"
Olaf,L100,long,57,27,30,5,0.6369,157,"[17, 24, 30, 48, 54, 64, 71, 76, 77, 78, 79, 85, 86, 87, 88, 89, 91, 97, 98, 101, 102, 103, 104, 105, 106, 108, 109, 111, 113, 114, 115, 116, 117, 118, 119, 120, 122, 124, 125, 126, 127, 128, 130, 132, 133, 135, 137, 139, 140, 141, 143, 145, 148, 151, 152, 153, 154]"
Olaf,L100,long,82,41,41,2,0.5495,182,"[17, 24, 28, 30, 46, 53, 56, 58, 59, 72, 75, 76, 78, 80, 82, 83, 84, 85, 86, 88, 90, 98, 99, 100, 103, 105, 106, 108, 109, 110, 112, 113, 114, 116, 117, 118, 119, 120, 121, 123, 124, 126, 128, 129, 130, 132, 134, 136, 137, 138, 140, 142, 143, 145, 146, 147, 148, 149, 150, 151, 152, 154, 156, 157, 158, 160, 161, 163, 164, 165, 167, 168, 169, 170, 172, 173, 174, 175, 176, 177, 179, 180]"
Olaf,L100,long,63,23,40,0,0.6135,163,"[17, 25, 29, 47, 52, 54, 55, 57, 58, 59, 70, 73, 75, 76, 77, 78, 79, 80, 81, 89, 96, 97, 101, 102, 103, 104, 106, 107, 108, 112, 114, 117, 118, 120, 121, 122, 123, 124, 125, 126, 127, 129, 131, 132, 133, 136, 137, 138, 139, 141, 143, 146, 147, 148, 149, 150, 151, 152, 153, 155, 156, 157, 158]"
Olaf,L100,long,79,43,36,1,0.5587,179,"[17, 24, 31, 47, 54, 56, 57, 59, 60, 63, 72, 75, 77, 79, 80, 81, 83, 85, 86, 89, 92, 93, 94, 100, 101, 102, 103, 104, 105, 106, 107, 108, 109, 110, 111, 112, 115, 116, 117, 118, 119, 120, 122, 123, 124, 125, 126, 127, 128, 130, 132, 133, 134, 135, 136, 138, 139, 141, 143, 145, 146, 147, 148, 149, 152, 153, 154, 155, 156, 159, 162, 164, 168, 171, 172, 173, 174, 176, 177]"
Olaf,L100,long,88,55,33,6,0.5319,188,"[21, 26, 28, 29, 47, 54, 56, 58, 61, 70, 73, 75, 76, 77, 78, 79, 80, 81, 82, 83, 84, 85, 87, 88, 90, 98, 102, 103, 104, 105, 108, 109, 110, 112, 113, 115, 116, 117, 118, 119, 120, 124, 127, 130, 131, 132, 135, 136, 137, 138, 140, 141, 142, 144, 145, 148, 149, 150, 151, 153, 154, 155, 156, 157, 158, 159, 160, 162, 163, 165, 166, 167, 168, 169, 170, 171, 172, 173, 174, 175, 176, 177, 179, 180, 181, 182, 184, 186]"
Olaf,L100,long,90,38,52,5,0.5263,190,"[16, 35, 51, 55, 56, 57, 59, 60, 72, 78, 79, 82, 83, 84, 85, 86, 87, 88, 89, 90, 95, 96, 98, 100, 101, 102, 103, 104, 105, 106, 107, 108, 111, 112, 113, 114, 115, 118, 119, 120, 127, 128, 129, 130, 131, 132, 133, 134, 136, 137, 138, 140, 141, 142, 143, 146, 148, 149, 150, 154, 155, 156, 158, 160, 161, 162, 163, 165, 166, 167, 168, 169, 170, 171, 172, 173, 174, 175, 176, 178, 179, 180, 181, 182, 183, 184, 185, 186, 187, 188]"
Olaf,L100,long,59,23,36,2,0.6289,159,"[17, 25, 28, 29, 30, 31, 48, 54, 57, 58, 59, 62, 72, 75, 77, 79, 80, 81, 82, 83, 84, 86, 88, 89, 90, 91, 103, 105, 106, 107, 108, 109, 110, 111, 113, 114, 115, 116, 119, 121, 123, 125, 126, 129, 130, 132, 133, 135, 136, 138, 140, 142, 147, 148, 149, 151, 153, 154, 157]"
Olaf,L100,long,80,56,24,6,0.5556,180,"[19, 26, 28, 29, 45, 52, 54, 55, 56, 58, 59, 66, 75, 78, 79, 82, 83, 85, 87, 88, 89, 90, 91, 99, 100, 101, 102, 103, 104, 105, 107, 108, 109, 110, 111, 112, 113, 114, 116, 117, 118, 119, 120, 123, 125, 126, 127, 130, 132, 135, 136, 138, 139, 141, 142, 143, 144, 145, 147, 148, 149, 150, 152, 153, 154, 155, 159, 160, 161, 162, 163, 164, 165, 166, 168, 170, 172, 173, 175, 176]"
Olaf,L100,long,102,39,63,4,0.49,200,"[16, 32, 47, 52, 54, 55, 56, 57, 58, 59, 73, 76, 79, 80, 82, 84, 85, 86, 88, 89, 94, 95, 96, 97, 98, 99, 101, 102, 103, 104, 106, 108, 109, 110, 111, 112, 113, 114, 115, 116, 117, 118, 120, 123, 125, 127, 128, 129, 130, 131, 132, 133, 134, 136, 137, 138, 139, 140, 141, 142, 143, 144, 145, 147, 149, 151, 152, 153, 155, 156, 157, 158, 159, 161, 162, 164, 165, 166, 167, 168, 169, 171, 173, 174, 175, 176, 177, 178, 179, 180, 181, 182, 184, 185, 186, 187, 188, 193, 194, 197, 198, 199]"
Olaf,L100,long,74,34,40,6,0.5747,174,"[18, 34, 50, 54, 55, 56, 57, 59, 72, 77, 78, 79, 82, 83, 84, 88, 89, 92, 94, 96, 98, 99, 100, 101, 102, 103, 105, 106, 107, 108, 109, 110, 111, 112, 114, 116, 117, 118, 120, 124, 125, 127, 128, 129, 130, 131, 132, 133, 134, 135, 136, 138, 140, 142, 143, 144, 145, 146, 147, 148, 149, 150, 152, 155, 156, 158, 159, 160, 161, 163, 166, 169, 170, 172]"
Olaf,L100,long,69,38,31,0,0.5917,169,"[17, 26, 29, 46, 52, 55, 57, 59, 68, 74, 76, 77, 78, 80, 81, 82, 84, 85, 86, 87, 88, 89, 90, 100, 102, 103, 104, 105, 106, 107, 109, 110, 111, 116, 119, 120, 121, 122, 123, 124, 125, 126, 127, 128, 132, 133, 134, 136, 138, 139, 140, 141, 142, 143, 147, 148, 149, 150, 151, 152, 156, 157, 158, 159, 162, 163, 164, 165, 167]"
Olaf,L100,long,80,35,45,1,0.5556,180,"[17, 25, 28, 29, 45, 53, 55, 57, 58, 59, 60, 61, 62, 64, 65, 67, 77, 80, 81, 82, 83, 84, 89, 90, 92, 93, 94, 97, 104, 107, 108, 109, 110, 112, 113, 114, 115, 116, 118, 119, 120, 121, 122, 123, 125, 128, 129, 130, 131, 133, 134, 136, 137, 138, 139, 142, 145, 147, 149, 150, 152, 153, 155, 156, 157, 158, 160, 161, 162, 164, 165, 167, 169, 170, 171, 173, 174, 176, 177, 178]"
Olaf,L100,long,45,28,17,9,0.6897,145,"[22, 38, 54, 57, 58, 59, 60, 61, 78, 79, 80, 82, 84, 85, 86, 87, 88, 89, 91, 93, 96, 97, 98, 100, 101, 105, 106, 107, 108, 113, 115, 121, 122, 123, 124, 125, 128, 130, 133, 135, 136, 137, 139, 140, 141]"
Olaf,L100,long,101,53,48,2,0.495,200,"[18, 26, 29, 30, 46, 53, 58, 59, 61, 70, 73, 75, 76, 77, 78, 79, 81, 82, 88, 90, 92, 97, 99, 100, 101, 102, 103, 104, 105, 106, 109, 110, 111, 112, 113, 114, 115, 116, 118, 119, 120, 121, 123, 124, 125, 127, 129, 131, 132, 133, 134, 135, 136, 137, 138, 139, 142, 143, 144, 145, 146, 147, 150, 151, 152, 153, 154, 155, 158, 159, 160, 161, 162, 163, 164, 165, 167, 168, 169, 173, 175, 177, 179, 180, 181, 182, 183, 184, 185, 187, 188, 189, 190, 191, 192, 193, 195, 196, 197, 198, 199]"
Olaf,L100,long,102,44,58,0,0.49,200,"[17, 24, 28, 29, 30, 31, 47, 54, 58, 60, 61, 62, 63, 64, 74, 79, 80, 81, 82, 83, 84, 86, 87, 90, 91, 93, 94, 95, 104, 105, 106, 108, 109, 110, 112, 113, 114, 115, 116, 117, 122, 123, 124, 125, 126, 127, 128, 129, 130, 132, 133, 134, 135, 136, 137, 138, 140, 142, 143, 146, 147, 148, 149, 150, 152, 153, 155, 156, 157, 158, 159, 160, 161, 162, 163, 164, 165, 166, 167, 169, 170, 171, 173, 174, 175, 176, 177, 179, 180, 182, 183, 184, 185, 187, 188, 189, 191, 192, 193, 194, 195, 196]"
Olaf,L100,long,81,43,38,2,0.5525,181,"[18, 25, 28, 29, 45, 53, 56, 58, 59, 70, 73, 74, 77, 78, 79, 81, 82, 83, 84, 85, 86, 88, 93, 99, 102, 103, 104, 105, 106, 107, 110, 111, 112, 113, 114, 115, 116, 118, 119, 120, 121, 122, 123, 125, 126, 127, 130, 131, 132, 134, 135, 136, 139, 140, 141, 142, 144, 146, 147, 149, 151, 152, 153, 155, 156, 157, 158, 161, 163, 164, 167, 168, 169, 170, 171, 172, 173, 174, 175, 177, 179]"
Olaf,L100,long,52,31,21,3,0.6579,152,"[18, 25, 30, 48, 53, 55, 56, 57, 58, 59, 61, 71, 78, 80, 81, 83, 85, 86, 87, 88, 92, 99, 101, 102, 103, 105, 106, 107, 108, 110, 111, 112, 116, 117, 119, 121, 124, 128, 129, 130, 132, 133, 134, 136, 137, 139, 141, 142, 145, 146, 147, 148]"
Olaf,L100,long,71,35,36,8,0.5848,171,"[17, 24, 28, 29, 46, 52, 54, 55, 56, 57, 58, 61, 67, 76, 79, 80, 82, 83, 85, 86, 87, 88, 89, 91, 95, 103, 106, 107, 108, 109, 110, 112, 113, 114, 115, 116, 117, 119, 120, 121, 124, 125, 126, 127, 128, 130, 131, 133, 134, 135, 136, 137, 141, 143, 145, 146, 149, 151, 152, 153, 154, 155, 157, 160, 161, 162, 163, 164, 165, 167, 169]"
Olaf,L100,long,91,51,40,10,0.5236,191,"[17, 33, 47, 52, 56, 57, 61, 72, 76, 79, 80, 83, 84, 85, 86, 89, 94, 96, 98, 99, 100, 101, 102, 103, 104, 105, 106, 109, 110, 111, 112, 113, 114, 115, 116, 117, 120, 121, 123, 124, 125, 126, 128, 129, 130, 131, 132, 135, 136, 138, 139, 140, 141, 142, 143, 144, 146, 147, 148, 149, 150, 151, 153, 154, 155, 157, 159, 160, 162, 163, 164, 165, 166, 167, 168, 169, 171, 173, 174, 175, 176, 177, 178, 180, 181, 182, 183, 184, 185, 188, 189]"
Olaf,L100,long,76,48,28,4,0.5682,176,"[17, 24, 29, 31, 48, 54, 56, 57, 58, 59, 61, 71, 76, 77, 78, 81, 84, 85, 86, 87, 88, 89, 90, 99, 100, 101, 103, 104, 105, 106, 108, 111, 112, 114, 116, 119, 120, 121, 123, 124, 125, 126, 127, 128, 129, 130, 132, 133, 134, 135, 136, 140, 141, 142, 143, 144, 146, 148, 149, 152, 153, 154, 155, 157, 161, 162, 163, 165, 166, 167, 168, 169, 170, 171, 172, 173]"
Olaf,L100,long,78,29,49,1,0.5618,178,"[17, 24, 29, 30, 46, 55, 56, 57, 58, 59, 60, 61, 63, 75, 77, 79, 81, 83, 85, 86, 87, 88, 89, 91, 92, 93, 103, 104, 105, 106, 107, 108, 109, 110, 111, 113, 115, 116, 117, 119, 120, 122, 123, 125, 127, 128, 129, 130, 131, 132, 133, 134, 135, 138, 141, 142, 143, 148, 149, 151, 152, 154, 155, 156, 158, 159, 160, 161, 162, 163, 165, 168, 169, 170, 171, 173, 174, 175]"
Olaf,L100,long,66,41,25,8,0.6024,166,"[17, 35, 51, 55, 56, 57, 61, 72, 77, 80, 82, 85, 89, 90, 91, 92, 93, 95, 96, 97, 99, 100, 101, 102, 104, 105, 107, 108, 109, 110, 111, 112, 113, 114, 115, 117, 118, 119, 122, 124, 125, 126, 127, 128, 130, 131, 133, 134, 136, 139, 141, 142, 143, 144, 147, 151, 152, 154, 155, 156, 157, 158, 159, 160, 163, 164]"
Olaf,L100,long,52,30,22,3,0.6579,152,"[18, 34, 50, 55, 57, 59, 60, 61, 62, 65, 79, 83, 85, 86, 87, 91, 92, 94, 95, 98, 100, 104, 105, 108, 109, 110, 111, 112, 113, 114, 119, 122, 124, 125, 127, 128, 129, 131, 132, 133, 134, 135, 136, 138, 139, 140, 141, 143, 145, 147, 149, 150]"
Olaf,L100,long,64,23,41,3,0.6098,164,"[17, 24, 28, 30, 46, 54, 56, 57, 58, 60, 71, 74, 75, 77, 78, 79, 82, 83, 84, 85, 87, 88, 89, 96, 100, 101, 108, 110, 111, 112, 113, 115, 117, 118, 120, 121, 122, 123, 124, 125, 128, 130, 131, 133, 136, 137, 140, 141, 142, 143, 145, 146, 147, 148, 149, 150, 151, 153, 154, 155, 156, 158, 159, 162]"
Olaf,L100,long,54,33,21,10,0.6494,154,"[18, 36, 50, 57, 58, 59, 71, 75, 76, 77, 78, 79, 80, 81, 82, 85, 86, 87, 88, 89, 91, 96, 98, 100, 103, 105, 106, 107, 109, 110, 111, 112, 113, 114, 115, 116, 120, 121, 122, 123, 124, 125, 128, 129, 131, 134, 136, 137, 138, 140, 142, 145, 149, 150]"
Olaf,L100,long,71,42,29,1,0.5848,171,"[17, 27, 28, 30, 48, 54, 56, 57, 58, 59, 60, 71, 74, 75, 76, 77, 78, 81, 82, 83, 85, 86, 87, 89, 90, 92, 94, 103, 105, 106, 107, 108, 109, 110, 111, 112, 115, 118, 119, 120, 123, 125, 126, 127, 128, 129, 130, 131, 132, 133, 134, 136, 137, 138, 140, 141, 142, 144, 148, 150, 152, 154, 155, 158, 159, 161, 162, 163, 166, 167, 169]"
Olaf,L100,long,78,36,42,4,0.5618,178,"[17, 24, 29, 45, 53, 55, 57, 58, 59, 60, 61, 67, 78, 80, 81, 82, 83, 85, 86, 87, 88, 89, 90, 91, 93, 101, 102, 104, 105, 107, 108, 110, 112, 113, 114, 115, 119, 120, 123, 125, 126, 127, 128, 130, 131, 132, 134, 136, 137, 138, 139, 140, 141, 143, 146, 147, 150, 151, 152, 154, 155, 156, 157, 158, 159, 160, 161, 162, 164, 165, 166, 167, 168, 170, 171, 173, 174, 176]"
Olaf,L100,long,45,20,25,8,0.6897,145,"[18, 34, 49, 54, 55, 56, 57, 59, 61, 74, 79, 80, 81, 82, 85, 86, 87, 88, 91, 93, 96, 97, 98, 99, 102, 103, 105, 106, 107, 108, 109, 111, 115, 118, 121, 123, 124, 129, 133, 134, 135, 137, 139, 141, 143]"
Olaf,L100,long,76,37,39,3,0.5682,176,"[16, 32, 47, 54, 55, 57, 58, 60, 72, 77, 78, 79, 80, 81, 82, 83, 86, 87, 89, 91, 95, 96, 97, 102, 103, 105, 108, 111, 112, 114, 115, 117, 118, 119, 120, 121, 122, 123, 125, 126, 128, 129, 130, 131, 132, 133, 134, 136, 137, 139, 142, 143, 144, 149, 150, 151, 152, 153, 154, 157, 158, 160, 161, 162, 163, 164, 165, 166, 167, 168, 169, 170, 171, 172, 173, 174]"
Olaf,L100,long,64,26,38,5,0.6098,164,"[16, 34, 49, 54, 55, 56, 57, 58, 59, 61, 74, 79, 82, 83, 85, 86, 88, 89, 91, 96, 97, 98, 103, 104, 107, 108, 109, 111, 113, 114, 115, 118, 119, 120, 121, 122, 123, 124, 125, 126, 129, 130, 131, 132, 133, 134, 135, 137, 138, 139, 140, 141, 142, 144, 145, 146, 147, 150, 153, 154, 157, 159, 160, 161]"
Olaf,L100,long,86,42,44,2,0.5376,186,"[17, 25, 29, 30, 46, 55, 56, 58, 59, 60, 62, 72, 75, 77, 78, 80, 81, 83, 84, 85, 86, 87, 88, 89, 90, 91, 99, 103, 105, 106, 108, 109, 110, 111, 112, 113, 114, 116, 118, 119, 120, 121, 122, 124, 126, 127, 128, 129, 133, 134, 135, 136, 140, 142, 143, 144, 145, 146, 148, 149, 150, 152, 155, 156, 157, 159, 161, 162, 163, 164, 165, 166, 167, 168, 169, 171, 172, 173, 174, 175, 176, 178, 179, 180, 181, 182]"
Olaf,L100,long,72,32,40,9,0.5814,172,"[16, 34, 49, 54, 55, 56, 57, 58, 59, 73, 77, 79, 80, 81, 82, 86, 88, 90, 93, 95, 97, 98, 99, 100, 101, 102, 104, 105, 106, 107, 108, 109, 110, 113, 115, 116, 117, 119, 120, 121, 124, 125, 126, 131, 132, 133, 134, 135, 136, 137, 139, 140, 142, 143, 144, 146, 147, 148, 149, 150, 154, 155, 156, 157, 159, 160, 161, 162, 166, 168, 169, 170]"
Olaf,L100,long,61,35,26,9,0.6211,161,"[18, 34, 50, 55, 57, 61, 75, 76, 77, 78, 79, 81, 82, 83, 85, 86, 89, 92, 94, 97, 98, 100, 103, 104, 105, 107, 108, 109, 112, 113, 114, 115, 117, 118, 119, 120, 123, 125, 126, 128, 129, 130, 131, 133, 134, 136, 138, 139, 140, 142, 143, 146, 147, 148, 149, 150, 151, 152, 153, 155, 158]"
Olaf,L100,long,66,18,48,3,0.6024,166,"[17, 24, 29, 30, 47, 53, 55, 58, 62, 71, 75, 76, 78, 79, 80, 81, 84, 87, 88, 90, 91, 97, 99, 101, 102, 104, 106, 108, 111, 113, 116, 118, 119, 120, 121, 122, 123, 124, 125, 126, 127, 128, 129, 131, 132, 135, 136, 137, 138, 142, 143, 144, 145, 146, 148, 149, 150, 152, 156, 157, 159, 160, 161, 162, 163, 164]"
Olaf,L100,long,80,42,38,5,0.5556,180,"[17, 26, 32, 50, 59, 61, 72, 75, 77, 78, 79, 81, 82, 85, 86, 87, 88, 89, 90, 91, 96, 98, 99, 102, 103, 104, 105, 106, 108, 109, 110, 111, 112, 113, 117, 119, 120, 122, 123, 124, 125, 126, 128, 129, 130, 131, 132, 134, 136, 138, 140, 142, 143, 144, 145, 146, 147, 148, 149, 150, 151, 153, 154, 155, 156, 157, 159, 160, 161, 162, 165, 168, 170, 171, 172, 173, 175, 176, 177, 178]"
Olaf,L100,long,72,34,38,6,0.5814,172,"[16, 34, 50, 54, 56, 57, 58, 60, 72, 78, 80, 81, 82, 83, 89, 91, 93, 95, 96, 98, 99, 101, 104, 107, 108, 109, 110, 111, 112, 113, 115, 116, 117, 118, 119, 120, 121, 124, 125, 126, 127, 131, 132, 133, 134, 135, 136, 137, 138, 139, 140, 141, 143, 144, 145, 146, 148, 149, 150, 151, 153, 154, 156, 157, 158, 159, 161, 162, 163, 164, 167, 168]"
Olaf,L100,long,71,36,35,0,0.5848,171,"[17, 24, 29, 46, 54, 55, 57, 58, 59, 69, 74, 75, 78, 79, 82, 83, 85, 86, 88, 89, 96, 97, 99, 100, 101, 102, 103, 105, 106, 107, 109, 111, 112, 114, 116, 117, 118, 119, 120, 121, 122, 125, 126, 132, 133, 135, 136, 137, 138, 139, 140, 143, 144, 145, 146, 147, 148, 149, 150, 152, 153, 154, 155, 156, 158, 159, 160, 164, 167, 168, 169]"
Olaf,L100,long,70,29,41,3,0.5882,170,"[17, 24, 29, 32, 48, 55, 57, 58, 59, 60, 62, 63, 73, 76, 77, 79, 81, 83, 84, 85, 86, 87, 88, 89, 90, 91, 92, 95, 105, 106, 109, 110, 111, 112, 114, 115, 116, 117, 118, 119, 121, 123, 125, 127, 129, 131, 132, 133, 135, 137, 138, 139, 141, 143, 144, 146, 147, 148, 149, 150, 151, 155, 158, 159, 160, 162, 163, 165, 166, 168]"
Olaf,L100,long,78,47,31,5,0.5618,178,"[17, 25, 28, 30, 47, 53, 55, 59, 62, 72, 74, 75, 76, 78, 80, 82, 84, 85, 86, 88, 91, 97, 99, 100, 101, 103, 105, 106, 107, 108, 110, 111, 112, 113, 117, 118, 121, 122, 123, 124, 125, 126, 127, 128, 129, 130, 131, 132, 133, 134, 135, 138, 141, 142, 144, 147, 148, 149, 151, 152, 153, 154, 155, 157, 158, 159, 160, 161, 162, 163, 164, 165, 167, 168, 169, 170, 171, 173]"
Olaf,L100,long,62,35,27,6,0.6173,162,"[16, 34, 50, 55, 56, 57, 58, 60, 72, 78, 80, 83, 84, 85, 86, 88, 90, 93, 94, 97, 98, 99, 101, 102, 103, 104, 105, 107, 108, 109, 110, 111, 112, 114, 116, 117, 118, 119, 120, 123, 124, 126, 127, 128, 130, 131, 132, 134, 137, 138, 140, 141, 143, 144, 145, 148, 149, 152, 153, 155, 157, 159]"
Olaf,L100,long,95,56,39,2,0.5128,195,"[16, 32, 47, 52, 55, 56, 57, 58, 59, 60, 61, 62, 76, 80, 82, 83, 84, 85, 86, 87, 88, 89, 90, 92, 93, 98, 103, 104, 105, 106, 107, 108, 109, 110, 111, 112, 113, 114, 115, 116, 117, 118, 119, 120, 121, 124, 126, 128, 129, 130, 132, 133, 134, 135, 136, 138, 139, 140, 142, 143, 145, 147, 148, 149, 150, 151, 152, 154, 156, 158, 160, 161, 163, 164, 167, 169, 170, 171, 172, 174, 175, 176, 178, 179, 180, 181, 182, 183, 184, 185, 186, 187, 189, 192, 193]"
Olaf,L100,long,72,24,48,4,0.5814,172,"[17, 24, 28, 29, 30, 31, 48, 54, 57, 60, 64, 75, 77, 80, 81, 82, 84, 86, 87, 88, 90, 92, 98, 101, 102, 103, 104, 105, 106, 107, 108, 109, 115, 116, 118, 120, 121, 122, 123, 124, 125, 126, 128, 129, 130, 133, 134, 137, 139, 143, 144, 146, 147, 148, 149, 150, 152, 154, 155, 156, 157, 159, 160, 161, 162, 163, 164, 166, 167, 168, 169, 170]"
Olaf,L100,long,88,41,47,1,0.5319,188,"[19, 25, 31, 47, 53, 56, 57, 58, 59, 62, 71, 76, 78, 79, 81, 83, 85, 86, 87, 89, 90, 91, 98, 99, 100, 102, 104, 105, 109, 110, 111, 113, 114, 115, 116, 117, 119, 120, 121, 122, 123, 124, 126, 127, 128, 130, 132, 133, 134, 135, 136, 138, 139, 140, 142, 144, 145, 147, 148, 150, 151, 153, 154, 155, 156, 157, 159, 160, 162, 164, 165, 167, 168, 169, 170, 171, 172, 173, 175, 176, 178, 179, 180, 181, 182, 183, 185, 186]"
Olaf,L100,long,67,33,34,6,0.5988,167,"[17, 33, 47, 52, 54, 55, 56, 57, 59, 60, 62, 75, 81, 83, 84, 85, 86, 87, 89, 92, 96, 97, 98, 101, 102, 104, 105, 106, 107, 108, 109, 110, 113, 117, 118, 119, 120, 122, 123, 124, 126, 127, 129, 130, 132, 134, 135, 137, 138, 140, 143, 144, 145, 146, 147, 148, 149, 150, 151, 153, 154, 155, 158, 160, 162, 163, 165]"
Olaf,L100,long,52,18,34,3,0.6579,152,"[17, 28, 31, 47, 53, 58, 59, 68, 71, 75, 76, 77, 78, 79, 80, 81, 82, 83, 84, 88, 90, 97, 99, 100, 102, 103, 104, 105, 106, 107, 108, 109, 113, 115, 117, 119, 120, 121, 122, 123, 126, 127, 133, 136, 138, 139, 140, 145, 146, 147, 148, 149]"
Olaf,L100,long,79,21,58,0,0.5587,179,"[18, 27, 28, 29, 30, 47, 56, 57, 58, 59, 60, 71, 74, 76, 77, 79, 80, 82, 83, 84, 85, 87, 88, 89, 90, 100, 102, 105, 106, 107, 108, 109, 110, 111, 112, 113, 114, 115, 116, 117, 118, 119, 120, 124, 125, 126, 127, 130, 131, 133, 134, 138, 142, 143, 144, 146, 147, 148, 149, 151, 152, 154, 156, 157, 158, 159, 160, 162, 164, 166, 167, 168, 170, 171, 172, 173, 174, 175, 177]"
Olaf,L100,long,54,19,35,3,0.6494,154,"[17, 26, 28, 29, 30, 48, 56, 57, 60, 72, 74, 78, 79, 80, 83, 84, 86, 88, 89, 91, 96, 98, 99, 100, 102, 103, 104, 106, 110, 111, 112, 113, 114, 118, 121, 122, 125, 126, 127, 128, 131, 132, 133, 134, 135, 136, 139, 140, 142, 143, 144, 146, 148, 151]"
Olaf,L100,long,75,49,26,3,0.5714,175,"[16, 32, 48, 52, 54, 55, 56, 57, 60, 62, 74, 79, 80, 82, 85, 86, 88, 90, 92, 95, 96, 97, 98, 99, 100, 101, 102, 104, 106, 107, 108, 111, 112, 113, 114, 115, 116, 119, 121, 122, 129, 130, 132, 133, 136, 137, 138, 139, 140, 141, 142, 144, 145, 146, 149, 150, 152, 153, 154, 155, 156, 157, 158, 159, 160, 161, 163, 164, 166, 167, 168, 169, 170, 171, 173]"
Olaf,L100,long,48,23,25,2,0.6757,148,"[17, 25, 28, 29, 45, 53, 55, 56, 58, 60, 70, 73, 76, 78, 80, 81, 83, 84, 88, 90, 92, 97, 99, 103, 105, 107, 108, 109, 110, 113, 114, 116, 119, 120, 122, 127, 128, 130, 132, 133, 134, 136, 137, 138, 139, 140, 143, 144]"
Olaf,L100,long,94,42,52,1,0.5155,194,"[17, 24, 28, 29, 46, 52, 56, 57, 58, 59, 71, 73, 74, 75, 79, 82, 83, 84, 85, 86, 87, 88, 89, 96, 100, 101, 102, 103, 104, 106, 107, 108, 109, 110, 111, 112, 114, 115, 116, 118, 119, 121, 122, 127, 128, 129, 130, 132, 134, 135, 136, 137, 142, 143, 145, 146, 147, 148, 152, 153, 154, 155, 156, 157, 158, 159, 161, 162, 164, 165, 166, 167, 168, 169, 170, 171, 172, 173, 174, 175, 176, 177, 178, 179, 180, 182, 183, 185, 187, 188, 189, 190, 191, 192]"
Olaf,L100,long,73,38,35,4,0.578,173,"[17, 24, 28, 31, 49, 54, 56, 57, 58, 60, 70, 73, 76, 77, 78, 79, 83, 85, 87, 88, 90, 97, 101, 103, 104, 105, 107, 108, 109, 110, 111, 114, 115, 116, 117, 119, 121, 122, 123, 126, 127, 128, 130, 132, 133, 135, 136, 138, 140, 142, 143, 145, 146, 147, 149, 150, 151, 153, 154, 155, 156, 158, 159, 160, 162, 163, 164, 165, 166, 168, 169, 170, 171]"
Olaf,L100,long,69,40,29,3,0.5917,169,"[17, 26, 28, 30, 46, 53, 55, 56, 57, 58, 59, 60, 73, 75, 76, 77, 78, 79, 80, 82, 83, 84, 87, 91, 100, 101, 103, 104, 105, 108, 110, 111, 113, 114, 116, 117, 118, 120, 122, 123, 124, 128, 129, 131, 134, 135, 137, 140, 141, 142, 143, 146, 147, 148, 149, 150, 151, 154, 155, 156, 157, 158, 159, 160, 161, 162, 163, 164, 166]"
Olaf,L100,long,65,28,37,5,0.6061,165,"[16, 32, 49, 53, 55, 56, 58, 59, 60, 77, 79, 80, 81, 82, 84, 85, 86, 87, 89, 90, 91, 93, 97, 98, 99, 100, 101, 103, 110, 111, 112, 114, 115, 116, 117, 118, 121, 122, 123, 125, 126, 127, 128, 129, 131, 134, 135, 136, 137, 140, 142, 143, 144, 145, 148, 149, 151, 152, 154, 155, 156, 157, 159, 160, 162]"
Olaf,L100,long,52,23,29,4,0.6579,152,"[17, 33, 47, 52, 54, 56, 57, 59, 60, 73, 78, 79, 82, 84, 85, 86, 90, 94, 96, 98, 101, 102, 105, 107, 108, 110, 111, 114, 115, 117, 118, 119, 120, 122, 124, 125, 126, 127, 129, 130, 131, 132, 133, 134, 140, 142, 144, 145, 146, 148, 149, 150]"
Olaf,L100,long,74,45,29,7,0.5747,174,"[16, 35, 50, 54, 56, 57, 58, 59, 63, 74, 78, 80, 83, 85, 87, 88, 89, 90, 92, 95, 96, 97, 99, 100, 103, 104, 105, 106, 107, 109, 110, 113, 115, 117, 118, 119, 120, 122, 123, 124, 125, 126, 127, 129, 132, 133, 134, 135, 136, 137, 138, 141, 142, 143, 144, 145, 146, 149, 150, 151, 152, 153, 157, 159, 161, 163, 164, 165, 166, 167, 168, 169, 170, 172]"
Olaf,L100,long,72,29,43,9,0.5814,172,"[16, 33, 47, 53, 55, 56, 62, 75, 77, 79, 81, 82, 83, 85, 86, 88, 90, 93, 94, 95, 97, 98, 101, 102, 103, 105, 106, 107, 112, 113, 114, 117, 118, 119, 120, 121, 122, 123, 124, 125, 126, 127, 128, 129, 130, 132, 134, 136, 138, 139, 140, 141, 142, 143, 144, 147, 148, 149, 150, 152, 153, 156, 157, 158, 159, 160, 163, 165, 166, 167, 169, 170]"
