agent_name,layout,event_update_level,num_attention_switches,num_attention_switches_margins,num_attention_switches_middle,inform_loss,reading_speed,total_steps,attention_switches_time_steps_list
Shakespeare,L0,short,100,41,59,3,0.5,200,"[1, 3, 4, 5, 6, 7, 8, 9, 11, 12, 13, 14, 15, 16, 17, 18, 19, 25, 27, 28, 29, 33, 34, 36, 37, 38, 39, 40, 41, 50, 52, 53, 54, 55, 57, 58, 59, 60, 62, 66, 67, 68, 69, 72, 73, 75, 76, 77, 78, 79, 81, 82, 88, 90, 91, 92, 93, 94, 95, 97, 98, 100, 101, 102, 109, 110, 111, 112, 113, 116, 117, 118, 119, 122, 129, 131, 132, 135, 137, 140, 141, 142, 149, 151, 152, 158, 159, 161, 163, 164, 165, 173, 174, 176, 184, 185, 186, 193, 194, 197]"
Shakespeare,L0,short,97,54,43,9,0.5076,197,"[0, 1, 3, 4, 7, 9, 12, 18, 19, 21, 22, 24, 25, 27, 29, 30, 31, 32, 34, 36, 38, 39, 40, 43, 44, 46, 48, 49, 55, 56, 58, 59, 60, 62, 65, 66, 71, 72, 76, 80, 81, 82, 83, 84, 89, 90, 91, 92, 93, 95, 96, 97, 98, 99, 100, 103, 104, 105, 108, 109, 110, 111, 113, 115, 117, 118, 121, 122, 123, 124, 125, 126, 133, 134, 136, 140, 141, 142, 143, 144, 145, 146, 153, 155, 156, 157, 159, 161, 170, 177, 178, 179, 180, 181, 182, 190, 192]"
Shakespeare,L0,short,97,59,38,8,0.5076,197,"[0, 1, 2, 3, 5, 6, 7, 9, 11, 13, 15, 16, 18, 19, 21, 24, 25, 26, 27, 30, 32, 33, 37, 40, 41, 43, 44, 48, 51, 53, 54, 55, 56, 57, 58, 59, 60, 62, 64, 65, 67, 68, 69, 70, 71, 76, 77, 79, 80, 81, 82, 83, 84, 85, 86, 87, 88, 89, 90, 91, 92, 100, 101, 103, 106, 108, 109, 110, 112, 114, 118, 125, 126, 128, 131, 134, 135, 144, 145, 146, 152, 153, 154, 156, 158, 166, 167, 168, 169, 177, 178, 179, 185, 187, 188, 190, 191]"
Shakespeare,L0,short,94,56,38,9,0.5155,194,"[1, 2, 3, 4, 5, 6, 7, 8, 9, 10, 11, 13, 14, 15, 16, 17, 18, 19, 20, 27, 29, 31, 34, 35, 37, 39, 41, 43, 50, 51, 52, 53, 54, 55, 56, 57, 58, 59, 61, 63, 69, 70, 71, 72, 73, 74, 75, 76, 77, 78, 79, 80, 81, 82, 83, 85, 94, 95, 96, 98, 99, 102, 104, 107, 108, 109, 116, 118, 120, 122, 125, 128, 129, 131, 138, 139, 140, 141, 146, 147, 149, 152, 160, 162, 168, 169, 170, 171, 173, 174, 175, 179, 186, 188]"
Shakespeare,L0,short,96,43,53,9,0.5102,196,"[0, 1, 4, 6, 7, 8, 9, 10, 12, 13, 15, 16, 17, 19, 20, 23, 24, 25, 26, 29, 30, 31, 37, 38, 39, 40, 41, 42, 43, 45, 46, 48, 49, 50, 51, 52, 59, 60, 61, 62, 63, 64, 65, 66, 67, 68, 69, 70, 72, 73, 74, 81, 83, 84, 85, 87, 88, 89, 91, 93, 96, 103, 105, 106, 107, 108, 110, 114, 115, 116, 117, 118, 120, 127, 131, 133, 135, 137, 139, 143, 150, 157, 158, 159, 160, 167, 168, 169, 171, 178, 179, 180, 181, 189, 190, 191]"
Shakespeare,L0,short,96,48,48,8,0.5102,196,"[0, 1, 2, 3, 5, 6, 7, 8, 9, 10, 11, 12, 15, 16, 17, 18, 19, 25, 26, 27, 28, 29, 30, 31, 35, 36, 37, 38, 40, 46, 47, 50, 52, 55, 58, 59, 61, 62, 64, 66, 70, 71, 72, 73, 75, 76, 78, 79, 81, 82, 83, 85, 87, 91, 92, 93, 94, 95, 96, 97, 98, 99, 101, 102, 103, 106, 113, 114, 116, 120, 124, 125, 127, 128, 135, 136, 138, 144, 145, 148, 149, 155, 158, 159, 167, 168, 169, 175, 177, 178, 180, 187, 188, 189, 190, 191]"
Shakespeare,L0,short,94,44,50,10,0.5155,194,"[0, 7, 9, 11, 13, 15, 16, 18, 19, 20, 21, 22, 23, 25, 27, 29, 30, 31, 33, 37, 38, 39, 44, 45, 46, 47, 50, 51, 54, 57, 60, 61, 63, 66, 68, 69, 70, 71, 72, 74, 76, 79, 82, 83, 84, 85, 86, 87, 88, 89, 90, 91, 93, 94, 95, 96, 97, 98, 99, 111, 112, 113, 115, 116, 117, 118, 119, 126, 127, 129, 131, 134, 136, 138, 139, 142, 143, 144, 145, 146, 147, 155, 156, 157, 163, 164, 166, 167, 174, 177, 184, 185, 186, 189]"
Shakespeare,L0,short,95,49,46,6,0.5128,195,"[0, 2, 5, 6, 7, 9, 10, 11, 13, 14, 15, 16, 17, 18, 19, 20, 21, 22, 26, 28, 29, 30, 32, 33, 34, 35, 36, 38, 39, 40, 42, 43, 50, 51, 54, 55, 56, 57, 58, 60, 61, 62, 64, 71, 72, 75, 76, 77, 78, 79, 80, 81, 82, 84, 91, 93, 96, 99, 102, 105, 106, 112, 115, 117, 118, 121, 123, 124, 125, 126, 127, 134, 135, 136, 137, 142, 143, 144, 146, 147, 150, 156, 157, 158, 161, 167, 169, 171, 172, 178, 179, 182, 189, 191, 192]"
Shakespeare,L0,short,96,55,41,11,0.5102,196,"[1, 2, 4, 5, 6, 8, 10, 11, 12, 13, 14, 15, 17, 18, 19, 22, 26, 28, 29, 30, 32, 33, 34, 35, 36, 37, 38, 39, 40, 46, 48, 49, 51, 52, 54, 55, 56, 57, 59, 60, 66, 67, 70, 71, 72, 73, 74, 75, 76, 77, 79, 80, 81, 87, 89, 90, 91, 92, 93, 95, 96, 97, 99, 102, 109, 114, 115, 116, 117, 118, 120, 121, 130, 133, 138, 140, 143, 151, 152, 153, 154, 155, 161, 162, 165, 167, 173, 174, 176, 177, 179, 185, 186, 187, 188, 194]"
Shakespeare,L0,short,97,49,48,2,0.5076,197,"[0, 1, 2, 3, 4, 6, 7, 9, 10, 11, 12, 13, 14, 15, 17, 18, 19, 20, 22, 27, 29, 31, 32, 33, 37, 38, 39, 40, 42, 47, 48, 49, 53, 54, 56, 59, 60, 61, 62, 64, 65, 66, 72, 74, 75, 76, 81, 82, 83, 85, 86, 90, 92, 93, 94, 95, 96, 97, 99, 100, 101, 102, 103, 105, 106, 107, 114, 115, 116, 117, 118, 121, 122, 125, 127, 135, 138, 144, 145, 147, 149, 155, 156, 157, 159, 166, 168, 169, 177, 178, 180, 182, 190, 191, 192, 193, 194]"
Shakespeare,L0,short,97,50,47,4,0.5076,197,"[0, 3, 4, 7, 8, 9, 10, 11, 12, 13, 15, 16, 18, 19, 20, 21, 22, 26, 27, 28, 32, 33, 35, 36, 37, 41, 42, 43, 48, 50, 51, 52, 53, 54, 56, 57, 61, 63, 67, 68, 71, 72, 75, 76, 77, 79, 80, 81, 82, 83, 84, 89, 91, 92, 93, 94, 95, 97, 98, 100, 102, 103, 104, 106, 107, 112, 115, 116, 118, 119, 120, 123, 125, 126, 127, 134, 135, 136, 137, 138, 139, 140, 147, 148, 150, 152, 160, 161, 162, 163, 170, 172, 173, 181, 184, 191, 193]"
Shakespeare,L0,short,97,47,50,7,0.5076,197,"[0, 2, 3, 4, 5, 6, 7, 9, 10, 11, 13, 14, 15, 16, 17, 20, 26, 27, 29, 32, 34, 37, 39, 42, 43, 44, 47, 48, 49, 52, 53, 54, 55, 59, 63, 65, 66, 68, 71, 72, 73, 75, 78, 80, 84, 85, 86, 87, 89, 91, 92, 93, 94, 96, 101, 104, 105, 106, 107, 108, 109, 110, 111, 112, 113, 114, 115, 117, 121, 122, 129, 130, 131, 134, 138, 139, 143, 151, 153, 158, 159, 161, 163, 164, 171, 172, 173, 175, 182, 183, 184, 188, 190, 191, 192, 193, 194]"
Shakespeare,L0,short,95,59,36,8,0.5128,195,"[0, 1, 2, 3, 4, 6, 7, 8, 10, 12, 13, 15, 16, 18, 19, 21, 22, 26, 31, 32, 34, 35, 37, 38, 40, 41, 42, 44, 49, 52, 54, 57, 58, 59, 60, 63, 64, 65, 68, 70, 71, 73, 78, 79, 80, 81, 82, 83, 84, 85, 86, 88, 93, 94, 95, 97, 98, 99, 100, 101, 103, 105, 106, 107, 113, 114, 115, 117, 118, 120, 122, 125, 127, 134, 135, 136, 138, 144, 145, 147, 149, 155, 156, 157, 158, 165, 166, 168, 169, 171, 178, 179, 180, 182, 191]"
Shakespeare,L0,short,97,61,36,8,0.5076,197,"[0, 1, 2, 4, 5, 6, 7, 11, 13, 14, 15, 16, 17, 18, 19, 23, 25, 26, 30, 32, 34, 37, 39, 45, 48, 50, 51, 52, 53, 54, 55, 56, 59, 61, 66, 67, 68, 69, 70, 71, 72, 73, 74, 75, 77, 78, 79, 80, 84, 86, 87, 88, 89, 90, 91, 93, 94, 95, 96, 97, 98, 99, 101, 102, 103, 110, 112, 113, 114, 115, 118, 120, 122, 124, 134, 141, 142, 144, 152, 153, 155, 161, 162, 163, 165, 172, 176, 181, 183, 184, 185, 187, 191, 192, 193, 194, 195]"
Shakespeare,L0,short,92,38,54,7,0.5208,192,"[3, 5, 7, 10, 14, 16, 17, 20, 21, 22, 24, 25, 26, 27, 28, 29, 31, 33, 34, 35, 39, 40, 41, 46, 48, 49, 50, 52, 54, 55, 57, 58, 60, 61, 63, 64, 68, 69, 70, 74, 77, 80, 81, 83, 86, 88, 89, 90, 91, 92, 94, 95, 96, 98, 99, 100, 105, 108, 109, 111, 118, 121, 122, 123, 124, 127, 128, 129, 130, 131, 138, 140, 141, 143, 149, 150, 151, 155, 160, 161, 162, 164, 165, 171, 172, 176, 181, 182, 183, 184, 185, 186]"
Shakespeare,L0,short,92,41,51,10,0.5208,192,"[1, 2, 5, 8, 9, 10, 13, 14, 15, 16, 17, 18, 20, 21, 22, 25, 26, 29, 30, 34, 35, 36, 37, 39, 40, 41, 42, 43, 45, 47, 49, 50, 51, 56, 57, 60, 64, 69, 71, 76, 78, 79, 80, 82, 83, 85, 87, 88, 89, 91, 92, 96, 98, 99, 100, 102, 106, 107, 108, 111, 113, 116, 117, 118, 120, 122, 123, 124, 126, 127, 128, 132, 134, 142, 143, 144, 149, 152, 153, 154, 162, 163, 165, 170, 172, 173, 174, 178, 183, 184, 185, 187]"
Shakespeare,L0,short,94,42,52,4,0.5155,194,"[3, 4, 7, 8, 9, 11, 13, 15, 16, 17, 19, 20, 22, 25, 26, 27, 28, 30, 31, 33, 34, 35, 36, 37, 39, 41, 45, 48, 50, 52, 53, 55, 57, 58, 59, 60, 61, 62, 64, 65, 66, 67, 68, 69, 70, 75, 76, 77, 78, 79, 80, 84, 85, 86, 87, 88, 89, 90, 97, 100, 103, 104, 105, 106, 107, 112, 118, 120, 121, 123, 125, 126, 127, 128, 131, 132, 139, 140, 141, 142, 148, 150, 153, 154, 163, 164, 171, 173, 174, 177, 179, 186, 187, 190]"
Shakespeare,L0,short,97,48,49,7,0.5076,197,"[0, 1, 2, 4, 5, 6, 7, 8, 9, 10, 12, 13, 15, 16, 17, 18, 20, 25, 26, 27, 28, 29, 31, 33, 34, 35, 36, 37, 40, 46, 47, 48, 49, 52, 53, 54, 55, 56, 57, 58, 59, 61, 62, 69, 70, 71, 72, 76, 77, 78, 79, 80, 82, 88, 90, 91, 92, 93, 94, 96, 99, 103, 108, 109, 111, 112, 113, 114, 116, 117, 126, 133, 134, 135, 136, 140, 141, 142, 143, 144, 146, 147, 148, 157, 158, 160, 166, 167, 169, 176, 177, 178, 179, 180, 181, 183, 192]"
Shakespeare,L0,short,98,45,53,5,0.5051,198,"[1, 2, 3, 4, 5, 6, 8, 10, 11, 12, 13, 14, 17, 20, 21, 24, 25, 26, 27, 28, 29, 30, 32, 33, 35, 38, 40, 42, 43, 48, 49, 52, 53, 54, 55, 57, 58, 59, 61, 62, 63, 64, 69, 70, 71, 72, 74, 77, 79, 80, 83, 84, 89, 90, 92, 94, 95, 97, 101, 102, 106, 111, 112, 113, 115, 116, 117, 118, 120, 121, 123, 124, 125, 131, 135, 139, 140, 141, 142, 144, 146, 155, 158, 164, 165, 166, 172, 173, 174, 175, 176, 182, 184, 185, 186, 191, 192, 195]"
Shakespeare,L0,short,95,65,30,3,0.5128,195,"[0, 2, 5, 6, 7, 9, 10, 11, 14, 19, 22, 23, 24, 25, 29, 30, 32, 33, 34, 36, 37, 38, 39, 40, 41, 42, 43, 44, 46, 47, 49, 52, 54, 59, 61, 64, 66, 67, 68, 70, 71, 72, 74, 80, 81, 82, 83, 84, 87, 89, 90, 91, 92, 93, 95, 100, 101, 102, 103, 104, 105, 107, 109, 112, 113, 116, 121, 123, 124, 125, 126, 127, 129, 130, 131, 132, 133, 134, 141, 142, 144, 145, 151, 152, 153, 155, 164, 166, 173, 174, 175, 176, 177, 184, 187]"
Shakespeare,L0,short,99,39,60,5,0.5025,199,"[1, 2, 3, 5, 6, 7, 8, 9, 11, 15, 17, 18, 21, 22, 23, 24, 25, 26, 28, 29, 30, 34, 36, 37, 38, 40, 44, 45, 46, 48, 50, 52, 57, 58, 60, 61, 62, 63, 64, 65, 66, 67, 68, 71, 72, 74, 75, 76, 81, 82, 83, 84, 85, 87, 88, 89, 90, 91, 94, 95, 96, 103, 104, 105, 106, 108, 109, 110, 112, 113, 114, 118, 126, 127, 128, 130, 131, 132, 133, 136, 137, 139, 148, 149, 157, 158, 159, 166, 167, 168, 170, 177, 178, 179, 180, 181, 188, 190, 191]"
Shakespeare,L0,short,96,47,49,3,0.5102,196,"[2, 3, 4, 5, 6, 7, 8, 9, 10, 16, 17, 19, 20, 21, 22, 23, 24, 25, 26, 27, 28, 29, 30, 31, 38, 39, 41, 42, 43, 45, 46, 50, 51, 52, 57, 59, 60, 61, 62, 63, 64, 66, 67, 69, 70, 71, 72, 73, 81, 82, 84, 85, 86, 87, 88, 90, 93, 96, 103, 104, 105, 106, 107, 109, 110, 111, 112, 113, 114, 117, 126, 127, 128, 130, 135, 137, 138, 139, 145, 146, 147, 149, 155, 157, 158, 159, 168, 170, 177, 181, 186, 187, 188, 189, 190, 191]"
Shakespeare,L0,short,103,69,34,10,0.485,200,"[0, 1, 2, 3, 4, 5, 6, 7, 8, 9, 11, 15, 16, 17, 18, 20, 21, 26, 28, 34, 36, 37, 39, 40, 41, 42, 43, 44, 46, 47, 48, 49, 51, 52, 53, 54, 57, 62, 63, 64, 65, 66, 67, 68, 69, 70, 72, 73, 75, 76, 82, 83, 84, 85, 86, 87, 88, 89, 90, 91, 94, 95, 96, 97, 98, 106, 107, 109, 111, 113, 114, 115, 116, 117, 118, 119, 123, 131, 133, 134, 135, 137, 138, 139, 140, 141, 149, 150, 151, 158, 160, 161, 162, 171, 172, 180, 181, 182, 190, 191, 192, 193, 194]"
Shakespeare,L0,short,96,39,57,4,0.5102,196,"[0, 1, 2, 3, 6, 7, 8, 9, 12, 13, 16, 18, 19, 20, 21, 22, 23, 24, 25, 26, 27, 29, 31, 36, 37, 40, 41, 42, 43, 46, 49, 50, 54, 55, 56, 58, 60, 62, 64, 65, 66, 67, 68, 70, 71, 80, 81, 82, 84, 85, 86, 87, 88, 89, 90, 92, 97, 99, 102, 103, 104, 105, 106, 107, 108, 109, 110, 112, 118, 119, 120, 121, 122, 123, 124, 125, 126, 127, 128, 129, 131, 132, 140, 141, 143, 149, 151, 155, 163, 165, 173, 176, 177, 184, 185, 187]"
Shakespeare,L0,short,98,44,54,15,0.5051,198,"[0, 1, 2, 4, 5, 8, 10, 12, 13, 14, 15, 16, 18, 19, 20, 23, 25, 26, 27, 28, 33, 35, 36, 37, 38, 39, 40, 46, 50, 52, 53, 54, 55, 56, 57, 58, 59, 60, 62, 66, 70, 71, 72, 73, 75, 76, 78, 79, 81, 82, 83, 85, 87, 89, 94, 96, 98, 99, 100, 102, 103, 104, 105, 106, 108, 109, 110, 112, 119, 120, 121, 124, 126, 127, 128, 130, 132, 133, 141, 142, 143, 149, 150, 151, 154, 162, 163, 164, 171, 172, 174, 175, 182, 184, 186, 187, 188, 192]"
Shakespeare,L0,short,98,60,38,7,0.5051,198,"[0, 2, 4, 5, 7, 10, 11, 12, 13, 14, 15, 18, 19, 22, 25, 30, 32, 34, 35, 36, 38, 39, 42, 43, 46, 47, 50, 51, 52, 53, 56, 57, 58, 59, 60, 64, 65, 70, 71, 72, 73, 74, 75, 81, 85, 87, 88, 89, 90, 91, 93, 95, 96, 97, 98, 99, 100, 101, 102, 103, 106, 111, 112, 113, 114, 116, 117, 119, 121, 123, 125, 132, 133, 135, 139, 140, 141, 142, 143, 144, 147, 155, 156, 157, 164, 165, 167, 171, 177, 178, 179, 180, 181, 182, 189, 191, 192, 194]"
Shakespeare,L0,short,96,61,35,11,0.5102,196,"[0, 2, 3, 4, 5, 6, 7, 8, 9, 10, 12, 16, 17, 18, 19, 20, 24, 25, 26, 27, 28, 29, 34, 35, 36, 37, 44, 48, 49, 51, 52, 53, 57, 58, 59, 61, 65, 66, 67, 68, 69, 70, 71, 72, 73, 77, 78, 80, 81, 84, 88, 89, 90, 91, 93, 94, 95, 98, 100, 101, 103, 104, 105, 110, 111, 112, 114, 115, 116, 117, 118, 119, 121, 122, 125, 134, 135, 140, 141, 143, 144, 146, 153, 154, 155, 157, 160, 167, 169, 177, 178, 179, 186, 187, 188, 189]"
Shakespeare,L0,short,94,45,49,8,0.5155,194,"[0, 1, 2, 3, 5, 6, 7, 9, 10, 11, 14, 15, 17, 19, 22, 29, 32, 33, 35, 38, 40, 42, 44, 45, 46, 47, 48, 49, 50, 52, 53, 54, 55, 56, 57, 59, 60, 61, 65, 66, 67, 69, 71, 72, 73, 74, 75, 77, 79, 80, 84, 91, 92, 93, 94, 96, 97, 98, 99, 102, 103, 104, 109, 110, 111, 112, 113, 114, 115, 116, 118, 119, 120, 121, 123, 124, 131, 133, 135, 139, 140, 143, 145, 146, 155, 156, 163, 165, 166, 167, 176, 180, 186, 188]"
Shakespeare,L0,short,101,52,49,7,0.495,200,"[3, 5, 6, 7, 8, 10, 12, 14, 15, 17, 18, 19, 21, 22, 23, 25, 27, 29, 30, 31, 32, 34, 36, 37, 39, 40, 44, 46, 49, 50, 52, 53, 54, 55, 56, 57, 59, 61, 63, 67, 68, 70, 73, 74, 76, 78, 80, 81, 82, 83, 88, 89, 90, 91, 92, 93, 94, 95, 96, 99, 100, 101, 103, 112, 114, 115, 116, 119, 121, 122, 125, 132, 133, 134, 138, 139, 140, 141, 143, 144, 150, 151, 152, 153, 154, 161, 162, 163, 164, 171, 175, 182, 184, 185, 186, 187, 192, 195, 196, 197, 198]"
Shakespeare,L0,short,96,52,44,4,0.5102,196,"[0, 2, 3, 4, 5, 6, 8, 9, 11, 13, 14, 15, 17, 18, 20, 23, 24, 25, 27, 31, 32, 33, 36, 38, 41, 45, 46, 47, 48, 52, 56, 59, 62, 63, 64, 65, 69, 71, 72, 77, 78, 79, 80, 81, 83, 84, 85, 86, 87, 89, 95, 97, 99, 100, 101, 103, 104, 108, 110, 111, 112, 117, 118, 119, 120, 121, 123, 125, 126, 128, 131, 132, 134, 135, 142, 143, 145, 146, 148, 155, 156, 157, 164, 165, 166, 167, 173, 174, 175, 176, 177, 183, 184, 185, 186, 187]"
Shakespeare,L0,short,94,47,47,8,0.5155,194,"[0, 6, 8, 10, 11, 14, 17, 18, 19, 21, 22, 23, 24, 29, 30, 31, 33, 34, 35, 37, 38, 40, 42, 43, 44, 48, 49, 50, 52, 53, 54, 56, 57, 58, 60, 62, 65, 67, 68, 69, 70, 71, 72, 74, 75, 77, 78, 79, 80, 81, 84, 86, 87, 88, 91, 96, 98, 100, 102, 103, 104, 105, 106, 108, 109, 110, 113, 118, 119, 122, 124, 125, 126, 127, 129, 130, 133, 140, 142, 150, 151, 152, 153, 155, 162, 163, 166, 173, 174, 175, 182, 183, 184, 185]"
Shakespeare,L0,short,94,40,54,12,0.5155,194,"[1, 2, 5, 7, 9, 10, 11, 12, 14, 15, 16, 17, 21, 22, 24, 26, 27, 28, 31, 34, 35, 37, 38, 39, 40, 41, 42, 43, 45, 47, 48, 49, 54, 55, 56, 57, 59, 62, 63, 65, 66, 67, 68, 69, 71, 76, 77, 78, 81, 84, 86, 87, 88, 89, 92, 97, 98, 99, 100, 101, 102, 103, 106, 107, 108, 109, 110, 112, 118, 120, 121, 124, 125, 126, 128, 129, 130, 131, 140, 143, 149, 150, 152, 161, 162, 163, 169, 170, 171, 172, 175, 183, 184, 192]"
Shakespeare,L0,short,95,59,36,11,0.5128,195,"[0, 1, 2, 4, 5, 6, 7, 8, 13, 15, 16, 17, 19, 21, 23, 24, 27, 29, 30, 31, 32, 33, 34, 35, 36, 37, 38, 39, 40, 41, 42, 48, 49, 50, 52, 54, 55, 56, 57, 59, 60, 61, 63, 64, 71, 72, 74, 79, 81, 82, 83, 84, 91, 92, 93, 94, 95, 96, 97, 98, 99, 100, 101, 103, 104, 113, 114, 116, 117, 118, 119, 121, 122, 123, 124, 125, 128, 135, 137, 138, 140, 145, 146, 147, 148, 150, 151, 153, 162, 173, 176, 183, 184, 192, 193]"
Shakespeare,L0,short,93,54,39,13,0.5181,193,"[1, 2, 5, 6, 7, 8, 9, 11, 12, 14, 17, 19, 20, 21, 22, 25, 26, 28, 31, 35, 36, 37, 39, 40, 44, 45, 46, 48, 49, 50, 54, 57, 63, 66, 68, 70, 71, 72, 73, 74, 78, 80, 82, 83, 84, 86, 87, 88, 89, 92, 93, 96, 99, 100, 104, 105, 106, 111, 112, 113, 117, 118, 119, 120, 121, 122, 123, 124, 125, 126, 127, 128, 129, 132, 134, 143, 144, 146, 153, 154, 155, 157, 165, 166, 171, 173, 174, 175, 177, 183, 184, 188, 190]"
Shakespeare,L0,short,101,47,54,11,0.495,200,"[1, 2, 3, 5, 6, 8, 10, 11, 12, 13, 16, 17, 19, 20, 26, 29, 30, 31, 32, 33, 34, 35, 37, 38, 39, 41, 45, 46, 47, 48, 49, 52, 53, 55, 56, 59, 60, 64, 65, 67, 68, 69, 71, 74, 75, 77, 78, 79, 80, 84, 88, 89, 91, 92, 93, 94, 95, 96, 98, 101, 103, 107, 108, 109, 111, 112, 113, 114, 116, 117, 118, 120, 122, 129, 130, 131, 132, 136, 137, 139, 141, 142, 143, 144, 146, 155, 162, 163, 164, 165, 166, 167, 175, 176, 179, 187, 192, 194, 195, 196, 198]"
Shakespeare,L0,short,97,47,50,5,0.5076,197,"[0, 1, 2, 3, 5, 6, 7, 10, 12, 14, 15, 16, 17, 18, 19, 22, 23, 24, 26, 29, 31, 35, 36, 37, 39, 40, 41, 42, 43, 47, 49, 50, 52, 56, 58, 59, 60, 61, 62, 65, 66, 67, 68, 70, 71, 72, 73, 74, 75, 76, 79, 85, 86, 88, 92, 93, 96, 98, 103, 105, 106, 109, 110, 113, 114, 115, 117, 118, 123, 125, 126, 128, 130, 132, 133, 136, 137, 138, 145, 146, 147, 148, 149, 155, 157, 158, 159, 167, 168, 169, 178, 179, 185, 186, 187, 188, 189]"
Shakespeare,L0,short,101,48,53,6,0.495,200,"[1, 3, 4, 6, 7, 10, 12, 13, 14, 15, 16, 17, 18, 20, 23, 24, 25, 26, 27, 29, 30, 31, 32, 34, 35, 37, 39, 40, 48, 49, 51, 54, 55, 56, 57, 58, 60, 61, 66, 68, 69, 70, 72, 73, 75, 76, 77, 79, 82, 86, 87, 88, 90, 91, 92, 93, 94, 95, 97, 98, 99, 101, 104, 110, 111, 112, 114, 115, 117, 118, 119, 121, 125, 126, 128, 136, 137, 141, 148, 154, 155, 157, 158, 164, 165, 166, 167, 168, 175, 176, 177, 178, 185, 186, 187, 188, 189, 190, 195, 197, 198]"
Shakespeare,L0,short,97,55,42,8,0.5076,197,"[0, 2, 3, 4, 5, 6, 8, 10, 14, 16, 18, 19, 22, 23, 24, 27, 28, 30, 31, 33, 36, 40, 41, 42, 45, 46, 47, 49, 51, 53, 56, 57, 59, 62, 64, 67, 68, 69, 70, 73, 74, 76, 78, 83, 84, 86, 87, 88, 89, 91, 92, 93, 94, 95, 99, 100, 101, 102, 106, 110, 112, 113, 114, 115, 116, 121, 123, 124, 129, 132, 133, 134, 135, 136, 138, 148, 149, 154, 155, 156, 157, 159, 165, 166, 167, 168, 170, 177, 178, 179, 180, 186, 187, 189, 190, 191, 192]"
Shakespeare,L0,short,96,35,61,5,0.5102,196,"[1, 2, 3, 5, 6, 8, 9, 12, 13, 16, 17, 18, 20, 22, 23, 24, 26, 27, 28, 30, 34, 36, 37, 39, 40, 41, 44, 45, 46, 47, 48, 51, 54, 58, 59, 60, 61, 63, 64, 65, 66, 67, 68, 71, 74, 79, 80, 82, 83, 84, 85, 86, 89, 90, 92, 93, 100, 101, 102, 103, 104, 105, 106, 107, 109, 111, 112, 113, 120, 123, 124, 125, 127, 128, 129, 130, 131, 132, 133, 134, 135, 144, 146, 154, 155, 165, 171, 172, 174, 175, 181, 182, 183, 184, 186, 194]"
Shakespeare,L0,short,88,47,41,9,0.5319,188,"[0, 1, 3, 5, 7, 8, 9, 10, 11, 12, 15, 16, 18, 20, 23, 24, 28, 29, 30, 31, 34, 36, 40, 41, 44, 45, 46, 50, 51, 53, 56, 57, 59, 60, 61, 64, 65, 66, 67, 68, 71, 72, 74, 76, 78, 80, 81, 85, 86, 88, 92, 94, 95, 97, 103, 105, 107, 114, 115, 116, 117, 120, 122, 126, 128, 129, 130, 131, 132, 135, 138, 139, 140, 141, 142, 149, 150, 151, 153, 160, 162, 165, 171, 172, 173, 174, 182, 184]"
Shakespeare,L0,short,98,47,51,7,0.5051,198,"[0, 3, 4, 6, 7, 8, 9, 11, 14, 16, 17, 18, 21, 22, 23, 24, 25, 27, 29, 30, 34, 36, 38, 40, 42, 44, 46, 48, 49, 51, 54, 55, 56, 57, 59, 60, 61, 62, 64, 65, 68, 69, 72, 76, 80, 82, 84, 85, 86, 87, 88, 91, 92, 95, 96, 97, 98, 100, 102, 103, 105, 106, 109, 110, 112, 113, 121, 122, 123, 124, 125, 126, 127, 128, 129, 130, 131, 133, 134, 136, 143, 144, 147, 155, 162, 165, 166, 167, 168, 169, 176, 177, 178, 179, 186, 187, 188, 189]"
Shakespeare,L0,short,94,44,50,6,0.5155,194,"[0, 1, 4, 5, 7, 8, 9, 10, 11, 12, 14, 16, 17, 18, 19, 23, 24, 26, 29, 30, 33, 34, 35, 36, 38, 41, 45, 47, 48, 49, 50, 51, 52, 53, 54, 55, 56, 58, 60, 61, 66, 67, 68, 69, 70, 72, 73, 76, 78, 79, 80, 83, 89, 91, 93, 94, 96, 98, 99, 100, 101, 107, 112, 113, 114, 116, 117, 118, 121, 127, 128, 130, 132, 133, 138, 140, 143, 151, 153, 154, 160, 161, 162, 164, 170, 171, 172, 173, 175, 183, 184, 188, 191, 192]"
Shakespeare,L0,short,94,33,61,10,0.5155,194,"[0, 1, 5, 6, 7, 8, 9, 10, 11, 12, 16, 17, 18, 20, 21, 22, 23, 24, 25, 26, 27, 28, 29, 31, 33, 36, 43, 44, 47, 48, 50, 51, 52, 55, 59, 60, 62, 64, 67, 68, 70, 71, 72, 73, 74, 76, 81, 82, 83, 85, 86, 87, 89, 90, 92, 94, 96, 99, 104, 105, 106, 107, 108, 109, 112, 113, 114, 115, 116, 119, 125, 126, 127, 128, 129, 130, 131, 133, 134, 135, 137, 139, 149, 155, 156, 157, 158, 168, 178, 184, 185, 186, 187, 188]"
Shakespeare,L0,short,98,38,60,19,0.5051,198,"[0, 1, 2, 3, 4, 6, 7, 8, 9, 14, 15, 17, 18, 19, 20, 23, 25, 26, 27, 28, 29, 31, 32, 33, 34, 36, 37, 38, 39, 40, 43, 49, 50, 51, 54, 55, 56, 59, 61, 62, 67, 68, 69, 70, 71, 72, 74, 75, 76, 77, 78, 79, 80, 81, 83, 91, 94, 95, 96, 97, 98, 99, 100, 101, 102, 103, 104, 107, 115, 116, 118, 119, 122, 123, 124, 127, 134, 135, 137, 142, 143, 144, 145, 146, 147, 155, 156, 158, 165, 166, 169, 177, 178, 180, 182, 189, 190, 195]"
Shakespeare,L0,short,101,56,45,13,0.495,200,"[1, 2, 3, 4, 5, 6, 7, 8, 10, 11, 14, 15, 16, 17, 18, 19, 24, 25, 26, 27, 29, 31, 33, 35, 36, 37, 39, 41, 47, 48, 49, 51, 52, 53, 56, 57, 58, 60, 64, 65, 66, 67, 69, 74, 75, 76, 77, 78, 80, 86, 87, 91, 92, 93, 94, 95, 96, 97, 98, 100, 106, 107, 108, 110, 111, 112, 114, 116, 119, 120, 127, 128, 129, 131, 134, 136, 137, 138, 139, 140, 147, 149, 150, 152, 159, 160, 161, 162, 163, 171, 172, 173, 174, 176, 184, 186, 192, 193, 194, 195, 199]"
Shakespeare,L0,short,96,38,58,3,0.5102,196,"[0, 1, 2, 3, 4, 6, 9, 10, 11, 12, 14, 17, 18, 19, 20, 23, 27, 28, 29, 30, 31, 32, 33, 34, 35, 36, 37, 38, 39, 40, 41, 42, 44, 54, 57, 58, 59, 60, 61, 62, 64, 70, 71, 72, 73, 74, 75, 76, 78, 79, 80, 81, 82, 84, 91, 92, 93, 94, 95, 96, 97, 102, 103, 104, 109, 115, 117, 118, 119, 120, 121, 122, 123, 124, 125, 127, 128, 130, 132, 134, 142, 143, 151, 153, 155, 163, 164, 171, 173, 174, 181, 183, 184, 192, 193, 194]"
Shakespeare,L0,short,96,59,37,10,0.5102,196,"[0, 1, 3, 4, 5, 6, 7, 8, 13, 17, 18, 19, 20, 21, 23, 24, 25, 26, 27, 29, 33, 34, 36, 37, 38, 39, 40, 42, 43, 45, 47, 50, 54, 55, 56, 57, 59, 61, 62, 63, 69, 70, 71, 72, 77, 78, 79, 80, 81, 82, 83, 84, 85, 86, 87, 88, 89, 90, 91, 93, 99, 101, 102, 105, 106, 107, 108, 109, 113, 119, 121, 123, 125, 126, 128, 129, 130, 132, 133, 134, 136, 144, 145, 149, 156, 163, 164, 165, 166, 168, 175, 176, 177, 185, 186, 187]"
Shakespeare,L0,short,98,44,54,6,0.5051,198,"[0, 1, 2, 3, 5, 7, 8, 10, 12, 15, 16, 17, 18, 19, 20, 24, 25, 26, 27, 28, 31, 32, 33, 34, 35, 36, 37, 38, 39, 40, 46, 47, 50, 52, 54, 55, 56, 57, 58, 59, 60, 67, 69, 70, 71, 72, 73, 74, 76, 78, 79, 80, 86, 89, 90, 93, 94, 95, 96, 99, 100, 101, 104, 109, 111, 112, 113, 115, 116, 117, 119, 121, 122, 124, 132, 134, 138, 141, 142, 143, 144, 151, 152, 153, 154, 161, 163, 164, 168, 175, 176, 177, 178, 185, 187, 188, 195, 196]"
Shakespeare,L0,short,96,58,38,9,0.5102,196,"[0, 1, 3, 4, 5, 7, 9, 11, 13, 14, 15, 17, 18, 19, 20, 22, 24, 26, 27, 30, 31, 32, 37, 38, 40, 42, 43, 46, 49, 50, 51, 52, 56, 58, 59, 60, 61, 63, 64, 65, 66, 67, 69, 70, 72, 73, 79, 80, 81, 82, 83, 84, 85, 86, 87, 88, 90, 91, 92, 95, 102, 103, 105, 106, 109, 110, 113, 114, 117, 125, 126, 127, 128, 129, 131, 132, 133, 134, 135, 137, 146, 153, 154, 155, 157, 166, 172, 174, 175, 177, 178, 184, 186, 187, 188, 189]"
Shakespeare,L0,short,97,43,54,2,0.5076,197,"[0, 3, 7, 9, 12, 14, 15, 16, 18, 19, 20, 21, 24, 25, 26, 27, 29, 30, 33, 35, 36, 37, 38, 39, 40, 42, 43, 44, 46, 47, 48, 50, 51, 57, 58, 59, 60, 61, 62, 63, 64, 67, 68, 69, 70, 71, 76, 77, 78, 79, 81, 82, 85, 87, 88, 89, 91, 92, 93, 101, 102, 103, 104, 105, 106, 107, 108, 110, 111, 113, 120, 121, 122, 123, 125, 128, 133, 134, 143, 144, 150, 151, 152, 154, 155, 164, 165, 166, 167, 174, 175, 176, 177, 184, 186, 187, 188]"
Shakespeare,L0,short,97,45,52,11,0.5076,197,"[0, 3, 4, 5, 7, 8, 10, 12, 13, 14, 16, 17, 18, 19, 20, 21, 22, 23, 24, 26, 28, 29, 31, 36, 38, 40, 41, 42, 43, 45, 46, 48, 49, 51, 52, 57, 58, 59, 60, 61, 63, 65, 66, 67, 70, 72, 73, 78, 80, 81, 82, 84, 87, 89, 94, 98, 100, 101, 103, 104, 107, 109, 110, 111, 112, 113, 114, 115, 116, 118, 124, 125, 127, 131, 134, 136, 137, 138, 144, 145, 146, 147, 149, 156, 157, 158, 159, 167, 169, 176, 177, 178, 179, 180, 181, 189, 195]"
Shakespeare,L0,short,89,41,48,11,0.5291,189,"[0, 2, 3, 4, 5, 6, 7, 8, 10, 12, 15, 16, 17, 19, 21, 22, 23, 24, 25, 26, 28, 31, 32, 34, 35, 40, 41, 43, 46, 48, 49, 51, 52, 54, 55, 56, 57, 60, 64, 65, 66, 67, 68, 69, 73, 74, 75, 78, 79, 84, 86, 87, 89, 91, 92, 93, 96, 100, 101, 106, 108, 109, 111, 116, 117, 118, 119, 121, 125, 131, 133, 136, 140, 141, 143, 145, 150, 151, 154, 157, 165, 170, 177, 182, 183, 184, 185, 186, 187]"
Shakespeare,L0,short,94,56,38,15,0.5155,194,"[0, 2, 3, 4, 6, 8, 9, 10, 11, 12, 15, 16, 24, 25, 26, 27, 28, 29, 30, 31, 33, 34, 36, 37, 42, 46, 48, 49, 52, 53, 54, 55, 56, 57, 58, 59, 60, 62, 66, 67, 69, 70, 71, 75, 76, 77, 78, 79, 80, 81, 83, 88, 91, 92, 93, 94, 95, 96, 97, 98, 100, 102, 106, 114, 115, 116, 118, 119, 120, 122, 123, 124, 126, 127, 134, 137, 138, 145, 149, 150, 158, 159, 161, 167, 168, 169, 171, 177, 178, 179, 180, 182, 190, 192]"
Shakespeare,L0,short,88,48,40,16,0.5319,188,"[1, 2, 3, 4, 5, 6, 7, 11, 14, 16, 18, 21, 24, 25, 26, 29, 30, 32, 33, 36, 38, 40, 42, 43, 44, 45, 46, 49, 50, 51, 52, 54, 55, 56, 57, 58, 60, 61, 65, 66, 67, 69, 70, 71, 72, 73, 75, 76, 80, 82, 87, 88, 90, 91, 97, 98, 100, 101, 102, 104, 105, 110, 112, 114, 116, 117, 118, 120, 121, 123, 128, 134, 136, 140, 143, 146, 153, 155, 157, 163, 167, 169, 173, 175, 178, 184, 185, 186]"
Shakespeare,L0,short,94,50,44,10,0.5155,194,"[1, 3, 5, 7, 9, 10, 12, 14, 15, 18, 20, 22, 23, 24, 25, 26, 30, 31, 32, 35, 36, 38, 39, 42, 44, 45, 46, 47, 49, 50, 51, 52, 53, 54, 55, 57, 59, 60, 64, 65, 66, 71, 76, 77, 78, 79, 82, 85, 86, 87, 89, 90, 92, 93, 94, 95, 96, 97, 98, 99, 100, 108, 110, 111, 112, 114, 115, 116, 117, 118, 122, 123, 124, 128, 135, 136, 137, 143, 144, 145, 146, 150, 157, 158, 164, 165, 168, 174, 177, 178, 184, 186, 187, 189]"
Shakespeare,L0,short,93,37,56,10,0.5181,193,"[0, 1, 2, 3, 7, 8, 9, 10, 12, 14, 16, 18, 19, 23, 29, 30, 31, 32, 33, 34, 35, 39, 42, 44, 45, 46, 47, 48, 49, 51, 52, 54, 55, 56, 59, 61, 63, 67, 68, 70, 71, 72, 73, 74, 75, 77, 78, 79, 80, 81, 82, 83, 84, 85, 91, 93, 94, 95, 97, 98, 99, 102, 103, 104, 105, 106, 111, 117, 118, 120, 121, 123, 125, 126, 132, 138, 139, 140, 143, 144, 145, 151, 153, 154, 155, 163, 165, 166, 174, 175, 176, 183, 187]"
Shakespeare,L0,short,101,56,45,4,0.495,200,"[0, 1, 2, 4, 5, 6, 7, 8, 9, 14, 16, 17, 19, 21, 22, 25, 26, 27, 28, 29, 33, 34, 37, 39, 40, 41, 43, 44, 45, 47, 48, 49, 50, 51, 52, 57, 59, 60, 62, 63, 64, 65, 66, 68, 69, 70, 71, 72, 74, 75, 77, 84, 86, 88, 89, 90, 92, 93, 95, 98, 104, 105, 107, 110, 111, 112, 113, 115, 116, 117, 118, 125, 126, 127, 128, 129, 130, 131, 133, 134, 136, 137, 138, 148, 155, 157, 158, 159, 160, 161, 169, 171, 178, 179, 180, 181, 188, 189, 190, 191, 192]"
Shakespeare,L0,short,95,42,53,6,0.5128,195,"[0, 1, 3, 4, 6, 8, 10, 12, 13, 17, 19, 20, 22, 23, 24, 26, 27, 28, 29, 33, 34, 35, 37, 39, 41, 42, 44, 45, 47, 48, 49, 50, 54, 56, 58, 60, 61, 63, 64, 66, 67, 71, 76, 77, 78, 79, 81, 83, 85, 87, 88, 89, 90, 91, 93, 97, 98, 102, 104, 105, 106, 107, 108, 112, 113, 114, 123, 125, 126, 128, 129, 131, 132, 133, 134, 135, 136, 145, 146, 147, 153, 154, 155, 156, 157, 160, 169, 171, 178, 179, 180, 187, 188, 189, 190]"
Shakespeare,L0,short,98,52,46,8,0.5051,198,"[3, 4, 5, 7, 9, 13, 14, 15, 17, 18, 19, 20, 23, 25, 27, 28, 29, 30, 32, 33, 35, 38, 40, 41, 42, 45, 48, 50, 51, 52, 56, 57, 58, 59, 60, 63, 65, 67, 69, 71, 72, 74, 75, 76, 77, 78, 79, 85, 88, 89, 90, 91, 92, 93, 94, 95, 96, 97, 98, 99, 100, 101, 102, 103, 105, 111, 112, 117, 118, 119, 120, 122, 123, 125, 132, 134, 135, 140, 141, 143, 144, 145, 152, 153, 154, 155, 162, 163, 164, 167, 175, 176, 183, 187, 192, 194, 195, 196]"
Shakespeare,L0,short,100,45,55,8,0.5,200,"[0, 1, 2, 3, 5, 8, 9, 10, 13, 14, 16, 18, 20, 22, 23, 24, 26, 27, 28, 29, 30, 31, 32, 34, 35, 36, 39, 41, 48, 49, 50, 52, 54, 56, 57, 59, 61, 63, 70, 73, 74, 76, 77, 78, 79, 81, 82, 84, 87, 88, 91, 92, 93, 95, 97, 99, 101, 102, 103, 106, 107, 109, 110, 111, 112, 114, 116, 117, 118, 120, 121, 124, 131, 132, 133, 136, 138, 141, 143, 149, 151, 152, 154, 161, 162, 163, 165, 173, 174, 175, 182, 183, 185, 186, 187, 192, 194, 195, 196, 198]"
Shakespeare,L0,short,91,36,55,11,0.5236,191,"[0, 3, 4, 6, 8, 10, 11, 13, 15, 16, 17, 18, 19, 22, 24, 26, 27, 29, 30, 32, 35, 36, 39, 42, 43, 45, 46, 47, 48, 51, 52, 53, 55, 57, 60, 61, 65, 68, 70, 71, 72, 73, 75, 78, 80, 81, 84, 85, 86, 87, 88, 89, 90, 91, 92, 93, 94, 95, 97, 98, 102, 108, 109, 110, 112, 114, 115, 118, 119, 120, 121, 130, 132, 136, 141, 146, 147, 149, 150, 151, 156, 157, 159, 160, 161, 168, 174, 176, 182, 184, 185]"
Shakespeare,L0,short,93,38,55,6,0.5181,193,"[0, 1, 2, 4, 5, 8, 9, 12, 13, 14, 15, 17, 18, 19, 20, 21, 23, 25, 27, 29, 33, 34, 37, 38, 39, 40, 41, 43, 44, 45, 46, 47, 48, 49, 55, 57, 58, 59, 60, 62, 65, 66, 68, 70, 76, 77, 78, 79, 80, 82, 83, 86, 87, 88, 89, 90, 91, 95, 100, 102, 103, 104, 105, 106, 107, 108, 109, 110, 111, 112, 113, 123, 126, 129, 130, 131, 134, 142, 145, 153, 155, 162, 164, 165, 166, 172, 173, 174, 175, 177, 183, 185, 186]"
Shakespeare,L0,short,93,43,50,14,0.5181,193,"[2, 3, 4, 6, 7, 8, 9, 11, 14, 17, 21, 22, 23, 25, 26, 27, 28, 29, 30, 32, 33, 34, 37, 40, 42, 43, 44, 47, 48, 49, 51, 52, 53, 54, 57, 58, 65, 66, 67, 73, 76, 77, 79, 80, 82, 84, 85, 86, 87, 88, 90, 92, 93, 94, 96, 97, 98, 99, 100, 105, 106, 109, 110, 111, 114, 115, 116, 117, 118, 121, 122, 130, 131, 132, 135, 136, 137, 140, 141, 142, 144, 151, 152, 153, 157, 165, 167, 174, 175, 176, 180, 186, 188]"
Shakespeare,L0,short,90,35,55,8,0.5263,190,"[0, 2, 4, 5, 6, 9, 10, 12, 14, 15, 18, 19, 23, 24, 25, 26, 27, 28, 29, 31, 32, 33, 35, 36, 37, 38, 40, 46, 47, 48, 49, 50, 51, 53, 55, 58, 59, 61, 65, 66, 67, 69, 71, 72, 74, 77, 78, 81, 86, 88, 91, 92, 93, 96, 97, 99, 100, 101, 104, 105, 106, 111, 112, 113, 114, 115, 116, 117, 118, 119, 120, 121, 122, 124, 133, 136, 141, 142, 143, 147, 154, 156, 164, 167, 174, 175, 179, 185, 186, 187]"
Shakespeare,L0,short,95,52,43,5,0.5128,195,"[0, 1, 2, 3, 4, 5, 7, 8, 9, 13, 15, 16, 17, 20, 21, 23, 25, 26, 27, 28, 30, 31, 35, 36, 37, 38, 41, 42, 43, 45, 46, 47, 50, 51, 54, 59, 61, 63, 64, 65, 66, 67, 68, 70, 71, 73, 79, 80, 81, 82, 83, 85, 87, 89, 90, 92, 93, 94, 103, 104, 106, 108, 109, 113, 114, 120, 122, 125, 126, 127, 128, 130, 131, 132, 133, 136, 142, 143, 144, 145, 146, 147, 156, 157, 160, 161, 168, 174, 181, 186, 187, 188, 189, 190, 191]"
Shakespeare,L0,short,101,52,49,10,0.495,200,"[1, 2, 3, 4, 5, 6, 7, 8, 11, 14, 15, 16, 17, 19, 21, 24, 25, 27, 28, 29, 30, 31, 32, 34, 35, 36, 38, 39, 41, 46, 47, 48, 51, 52, 53, 55, 56, 57, 60, 61, 67, 68, 69, 70, 71, 72, 73, 76, 77, 78, 79, 81, 88, 89, 90, 91, 92, 93, 94, 95, 97, 99, 101, 102, 104, 107, 114, 115, 116, 118, 119, 120, 121, 123, 124, 125, 126, 127, 128, 137, 140, 146, 148, 151, 158, 159, 166, 167, 168, 169, 176, 177, 178, 179, 182, 189, 190, 196, 197, 198, 199]"
Shakespeare,L0,short,94,39,55,15,0.5155,194,"[0, 3, 4, 5, 6, 7, 8, 9, 12, 13, 14, 15, 17, 18, 19, 23, 24, 25, 26, 28, 30, 34, 35, 36, 37, 39, 40, 41, 42, 43, 44, 45, 48, 49, 50, 51, 59, 60, 61, 63, 66, 67, 68, 69, 70, 71, 72, 73, 75, 80, 82, 83, 85, 87, 89, 91, 92, 93, 94, 100, 101, 104, 105, 106, 107, 108, 109, 110, 113, 114, 115, 123, 130, 132, 133, 134, 135, 136, 144, 145, 146, 152, 153, 154, 155, 156, 164, 165, 166, 174, 176, 184, 185, 186]"
Shakespeare,L0,short,98,45,53,8,0.5051,198,"[1, 2, 4, 5, 6, 7, 8, 9, 11, 14, 15, 16, 19, 23, 26, 28, 29, 30, 31, 33, 36, 37, 38, 39, 40, 41, 42, 44, 45, 46, 47, 49, 51, 52, 53, 58, 59, 60, 61, 62, 64, 65, 66, 67, 70, 71, 72, 73, 75, 80, 81, 82, 83, 86, 87, 88, 89, 91, 92, 94, 95, 96, 97, 100, 107, 110, 112, 113, 114, 117, 119, 120, 122, 130, 131, 133, 135, 136, 137, 138, 139, 141, 148, 149, 150, 151, 159, 160, 161, 162, 173, 180, 182, 183, 184, 191, 192, 194]"
Shakespeare,L0,short,95,44,51,12,0.5128,195,"[0, 2, 3, 4, 5, 7, 8, 9, 12, 13, 14, 16, 17, 18, 20, 22, 26, 28, 31, 32, 33, 35, 37, 38, 42, 45, 47, 49, 51, 52, 55, 56, 57, 58, 59, 61, 62, 66, 67, 69, 70, 71, 74, 75, 77, 79, 80, 81, 83, 87, 88, 89, 90, 92, 93, 95, 97, 98, 99, 100, 101, 104, 110, 113, 115, 117, 118, 120, 121, 122, 125, 133, 134, 138, 141, 142, 145, 151, 152, 153, 155, 162, 163, 164, 170, 171, 172, 174, 176, 183, 184, 186, 187, 188, 193]"
Shakespeare,L0,short,94,47,47,2,0.5155,194,"[0, 1, 5, 6, 7, 8, 9, 11, 12, 13, 14, 15, 16, 17, 18, 19, 20, 21, 22, 24, 27, 28, 29, 35, 36, 37, 39, 42, 44, 45, 47, 49, 50, 51, 56, 58, 60, 62, 63, 64, 65, 66, 70, 71, 73, 78, 79, 80, 82, 83, 86, 90, 91, 92, 94, 98, 99, 100, 102, 105, 106, 107, 110, 112, 116, 121, 122, 125, 126, 127, 129, 133, 134, 136, 138, 145, 148, 155, 156, 158, 163, 164, 165, 166, 167, 168, 175, 177, 178, 184, 185, 186, 188, 189]"
Shakespeare,L0,short,94,36,58,3,0.5155,194,"[1, 2, 3, 5, 6, 8, 9, 10, 11, 12, 13, 16, 17, 19, 20, 23, 25, 27, 29, 30, 31, 32, 33, 34, 35, 38, 40, 45, 46, 47, 48, 49, 50, 51, 54, 56, 58, 59, 60, 61, 68, 70, 72, 73, 74, 75, 77, 79, 81, 82, 83, 88, 89, 90, 92, 94, 95, 96, 97, 99, 101, 103, 104, 109, 110, 112, 113, 115, 117, 118, 119, 121, 122, 123, 124, 132, 133, 134, 135, 140, 141, 142, 145, 146, 154, 155, 157, 164, 165, 167, 168, 176, 179, 189]"
Shakespeare,L0,short,95,53,42,14,0.5128,195,"[1, 2, 3, 4, 5, 7, 10, 13, 14, 15, 16, 17, 18, 20, 21, 23, 26, 29, 30, 32, 36, 37, 38, 39, 41, 42, 46, 47, 49, 50, 52, 53, 55, 61, 62, 64, 65, 66, 69, 70, 71, 72, 73, 76, 81, 82, 83, 85, 86, 88, 89, 90, 91, 92, 93, 97, 102, 104, 105, 106, 107, 110, 111, 113, 114, 115, 116, 117, 123, 124, 125, 127, 128, 130, 131, 132, 133, 134, 135, 136, 137, 141, 149, 151, 157, 158, 159, 160, 168, 169, 171, 178, 180, 189, 190]"
Shakespeare,L0,short,92,46,46,9,0.5208,192,"[0, 2, 4, 5, 6, 7, 8, 10, 11, 12, 13, 14, 15, 17, 18, 20, 25, 28, 30, 31, 32, 33, 35, 36, 37, 40, 44, 45, 49, 50, 51, 53, 54, 60, 63, 65, 66, 67, 69, 72, 74, 75, 78, 80, 81, 82, 83, 85, 88, 90, 91, 93, 95, 96, 97, 99, 100, 101, 102, 103, 104, 108, 111, 112, 117, 118, 121, 122, 125, 131, 133, 135, 140, 141, 142, 143, 145, 151, 152, 153, 154, 155, 156, 162, 163, 164, 167, 173, 179, 185, 186, 190]"
Shakespeare,L0,short,91,57,34,8,0.5236,191,"[3, 4, 5, 7, 9, 11, 16, 17, 18, 19, 21, 22, 24, 25, 27, 29, 31, 33, 34, 35, 36, 37, 39, 42, 45, 46, 48, 50, 51, 52, 54, 60, 62, 65, 66, 67, 68, 70, 72, 76, 77, 78, 79, 80, 83, 85, 86, 88, 89, 90, 91, 92, 100, 104, 106, 108, 109, 110, 111, 112, 113, 114, 115, 118, 119, 121, 126, 127, 128, 129, 131, 132, 134, 139, 141, 148, 155, 160, 161, 163, 164, 172, 173, 174, 175, 181, 182, 183, 184, 185, 188]"
Shakespeare,L0,short,93,51,42,15,0.5181,193,"[0, 2, 3, 4, 5, 6, 7, 8, 9, 10, 11, 15, 16, 17, 18, 23, 24, 25, 27, 28, 29, 30, 31, 33, 38, 39, 40, 41, 42, 43, 45, 49, 52, 54, 60, 61, 63, 67, 69, 71, 72, 75, 77, 80, 82, 83, 84, 90, 91, 94, 95, 97, 99, 100, 101, 102, 103, 106, 107, 108, 109, 110, 112, 117, 122, 125, 126, 128, 130, 132, 136, 137, 142, 144, 146, 147, 148, 153, 154, 155, 156, 157, 158, 166, 168, 170, 176, 180, 184, 188, 189, 190, 191]"
Shakespeare,L0,short,95,49,46,8,0.5128,195,"[1, 5, 6, 8, 11, 13, 14, 15, 18, 19, 20, 21, 22, 23, 24, 26, 28, 29, 30, 36, 37, 38, 39, 40, 41, 42, 44, 45, 46, 47, 48, 50, 54, 61, 65, 66, 67, 71, 72, 73, 75, 77, 78, 79, 81, 82, 83, 84, 85, 86, 88, 90, 91, 92, 93, 94, 99, 101, 103, 104, 106, 107, 108, 109, 110, 111, 112, 113, 114, 115, 121, 122, 124, 125, 126, 127, 128, 129, 130, 132, 133, 134, 135, 136, 137, 152, 159, 166, 167, 169, 180, 188, 189, 190, 191]"
Shakespeare,L0,short,98,42,56,9,0.5051,198,"[2, 3, 4, 5, 7, 9, 11, 15, 17, 18, 19, 20, 22, 23, 25, 26, 28, 29, 30, 31, 35, 36, 37, 38, 39, 40, 41, 42, 43, 44, 45, 46, 47, 48, 50, 51, 55, 61, 63, 64, 65, 66, 67, 68, 69, 70, 71, 72, 74, 80, 84, 85, 86, 87, 88, 89, 91, 92, 93, 100, 101, 103, 105, 106, 108, 109, 111, 112, 113, 114, 116, 117, 125, 127, 128, 129, 131, 132, 133, 137, 138, 147, 148, 150, 156, 157, 158, 160, 168, 169, 177, 179, 180, 181, 188, 189, 191, 192]"
Shakespeare,L0,short,91,38,53,5,0.5236,191,"[1, 3, 5, 6, 7, 8, 9, 11, 12, 14, 15, 16, 17, 18, 19, 20, 21, 22, 25, 26, 27, 28, 29, 35, 37, 38, 39, 40, 41, 43, 44, 45, 48, 51, 60, 61, 62, 63, 65, 66, 68, 69, 72, 76, 78, 79, 80, 81, 83, 86, 89, 90, 92, 93, 94, 96, 97, 103, 104, 105, 107, 108, 109, 110, 112, 113, 114, 116, 118, 124, 128, 131, 133, 134, 136, 138, 146, 147, 148, 154, 155, 158, 164, 168, 174, 175, 176, 178, 183, 186, 188]"
Shakespeare,L0,short,96,42,54,11,0.5102,196,"[0, 1, 2, 5, 6, 9, 10, 11, 12, 14, 15, 16, 17, 18, 19, 21, 25, 26, 27, 28, 29, 31, 32, 33, 35, 37, 39, 41, 46, 47, 48, 49, 50, 51, 52, 53, 54, 55, 56, 57, 61, 62, 72, 73, 74, 76, 77, 81, 82, 83, 85, 89, 93, 96, 97, 98, 101, 102, 104, 110, 114, 115, 116, 118, 119, 121, 123, 125, 126, 128, 129, 138, 140, 145, 147, 148, 149, 150, 153, 160, 161, 163, 169, 170, 171, 172, 177, 178, 179, 181, 182, 188, 189, 190, 191, 192]"
Shakespeare,L0,short,95,31,64,13,0.5128,195,"[0, 1, 4, 5, 6, 8, 9, 10, 12, 14, 16, 17, 18, 19, 22, 23, 24, 25, 26, 27, 28, 31, 32, 33, 34, 35, 36, 37, 38, 39, 49, 50, 51, 52, 53, 54, 55, 56, 58, 59, 61, 67, 68, 69, 72, 75, 77, 78, 79, 80, 81, 82, 83, 84, 85, 86, 87, 94, 96, 97, 98, 101, 102, 103, 104, 105, 106, 107, 108, 109, 111, 118, 119, 120, 121, 122, 123, 124, 125, 126, 127, 128, 129, 130, 131, 142, 149, 151, 159, 160, 162, 170, 171, 174, 182]"
Shakespeare,L0,short,94,44,50,11,0.5155,194,"[0, 2, 4, 5, 6, 7, 9, 11, 14, 15, 16, 17, 18, 19, 20, 25, 27, 28, 29, 30, 33, 34, 40, 42, 44, 48, 49, 52, 53, 55, 58, 59, 60, 62, 63, 64, 68, 70, 71, 72, 73, 74, 75, 76, 77, 78, 79, 81, 82, 83, 86, 90, 91, 92, 94, 98, 99, 101, 102, 103, 105, 107, 112, 113, 115, 116, 121, 125, 126, 127, 128, 134, 135, 136, 138, 144, 146, 148, 156, 157, 158, 165, 166, 167, 168, 174, 175, 176, 177, 178, 185, 186, 188, 189]"
Shakespeare,L0,short,95,33,62,9,0.5128,195,"[2, 4, 7, 8, 10, 12, 13, 15, 16, 17, 21, 23, 25, 28, 30, 31, 33, 35, 36, 37, 38, 43, 44, 45, 46, 47, 49, 50, 51, 53, 54, 56, 59, 63, 64, 65, 66, 70, 73, 74, 75, 78, 81, 82, 83, 84, 85, 86, 87, 89, 90, 91, 92, 95, 97, 98, 100, 103, 105, 106, 107, 112, 113, 114, 115, 116, 120, 127, 128, 129, 130, 133, 135, 136, 137, 138, 142, 150, 155, 156, 157, 160, 168, 169, 171, 177, 179, 181, 182, 186, 187, 188, 190, 191, 192]"
Shakespeare,L0,short,97,48,49,6,0.5076,197,"[0, 2, 3, 7, 8, 9, 10, 12, 13, 15, 16, 17, 18, 19, 21, 22, 23, 24, 26, 27, 28, 29, 34, 35, 37, 39, 41, 42, 43, 44, 45, 46, 48, 49, 55, 56, 57, 58, 59, 60, 61, 62, 63, 64, 66, 68, 70, 72, 75, 81, 82, 84, 85, 86, 87, 88, 89, 90, 91, 94, 101, 103, 104, 105, 106, 107, 108, 110, 112, 113, 115, 122, 123, 124, 125, 126, 127, 128, 131, 133, 134, 135, 136, 146, 147, 153, 154, 157, 167, 168, 169, 170, 172, 180, 181, 189, 191]"
Shakespeare,L0,short,91,53,38,5,0.5236,191,"[1, 2, 3, 4, 5, 6, 7, 9, 13, 15, 18, 20, 21, 22, 23, 24, 25, 26, 27, 28, 29, 33, 34, 36, 38, 39, 40, 44, 45, 46, 47, 48, 49, 51, 58, 59, 60, 61, 62, 64, 65, 67, 68, 69, 71, 76, 78, 79, 80, 83, 84, 85, 86, 87, 88, 89, 90, 91, 92, 98, 100, 101, 102, 103, 104, 105, 107, 108, 112, 121, 122, 123, 124, 125, 129, 130, 131, 132, 133, 141, 142, 143, 152, 154, 164, 171, 172, 173, 174, 176, 185]"
Shakespeare,L0,short,95,51,44,12,0.5128,195,"[0, 1, 2, 3, 5, 7, 9, 11, 16, 18, 19, 20, 22, 23, 25, 27, 28, 30, 31, 34, 35, 37, 38, 40, 46, 48, 49, 50, 51, 52, 55, 56, 58, 59, 60, 61, 62, 64, 65, 67, 68, 69, 70, 75, 81, 82, 84, 86, 87, 88, 89, 91, 92, 94, 97, 98, 103, 106, 108, 110, 111, 113, 119, 120, 121, 122, 123, 124, 125, 126, 127, 130, 131, 133, 134, 136, 142, 143, 144, 145, 151, 152, 154, 155, 162, 163, 164, 166, 173, 174, 176, 184, 185, 186, 187]"
Shakespeare,L0,short,99,58,41,11,0.5025,199,"[5, 6, 7, 8, 12, 14, 16, 18, 19, 21, 22, 23, 26, 27, 28, 29, 30, 32, 34, 35, 37, 39, 43, 44, 47, 48, 50, 51, 52, 53, 54, 57, 58, 61, 64, 65, 66, 67, 68, 70, 72, 73, 75, 76, 80, 83, 85, 86, 90, 92, 93, 94, 96, 97, 98, 100, 101, 102, 103, 104, 106, 111, 112, 114, 116, 120, 122, 123, 124, 125, 126, 129, 136, 137, 138, 139, 140, 145, 146, 147, 149, 150, 151, 158, 159, 160, 161, 167, 169, 170, 171, 173, 180, 181, 182, 183, 191, 192, 193]"
Shakespeare,L0,short,96,62,34,6,0.5102,196,"[0, 1, 2, 3, 5, 7, 9, 12, 13, 14, 15, 16, 17, 18, 19, 20, 22, 24, 26, 27, 29, 30, 35, 38, 39, 40, 42, 43, 45, 46, 47, 48, 49, 50, 52, 57, 61, 63, 65, 66, 67, 68, 70, 71, 72, 76, 77, 78, 79, 80, 81, 83, 84, 86, 88, 89, 90, 91, 92, 98, 100, 101, 102, 103, 104, 105, 106, 107, 108, 109, 110, 112, 113, 114, 123, 124, 127, 128, 132, 133, 136, 143, 145, 151, 152, 153, 155, 164, 165, 174, 175, 183, 184, 185, 193, 194]"
Shakespeare,L0,short,95,57,38,10,0.5128,195,"[0, 1, 2, 3, 5, 6, 7, 9, 12, 14, 15, 16, 17, 18, 20, 21, 22, 23, 24, 25, 26, 27, 28, 29, 30, 31, 32, 39, 40, 41, 42, 43, 45, 46, 47, 48, 49, 50, 52, 60, 61, 64, 65, 67, 68, 70, 71, 73, 79, 80, 81, 85, 86, 87, 90, 92, 93, 99, 101, 104, 105, 106, 107, 108, 110, 111, 113, 120, 121, 122, 123, 124, 125, 126, 128, 129, 130, 131, 132, 133, 144, 145, 151, 152, 153, 154, 158, 166, 170, 177, 178, 184, 185, 186, 188]"
Shakespeare,L0,short,94,38,56,7,0.5155,194,"[0, 1, 2, 4, 5, 7, 8, 9, 10, 14, 17, 18, 19, 21, 22, 23, 25, 26, 27, 28, 29, 30, 34, 35, 37, 39, 40, 41, 42, 43, 44, 46, 51, 53, 60, 61, 62, 63, 65, 66, 67, 68, 69, 70, 71, 72, 77, 81, 82, 83, 85, 87, 88, 89, 91, 94, 103, 104, 107, 109, 111, 112, 117, 119, 120, 121, 122, 125, 127, 128, 129, 132, 134, 135, 143, 144, 145, 150, 152, 154, 155, 156, 163, 166, 168, 169, 172, 178, 179, 180, 185, 186, 188, 190]"
Shakespeare,L0,short,98,35,63,12,0.5051,198,"[0, 1, 4, 5, 7, 8, 10, 12, 13, 14, 16, 17, 18, 19, 22, 23, 27, 28, 29, 31, 36, 37, 38, 39, 40, 41, 43, 45, 46, 47, 48, 49, 50, 51, 56, 58, 60, 61, 62, 66, 67, 68, 69, 71, 74, 80, 81, 82, 85, 86, 87, 88, 90, 91, 92, 93, 94, 95, 100, 103, 104, 106, 107, 110, 111, 112, 113, 114, 115, 116, 117, 120, 129, 131, 132, 133, 135, 136, 137, 138, 139, 147, 148, 149, 153, 154, 161, 162, 163, 164, 165, 166, 168, 178, 185, 188, 195, 196]"
Shakespeare,L0,short,99,44,55,5,0.5025,199,"[0, 1, 2, 4, 6, 8, 10, 12, 19, 20, 21, 23, 25, 26, 27, 29, 31, 32, 33, 34, 35, 36, 37, 38, 39, 40, 41, 42, 44, 46, 47, 48, 49, 55, 56, 57, 58, 59, 60, 61, 62, 63, 64, 65, 67, 68, 69, 71, 80, 81, 84, 85, 86, 87, 88, 89, 90, 92, 98, 100, 101, 102, 103, 104, 105, 107, 108, 109, 111, 112, 113, 121, 122, 125, 126, 127, 128, 129, 130, 131, 132, 134, 143, 150, 152, 153, 160, 161, 163, 172, 173, 180, 181, 183, 190, 192, 193, 194, 195]"
Shakespeare,L0,short,93,59,34,13,0.5181,193,"[1, 2, 3, 5, 7, 9, 10, 11, 12, 13, 14, 15, 16, 17, 21, 23, 28, 29, 30, 35, 36, 37, 38, 39, 40, 41, 42, 43, 45, 46, 48, 52, 56, 57, 61, 63, 64, 65, 66, 67, 68, 69, 70, 71, 72, 75, 80, 81, 83, 84, 85, 86, 87, 88, 89, 90, 92, 95, 100, 102, 103, 104, 106, 108, 109, 110, 111, 112, 113, 115, 122, 124, 125, 126, 127, 128, 130, 132, 133, 138, 147, 153, 154, 157, 166, 168, 175, 176, 177, 183, 185, 186, 187]"
Shakespeare,L0,short,95,41,54,15,0.5128,195,"[0, 1, 5, 6, 7, 8, 11, 12, 13, 14, 15, 16, 17, 18, 19, 20, 21, 26, 27, 28, 31, 32, 34, 35, 41, 44, 45, 46, 49, 50, 53, 54, 55, 56, 57, 59, 60, 65, 68, 69, 70, 71, 72, 73, 74, 75, 77, 78, 79, 81, 82, 87, 90, 91, 92, 93, 94, 95, 96, 97, 98, 99, 100, 101, 102, 103, 111, 112, 114, 115, 116, 117, 118, 119, 121, 122, 123, 124, 126, 127, 128, 129, 132, 141, 148, 149, 152, 163, 169, 170, 179, 181, 189, 190, 193]"
Shakespeare,L0,short,95,53,42,15,0.5128,195,"[0, 1, 3, 5, 6, 7, 11, 12, 16, 17, 18, 19, 21, 23, 24, 25, 27, 29, 34, 35, 38, 39, 40, 43, 44, 45, 46, 48, 49, 50, 52, 54, 55, 56, 57, 58, 59, 61, 66, 67, 68, 69, 70, 72, 73, 74, 76, 78, 79, 80, 85, 89, 90, 91, 92, 98, 99, 100, 101, 103, 108, 109, 111, 112, 113, 114, 115, 116, 117, 118, 119, 120, 123, 124, 125, 133, 136, 141, 142, 143, 144, 145, 148, 150, 158, 159, 161, 167, 168, 169, 170, 175, 183, 191, 192]"
Shakespeare,L0,short,92,33,59,10,0.5208,192,"[0, 1, 2, 5, 6, 8, 9, 10, 11, 13, 15, 17, 18, 19, 20, 23, 24, 26, 27, 28, 29, 32, 33, 34, 35, 36, 37, 38, 39, 41, 42, 43, 45, 53, 54, 55, 58, 59, 60, 61, 62, 63, 65, 73, 74, 76, 77, 80, 81, 83, 84, 85, 88, 93, 95, 96, 97, 98, 99, 100, 102, 104, 105, 106, 107, 112, 117, 119, 121, 123, 124, 126, 127, 131, 132, 133, 135, 144, 145, 152, 154, 161, 168, 173, 174, 176, 178, 182, 186, 187, 188, 189]"
Shakespeare,L0,short,95,44,51,13,0.5128,195,"[0, 3, 4, 6, 7, 9, 11, 14, 15, 16, 17, 19, 20, 22, 24, 25, 26, 27, 28, 31, 32, 34, 35, 36, 38, 39, 40, 41, 44, 49, 52, 55, 57, 58, 59, 62, 63, 65, 68, 70, 71, 72, 73, 74, 75, 77, 79, 80, 81, 82, 85, 86, 89, 94, 95, 96, 97, 99, 100, 102, 106, 107, 111, 116, 117, 119, 120, 124, 125, 126, 127, 131, 138, 139, 141, 147, 149, 150, 156, 157, 159, 160, 167, 168, 169, 170, 177, 178, 179, 180, 187, 189, 190, 191, 192]"
Shakespeare,L0,short,96,54,42,8,0.5102,196,"[1, 2, 3, 5, 6, 7, 9, 11, 12, 14, 16, 17, 18, 19, 21, 24, 25, 27, 29, 31, 32, 33, 36, 41, 44, 45, 46, 48, 50, 51, 52, 53, 54, 55, 57, 58, 60, 61, 62, 64, 69, 70, 71, 72, 73, 74, 75, 78, 80, 81, 82, 83, 89, 90, 92, 93, 94, 96, 97, 99, 101, 102, 103, 109, 110, 111, 113, 114, 116, 118, 119, 120, 121, 122, 123, 130, 132, 134, 135, 139, 140, 141, 142, 143, 145, 155, 157, 164, 169, 176, 177, 178, 179, 187, 188, 189]"
Shakespeare,L0,short,101,49,52,10,0.495,200,"[0, 1, 2, 5, 6, 7, 9, 10, 13, 16, 18, 20, 22, 23, 24, 25, 26, 28, 30, 31, 35, 36, 37, 38, 40, 41, 42, 44, 45, 47, 48, 49, 50, 51, 53, 54, 55, 64, 65, 69, 70, 71, 72, 73, 75, 78, 82, 83, 84, 85, 86, 88, 89, 90, 91, 95, 96, 97, 101, 103, 104, 105, 106, 107, 109, 110, 111, 113, 115, 116, 118, 127, 128, 129, 131, 132, 133, 134, 137, 138, 146, 148, 154, 156, 157, 161, 162, 163, 170, 171, 172, 173, 175, 176, 177, 178, 180, 188, 192, 198, 199]"
Shakespeare,L0,short,94,54,40,13,0.5155,194,"[0, 2, 3, 5, 7, 9, 12, 17, 19, 26, 27, 28, 29, 30, 32, 33, 35, 37, 38, 42, 43, 45, 47, 48, 49, 50, 51, 53, 55, 57, 58, 59, 61, 63, 64, 69, 72, 73, 74, 77, 78, 81, 82, 83, 84, 85, 86, 87, 88, 89, 90, 91, 92, 95, 96, 98, 100, 103, 104, 105, 106, 108, 110, 112, 116, 118, 119, 121, 127, 128, 129, 132, 137, 138, 142, 150, 151, 156, 157, 159, 160, 162, 168, 169, 171, 177, 178, 179, 180, 181, 188, 189, 190, 191]"
Shakespeare,L0,short,94,54,40,6,0.5155,194,"[1, 5, 7, 8, 9, 10, 11, 14, 16, 17, 19, 21, 22, 23, 24, 26, 28, 29, 30, 31, 38, 39, 41, 42, 44, 45, 46, 47, 48, 49, 50, 51, 55, 57, 59, 60, 61, 62, 63, 64, 66, 69, 70, 71, 75, 77, 78, 79, 80, 81, 83, 84, 85, 86, 93, 97, 98, 100, 104, 105, 106, 107, 109, 110, 111, 112, 118, 119, 121, 122, 123, 125, 127, 128, 129, 131, 132, 134, 135, 138, 148, 155, 156, 157, 166, 167, 173, 174, 175, 178, 184, 186, 188, 189]"
Shakespeare,L50,short,81,39,42,15,0.5525,181,"[5, 6, 7, 9, 10, 13, 14, 16, 18, 19, 20, 24, 25, 26, 27, 28, 29, 30, 31, 32, 39, 40, 45, 46, 47, 48, 49, 50, 51, 52, 53, 55, 56, 57, 59, 62, 70, 73, 74, 75, 76, 77, 78, 80, 82, 88, 89, 90, 91, 92, 93, 95, 96, 97, 100, 104, 109, 112, 113, 116, 120, 121, 128, 130, 132, 136, 137, 138, 142, 148, 150, 153, 157, 163, 164, 166, 167, 169, 175, 177, 178]"
Shakespeare,L50,short,85,53,32,7,0.5405,185,"[4, 5, 8, 11, 12, 14, 15, 16, 17, 18, 19, 21, 27, 28, 33, 34, 36, 37, 38, 39, 40, 44, 51, 52, 55, 57, 58, 59, 61, 62, 63, 68, 72, 73, 75, 78, 79, 80, 81, 84, 87, 92, 93, 94, 95, 96, 97, 100, 101, 102, 103, 107, 108, 110, 111, 113, 115, 116, 120, 121, 123, 125, 131, 132, 133, 134, 135, 140, 141, 142, 143, 144, 145, 152, 156, 162, 163, 164, 165, 166, 173, 174, 175, 176, 177]"
Shakespeare,L50,short,84,60,24,12,0.5435,184,"[4, 5, 6, 7, 8, 9, 10, 11, 12, 13, 14, 15, 16, 17, 18, 19, 20, 27, 28, 31, 32, 33, 34, 35, 40, 41, 44, 50, 51, 54, 57, 58, 59, 60, 61, 62, 63, 73, 74, 75, 76, 77, 78, 79, 81, 82, 83, 84, 91, 95, 97, 98, 99, 101, 102, 104, 109, 110, 111, 112, 113, 114, 115, 117, 119, 121, 122, 123, 124, 125, 126, 131, 140, 146, 147, 148, 155, 156, 158, 166, 169, 176, 177, 179]"
Shakespeare,L50,short,88,50,38,7,0.5319,188,"[3, 4, 5, 8, 10, 11, 12, 13, 15, 16, 17, 19, 24, 25, 27, 28, 29, 31, 32, 33, 34, 35, 36, 37, 38, 40, 41, 44, 51, 54, 57, 59, 60, 61, 62, 63, 69, 70, 71, 72, 73, 74, 75, 78, 79, 81, 82, 83, 89, 92, 94, 95, 96, 97, 98, 99, 101, 102, 103, 104, 105, 106, 116, 118, 119, 120, 121, 122, 123, 125, 126, 127, 135, 136, 137, 143, 144, 145, 146, 147, 160, 167, 168, 169, 176, 177, 178, 180]"
Shakespeare,L50,short,85,45,40,11,0.5405,185,"[0, 1, 2, 3, 5, 6, 8, 12, 17, 18, 19, 20, 21, 23, 24, 25, 26, 27, 28, 31, 37, 38, 40, 41, 43, 44, 46, 48, 49, 52, 59, 60, 61, 62, 64, 65, 66, 71, 76, 77, 80, 83, 85, 87, 88, 89, 90, 91, 92, 101, 105, 106, 108, 109, 110, 111, 113, 115, 120, 121, 124, 125, 131, 132, 133, 134, 135, 141, 142, 143, 144, 145, 147, 152, 153, 154, 155, 156, 157, 158, 165, 166, 168, 170, 180]"
Shakespeare,L50,short,90,42,48,6,0.5263,190,"[1, 2, 3, 4, 6, 8, 9, 10, 18, 19, 20, 22, 23, 25, 26, 28, 30, 32, 37, 39, 40, 42, 43, 44, 45, 46, 48, 49, 53, 54, 55, 56, 58, 64, 65, 68, 69, 70, 71, 72, 74, 75, 76, 77, 84, 85, 86, 87, 89, 90, 91, 92, 93, 95, 96, 99, 105, 111, 112, 114, 115, 116, 117, 118, 119, 120, 121, 123, 130, 131, 134, 139, 140, 141, 142, 144, 151, 152, 155, 162, 163, 164, 172, 173, 175, 176, 184, 185, 186, 188]"
Shakespeare,L50,short,83,53,30,5,0.5464,183,"[4, 5, 7, 8, 10, 11, 13, 15, 16, 18, 19, 20, 25, 26, 27, 28, 29, 30, 34, 35, 36, 37, 38, 39, 40, 48, 50, 51, 52, 53, 58, 59, 60, 68, 69, 70, 71, 72, 75, 76, 77, 78, 80, 82, 87, 88, 89, 90, 92, 95, 97, 99, 100, 101, 106, 107, 108, 111, 112, 115, 116, 120, 121, 127, 128, 130, 131, 133, 134, 141, 143, 144, 151, 152, 153, 155, 162, 163, 164, 167, 173, 174, 176]"
Shakespeare,L50,short,86,41,45,7,0.5376,186,"[1, 2, 3, 6, 7, 8, 9, 16, 17, 19, 22, 23, 26, 28, 29, 30, 31, 35, 36, 37, 41, 42, 45, 46, 47, 49, 50, 51, 52, 58, 59, 62, 63, 64, 67, 70, 71, 72, 73, 74, 80, 81, 83, 85, 86, 87, 88, 89, 90, 92, 93, 95, 101, 103, 105, 106, 108, 109, 111, 112, 113, 114, 118, 124, 125, 126, 127, 128, 129, 134, 135, 137, 138, 139, 148, 149, 155, 159, 160, 161, 168, 169, 173, 180, 181, 182]"
Shakespeare,L50,short,83,39,44,7,0.5464,183,"[0, 2, 4, 6, 7, 8, 9, 17, 20, 21, 22, 23, 24, 25, 26, 27, 29, 34, 35, 36, 37, 40, 43, 46, 50, 51, 55, 56, 57, 58, 60, 61, 62, 64, 65, 68, 69, 71, 72, 78, 79, 80, 81, 82, 83, 84, 85, 86, 88, 89, 90, 92, 94, 96, 102, 104, 105, 106, 108, 110, 113, 114, 116, 118, 124, 126, 127, 128, 129, 135, 136, 137, 139, 140, 149, 151, 158, 160, 161, 169, 170, 173, 181]"
Shakespeare,L50,short,83,60,23,7,0.5464,183,"[4, 5, 6, 7, 9, 10, 11, 13, 14, 16, 18, 19, 20, 25, 26, 27, 28, 29, 30, 31, 33, 34, 35, 39, 41, 48, 50, 51, 52, 53, 55, 56, 57, 58, 59, 60, 61, 68, 70, 72, 73, 76, 78, 80, 81, 87, 88, 89, 90, 92, 94, 95, 96, 98, 99, 101, 102, 103, 105, 111, 114, 116, 117, 119, 120, 121, 122, 123, 124, 125, 133, 134, 137, 142, 143, 144, 146, 155, 162, 165, 172, 174, 175]"
Shakespeare,L50,short,83,34,49,12,0.5464,183,"[0, 3, 6, 7, 8, 9, 10, 12, 17, 18, 19, 20, 22, 23, 24, 26, 31, 32, 36, 37, 39, 41, 44, 45, 46, 48, 49, 53, 58, 59, 60, 64, 65, 66, 68, 69, 71, 73, 78, 80, 81, 82, 83, 84, 87, 88, 89, 90, 91, 92, 93, 99, 102, 103, 105, 106, 107, 108, 109, 110, 113, 114, 116, 123, 128, 133, 136, 137, 138, 139, 148, 152, 159, 165, 167, 168, 169, 170, 177, 178, 179, 180, 181]"
Shakespeare,L50,short,81,38,43,8,0.5525,181,"[1, 2, 3, 5, 6, 7, 9, 10, 16, 17, 18, 19, 20, 21, 22, 23, 28, 29, 33, 37, 42, 43, 45, 47, 53, 57, 59, 60, 61, 62, 64, 65, 66, 67, 68, 69, 70, 71, 72, 78, 79, 81, 82, 83, 86, 88, 89, 92, 93, 94, 99, 101, 102, 103, 105, 106, 108, 109, 110, 111, 114, 120, 121, 122, 124, 125, 131, 133, 136, 143, 144, 146, 151, 153, 154, 155, 162, 164, 165, 174, 175]"
Shakespeare,L50,short,83,56,27,10,0.5464,183,"[0, 1, 2, 3, 4, 5, 6, 7, 8, 9, 11, 17, 19, 21, 22, 24, 25, 26, 27, 28, 29, 30, 31, 39, 41, 42, 43, 44, 46, 47, 48, 51, 58, 59, 60, 64, 68, 70, 71, 77, 78, 79, 82, 83, 84, 86, 87, 88, 89, 92, 98, 99, 100, 101, 102, 104, 105, 108, 110, 114, 120, 121, 122, 125, 126, 127, 128, 130, 132, 134, 141, 142, 143, 148, 149, 152, 153, 161, 163, 169, 170, 173, 177]"
Shakespeare,L50,short,85,49,36,5,0.5405,185,"[0, 3, 6, 8, 9, 14, 15, 16, 17, 18, 19, 20, 21, 22, 26, 27, 30, 35, 36, 38, 39, 40, 44, 45, 46, 47, 48, 50, 51, 52, 58, 60, 63, 64, 65, 66, 67, 69, 71, 72, 79, 81, 82, 85, 87, 90, 91, 92, 93, 97, 98, 99, 100, 101, 103, 104, 105, 107, 109, 112, 113, 117, 122, 123, 124, 125, 126, 129, 130, 131, 132, 135, 137, 144, 146, 147, 149, 155, 156, 157, 158, 159, 166, 169, 180]"
Shakespeare,L50,short,86,42,44,4,0.5376,186,"[0, 2, 4, 5, 7, 9, 11, 15, 16, 17, 18, 19, 20, 21, 22, 23, 24, 25, 27, 29, 30, 31, 33, 34, 43, 47, 48, 50, 51, 55, 56, 57, 63, 64, 65, 66, 67, 68, 69, 70, 71, 73, 74, 75, 76, 77, 78, 86, 87, 88, 90, 91, 93, 94, 95, 97, 98, 107, 108, 109, 110, 112, 113, 114, 117, 118, 119, 121, 130, 133, 139, 140, 141, 142, 144, 145, 153, 156, 163, 164, 166, 174, 175, 176, 177, 179]"
Shakespeare,L50,short,83,37,46,15,0.5464,183,"[0, 3, 4, 5, 6, 7, 9, 10, 15, 17, 18, 21, 22, 24, 26, 27, 28, 29, 30, 36, 37, 38, 40, 42, 43, 44, 45, 46, 47, 48, 49, 51, 59, 60, 62, 63, 65, 66, 68, 69, 70, 72, 79, 80, 82, 83, 84, 87, 88, 90, 91, 92, 100, 101, 102, 105, 106, 107, 108, 109, 111, 113, 114, 115, 116, 122, 123, 126, 131, 132, 135, 137, 145, 146, 153, 154, 155, 156, 158, 166, 167, 173, 181]"
Shakespeare,L50,short,81,35,46,6,0.5525,181,"[4, 5, 8, 10, 11, 12, 16, 17, 18, 19, 24, 26, 27, 28, 29, 30, 31, 32, 33, 37, 38, 39, 40, 46, 47, 48, 49, 50, 51, 53, 54, 55, 56, 57, 58, 60, 61, 68, 69, 71, 72, 73, 74, 76, 80, 83, 89, 92, 96, 99, 101, 103, 104, 108, 110, 111, 113, 114, 116, 117, 118, 119, 122, 125, 132, 134, 135, 136, 141, 142, 143, 146, 156, 163, 167, 172, 174, 175, 176, 177, 179]"
Shakespeare,L50,short,86,24,62,13,0.5376,186,"[1, 3, 5, 6, 8, 9, 13, 15, 17, 18, 20, 21, 24, 27, 28, 29, 30, 32, 37, 38, 39, 40, 44, 48, 49, 51, 55, 56, 57, 59, 61, 62, 63, 64, 66, 67, 70, 76, 80, 81, 82, 83, 84, 85, 86, 87, 89, 95, 102, 103, 104, 105, 106, 108, 109, 110, 112, 117, 118, 119, 122, 124, 125, 126, 127, 129, 130, 131, 132, 139, 141, 142, 147, 148, 149, 150, 152, 159, 160, 161, 163, 172, 173, 181, 183, 184]"
Shakespeare,L50,short,86,41,45,3,0.5376,186,"[3, 4, 5, 6, 7, 8, 9, 10, 12, 13, 14, 15, 16, 17, 18, 19, 20, 22, 24, 25, 26, 28, 36, 37, 39, 40, 41, 43, 45, 47, 54, 55, 59, 60, 62, 63, 66, 67, 73, 74, 76, 77, 78, 80, 81, 84, 85, 86, 88, 91, 97, 98, 99, 100, 102, 103, 104, 105, 106, 107, 108, 110, 112, 113, 114, 115, 116, 123, 125, 126, 134, 135, 136, 137, 146, 147, 148, 155, 156, 157, 158, 165, 169, 177, 178, 179]"
Shakespeare,L50,short,85,39,46,9,0.5405,185,"[3, 4, 6, 7, 8, 9, 10, 14, 15, 18, 19, 20, 21, 26, 28, 30, 31, 32, 33, 34, 35, 36, 39, 40, 41, 44, 51, 53, 54, 55, 57, 58, 59, 60, 61, 62, 63, 64, 71, 72, 74, 75, 77, 78, 79, 82, 83, 88, 93, 95, 96, 99, 101, 104, 105, 111, 113, 114, 115, 116, 117, 118, 119, 122, 125, 128, 130, 131, 134, 143, 148, 149, 150, 151, 152, 153, 154, 161, 162, 163, 164, 165, 168, 176, 178]"
Shakespeare,L50,short,80,26,54,10,0.5556,180,"[4, 5, 6, 9, 10, 11, 12, 13, 14, 16, 19, 20, 27, 28, 31, 32, 33, 35, 36, 37, 38, 39, 41, 47, 49, 51, 52, 55, 56, 57, 60, 61, 66, 68, 69, 70, 71, 72, 73, 76, 77, 78, 80, 81, 87, 88, 89, 91, 93, 98, 99, 101, 105, 107, 108, 109, 110, 116, 117, 118, 121, 127, 128, 129, 130, 131, 133, 137, 140, 141, 142, 149, 153, 160, 161, 162, 170, 171, 172, 173]"
Shakespeare,L50,short,86,48,38,14,0.5376,186,"[0, 2, 3, 4, 5, 6, 7, 8, 12, 17, 18, 19, 20, 23, 24, 25, 27, 28, 29, 30, 32, 38, 39, 40, 42, 43, 44, 45, 59, 63, 64, 67, 68, 69, 71, 74, 77, 78, 79, 80, 81, 82, 86, 87, 89, 90, 91, 92, 94, 96, 100, 101, 102, 104, 105, 106, 108, 109, 110, 111, 112, 113, 115, 122, 124, 126, 129, 131, 132, 133, 134, 138, 139, 147, 148, 149, 150, 156, 157, 158, 159, 160, 167, 169, 171, 181]"
Shakespeare,L50,short,84,48,36,5,0.5435,184,"[7, 10, 11, 14, 16, 19, 20, 22, 23, 26, 28, 31, 32, 35, 36, 37, 38, 39, 40, 43, 44, 45, 46, 47, 48, 49, 50, 51, 53, 55, 57, 59, 61, 62, 68, 69, 70, 72, 74, 76, 77, 80, 81, 82, 84, 89, 90, 92, 93, 95, 98, 99, 100, 101, 102, 103, 105, 108, 115, 116, 117, 118, 120, 122, 123, 125, 126, 127, 128, 135, 137, 138, 140, 148, 149, 158, 159, 166, 167, 170, 176, 177, 179, 181]"
Shakespeare,L50,short,97,51,46,4,0.5076,197,"[0, 1, 5, 6, 7, 8, 10, 14, 15, 17, 19, 21, 22, 24, 25, 28, 29, 34, 35, 37, 38, 39, 40, 42, 44, 45, 46, 50, 59, 60, 61, 62, 63, 64, 65, 66, 67, 69, 70, 76, 77, 78, 80, 82, 84, 85, 86, 87, 88, 89, 90, 96, 97, 99, 100, 101, 102, 103, 104, 105, 108, 109, 110, 111, 112, 114, 116, 123, 124, 125, 126, 130, 131, 134, 136, 144, 145, 146, 152, 153, 154, 155, 157, 165, 166, 174, 175, 176, 177, 178, 179, 187, 189, 190, 191, 192, 194]"
Shakespeare,L50,short,84,34,50,15,0.5435,184,"[2, 3, 5, 6, 11, 14, 16, 17, 18, 19, 20, 21, 23, 24, 26, 28, 30, 34, 35, 37, 38, 39, 40, 41, 42, 43, 45, 46, 48, 49, 51, 53, 62, 64, 66, 68, 69, 70, 71, 72, 74, 80, 81, 87, 90, 92, 93, 94, 100, 101, 102, 103, 104, 105, 108, 109, 110, 111, 112, 113, 114, 117, 122, 123, 124, 125, 128, 129, 130, 133, 134, 139, 147, 156, 162, 163, 164, 165, 172, 173, 175, 176, 177, 179]"
Shakespeare,L50,short,87,44,43,11,0.5348,187,"[3, 7, 9, 12, 13, 14, 15, 17, 19, 23, 25, 28, 29, 31, 32, 34, 37, 40, 43, 44, 45, 46, 48, 50, 52, 53, 55, 56, 57, 59, 64, 65, 66, 67, 69, 71, 72, 73, 74, 78, 80, 81, 84, 87, 92, 95, 96, 97, 98, 99, 100, 102, 104, 105, 106, 107, 109, 112, 117, 118, 119, 121, 124, 125, 126, 127, 130, 131, 133, 140, 142, 148, 149, 150, 151, 152, 154, 161, 163, 170, 171, 172, 173, 179, 180, 181, 184]"
Shakespeare,L50,short,86,56,30,10,0.5376,186,"[4, 6, 7, 8, 9, 11, 12, 13, 17, 18, 19, 21, 22, 28, 29, 30, 33, 35, 36, 38, 40, 45, 49, 51, 52, 53, 55, 56, 57, 58, 62, 63, 64, 65, 67, 72, 73, 74, 75, 76, 78, 79, 80, 82, 84, 85, 86, 91, 92, 94, 96, 100, 101, 102, 103, 104, 105, 106, 111, 112, 113, 114, 115, 116, 117, 120, 121, 122, 127, 134, 135, 136, 137, 140, 146, 147, 149, 156, 157, 161, 169, 176, 177, 178, 179, 180]"
Shakespeare,L50,short,83,43,40,11,0.5464,183,"[3, 6, 8, 9, 10, 11, 12, 13, 14, 15, 22, 25, 26, 27, 28, 30, 31, 32, 35, 39, 44, 49, 50, 51, 53, 56, 57, 58, 61, 62, 66, 67, 68, 70, 71, 72, 74, 75, 76, 78, 79, 81, 82, 83, 84, 91, 92, 94, 95, 96, 98, 100, 101, 102, 103, 104, 105, 108, 114, 116, 120, 123, 124, 125, 126, 127, 134, 135, 136, 138, 143, 144, 145, 147, 155, 156, 158, 164, 165, 166, 168, 169, 179]"
Shakespeare,L50,short,87,59,28,4,0.5348,187,"[0, 1, 4, 5, 8, 9, 10, 15, 16, 17, 18, 20, 21, 22, 23, 24, 25, 26, 27, 28, 29, 30, 31, 32, 33, 34, 43, 45, 46, 48, 50, 51, 53, 54, 56, 57, 66, 67, 68, 71, 72, 73, 74, 75, 76, 77, 85, 87, 88, 91, 94, 95, 96, 97, 99, 106, 108, 109, 112, 114, 116, 117, 119, 126, 129, 130, 135, 137, 138, 139, 140, 143, 150, 151, 157, 158, 159, 160, 161, 162, 169, 170, 171, 172, 173, 182, 183]"
Shakespeare,L50,short,86,42,44,5,0.5376,186,"[3, 5, 7, 8, 9, 13, 15, 17, 18, 20, 23, 24, 25, 26, 27, 29, 31, 32, 34, 37, 38, 39, 40, 41, 43, 51, 52, 53, 54, 56, 59, 60, 62, 63, 64, 65, 72, 78, 79, 80, 81, 83, 84, 85, 86, 88, 93, 95, 96, 97, 98, 99, 100, 103, 105, 106, 107, 108, 114, 115, 117, 120, 124, 125, 126, 129, 137, 138, 140, 146, 147, 148, 149, 151, 158, 159, 161, 167, 168, 169, 170, 177, 178, 179, 180, 181]"
Shakespeare,L50,short,79,42,37,6,0.5587,179,"[3, 4, 5, 7, 8, 9, 10, 11, 12, 13, 14, 15, 16, 17, 18, 19, 20, 29, 31, 34, 36, 38, 40, 41, 46, 48, 50, 51, 52, 53, 57, 58, 62, 67, 69, 71, 72, 76, 77, 78, 80, 81, 86, 92, 93, 94, 95, 98, 99, 105, 109, 111, 112, 113, 116, 121, 122, 123, 125, 131, 135, 136, 140, 141, 142, 144, 145, 146, 151, 153, 155, 156, 157, 159, 161, 168, 171, 172, 174]"
Shakespeare,L50,short,80,41,39,8,0.5556,180,"[0, 1, 2, 5, 7, 9, 13, 14, 16, 17, 19, 22, 23, 24, 26, 29, 31, 32, 33, 35, 39, 40, 42, 44, 45, 46, 47, 48, 49, 51, 54, 55, 58, 64, 65, 66, 68, 69, 71, 74, 75, 77, 82, 83, 85, 87, 88, 89, 90, 91, 92, 93, 96, 99, 106, 108, 112, 113, 114, 115, 117, 118, 123, 125, 127, 130, 136, 137, 138, 148, 153, 154, 156, 157, 158, 159, 167, 170, 177, 178]"
Shakespeare,L50,short,82,34,48,9,0.5495,182,"[0, 1, 3, 5, 6, 7, 9, 10, 15, 18, 21, 23, 24, 25, 26, 30, 31, 35, 36, 37, 39, 41, 43, 45, 47, 48, 49, 50, 51, 52, 53, 54, 61, 62, 63, 66, 67, 69, 70, 71, 74, 81, 82, 83, 84, 86, 89, 92, 93, 94, 96, 100, 101, 102, 105, 106, 107, 112, 114, 117, 118, 124, 125, 127, 129, 135, 136, 137, 140, 148, 153, 154, 155, 156, 159, 165, 167, 169, 170, 177, 178, 179]"
Shakespeare,L50,short,88,32,56,8,0.5319,188,"[0, 2, 3, 5, 6, 7, 9, 14, 19, 20, 21, 22, 23, 24, 26, 27, 28, 32, 36, 37, 38, 39, 40, 42, 43, 44, 46, 47, 48, 50, 51, 58, 59, 60, 61, 62, 63, 64, 65, 66, 67, 70, 72, 79, 80, 82, 84, 85, 86, 87, 90, 91, 97, 98, 99, 101, 105, 106, 107, 108, 109, 111, 112, 113, 114, 115, 122, 124, 126, 128, 129, 133, 134, 135, 137, 138, 139, 147, 148, 149, 156, 157, 158, 162, 169, 170, 180, 181]"
Shakespeare,L50,short,79,46,33,4,0.5587,179,"[4, 5, 6, 7, 8, 9, 10, 11, 13, 16, 17, 18, 19, 20, 21, 27, 29, 30, 32, 34, 35, 36, 38, 40, 41, 47, 48, 49, 51, 52, 53, 54, 56, 57, 58, 59, 62, 71, 72, 73, 78, 81, 82, 88, 92, 93, 94, 96, 97, 98, 100, 101, 103, 104, 110, 111, 112, 113, 114, 115, 119, 121, 122, 123, 125, 132, 134, 136, 141, 142, 143, 147, 155, 164, 166, 167, 174, 176, 177]"
Shakespeare,L50,short,87,45,42,11,0.5348,187,"[3, 7, 10, 14, 15, 16, 17, 18, 19, 23, 24, 25, 28, 29, 30, 31, 32, 35, 37, 38, 39, 43, 44, 46, 47, 50, 51, 52, 53, 55, 56, 57, 58, 61, 62, 64, 66, 72, 75, 79, 80, 81, 82, 83, 84, 86, 91, 92, 93, 94, 95, 96, 97, 98, 99, 101, 102, 105, 106, 111, 112, 113, 114, 118, 122, 123, 124, 125, 127, 134, 136, 138, 143, 146, 149, 156, 157, 159, 167, 168, 170, 171, 172, 173, 180, 182, 183]"
Shakespeare,L50,short,82,29,53,10,0.5495,182,"[6, 7, 8, 9, 11, 12, 13, 14, 15, 19, 24, 25, 26, 30, 31, 32, 33, 34, 35, 38, 39, 40, 41, 48, 49, 50, 52, 53, 54, 55, 56, 57, 59, 60, 62, 66, 73, 74, 78, 79, 84, 87, 88, 91, 92, 94, 97, 98, 99, 100, 101, 107, 111, 114, 116, 117, 119, 121, 122, 123, 124, 131, 132, 133, 135, 139, 140, 141, 142, 143, 144, 150, 151, 152, 153, 155, 162, 164, 170, 172, 173, 174]"
Shakespeare,L50,short,85,44,41,5,0.5405,185,"[3, 4, 7, 9, 12, 13, 14, 15, 16, 17, 18, 19, 24, 25, 26, 29, 32, 34, 35, 37, 39, 43, 44, 45, 46, 47, 49, 50, 54, 55, 57, 59, 60, 66, 67, 68, 71, 72, 73, 74, 75, 78, 79, 81, 82, 88, 89, 90, 91, 92, 93, 94, 97, 98, 99, 100, 101, 104, 110, 111, 112, 113, 116, 117, 118, 120, 121, 122, 124, 132, 133, 134, 137, 142, 143, 144, 145, 146, 148, 156, 157, 165, 167, 176, 177]"
Shakespeare,L50,short,80,46,34,11,0.5556,180,"[0, 3, 4, 5, 6, 9, 13, 14, 17, 19, 20, 22, 25, 28, 29, 32, 35, 37, 38, 39, 40, 41, 42, 43, 44, 46, 47, 48, 51, 54, 62, 64, 65, 67, 68, 71, 72, 73, 74, 80, 81, 82, 84, 86, 87, 88, 90, 91, 93, 95, 99, 100, 104, 106, 108, 111, 112, 114, 115, 116, 121, 123, 124, 128, 131, 132, 134, 135, 136, 143, 144, 147, 155, 157, 164, 165, 167, 175, 176, 178]"
Shakespeare,L50,short,84,41,43,18,0.5435,184,"[4, 5, 7, 8, 10, 13, 14, 16, 21, 24, 25, 26, 27, 29, 30, 31, 32, 33, 34, 36, 37, 38, 41, 42, 43, 51, 52, 53, 54, 56, 57, 58, 59, 60, 61, 62, 65, 72, 77, 79, 80, 81, 82, 83, 84, 85, 91, 95, 96, 97, 98, 99, 100, 101, 105, 106, 107, 112, 117, 119, 120, 124, 128, 129, 130, 131, 132, 133, 141, 142, 145, 150, 151, 152, 153, 160, 161, 162, 165, 172, 174, 180, 181, 182]"
Shakespeare,L50,short,82,55,27,7,0.5495,182,"[4, 5, 6, 7, 8, 9, 10, 11, 15, 16, 18, 19, 24, 25, 26, 27, 29, 31, 32, 34, 36, 39, 44, 45, 46, 47, 51, 53, 55, 57, 58, 59, 60, 66, 67, 70, 72, 73, 76, 77, 80, 81, 86, 87, 88, 89, 91, 92, 93, 94, 95, 96, 97, 98, 100, 103, 108, 109, 111, 112, 113, 115, 118, 120, 121, 122, 125, 131, 132, 133, 138, 142, 143, 151, 152, 154, 162, 163, 165, 166, 172, 177]"
Shakespeare,L50,short,88,45,43,6,0.5319,188,"[3, 6, 7, 8, 10, 11, 14, 15, 17, 18, 20, 25, 27, 28, 29, 30, 31, 32, 33, 35, 36, 39, 40, 46, 47, 48, 50, 53, 54, 55, 56, 57, 58, 59, 61, 67, 68, 69, 71, 73, 74, 75, 76, 78, 79, 80, 82, 84, 91, 93, 94, 95, 96, 97, 99, 100, 101, 102, 105, 111, 114, 116, 118, 119, 120, 121, 122, 123, 129, 130, 131, 132, 133, 140, 143, 150, 153, 159, 160, 162, 163, 170, 171, 173, 180, 181, 183, 184]"
Shakespeare,L50,short,81,41,40,8,0.5525,181,"[1, 2, 3, 4, 5, 7, 8, 10, 15, 17, 20, 21, 22, 23, 25, 26, 27, 28, 29, 35, 36, 37, 38, 40, 41, 43, 45, 46, 47, 48, 50, 58, 60, 62, 64, 65, 68, 69, 71, 78, 79, 81, 82, 83, 85, 86, 87, 88, 90, 92, 98, 99, 102, 105, 108, 109, 110, 112, 113, 121, 122, 124, 128, 131, 133, 139, 141, 142, 144, 151, 153, 155, 161, 162, 163, 164, 165, 166, 167, 176, 177]"
Shakespeare,L50,short,82,26,56,8,0.5495,182,"[3, 7, 8, 9, 11, 12, 13, 14, 18, 20, 21, 24, 27, 29, 32, 33, 34, 35, 36, 38, 42, 44, 48, 52, 53, 54, 55, 56, 57, 59, 60, 62, 63, 64, 65, 66, 68, 69, 70, 71, 77, 79, 80, 81, 83, 84, 85, 89, 91, 94, 100, 101, 104, 106, 108, 109, 110, 111, 112, 114, 120, 121, 125, 129, 130, 131, 132, 133, 135, 136, 137, 146, 147, 154, 157, 163, 164, 165, 166, 167, 176, 177]"
Shakespeare,L50,short,86,34,52,6,0.5376,186,"[3, 4, 6, 7, 8, 9, 11, 13, 14, 15, 16, 17, 19, 20, 23, 29, 30, 32, 33, 34, 35, 36, 40, 41, 42, 43, 49, 50, 51, 52, 53, 55, 56, 57, 58, 60, 62, 63, 65, 66, 74, 75, 76, 77, 78, 80, 84, 87, 92, 93, 94, 96, 97, 98, 99, 100, 102, 104, 105, 106, 108, 111, 118, 119, 121, 129, 130, 137, 139, 141, 147, 148, 150, 151, 158, 159, 161, 167, 168, 169, 170, 171, 172, 179, 181, 183]"
Shakespeare,L50,short,83,46,37,6,0.5464,183,"[0, 1, 2, 3, 4, 6, 7, 9, 14, 15, 16, 18, 19, 21, 23, 24, 25, 29, 34, 35, 38, 39, 42, 44, 45, 46, 48, 49, 50, 56, 59, 60, 62, 63, 64, 65, 66, 69, 70, 72, 81, 83, 85, 88, 89, 90, 91, 93, 97, 98, 100, 101, 103, 104, 106, 107, 108, 110, 112, 114, 120, 125, 129, 131, 132, 134, 135, 141, 143, 144, 145, 147, 154, 155, 156, 157, 160, 167, 168, 175, 176, 177, 178]"
Shakespeare,L50,short,88,45,43,10,0.5319,188,"[0, 2, 3, 5, 6, 7, 8, 9, 15, 16, 17, 18, 25, 26, 27, 28, 30, 36, 38, 39, 40, 41, 42, 44, 49, 50, 56, 57, 58, 59, 61, 62, 63, 64, 65, 66, 67, 70, 75, 77, 78, 79, 80, 81, 82, 83, 86, 88, 92, 97, 98, 99, 100, 101, 102, 103, 104, 106, 107, 108, 109, 110, 113, 119, 121, 122, 123, 129, 130, 131, 133, 140, 141, 142, 143, 149, 150, 151, 153, 161, 162, 163, 173, 174, 180, 181, 183, 184]"
Shakespeare,L50,short,81,47,34,13,0.5525,181,"[0, 1, 3, 4, 5, 6, 7, 12, 17, 18, 19, 20, 21, 22, 23, 24, 25, 29, 31, 36, 37, 40, 42, 44, 45, 47, 48, 54, 59, 61, 62, 67, 68, 69, 70, 71, 73, 74, 80, 82, 83, 84, 85, 87, 88, 90, 91, 93, 94, 95, 96, 97, 102, 103, 104, 105, 106, 109, 112, 113, 114, 115, 116, 117, 120, 126, 131, 136, 137, 141, 148, 149, 150, 153, 160, 163, 164, 171, 172, 173, 174]"
Shakespeare,L50,short,87,54,33,10,0.5348,187,"[3, 4, 6, 8, 9, 10, 11, 12, 14, 16, 17, 19, 21, 28, 32, 33, 35, 40, 41, 42, 44, 48, 49, 51, 52, 53, 57, 59, 61, 62, 63, 65, 69, 71, 72, 74, 75, 77, 78, 79, 80, 81, 82, 83, 84, 89, 90, 91, 92, 93, 94, 95, 96, 97, 98, 100, 101, 102, 104, 105, 112, 113, 114, 115, 118, 120, 121, 123, 125, 134, 135, 140, 141, 144, 146, 153, 155, 156, 157, 164, 165, 166, 167, 174, 175, 176, 178]"
Shakespeare,L50,short,90,47,43,2,0.5263,190,"[3, 4, 7, 9, 13, 14, 17, 18, 20, 21, 22, 25, 26, 28, 29, 32, 33, 34, 35, 36, 37, 38, 39, 40, 41, 42, 43, 44, 51, 52, 54, 55, 56, 59, 60, 62, 63, 64, 71, 72, 73, 74, 75, 76, 77, 78, 80, 81, 83, 84, 91, 92, 93, 94, 95, 97, 98, 99, 100, 101, 102, 103, 104, 111, 112, 114, 117, 118, 119, 120, 122, 123, 124, 134, 140, 142, 143, 144, 145, 155, 156, 157, 158, 159, 167, 168, 169, 178, 179, 188]"
Shakespeare,L50,short,85,39,46,10,0.5405,185,"[4, 7, 9, 10, 11, 12, 13, 14, 16, 17, 18, 19, 20, 21, 23, 30, 32, 33, 35, 38, 40, 41, 43, 44, 45, 52, 55, 56, 57, 59, 61, 62, 64, 66, 68, 73, 74, 75, 76, 78, 79, 80, 81, 82, 83, 87, 91, 94, 96, 98, 100, 101, 103, 104, 105, 106, 107, 112, 113, 116, 117, 119, 120, 121, 122, 123, 125, 126, 127, 135, 138, 143, 144, 145, 146, 147, 149, 157, 160, 168, 169, 172, 178, 179, 181]"
Shakespeare,L50,short,87,46,41,7,0.5348,187,"[0, 1, 2, 3, 8, 10, 14, 15, 17, 20, 21, 23, 24, 26, 28, 30, 31, 35, 38, 39, 41, 43, 44, 45, 47, 51, 54, 58, 59, 61, 62, 63, 64, 65, 66, 70, 72, 74, 76, 80, 81, 82, 84, 85, 86, 90, 92, 95, 97, 99, 103, 106, 107, 110, 113, 114, 115, 117, 119, 120, 125, 127, 128, 129, 130, 136, 137, 138, 139, 142, 149, 150, 157, 158, 159, 160, 163, 169, 170, 171, 172, 173, 181, 182, 183, 184, 185]"
Shakespeare,L50,short,86,49,37,12,0.5376,186,"[1, 4, 6, 9, 12, 13, 14, 16, 17, 18, 19, 23, 24, 25, 26, 27, 28, 29, 34, 36, 37, 39, 40, 41, 43, 44, 45, 47, 48, 51, 57, 58, 59, 63, 64, 68, 69, 72, 80, 81, 83, 84, 85, 87, 89, 90, 91, 92, 96, 97, 98, 99, 100, 101, 102, 103, 105, 106, 107, 108, 109, 111, 114, 120, 122, 128, 130, 134, 142, 147, 148, 149, 150, 151, 152, 160, 161, 162, 165, 172, 173, 179, 180, 181, 182, 183]"
Shakespeare,L50,short,91,45,46,9,0.5236,191,"[0, 2, 3, 5, 6, 7, 10, 14, 15, 18, 19, 23, 24, 25, 26, 28, 30, 36, 37, 39, 42, 44, 45, 46, 47, 48, 51, 56, 57, 59, 60, 62, 63, 64, 66, 68, 69, 70, 75, 76, 78, 79, 80, 81, 82, 83, 86, 89, 90, 91, 97, 98, 99, 100, 101, 102, 104, 105, 106, 107, 108, 113, 120, 123, 126, 127, 128, 131, 132, 133, 140, 141, 142, 144, 151, 152, 153, 154, 155, 156, 157, 164, 166, 167, 174, 176, 177, 184, 185, 186, 187]"
Shakespeare,L50,short,83,45,38,4,0.5464,183,"[3, 6, 7, 10, 11, 12, 13, 15, 16, 17, 19, 20, 25, 26, 28, 29, 30, 34, 37, 38, 39, 40, 46, 47, 48, 49, 50, 52, 53, 54, 58, 59, 60, 61, 67, 68, 69, 71, 72, 73, 75, 76, 77, 78, 80, 81, 87, 91, 92, 95, 97, 98, 100, 103, 107, 108, 109, 111, 112, 113, 114, 116, 117, 118, 119, 121, 122, 128, 129, 132, 133, 138, 141, 142, 144, 152, 153, 159, 162, 163, 171, 172, 174]"
Shakespeare,L50,short,85,40,45,11,0.5405,185,"[3, 5, 8, 9, 11, 12, 14, 15, 16, 17, 18, 19, 20, 21, 27, 28, 29, 32, 33, 35, 36, 37, 39, 41, 42, 43, 44, 45, 46, 47, 54, 55, 56, 57, 58, 59, 60, 62, 63, 64, 65, 66, 69, 77, 78, 82, 84, 85, 86, 89, 96, 97, 99, 100, 102, 105, 106, 107, 108, 114, 115, 116, 118, 122, 123, 124, 126, 127, 129, 136, 137, 138, 139, 142, 148, 149, 151, 159, 164, 170, 171, 177, 179, 180, 181]"
Shakespeare,L50,short,85,47,38,6,0.5405,185,"[0, 1, 2, 4, 5, 6, 7, 10, 17, 18, 21, 22, 23, 24, 26, 28, 29, 30, 31, 32, 38, 42, 43, 44, 45, 46, 49, 51, 52, 53, 59, 61, 63, 64, 65, 66, 67, 68, 69, 71, 75, 82, 83, 86, 87, 89, 90, 91, 92, 94, 99, 100, 102, 103, 104, 105, 106, 107, 108, 109, 110, 114, 119, 120, 121, 125, 128, 129, 130, 134, 141, 142, 143, 144, 150, 151, 152, 154, 155, 162, 163, 164, 167, 174, 177]"
Shakespeare,L50,short,82,49,33,5,0.5495,182,"[7, 8, 9, 10, 11, 12, 13, 14, 15, 17, 18, 19, 20, 24, 28, 29, 31, 32, 33, 34, 35, 36, 37, 40, 41, 42, 46, 49, 57, 60, 61, 63, 64, 65, 66, 67, 72, 73, 75, 76, 77, 78, 79, 80, 81, 82, 83, 87, 92, 93, 95, 96, 97, 98, 99, 101, 104, 105, 106, 107, 113, 117, 120, 121, 123, 127, 135, 136, 138, 147, 153, 155, 156, 157, 158, 165, 167, 168, 170, 176, 177, 178]"
Shakespeare,L50,short,80,39,41,6,0.5556,180,"[0, 3, 5, 7, 9, 13, 15, 16, 17, 18, 19, 20, 21, 23, 24, 25, 26, 27, 30, 36, 37, 39, 40, 41, 42, 44, 45, 46, 47, 48, 50, 57, 58, 60, 61, 65, 66, 67, 68, 69, 71, 81, 82, 83, 84, 85, 90, 91, 96, 97, 98, 99, 101, 102, 103, 104, 105, 107, 108, 110, 111, 118, 120, 121, 128, 129, 130, 132, 135, 143, 148, 149, 150, 152, 154, 162, 163, 170, 172, 175]"
Shakespeare,L50,short,86,45,41,6,0.5376,186,"[0, 1, 2, 3, 4, 5, 6, 7, 8, 10, 16, 17, 18, 19, 20, 22, 24, 25, 26, 27, 29, 30, 37, 38, 39, 40, 43, 44, 45, 46, 47, 48, 51, 52, 60, 61, 62, 63, 64, 65, 67, 68, 69, 70, 71, 73, 82, 83, 87, 89, 90, 91, 96, 101, 102, 103, 104, 105, 106, 107, 110, 111, 112, 113, 114, 115, 117, 124, 125, 126, 127, 134, 135, 136, 137, 145, 147, 148, 155, 156, 157, 159, 168, 176, 177, 179]"
Shakespeare,L50,short,87,41,46,7,0.5348,187,"[2, 4, 5, 6, 7, 8, 9, 11, 16, 17, 18, 20, 21, 22, 23, 25, 26, 29, 30, 32, 38, 39, 42, 43, 44, 45, 48, 50, 53, 54, 60, 61, 62, 64, 65, 67, 70, 71, 72, 73, 74, 76, 82, 84, 85, 86, 87, 89, 90, 91, 93, 97, 105, 106, 108, 109, 111, 112, 113, 114, 116, 121, 122, 124, 125, 128, 132, 133, 134, 135, 136, 144, 146, 151, 154, 156, 157, 158, 166, 167, 168, 175, 176, 180, 181, 182, 184]"
Shakespeare,L50,short,87,46,41,5,0.5348,187,"[1, 3, 5, 6, 7, 8, 10, 14, 16, 17, 18, 19, 22, 23, 24, 28, 29, 35, 37, 38, 39, 40, 41, 42, 43, 44, 45, 46, 47, 50, 52, 54, 61, 63, 64, 66, 68, 69, 71, 73, 76, 82, 83, 84, 86, 88, 90, 91, 92, 94, 95, 101, 103, 104, 106, 110, 112, 114, 116, 117, 124, 125, 127, 128, 133, 134, 135, 136, 137, 138, 139, 140, 148, 149, 150, 157, 158, 159, 160, 161, 168, 169, 171, 173, 181, 182, 183]"
Shakespeare,L50,short,90,44,46,7,0.5263,190,"[0, 2, 3, 4, 5, 8, 9, 16, 17, 18, 19, 20, 21, 22, 23, 24, 28, 29, 34, 35, 38, 39, 41, 42, 43, 44, 45, 46, 49, 50, 51, 52, 54, 61, 64, 65, 69, 70, 72, 74, 75, 81, 83, 84, 85, 86, 88, 89, 90, 91, 92, 94, 95, 96, 98, 103, 104, 105, 106, 107, 108, 109, 111, 114, 115, 116, 119, 126, 127, 128, 132, 133, 134, 136, 137, 138, 148, 149, 150, 158, 159, 162, 169, 170, 171, 172, 180, 181, 182, 184]"
Shakespeare,L50,short,78,38,40,14,0.5618,178,"[4, 5, 6, 7, 8, 11, 12, 13, 14, 15, 16, 18, 21, 26, 29, 30, 31, 32, 34, 35, 36, 37, 39, 40, 42, 48, 49, 50, 51, 52, 54, 58, 59, 60, 61, 63, 69, 71, 72, 73, 74, 76, 77, 78, 79, 80, 83, 84, 85, 93, 94, 95, 96, 97, 102, 104, 105, 106, 107, 108, 109, 117, 118, 119, 120, 123, 124, 125, 126, 127, 128, 130, 132, 133, 147, 154, 167, 176]"
Shakespeare,L50,short,88,47,41,7,0.5319,188,"[3, 4, 6, 7, 11, 12, 13, 14, 15, 16, 18, 20, 25, 26, 27, 28, 29, 30, 31, 32, 36, 37, 39, 41, 42, 48, 49, 51, 52, 53, 54, 55, 56, 58, 59, 60, 61, 62, 63, 71, 74, 75, 76, 78, 79, 80, 82, 87, 93, 94, 95, 96, 97, 98, 99, 101, 102, 103, 104, 105, 107, 108, 109, 110, 111, 112, 113, 121, 122, 124, 129, 131, 132, 133, 135, 136, 144, 145, 147, 154, 155, 157, 165, 166, 175, 177, 184, 185]"
Shakespeare,L50,short,82,41,41,6,0.5495,182,"[0, 1, 4, 5, 7, 9, 14, 15, 16, 17, 18, 20, 21, 22, 23, 25, 26, 27, 28, 29, 35, 36, 37, 38, 41, 42, 43, 44, 45, 46, 47, 49, 50, 51, 52, 62, 64, 65, 67, 68, 71, 72, 73, 74, 75, 76, 84, 85, 87, 89, 93, 98, 103, 105, 106, 108, 109, 112, 113, 114, 117, 118, 119, 121, 128, 129, 130, 132, 137, 140, 141, 150, 151, 156, 159, 160, 161, 162, 169, 170, 171, 173]"
Shakespeare,L50,short,83,49,34,11,0.5464,183,"[1, 2, 3, 9, 13, 14, 15, 16, 17, 18, 19, 20, 21, 22, 24, 25, 26, 27, 28, 29, 35, 37, 38, 39, 40, 41, 42, 44, 46, 48, 49, 50, 51, 52, 53, 61, 62, 64, 65, 67, 68, 70, 71, 75, 82, 85, 86, 87, 90, 92, 97, 102, 104, 106, 107, 108, 109, 112, 118, 123, 124, 125, 128, 131, 132, 133, 134, 137, 143, 146, 147, 154, 155, 156, 157, 163, 164, 165, 166, 167, 174, 176, 178]"
Shakespeare,L50,short,84,49,35,7,0.5435,184,"[5, 6, 7, 8, 9, 10, 11, 12, 14, 15, 16, 18, 21, 30, 34, 35, 37, 40, 42, 43, 44, 46, 52, 53, 54, 56, 57, 58, 59, 61, 63, 65, 66, 67, 71, 72, 75, 77, 78, 79, 80, 81, 82, 86, 87, 88, 89, 91, 96, 97, 99, 100, 101, 103, 105, 106, 108, 109, 113, 119, 120, 123, 125, 128, 129, 130, 132, 134, 142, 145, 152, 153, 154, 156, 162, 163, 165, 166, 167, 174, 175, 177, 178, 179]"
Shakespeare,L50,short,87,36,51,9,0.5348,187,"[3, 4, 5, 6, 8, 11, 12, 13, 14, 15, 16, 17, 19, 21, 27, 29, 30, 31, 32, 33, 34, 36, 37, 38, 40, 49, 50, 52, 53, 56, 57, 63, 68, 71, 72, 73, 75, 76, 77, 78, 80, 81, 86, 88, 89, 90, 91, 92, 93, 94, 95, 96, 98, 99, 100, 101, 103, 110, 111, 112, 114, 116, 118, 119, 122, 123, 124, 125, 133, 134, 135, 142, 144, 145, 152, 153, 155, 156, 164, 166, 167, 168, 169, 176, 177, 178, 179]"
Shakespeare,L50,short,78,31,47,5,0.5618,178,"[0, 1, 2, 6, 10, 13, 14, 15, 16, 18, 20, 21, 23, 24, 25, 26, 27, 28, 30, 37, 38, 39, 41, 42, 45, 47, 48, 49, 55, 57, 59, 60, 61, 62, 63, 64, 67, 68, 69, 70, 71, 79, 80, 81, 83, 86, 87, 89, 91, 92, 93, 94, 102, 104, 105, 107, 109, 111, 113, 114, 115, 116, 123, 126, 132, 133, 134, 135, 137, 144, 146, 147, 154, 156, 158, 166, 167, 170]"
Shakespeare,L50,short,85,36,49,1,0.5405,185,"[1, 2, 3, 4, 5, 7, 10, 11, 17, 19, 20, 21, 23, 24, 25, 26, 27, 28, 29, 30, 31, 32, 33, 40, 41, 42, 43, 45, 48, 49, 52, 53, 54, 61, 62, 63, 64, 66, 68, 69, 70, 71, 74, 75, 82, 83, 84, 85, 86, 89, 93, 95, 97, 98, 103, 104, 105, 107, 108, 109, 111, 112, 115, 116, 118, 125, 126, 130, 134, 136, 137, 138, 139, 148, 149, 150, 151, 158, 160, 161, 162, 169, 170, 175, 183]"
Shakespeare,L50,short,81,31,50,6,0.5525,181,"[0, 1, 3, 6, 7, 8, 9, 10, 15, 16, 17, 18, 20, 21, 22, 23, 26, 27, 32, 33, 38, 39, 42, 44, 46, 47, 48, 50, 51, 53, 60, 62, 63, 64, 65, 66, 67, 68, 69, 72, 73, 77, 82, 83, 85, 89, 91, 92, 93, 95, 96, 101, 104, 105, 106, 107, 108, 111, 112, 114, 118, 125, 126, 127, 128, 132, 133, 137, 138, 147, 148, 149, 155, 156, 157, 158, 159, 166, 168, 172, 179]"
Shakespeare,L50,short,91,51,40,7,0.5236,191,"[0, 1, 4, 5, 7, 8, 9, 15, 16, 17, 18, 20, 22, 23, 24, 25, 27, 28, 30, 38, 39, 42, 43, 44, 45, 46, 50, 55, 56, 57, 58, 59, 61, 62, 65, 66, 67, 69, 70, 71, 74, 81, 82, 83, 84, 85, 86, 87, 88, 89, 91, 92, 94, 101, 102, 103, 105, 106, 108, 109, 112, 113, 114, 121, 122, 124, 128, 129, 130, 131, 132, 133, 135, 143, 144, 145, 151, 152, 155, 156, 157, 164, 166, 167, 174, 176, 177, 184, 185, 186, 188]"
Shakespeare,L50,short,86,40,46,7,0.5376,186,"[3, 4, 5, 7, 8, 9, 14, 15, 20, 24, 26, 27, 29, 31, 32, 33, 34, 35, 38, 39, 40, 42, 48, 49, 50, 52, 54, 55, 56, 57, 58, 59, 60, 61, 62, 63, 64, 71, 72, 75, 76, 78, 79, 80, 81, 83, 84, 85, 86, 93, 94, 96, 98, 99, 100, 101, 102, 103, 104, 106, 113, 115, 118, 121, 122, 123, 126, 132, 133, 135, 136, 137, 142, 144, 145, 146, 147, 148, 156, 157, 160, 167, 169, 176, 178, 179]"
Shakespeare,L50,short,84,55,29,5,0.5435,184,"[3, 4, 5, 7, 8, 9, 10, 13, 15, 16, 17, 18, 20, 25, 26, 27, 28, 29, 30, 31, 35, 36, 39, 40, 41, 42, 43, 50, 51, 52, 53, 56, 57, 58, 59, 61, 62, 63, 64, 65, 66, 70, 78, 79, 80, 81, 82, 83, 84, 85, 87, 88, 96, 97, 98, 99, 101, 105, 107, 108, 113, 118, 119, 122, 124, 125, 126, 127, 128, 131, 138, 139, 146, 147, 149, 157, 158, 159, 166, 168, 170, 178, 179, 180]"
Shakespeare,L50,short,86,35,51,2,0.5376,186,"[0, 2, 3, 5, 6, 7, 8, 9, 14, 16, 19, 21, 22, 23, 24, 25, 27, 28, 29, 30, 31, 32, 39, 40, 41, 42, 43, 44, 45, 48, 49, 50, 51, 52, 53, 54, 55, 67, 68, 69, 70, 71, 72, 73, 74, 75, 76, 78, 87, 89, 90, 91, 92, 94, 95, 96, 97, 98, 106, 107, 109, 111, 113, 116, 119, 120, 127, 128, 129, 130, 135, 137, 138, 140, 149, 151, 159, 160, 168, 169, 170, 178, 179, 180, 181, 182]"
Shakespeare,L50,short,89,45,44,10,0.5291,189,"[1, 2, 3, 5, 6, 8, 10, 14, 15, 16, 18, 19, 21, 23, 27, 28, 29, 34, 36, 37, 38, 41, 42, 43, 45, 46, 47, 48, 49, 51, 57, 58, 59, 60, 61, 64, 65, 66, 69, 71, 73, 79, 81, 82, 83, 84, 85, 86, 87, 88, 89, 90, 92, 94, 103, 104, 105, 107, 108, 111, 112, 113, 118, 120, 124, 127, 128, 129, 130, 131, 132, 133, 135, 143, 144, 151, 154, 161, 162, 163, 164, 171, 172, 174, 180, 181, 183, 184, 185]"
Shakespeare,L50,short,88,36,52,4,0.5319,188,"[4, 6, 7, 8, 10, 11, 13, 14, 15, 16, 17, 19, 21, 22, 23, 24, 25, 27, 28, 34, 36, 38, 39, 40, 42, 44, 46, 47, 48, 49, 56, 57, 59, 62, 63, 65, 67, 68, 69, 70, 71, 72, 80, 81, 82, 83, 85, 86, 87, 88, 92, 93, 99, 100, 101, 102, 104, 107, 108, 110, 111, 113, 119, 120, 121, 122, 124, 130, 132, 133, 134, 141, 143, 144, 145, 151, 152, 154, 155, 156, 163, 164, 165, 166, 167, 169, 177, 180]"
Shakespeare,L50,short,84,48,36,5,0.5435,184,"[0, 1, 3, 4, 6, 8, 9, 14, 15, 17, 18, 20, 21, 22, 24, 27, 28, 29, 30, 38, 39, 41, 44, 45, 46, 48, 49, 52, 57, 59, 60, 61, 63, 65, 67, 68, 72, 77, 78, 79, 80, 81, 82, 84, 85, 86, 87, 88, 89, 90, 91, 93, 94, 101, 103, 104, 105, 107, 108, 111, 112, 114, 115, 120, 121, 123, 125, 126, 130, 131, 133, 134, 136, 138, 148, 154, 156, 157, 164, 165, 166, 168, 176, 178]"
Shakespeare,L50,short,94,51,43,6,0.5155,194,"[0, 1, 2, 3, 4, 5, 6, 7, 8, 9, 17, 18, 20, 21, 22, 24, 28, 29, 30, 36, 38, 39, 40, 43, 46, 47, 48, 50, 51, 55, 58, 63, 64, 65, 67, 68, 69, 70, 72, 73, 74, 76, 78, 84, 85, 86, 87, 89, 90, 92, 93, 94, 95, 96, 97, 103, 104, 106, 107, 108, 109, 111, 112, 113, 115, 116, 118, 119, 127, 129, 130, 131, 135, 136, 137, 138, 139, 143, 151, 152, 159, 160, 161, 162, 163, 164, 165, 166, 168, 177, 178, 179, 188, 189]"
Shakespeare,L50,short,85,48,37,10,0.5405,185,"[3, 4, 6, 7, 8, 9, 10, 11, 12, 13, 14, 15, 16, 19, 21, 27, 28, 29, 30, 31, 32, 33, 35, 36, 38, 39, 41, 42, 46, 55, 57, 60, 61, 62, 66, 73, 76, 78, 79, 80, 81, 84, 86, 90, 91, 93, 94, 95, 97, 98, 99, 100, 102, 103, 104, 106, 111, 112, 114, 115, 118, 124, 125, 127, 134, 135, 136, 137, 142, 143, 144, 146, 148, 155, 157, 160, 166, 168, 169, 175, 176, 177, 178, 179, 180]"
Shakespeare,L50,short,86,35,51,11,0.5376,186,"[2, 4, 6, 7, 10, 13, 14, 15, 16, 17, 21, 25, 26, 27, 28, 31, 35, 37, 39, 42, 44, 45, 46, 48, 49, 50, 55, 57, 58, 59, 60, 62, 65, 66, 67, 68, 69, 71, 76, 77, 78, 79, 80, 81, 82, 84, 85, 86, 87, 88, 89, 91, 97, 99, 100, 101, 103, 104, 105, 107, 109, 110, 111, 118, 119, 120, 121, 125, 126, 127, 129, 134, 141, 142, 144, 150, 151, 153, 155, 166, 173, 174, 175, 182, 183, 184]"
Shakespeare,L50,short,90,58,32,8,0.5263,190,"[0, 2, 4, 5, 6, 7, 8, 9, 10, 15, 16, 18, 20, 22, 23, 24, 25, 27, 28, 29, 34, 40, 41, 42, 43, 44, 46, 47, 49, 50, 51, 52, 53, 61, 62, 63, 64, 65, 67, 68, 70, 72, 74, 75, 82, 83, 84, 86, 87, 88, 91, 92, 93, 96, 97, 103, 104, 105, 106, 107, 108, 109, 110, 111, 112, 114, 115, 116, 117, 118, 119, 127, 129, 132, 138, 139, 140, 141, 142, 150, 152, 153, 155, 163, 164, 166, 174, 175, 183, 186]"
Shakespeare,L50,short,85,42,43,7,0.5405,185,"[3, 4, 5, 6, 7, 8, 10, 17, 18, 20, 22, 24, 25, 29, 31, 35, 36, 37, 38, 39, 40, 41, 42, 44, 45, 46, 47, 49, 50, 51, 57, 59, 60, 61, 63, 64, 65, 67, 68, 69, 70, 71, 78, 80, 82, 83, 84, 85, 87, 88, 89, 91, 92, 93, 100, 101, 104, 106, 108, 110, 111, 112, 114, 117, 118, 125, 126, 127, 130, 135, 136, 138, 139, 141, 148, 150, 151, 158, 159, 160, 162, 170, 172, 180, 181]"
Shakespeare,L50,short,81,24,57,12,0.5525,181,"[2, 3, 4, 5, 6, 7, 8, 10, 15, 16, 22, 24, 25, 26, 27, 29, 32, 36, 37, 38, 39, 40, 41, 42, 43, 44, 47, 49, 51, 53, 61, 65, 66, 67, 69, 70, 71, 72, 73, 80, 81, 82, 83, 85, 86, 88, 89, 90, 91, 92, 93, 94, 95, 102, 103, 107, 110, 111, 113, 115, 116, 118, 129, 133, 134, 135, 136, 137, 143, 145, 147, 154, 155, 156, 157, 163, 164, 166, 168, 175, 178]"
Shakespeare,L50,short,82,37,45,12,0.5495,182,"[0, 2, 3, 5, 6, 7, 8, 9, 15, 16, 17, 18, 19, 21, 22, 23, 24, 26, 27, 29, 30, 31, 35, 41, 42, 43, 44, 45, 47, 48, 49, 50, 51, 54, 63, 65, 66, 67, 68, 71, 72, 73, 74, 75, 82, 83, 85, 87, 88, 89, 90, 91, 92, 93, 97, 99, 105, 106, 107, 108, 109, 110, 114, 115, 116, 118, 119, 122, 131, 136, 137, 138, 139, 140, 148, 149, 151, 161, 168, 169, 170, 172]"
Shakespeare,L50,short,84,39,45,8,0.5435,184,"[3, 4, 6, 9, 10, 12, 13, 14, 16, 18, 20, 21, 25, 27, 29, 30, 31, 32, 33, 35, 36, 37, 39, 42, 47, 48, 49, 51, 52, 53, 54, 55, 58, 59, 60, 61, 63, 70, 71, 72, 73, 74, 77, 78, 81, 84, 90, 91, 93, 94, 95, 97, 98, 99, 100, 101, 103, 109, 111, 112, 114, 118, 121, 122, 123, 126, 134, 136, 143, 144, 146, 153, 155, 156, 164, 165, 169, 174, 175, 176, 177, 178, 179, 181]"
Shakespeare,L50,short,87,54,33,8,0.5348,187,"[0, 1, 2, 4, 5, 6, 7, 8, 9, 11, 17, 19, 20, 22, 23, 24, 27, 30, 35, 36, 37, 38, 39, 40, 41, 43, 44, 45, 46, 48, 50, 51, 53, 54, 55, 56, 64, 66, 67, 69, 72, 73, 75, 78, 84, 85, 87, 88, 90, 92, 95, 96, 97, 98, 102, 109, 110, 111, 112, 114, 115, 116, 117, 118, 119, 120, 121, 122, 128, 129, 130, 131, 133, 140, 141, 143, 150, 151, 153, 160, 161, 162, 169, 170, 173, 182, 184]"
Shakespeare,L50,short,81,43,38,8,0.5525,181,"[0, 1, 4, 5, 8, 10, 15, 16, 17, 18, 22, 23, 25, 26, 27, 28, 29, 31, 36, 37, 38, 39, 40, 41, 45, 47, 48, 49, 50, 51, 57, 59, 60, 61, 62, 63, 64, 66, 67, 68, 69, 71, 73, 81, 83, 86, 87, 88, 89, 90, 91, 92, 93, 101, 103, 106, 107, 108, 112, 113, 114, 115, 116, 123, 125, 127, 132, 133, 135, 136, 145, 146, 153, 154, 156, 162, 163, 166, 173, 175, 177]"
Shakespeare,L50,short,83,47,36,11,0.5464,183,"[0, 1, 2, 3, 5, 6, 7, 8, 9, 16, 18, 19, 20, 21, 22, 23, 26, 28, 29, 31, 37, 38, 40, 41, 45, 46, 47, 51, 56, 57, 58, 59, 60, 61, 62, 68, 69, 70, 71, 73, 79, 80, 81, 85, 86, 87, 88, 92, 93, 97, 98, 102, 103, 106, 107, 108, 109, 111, 112, 113, 120, 121, 122, 124, 125, 128, 132, 134, 135, 136, 137, 149, 154, 155, 156, 158, 165, 167, 168, 170, 178, 179, 180]"
Shakespeare,L50,short,85,40,45,13,0.5405,185,"[3, 5, 6, 14, 15, 16, 21, 24, 26, 27, 29, 30, 34, 35, 37, 38, 39, 42, 44, 46, 47, 48, 49, 50, 55, 57, 60, 64, 66, 67, 70, 71, 73, 74, 75, 79, 80, 81, 82, 83, 86, 87, 88, 90, 91, 93, 94, 95, 97, 98, 99, 100, 101, 102, 103, 105, 112, 114, 116, 117, 119, 120, 123, 125, 131, 132, 133, 134, 139, 142, 143, 144, 151, 152, 153, 154, 161, 162, 163, 164, 165, 173, 174, 175, 183]"
Shakespeare,L50,short,85,49,36,10,0.5405,185,"[3, 5, 6, 9, 10, 11, 12, 13, 16, 18, 20, 24, 26, 27, 28, 30, 32, 33, 34, 35, 37, 40, 46, 47, 49, 50, 51, 52, 53, 54, 55, 56, 57, 61, 67, 69, 70, 71, 73, 74, 75, 76, 77, 83, 88, 89, 90, 92, 93, 94, 95, 97, 98, 99, 100, 103, 108, 109, 110, 112, 113, 116, 117, 119, 120, 122, 123, 126, 133, 134, 136, 143, 144, 145, 146, 147, 154, 155, 156, 157, 158, 159, 173, 179, 182]"
Shakespeare,L50,short,82,35,47,13,0.5495,182,"[3, 4, 5, 6, 7, 9, 10, 11, 13, 14, 15, 16, 17, 18, 20, 26, 28, 31, 32, 33, 35, 36, 38, 39, 40, 47, 48, 49, 50, 51, 54, 55, 56, 58, 59, 60, 61, 63, 64, 72, 73, 74, 76, 77, 78, 80, 81, 84, 85, 88, 95, 96, 97, 99, 100, 101, 102, 103, 105, 106, 112, 113, 114, 116, 118, 123, 125, 126, 127, 128, 130, 138, 142, 147, 148, 149, 151, 163, 170, 172, 178, 179]"
Shakespeare,L50,short,88,51,37,6,0.5319,188,"[4, 8, 9, 10, 12, 13, 15, 16, 17, 19, 20, 21, 26, 28, 30, 33, 34, 36, 38, 39, 40, 41, 42, 47, 49, 52, 53, 54, 55, 56, 58, 59, 61, 62, 69, 71, 73, 75, 77, 78, 79, 80, 81, 82, 85, 90, 91, 92, 93, 94, 95, 97, 98, 99, 100, 101, 102, 103, 104, 112, 113, 114, 118, 119, 120, 121, 122, 123, 124, 130, 131, 132, 134, 142, 143, 144, 153, 155, 162, 163, 165, 172, 173, 174, 181, 182, 183, 184]"
Shakespeare,L50,short,90,49,41,4,0.5263,190,"[3, 5, 6, 7, 8, 9, 10, 11, 12, 16, 17, 18, 20, 25, 26, 27, 28, 31, 34, 35, 36, 38, 39, 45, 46, 49, 50, 54, 55, 56, 58, 59, 64, 65, 66, 67, 69, 70, 71, 72, 73, 74, 77, 79, 81, 87, 89, 90, 91, 92, 93, 94, 95, 96, 98, 99, 100, 106, 110, 113, 114, 115, 116, 118, 120, 126, 128, 129, 130, 135, 138, 139, 140, 141, 142, 149, 150, 151, 152, 161, 163, 165, 172, 175, 176, 184, 185, 186, 187, 188]"
Shakespeare,L50,short,85,60,25,9,0.5405,185,"[4, 5, 6, 7, 8, 10, 13, 14, 15, 17, 18, 19, 20, 25, 27, 28, 29, 30, 31, 32, 33, 34, 35, 36, 37, 38, 39, 40, 47, 48, 49, 51, 55, 56, 57, 58, 59, 61, 69, 71, 72, 73, 75, 76, 79, 81, 82, 85, 92, 93, 94, 95, 96, 101, 103, 104, 105, 110, 111, 112, 114, 118, 120, 121, 122, 123, 125, 131, 132, 133, 134, 135, 140, 141, 143, 144, 145, 146, 155, 156, 159, 167, 176, 177, 178]"
Shakespeare,L50,short,83,43,40,5,0.5464,183,"[0, 1, 2, 3, 4, 6, 8, 9, 14, 16, 17, 20, 21, 22, 26, 28, 30, 34, 36, 37, 38, 39, 40, 43, 45, 46, 47, 48, 51, 57, 58, 60, 61, 62, 63, 65, 67, 68, 70, 71, 77, 78, 79, 81, 82, 84, 85, 87, 88, 90, 91, 93, 100, 101, 102, 105, 106, 107, 108, 109, 111, 113, 119, 120, 121, 122, 124, 125, 130, 132, 133, 134, 136, 144, 146, 153, 156, 163, 164, 166, 174, 175, 177]"
Shakespeare,L50,short,90,50,40,11,0.5263,190,"[0, 2, 4, 5, 6, 7, 8, 10, 15, 16, 17, 18, 21, 22, 23, 24, 25, 26, 27, 28, 29, 30, 37, 38, 44, 45, 46, 48, 49, 51, 54, 60, 62, 65, 66, 67, 68, 71, 73, 78, 80, 81, 82, 83, 84, 85, 87, 88, 89, 94, 98, 100, 101, 102, 103, 104, 107, 108, 109, 111, 112, 113, 121, 122, 123, 127, 128, 129, 130, 131, 132, 133, 140, 141, 142, 143, 149, 151, 152, 153, 161, 165, 173, 174, 180, 183, 184, 185, 186, 188]"
Shakespeare,L50,short,86,33,53,16,0.5376,186,"[4, 5, 6, 7, 9, 11, 12, 14, 17, 18, 19, 20, 22, 28, 31, 33, 35, 36, 37, 39, 40, 44, 48, 49, 50, 51, 54, 56, 57, 60, 61, 62, 64, 70, 71, 72, 74, 75, 76, 77, 78, 79, 80, 81, 82, 83, 84, 87, 92, 94, 95, 96, 97, 99, 100, 102, 103, 104, 108, 115, 118, 120, 121, 124, 126, 135, 136, 137, 138, 143, 144, 145, 146, 147, 151, 158, 159, 160, 168, 169, 171, 177, 178, 179, 180, 182]"
Shakespeare,L50,short,83,36,47,8,0.5464,183,"[0, 2, 4, 5, 8, 11, 15, 17, 18, 20, 21, 22, 23, 24, 26, 28, 31, 37, 38, 39, 42, 43, 44, 45, 48, 50, 51, 52, 53, 58, 59, 61, 63, 64, 65, 68, 72, 74, 79, 82, 83, 84, 88, 90, 91, 92, 93, 94, 95, 99, 100, 102, 104, 105, 108, 109, 110, 111, 114, 115, 117, 122, 123, 127, 131, 137, 138, 139, 140, 148, 149, 150, 155, 156, 157, 158, 159, 160, 167, 168, 169, 173, 181]"
Shakespeare,L100,short,91,45,46,3,0.5236,191,"[0, 1, 2, 4, 5, 7, 8, 9, 13, 14, 15, 16, 17, 19, 20, 21, 22, 24, 25, 26, 27, 28, 29, 34, 36, 39, 40, 41, 43, 44, 45, 47, 48, 50, 57, 58, 59, 61, 62, 64, 65, 66, 68, 70, 72, 73, 74, 81, 83, 84, 85, 88, 89, 90, 91, 92, 94, 95, 103, 104, 105, 106, 107, 108, 109, 110, 112, 113, 114, 115, 124, 126, 127, 134, 135, 136, 138, 145, 146, 147, 149, 157, 158, 159, 167, 168, 169, 177, 179, 188, 189]"
Shakespeare,L100,short,92,52,40,6,0.5208,192,"[0, 4, 7, 9, 12, 13, 14, 17, 18, 21, 22, 23, 24, 27, 28, 30, 33, 34, 35, 36, 40, 41, 43, 44, 45, 46, 48, 50, 54, 55, 56, 62, 63, 64, 66, 68, 69, 70, 71, 72, 78, 79, 81, 82, 84, 85, 87, 89, 90, 91, 92, 95, 101, 103, 106, 111, 112, 114, 115, 116, 121, 122, 123, 124, 125, 126, 132, 133, 134, 135, 137, 143, 145, 147, 153, 154, 155, 157, 163, 165, 167, 173, 174, 175, 176, 177, 179, 185, 186, 187, 188, 189]"
Shakespeare,L100,short,86,37,49,15,0.5376,186,"[1, 2, 3, 4, 7, 8, 10, 13, 14, 15, 19, 21, 23, 24, 26, 27, 29, 35, 36, 40, 41, 43, 44, 45, 46, 47, 48, 51, 55, 57, 58, 63, 65, 66, 67, 68, 69, 75, 77, 78, 80, 82, 83, 84, 86, 88, 89, 90, 91, 95, 97, 100, 101, 104, 105, 106, 107, 108, 109, 112, 119, 120, 126, 133, 140, 141, 142, 145, 150, 151, 152, 153, 154, 160, 161, 162, 165, 170, 171, 172, 173, 174, 176, 182, 183, 184]"
Shakespeare,L100,short,83,54,29,2,0.5464,183,"[0, 1, 2, 3, 4, 5, 6, 7, 9, 14, 15, 18, 20, 23, 25, 27, 29, 31, 35, 36, 37, 38, 39, 40, 41, 42, 43, 46, 48, 49, 50, 51, 58, 59, 60, 61, 62, 65, 66, 67, 69, 70, 71, 72, 80, 81, 82, 83, 84, 86, 88, 90, 91, 92, 99, 101, 102, 107, 108, 109, 110, 111, 113, 120, 121, 122, 123, 124, 125, 126, 133, 134, 136, 143, 145, 146, 153, 157, 163, 164, 166, 167, 178]"
Shakespeare,L100,short,88,52,36,5,0.5319,188,"[0, 2, 3, 8, 10, 13, 14, 15, 16, 18, 20, 22, 24, 25, 26, 29, 32, 33, 35, 36, 39, 40, 41, 43, 45, 46, 47, 49, 54, 55, 57, 59, 60, 61, 62, 63, 64, 65, 66, 69, 70, 80, 81, 83, 84, 85, 87, 88, 89, 91, 98, 99, 100, 101, 108, 109, 110, 111, 112, 115, 120, 121, 122, 123, 124, 130, 131, 133, 134, 140, 141, 143, 144, 145, 152, 153, 155, 156, 158, 166, 168, 171, 172, 173, 181, 183, 184, 185]"
Shakespeare,L100,short,81,42,39,8,0.5525,181,"[1, 2, 5, 7, 10, 14, 16, 20, 21, 23, 24, 25, 26, 27, 28, 29, 32, 33, 35, 42, 43, 49, 52, 53, 54, 55, 56, 59, 62, 63, 65, 66, 67, 68, 71, 74, 75, 77, 79, 80, 81, 83, 86, 87, 89, 97, 99, 100, 106, 107, 108, 111, 115, 116, 117, 119, 120, 121, 126, 127, 130, 132, 133, 139, 140, 142, 143, 144, 150, 152, 153, 155, 161, 162, 163, 164, 165, 170, 171, 172, 175]"
Shakespeare,L100,short,81,35,46,5,0.5525,181,"[0, 1, 2, 4, 6, 8, 9, 13, 14, 15, 16, 17, 18, 19, 20, 21, 24, 27, 28, 29, 35, 37, 39, 41, 42, 44, 45, 46, 47, 48, 50, 53, 58, 60, 61, 62, 64, 65, 67, 72, 78, 79, 81, 82, 84, 86, 87, 88, 89, 91, 93, 99, 102, 103, 106, 110, 111, 112, 114, 115, 120, 122, 123, 124, 125, 126, 135, 136, 142, 144, 145, 146, 153, 157, 163, 165, 166, 167, 174, 176, 177]"
Shakespeare,L100,short,81,41,40,8,0.5525,181,"[0, 2, 3, 5, 6, 7, 8, 9, 12, 17, 18, 20, 24, 25, 26, 27, 28, 29, 32, 37, 38, 39, 40, 41, 42, 44, 45, 46, 47, 48, 49, 50, 51, 60, 61, 62, 64, 66, 67, 68, 70, 71, 72, 74, 81, 82, 83, 84, 86, 87, 90, 93, 100, 101, 102, 103, 105, 109, 111, 112, 113, 115, 122, 124, 130, 132, 133, 134, 140, 141, 143, 146, 152, 153, 156, 161, 163, 165, 167, 174, 176]"
Shakespeare,L100,short,91,39,52,10,0.5236,191,"[2, 3, 4, 5, 6, 7, 8, 9, 11, 12, 13, 15, 16, 17, 18, 23, 27, 28, 29, 30, 31, 32, 33, 34, 36, 40, 48, 50, 51, 52, 57, 59, 62, 67, 69, 71, 72, 73, 75, 76, 77, 78, 79, 80, 81, 89, 90, 91, 93, 95, 97, 98, 99, 100, 101, 103, 108, 109, 110, 113, 118, 119, 121, 122, 124, 130, 131, 132, 133, 134, 141, 143, 144, 145, 152, 153, 154, 155, 161, 162, 166, 172, 173, 174, 175, 182, 183, 184, 185, 186, 188]"
Shakespeare,L100,short,84,36,48,8,0.5435,184,"[3, 6, 8, 9, 10, 11, 12, 13, 17, 18, 19, 21, 22, 23, 24, 25, 26, 27, 28, 30, 32, 34, 36, 37, 42, 49, 50, 52, 53, 54, 55, 56, 57, 58, 61, 63, 70, 71, 72, 74, 76, 78, 79, 81, 82, 83, 84, 85, 90, 91, 92, 93, 94, 97, 101, 104, 105, 106, 112, 113, 114, 115, 116, 117, 118, 125, 126, 128, 134, 137, 139, 146, 148, 154, 155, 156, 157, 158, 159, 168, 170, 176, 177, 181]"
Shakespeare,L100,short,84,25,59,6,0.5435,184,"[0, 3, 4, 5, 6, 7, 8, 9, 10, 11, 16, 17, 18, 19, 21, 22, 25, 26, 28, 30, 31, 32, 33, 38, 39, 40, 42, 43, 45, 46, 47, 48, 50, 51, 52, 54, 55, 64, 65, 66, 67, 68, 69, 70, 71, 73, 75, 76, 77, 88, 90, 93, 94, 95, 96, 99, 105, 108, 114, 117, 118, 124, 125, 126, 129, 136, 137, 138, 143, 144, 145, 146, 148, 154, 156, 157, 158, 164, 166, 167, 168, 172, 178, 179]"
Shakespeare,L100,short,84,48,36,13,0.5435,184,"[2, 3, 4, 5, 6, 7, 8, 9, 12, 13, 15, 16, 18, 19, 25, 26, 27, 29, 30, 31, 32, 33, 34, 35, 39, 40, 42, 43, 45, 51, 55, 56, 63, 65, 69, 71, 72, 73, 74, 75, 76, 77, 78, 79, 80, 81, 82, 84, 85, 92, 93, 94, 97, 98, 99, 100, 102, 103, 104, 105, 106, 108, 114, 115, 116, 117, 123, 124, 125, 126, 127, 134, 135, 136, 138, 146, 147, 154, 156, 157, 163, 170, 176, 180]"
Shakespeare,L100,short,88,48,40,10,0.5319,188,"[0, 1, 5, 7, 9, 11, 12, 13, 14, 16, 17, 19, 20, 21, 22, 24, 25, 26, 27, 29, 30, 35, 37, 38, 41, 42, 44, 45, 46, 47, 48, 49, 50, 51, 65, 66, 67, 69, 70, 73, 78, 82, 85, 86, 87, 88, 90, 92, 93, 94, 99, 101, 102, 106, 110, 111, 112, 113, 114, 115, 116, 121, 123, 124, 126, 128, 134, 136, 137, 138, 145, 146, 148, 149, 155, 156, 157, 158, 160, 162, 165, 171, 172, 173, 180, 181, 182, 183]"
Shakespeare,L100,short,87,55,32,5,0.5348,187,"[0, 1, 2, 3, 4, 5, 7, 8, 10, 14, 15, 17, 19, 20, 22, 23, 24, 25, 26, 28, 32, 33, 37, 38, 41, 42, 43, 44, 45, 46, 47, 48, 50, 52, 53, 54, 62, 63, 64, 66, 67, 68, 70, 71, 73, 74, 75, 82, 85, 86, 87, 88, 89, 91, 92, 94, 95, 96, 98, 106, 107, 109, 114, 115, 116, 117, 118, 124, 125, 127, 128, 129, 136, 137, 138, 140, 150, 153, 161, 168, 171, 172, 173, 179, 181, 182, 183]"
Shakespeare,L100,short,89,40,49,8,0.5291,189,"[3, 4, 5, 6, 7, 8, 10, 13, 15, 16, 17, 19, 20, 21, 24, 25, 27, 29, 30, 32, 33, 34, 35, 36, 37, 39, 41, 46, 48, 49, 50, 52, 53, 55, 57, 58, 59, 60, 61, 69, 70, 73, 74, 75, 77, 78, 79, 80, 81, 88, 90, 91, 93, 95, 96, 97, 102, 108, 109, 111, 117, 118, 120, 121, 122, 123, 129, 130, 132, 133, 140, 142, 143, 149, 150, 152, 153, 159, 160, 162, 163, 164, 172, 173, 175, 182, 183, 184, 186]"
Shakespeare,L100,short,88,53,35,10,0.5319,188,"[3, 5, 6, 7, 8, 9, 10, 11, 12, 13, 15, 16, 17, 18, 19, 20, 26, 27, 28, 30, 31, 32, 34, 37, 39, 40, 42, 48, 51, 52, 53, 54, 55, 59, 62, 68, 69, 70, 71, 72, 73, 74, 75, 76, 79, 81, 83, 91, 92, 93, 94, 96, 98, 99, 100, 101, 103, 104, 105, 111, 112, 113, 114, 115, 120, 121, 122, 123, 124, 126, 134, 135, 142, 148, 154, 155, 157, 163, 164, 165, 166, 167, 168, 169, 171, 172, 182, 183]"
Shakespeare,L100,short,86,47,39,7,0.5376,186,"[0, 2, 3, 5, 6, 8, 10, 13, 15, 16, 17, 18, 19, 20, 23, 24, 25, 26, 27, 28, 29, 30, 37, 40, 41, 42, 44, 46, 48, 49, 50, 52, 53, 59, 60, 61, 62, 63, 65, 66, 68, 70, 71, 72, 73, 75, 83, 86, 88, 89, 91, 93, 94, 99, 104, 106, 107, 111, 113, 115, 116, 117, 122, 123, 124, 125, 128, 134, 135, 136, 137, 143, 144, 146, 147, 155, 156, 158, 165, 166, 168, 174, 175, 176, 178, 184]"
Shakespeare,L100,short,87,50,37,8,0.5348,187,"[3, 4, 6, 8, 9, 10, 11, 12, 13, 14, 15, 16, 17, 18, 19, 21, 23, 27, 29, 30, 32, 38, 40, 41, 43, 44, 48, 49, 50, 51, 53, 54, 60, 61, 62, 63, 64, 71, 72, 74, 77, 78, 79, 80, 82, 83, 84, 86, 91, 92, 93, 94, 95, 98, 99, 100, 101, 102, 103, 104, 105, 106, 107, 109, 116, 117, 118, 124, 125, 126, 127, 128, 129, 137, 139, 146, 149, 157, 159, 166, 167, 168, 169, 170, 177, 178, 180]"
Shakespeare,L100,short,84,41,43,5,0.5435,184,"[3, 4, 5, 7, 8, 9, 10, 11, 14, 15, 17, 18, 19, 20, 24, 26, 27, 28, 30, 31, 32, 33, 34, 36, 37, 39, 41, 42, 43, 44, 55, 56, 57, 61, 64, 66, 71, 73, 74, 75, 79, 80, 81, 83, 84, 85, 88, 93, 94, 95, 96, 98, 99, 102, 103, 105, 107, 108, 109, 115, 116, 118, 119, 124, 126, 128, 130, 136, 137, 140, 146, 147, 150, 151, 157, 159, 160, 161, 162, 163, 164, 171, 173, 175]"
Shakespeare,L100,short,87,56,31,2,0.5348,187,"[0, 1, 3, 4, 5, 6, 9, 14, 15, 19, 20, 22, 25, 27, 28, 29, 30, 31, 32, 33, 37, 38, 39, 44, 45, 46, 47, 48, 52, 54, 55, 61, 62, 65, 66, 68, 70, 73, 74, 75, 76, 82, 83, 87, 88, 89, 90, 91, 93, 95, 96, 101, 102, 103, 104, 105, 106, 110, 111, 113, 114, 115, 116, 117, 119, 125, 126, 127, 128, 137, 138, 144, 145, 146, 147, 148, 149, 156, 158, 160, 168, 170, 171, 179, 180, 181, 182]"
Shakespeare,L100,short,86,36,50,6,0.5376,186,"[4, 5, 6, 8, 9, 12, 13, 15, 19, 20, 22, 24, 26, 27, 28, 29, 30, 31, 32, 34, 35, 37, 38, 40, 41, 47, 48, 52, 53, 54, 56, 57, 58, 59, 60, 61, 62, 63, 69, 70, 71, 72, 75, 78, 79, 80, 81, 84, 86, 92, 93, 95, 98, 101, 102, 103, 104, 105, 108, 114, 116, 118, 123, 125, 126, 127, 128, 135, 136, 138, 144, 145, 146, 147, 149, 155, 156, 158, 159, 167, 168, 169, 176, 177, 178, 180]"
Shakespeare,L100,short,79,34,45,7,0.5587,179,"[2, 3, 5, 6, 9, 10, 11, 12, 13, 14, 16, 17, 18, 19, 25, 27, 29, 30, 31, 32, 33, 34, 36, 39, 43, 44, 46, 47, 49, 50, 51, 53, 55, 56, 57, 58, 59, 67, 69, 70, 71, 72, 73, 76, 78, 79, 80, 81, 87, 90, 94, 95, 96, 98, 99, 102, 103, 104, 105, 111, 114, 115, 123, 124, 125, 127, 133, 134, 135, 137, 144, 145, 146, 147, 150, 156, 160, 167, 172]"
Shakespeare,L100,short,87,35,52,9,0.5348,187,"[0, 1, 4, 6, 7, 8, 9, 10, 15, 16, 17, 18, 19, 23, 24, 25, 26, 27, 28, 29, 30, 37, 38, 40, 44, 45, 46, 47, 49, 53, 61, 62, 63, 64, 65, 66, 70, 75, 76, 77, 78, 80, 81, 85, 86, 87, 90, 94, 96, 98, 99, 100, 104, 105, 106, 109, 110, 116, 117, 118, 119, 124, 129, 130, 131, 132, 138, 139, 140, 141, 142, 148, 149, 150, 151, 152, 153, 154, 162, 163, 165, 166, 173, 174, 175, 176, 185]"
Shakespeare,L100,short,82,58,24,21,0.5495,182,"[0, 1, 2, 3, 4, 5, 7, 8, 9, 14, 16, 19, 21, 22, 24, 25, 28, 31, 36, 37, 40, 41, 42, 44, 45, 46, 47, 48, 49, 52, 58, 59, 60, 61, 62, 63, 64, 66, 67, 68, 69, 70, 78, 87, 88, 91, 92, 93, 95, 99, 101, 102, 103, 104, 109, 111, 112, 113, 114, 118, 124, 125, 131, 132, 134, 135, 143, 144, 148, 153, 154, 155, 156, 157, 158, 166, 167, 169, 174, 175, 179, 180]"
Shakespeare,L100,short,88,52,36,16,0.5319,188,"[4, 5, 7, 9, 10, 11, 13, 14, 16, 21, 23, 24, 25, 26, 27, 28, 29, 30, 31, 32, 33, 34, 35, 36, 38, 39, 45, 46, 47, 49, 50, 51, 53, 56, 58, 59, 66, 67, 68, 69, 70, 72, 73, 75, 76, 77, 78, 79, 87, 93, 94, 95, 96, 97, 98, 100, 102, 108, 109, 110, 111, 116, 117, 118, 119, 120, 122, 128, 129, 130, 135, 143, 149, 151, 152, 153, 155, 162, 165, 171, 172, 174, 175, 176, 181, 182, 184, 186]"
Shakespeare,L100,short,88,50,38,3,0.5319,188,"[1, 3, 6, 8, 9, 11, 12, 13, 14, 15, 16, 20, 21, 24, 25, 28, 29, 32, 34, 35, 36, 37, 38, 39, 40, 41, 42, 43, 45, 47, 49, 56, 57, 58, 59, 60, 61, 62, 63, 64, 67, 68, 69, 77, 78, 79, 80, 84, 86, 87, 90, 97, 98, 99, 100, 101, 104, 107, 108, 110, 111, 117, 118, 119, 120, 121, 127, 129, 130, 132, 138, 139, 140, 141, 143, 150, 152, 158, 159, 161, 162, 169, 170, 171, 172, 180, 181, 183]"
Shakespeare,L100,short,82,31,51,13,0.5495,182,"[2, 3, 5, 8, 9, 10, 11, 12, 13, 14, 15, 18, 20, 23, 24, 26, 28, 29, 32, 34, 35, 38, 41, 45, 50, 51, 52, 53, 55, 56, 57, 59, 61, 62, 69, 70, 71, 72, 73, 74, 75, 77, 78, 80, 83, 89, 90, 91, 95, 99, 100, 102, 106, 108, 109, 111, 113, 118, 119, 120, 121, 122, 124, 129, 130, 131, 135, 142, 143, 144, 149, 150, 154, 159, 160, 162, 163, 164, 169, 170, 173, 177]"
Shakespeare,L100,short,89,43,46,8,0.5291,189,"[0, 1, 2, 4, 5, 7, 8, 9, 11, 12, 18, 21, 23, 24, 27, 28, 30, 31, 34, 37, 39, 40, 42, 45, 46, 47, 48, 50, 53, 59, 60, 61, 62, 64, 65, 67, 68, 69, 70, 72, 76, 82, 83, 85, 86, 87, 89, 90, 91, 93, 95, 96, 101, 103, 104, 105, 106, 110, 111, 112, 113, 114, 116, 117, 124, 125, 126, 127, 128, 135, 136, 138, 139, 140, 141, 148, 149, 151, 159, 160, 161, 168, 169, 170, 172, 178, 179, 180, 181]"
Shakespeare,L100,short,81,50,31,7,0.5525,181,"[0, 1, 2, 4, 5, 6, 8, 9, 14, 16, 17, 18, 20, 21, 22, 23, 24, 26, 27, 28, 29, 36, 38, 39, 41, 42, 43, 44, 45, 46, 47, 48, 49, 50, 57, 63, 64, 65, 67, 68, 70, 71, 78, 81, 82, 84, 85, 86, 87, 88, 89, 92, 94, 105, 106, 108, 113, 114, 115, 116, 118, 124, 126, 128, 130, 136, 138, 140, 141, 147, 148, 150, 151, 154, 160, 161, 163, 164, 174, 175, 176]"
Shakespeare,L100,short,85,30,55,6,0.5405,185,"[2, 3, 5, 6, 7, 8, 9, 10, 11, 12, 13, 14, 15, 18, 19, 20, 22, 28, 29, 31, 32, 33, 36, 38, 39, 41, 50, 52, 55, 56, 57, 58, 59, 60, 61, 68, 71, 72, 77, 78, 84, 87, 88, 89, 90, 93, 96, 97, 98, 100, 101, 104, 108, 109, 111, 113, 115, 120, 121, 122, 124, 129, 130, 131, 132, 133, 135, 141, 142, 144, 149, 150, 151, 152, 153, 154, 155, 157, 166, 167, 168, 170, 171, 177, 181]"
Shakespeare,L100,short,83,44,39,16,0.5464,183,"[4, 5, 7, 8, 10, 11, 12, 13, 15, 16, 17, 19, 22, 25, 29, 30, 31, 32, 33, 34, 35, 36, 37, 40, 45, 46, 49, 50, 56, 57, 59, 62, 66, 67, 68, 71, 73, 77, 78, 79, 80, 81, 82, 84, 86, 94, 95, 96, 98, 99, 101, 103, 105, 106, 107, 111, 112, 113, 114, 115, 117, 119, 125, 128, 134, 137, 138, 144, 145, 146, 147, 148, 150, 156, 157, 158, 165, 170, 176, 177, 178, 179, 181]"
Shakespeare,L100,short,84,42,42,10,0.5435,184,"[0, 1, 2, 3, 5, 7, 8, 10, 14, 15, 17, 18, 19, 20, 21, 22, 24, 25, 26, 27, 29, 30, 31, 33, 38, 39, 41, 44, 45, 46, 47, 48, 49, 52, 53, 61, 62, 63, 64, 65, 67, 69, 70, 72, 74, 76, 84, 85, 86, 87, 88, 91, 92, 93, 94, 95, 96, 99, 106, 108, 109, 111, 118, 120, 123, 129, 130, 132, 138, 139, 140, 141, 143, 150, 151, 154, 160, 162, 163, 169, 170, 173, 178, 181]"
Shakespeare,L100,short,83,46,37,20,0.5464,183,"[2, 4, 5, 6, 8, 9, 11, 12, 13, 14, 16, 17, 19, 24, 28, 29, 31, 33, 34, 35, 36, 39, 40, 45, 48, 49, 51, 52, 53, 56, 58, 59, 61, 65, 69, 70, 71, 72, 73, 74, 75, 76, 77, 79, 81, 82, 83, 84, 85, 88, 94, 97, 99, 100, 102, 103, 104, 106, 113, 114, 115, 117, 122, 123, 124, 125, 127, 129, 136, 137, 142, 148, 151, 161, 167, 168, 169, 170, 171, 177, 178, 179, 180]"
Shakespeare,L100,short,82,46,36,8,0.5495,182,"[0, 1, 3, 4, 5, 6, 7, 8, 9, 10, 16, 17, 18, 19, 24, 25, 26, 28, 30, 32, 36, 37, 39, 40, 43, 45, 46, 47, 48, 50, 52, 58, 59, 61, 62, 63, 66, 67, 68, 69, 73, 74, 75, 76, 82, 85, 87, 89, 90, 91, 92, 93, 94, 95, 96, 97, 104, 105, 106, 108, 112, 115, 117, 118, 127, 128, 134, 135, 136, 138, 147, 148, 149, 150, 158, 161, 166, 167, 170, 172, 178, 180]"
Shakespeare,L100,short,88,35,53,5,0.5319,188,"[5, 6, 7, 8, 11, 12, 16, 17, 19, 21, 23, 24, 26, 27, 28, 29, 30, 32, 33, 34, 35, 36, 37, 38, 39, 40, 41, 42, 48, 49, 50, 52, 53, 54, 56, 57, 60, 61, 62, 69, 70, 71, 73, 74, 75, 76, 80, 81, 84, 91, 92, 94, 95, 96, 97, 98, 99, 100, 101, 102, 103, 106, 114, 115, 117, 122, 123, 124, 125, 126, 134, 136, 143, 145, 146, 152, 153, 155, 156, 159, 166, 167, 168, 169, 170, 177, 178, 181]"
Shakespeare,L100,short,85,35,50,9,0.5405,185,"[0, 1, 3, 4, 6, 7, 8, 9, 13, 14, 16, 19, 20, 21, 22, 23, 24, 25, 27, 29, 30, 35, 36, 37, 38, 39, 42, 43, 45, 47, 50, 51, 52, 59, 60, 61, 62, 63, 64, 66, 67, 68, 69, 71, 72, 73, 80, 85, 86, 87, 88, 89, 90, 91, 92, 93, 97, 106, 110, 113, 114, 115, 117, 119, 125, 126, 127, 131, 138, 146, 149, 150, 155, 156, 157, 158, 162, 167, 168, 171, 172, 178, 180, 181, 182]"
Shakespeare,L100,short,86,43,43,5,0.5376,186,"[4, 5, 7, 8, 9, 10, 11, 12, 13, 17, 18, 19, 20, 21, 22, 23, 24, 28, 30, 31, 34, 37, 38, 39, 41, 42, 43, 44, 46, 52, 53, 54, 56, 57, 58, 59, 61, 62, 64, 65, 73, 75, 76, 77, 78, 79, 80, 83, 84, 85, 87, 93, 97, 99, 100, 101, 102, 107, 108, 114, 115, 120, 126, 127, 128, 130, 137, 140, 146, 147, 148, 149, 150, 151, 152, 158, 159, 160, 161, 162, 170, 171, 173, 181, 182, 183]"
Shakespeare,L100,short,82,31,51,10,0.5495,182,"[0, 1, 3, 4, 5, 6, 8, 9, 10, 14, 15, 16, 17, 20, 21, 22, 23, 27, 28, 29, 30, 31, 36, 37, 39, 40, 41, 42, 43, 44, 45, 46, 48, 50, 51, 58, 59, 60, 61, 62, 66, 67, 68, 71, 74, 82, 84, 85, 86, 87, 88, 90, 91, 92, 93, 97, 104, 106, 110, 111, 112, 115, 121, 124, 125, 133, 135, 141, 142, 143, 144, 145, 152, 153, 154, 156, 162, 164, 165, 171, 172, 173]"
Shakespeare,L100,short,84,49,35,3,0.5435,184,"[0, 1, 3, 8, 10, 13, 14, 15, 16, 18, 19, 21, 23, 24, 25, 26, 28, 29, 32, 33, 35, 36, 38, 39, 40, 41, 43, 44, 45, 47, 48, 49, 55, 56, 58, 59, 60, 62, 63, 65, 66, 67, 68, 71, 78, 82, 83, 86, 88, 90, 91, 97, 98, 99, 100, 101, 102, 106, 107, 108, 109, 110, 111, 112, 113, 114, 121, 123, 124, 131, 134, 140, 142, 143, 144, 145, 152, 153, 155, 162, 164, 166, 175, 182]"
Shakespeare,L100,short,86,38,48,10,0.5376,186,"[0, 2, 3, 4, 6, 11, 13, 14, 15, 16, 17, 18, 19, 20, 21, 22, 23, 24, 25, 28, 29, 30, 31, 32, 33, 34, 40, 46, 48, 49, 50, 53, 54, 60, 61, 62, 63, 64, 65, 66, 67, 69, 71, 73, 74, 77, 84, 85, 86, 89, 90, 92, 93, 94, 95, 96, 98, 104, 106, 107, 109, 116, 118, 119, 125, 127, 128, 130, 138, 139, 141, 148, 150, 151, 158, 160, 161, 162, 163, 169, 170, 171, 172, 173, 180, 181]"
Shakespeare,L100,short,84,44,40,7,0.5435,184,"[4, 5, 6, 7, 10, 13, 14, 15, 16, 17, 18, 19, 21, 22, 25, 26, 27, 30, 32, 33, 34, 36, 39, 44, 49, 50, 51, 52, 53, 55, 56, 57, 59, 61, 62, 65, 70, 71, 72, 73, 76, 77, 79, 81, 82, 83, 85, 86, 87, 93, 94, 95, 96, 99, 103, 105, 106, 107, 110, 115, 116, 118, 123, 124, 125, 129, 137, 138, 139, 144, 145, 146, 147, 149, 155, 156, 160, 161, 168, 170, 171, 180, 181, 182]"
Shakespeare,L100,short,86,41,45,8,0.5376,186,"[2, 4, 5, 7, 9, 10, 12, 13, 14, 15, 18, 20, 23, 24, 26, 27, 29, 30, 31, 32, 34, 35, 36, 39, 40, 41, 47, 48, 52, 53, 55, 56, 57, 60, 62, 68, 69, 72, 73, 74, 75, 77, 78, 79, 80, 83, 88, 89, 90, 91, 92, 93, 94, 95, 98, 101, 104, 109, 110, 112, 113, 115, 116, 117, 120, 126, 128, 130, 136, 138, 139, 145, 146, 147, 148, 149, 156, 159, 165, 166, 167, 170, 176, 177, 178, 180]"
Shakespeare,L100,short,84,41,43,9,0.5435,184,"[0, 1, 2, 3, 5, 6, 7, 9, 10, 15, 16, 17, 18, 19, 21, 23, 24, 25, 27, 28, 29, 30, 32, 34, 39, 40, 41, 43, 45, 46, 49, 50, 51, 52, 53, 54, 56, 64, 66, 67, 68, 69, 71, 72, 73, 76, 80, 86, 87, 90, 91, 92, 93, 94, 95, 96, 97, 98, 100, 103, 110, 112, 114, 121, 122, 123, 124, 125, 135, 141, 142, 145, 148, 156, 157, 160, 166, 167, 168, 169, 174, 175, 177, 180]"
Shakespeare,L100,short,86,38,48,13,0.5376,186,"[0, 2, 3, 6, 7, 9, 11, 13, 14, 15, 18, 19, 25, 26, 29, 30, 31, 33, 36, 37, 38, 39, 40, 42, 43, 44, 45, 46, 47, 49, 50, 51, 52, 59, 61, 64, 65, 67, 71, 73, 80, 81, 82, 83, 85, 86, 87, 88, 90, 91, 92, 93, 94, 99, 100, 101, 104, 105, 109, 110, 111, 112, 113, 114, 116, 122, 123, 125, 129, 136, 142, 143, 144, 145, 148, 154, 157, 158, 164, 166, 168, 175, 176, 177, 178, 180]"
Shakespeare,L100,short,90,35,55,5,0.5263,190,"[0, 2, 3, 5, 7, 8, 9, 11, 14, 15, 16, 17, 19, 20, 21, 22, 23, 24, 25, 26, 27, 29, 31, 37, 38, 42, 43, 44, 45, 46, 48, 49, 50, 51, 60, 61, 62, 63, 64, 67, 69, 70, 71, 77, 80, 81, 83, 84, 85, 87, 89, 90, 91, 92, 99, 101, 102, 104, 106, 108, 109, 111, 113, 116, 124, 126, 132, 133, 134, 135, 141, 144, 145, 146, 152, 153, 154, 156, 162, 163, 165, 166, 173, 174, 175, 178, 184, 185, 187, 188]"
Shakespeare,L100,short,95,31,64,4,0.5128,195,"[1, 2, 3, 4, 7, 10, 12, 13, 15, 16, 17, 18, 19, 20, 21, 22, 24, 25, 26, 30, 34, 36, 37, 39, 40, 41, 44, 45, 46, 47, 49, 50, 51, 52, 53, 61, 64, 66, 67, 70, 72, 74, 80, 81, 82, 83, 84, 85, 86, 87, 89, 90, 91, 93, 94, 95, 102, 103, 104, 105, 107, 112, 113, 114, 115, 116, 117, 118, 125, 126, 127, 129, 136, 137, 139, 146, 147, 148, 149, 150, 158, 159, 160, 167, 168, 169, 170, 173, 180, 182, 189, 190, 191, 192, 193]"
Shakespeare,L100,short,86,43,43,3,0.5376,186,"[2, 3, 5, 6, 7, 9, 13, 15, 16, 18, 19, 21, 22, 23, 24, 25, 26, 27, 32, 36, 37, 38, 39, 41, 42, 43, 44, 45, 46, 48, 49, 50, 54, 60, 61, 63, 64, 65, 66, 67, 68, 70, 71, 72, 75, 77, 84, 85, 86, 87, 88, 91, 92, 94, 95, 96, 97, 104, 105, 107, 112, 115, 116, 117, 124, 125, 128, 129, 130, 137, 138, 139, 141, 149, 150, 157, 158, 161, 167, 168, 169, 171, 178, 179, 180, 181]"
Shakespeare,L100,short,84,35,49,4,0.5435,184,"[2, 3, 4, 5, 8, 9, 10, 11, 13, 14, 15, 16, 18, 19, 24, 25, 27, 28, 29, 31, 33, 34, 39, 44, 45, 46, 48, 49, 51, 53, 54, 55, 56, 58, 60, 65, 70, 71, 72, 73, 75, 76, 77, 78, 79, 80, 81, 82, 89, 91, 92, 93, 94, 95, 96, 99, 101, 102, 109, 110, 112, 118, 121, 122, 131, 132, 134, 140, 141, 142, 143, 149, 153, 159, 160, 161, 162, 163, 169, 170, 171, 174, 179, 180]"
Shakespeare,L100,short,82,39,43,12,0.5495,182,"[4, 5, 6, 7, 9, 10, 11, 12, 14, 15, 17, 21, 24, 25, 27, 28, 29, 30, 31, 33, 34, 35, 36, 38, 41, 46, 48, 50, 51, 52, 54, 55, 58, 59, 60, 61, 62, 63, 69, 70, 73, 74, 75, 76, 77, 78, 79, 81, 82, 85, 92, 93, 94, 95, 97, 98, 100, 104, 110, 111, 115, 120, 125, 130, 135, 140, 142, 143, 148, 154, 155, 156, 161, 164, 166, 170, 171, 172, 175, 177, 178, 179]"
Shakespeare,L100,short,83,48,35,5,0.5464,183,"[0, 2, 4, 6, 7, 8, 10, 13, 15, 17, 18, 19, 20, 21, 22, 23, 24, 25, 26, 27, 29, 31, 37, 39, 42, 43, 44, 45, 46, 47, 48, 49, 50, 52, 60, 63, 64, 66, 67, 68, 69, 72, 73, 80, 81, 82, 83, 86, 87, 88, 89, 90, 91, 93, 94, 96, 102, 103, 105, 108, 109, 110, 111, 112, 113, 114, 115, 117, 124, 125, 126, 136, 145, 146, 153, 155, 156, 162, 163, 166, 172, 175, 176]"
Shakespeare,L100,short,81,44,37,3,0.5525,181,"[1, 2, 5, 6, 7, 8, 9, 14, 15, 16, 17, 19, 21, 26, 27, 28, 29, 32, 34, 36, 37, 38, 39, 40, 41, 42, 44, 45, 46, 47, 50, 57, 60, 62, 66, 67, 68, 70, 71, 78, 79, 80, 82, 86, 88, 90, 91, 96, 97, 98, 99, 100, 104, 108, 109, 110, 113, 115, 120, 121, 124, 130, 132, 134, 139, 142, 144, 150, 151, 152, 153, 155, 161, 162, 163, 165, 166, 172, 173, 175, 177]"
Shakespeare,L100,short,88,35,53,5,0.5319,188,"[0, 2, 3, 5, 6, 7, 8, 9, 13, 15, 16, 17, 18, 19, 21, 25, 26, 28, 29, 33, 35, 36, 37, 38, 39, 40, 41, 43, 45, 48, 49, 50, 51, 58, 59, 60, 61, 62, 63, 65, 67, 69, 70, 72, 79, 80, 81, 89, 91, 93, 99, 100, 103, 107, 110, 111, 112, 114, 121, 122, 123, 128, 129, 131, 132, 133, 139, 140, 141, 142, 143, 145, 151, 152, 154, 161, 162, 163, 164, 170, 172, 173, 174, 175, 182, 183, 184, 185]"
Shakespeare,L100,short,80,33,47,12,0.5556,180,"[2, 3, 4, 7, 8, 9, 11, 13, 15, 16, 17, 18, 21, 25, 26, 27, 28, 32, 33, 34, 35, 37, 39, 40, 41, 43, 48, 49, 50, 51, 52, 53, 54, 55, 57, 61, 62, 69, 70, 71, 72, 74, 75, 76, 77, 79, 80, 81, 82, 91, 92, 93, 94, 95, 96, 97, 99, 101, 103, 109, 110, 111, 112, 117, 119, 120, 122, 125, 132, 134, 141, 142, 144, 150, 151, 154, 160, 161, 166, 175]"
Shakespeare,L100,short,90,42,48,5,0.5263,190,"[2, 3, 5, 7, 8, 9, 10, 12, 13, 16, 17, 18, 19, 21, 24, 25, 26, 27, 28, 29, 30, 31, 33, 34, 35, 37, 38, 39, 40, 47, 51, 52, 53, 55, 56, 59, 62, 71, 73, 76, 77, 78, 79, 81, 82, 87, 89, 90, 91, 93, 94, 95, 96, 97, 99, 100, 102, 103, 109, 110, 111, 112, 114, 119, 120, 123, 124, 131, 133, 134, 136, 137, 139, 146, 147, 148, 149, 150, 153, 160, 162, 163, 164, 171, 172, 173, 174, 181, 183, 184]"
Shakespeare,L100,short,88,47,41,8,0.5319,188,"[1, 3, 5, 6, 8, 10, 13, 14, 16, 17, 19, 20, 21, 22, 23, 24, 26, 27, 29, 37, 38, 40, 42, 43, 45, 47, 49, 53, 54, 55, 56, 57, 59, 62, 63, 64, 65, 66, 69, 71, 80, 81, 82, 83, 84, 85, 87, 88, 89, 90, 92, 93, 99, 100, 101, 102, 103, 105, 106, 108, 109, 110, 111, 112, 114, 115, 122, 124, 126, 133, 140, 146, 147, 153, 154, 155, 156, 158, 159, 165, 166, 167, 169, 175, 178, 179, 180, 181]"
Shakespeare,L100,short,88,47,41,10,0.5319,188,"[3, 4, 6, 7, 9, 10, 12, 13, 14, 15, 16, 21, 23, 24, 25, 26, 27, 32, 33, 34, 35, 37, 42, 46, 48, 49, 50, 51, 52, 54, 56, 59, 63, 64, 66, 67, 68, 69, 70, 76, 77, 78, 79, 80, 81, 83, 88, 89, 91, 92, 93, 94, 96, 97, 98, 99, 102, 108, 109, 111, 112, 117, 118, 119, 122, 129, 130, 132, 133, 134, 142, 143, 146, 152, 153, 156, 163, 164, 165, 166, 167, 174, 175, 176, 177, 178, 179, 182]"
Shakespeare,L100,short,85,31,54,4,0.5405,185,"[0, 1, 3, 4, 5, 7, 9, 10, 16, 17, 20, 21, 22, 24, 25, 26, 27, 28, 29, 30, 31, 35, 36, 37, 39, 42, 43, 45, 46, 47, 48, 49, 51, 58, 59, 61, 62, 63, 64, 65, 66, 67, 68, 69, 70, 71, 72, 81, 82, 83, 85, 88, 89, 90, 93, 94, 101, 102, 103, 105, 109, 110, 112, 116, 123, 125, 126, 132, 134, 136, 142, 143, 144, 145, 147, 153, 155, 156, 157, 164, 165, 169, 177, 178, 179]"
Shakespeare,L100,short,84,42,42,17,0.5435,184,"[3, 4, 5, 6, 7, 8, 10, 14, 15, 16, 17, 18, 19, 21, 22, 26, 29, 30, 33, 34, 35, 36, 37, 38, 40, 41, 42, 43, 44, 46, 47, 48, 51, 53, 54, 61, 62, 63, 64, 65, 66, 67, 69, 70, 73, 74, 75, 76, 77, 78, 89, 91, 92, 93, 94, 95, 96, 97, 100, 107, 109, 113, 114, 115, 116, 117, 120, 127, 128, 130, 137, 146, 152, 161, 165, 166, 167, 169, 171, 178, 179, 180, 181, 182]"
Shakespeare,L100,short,87,33,54,7,0.5348,187,"[0, 3, 4, 5, 7, 8, 10, 11, 14, 15, 17, 18, 19, 20, 21, 22, 23, 24, 27, 30, 31, 36, 37, 38, 39, 41, 42, 43, 44, 45, 46, 49, 50, 52, 60, 61, 62, 66, 67, 68, 70, 71, 72, 79, 80, 81, 85, 86, 87, 89, 90, 92, 98, 99, 100, 101, 104, 108, 109, 110, 111, 113, 118, 122, 123, 129, 131, 132, 134, 140, 141, 142, 143, 145, 146, 155, 157, 163, 164, 165, 166, 167, 174, 175, 176, 177, 185]"
Shakespeare,L100,short,84,44,40,9,0.5435,184,"[2, 4, 5, 6, 7, 13, 14, 15, 17, 18, 19, 22, 23, 24, 25, 26, 28, 29, 33, 34, 36, 39, 43, 44, 45, 47, 50, 51, 53, 54, 55, 56, 57, 58, 59, 60, 66, 67, 68, 69, 70, 73, 74, 75, 76, 77, 79, 81, 83, 90, 92, 93, 94, 95, 98, 100, 101, 102, 104, 110, 111, 113, 115, 120, 121, 123, 124, 131, 132, 135, 141, 143, 144, 150, 151, 153, 154, 161, 164, 170, 171, 172, 173, 177]"
Shakespeare,L100,short,79,29,50,11,0.5587,179,"[2, 3, 4, 6, 7, 9, 10, 13, 18, 19, 21, 22, 23, 24, 25, 27, 30, 31, 32, 33, 35, 36, 37, 39, 43, 44, 45, 46, 49, 50, 51, 52, 53, 54, 56, 58, 61, 67, 68, 69, 70, 73, 75, 76, 78, 79, 81, 88, 90, 91, 92, 95, 96, 99, 100, 101, 106, 107, 110, 111, 112, 120, 122, 128, 130, 131, 134, 140, 141, 142, 150, 151, 154, 159, 160, 161, 165, 171, 173]"
Shakespeare,L100,short,81,25,56,5,0.5525,181,"[0, 1, 3, 6, 7, 8, 9, 13, 14, 15, 17, 20, 22, 23, 26, 28, 29, 33, 34, 35, 37, 39, 40, 41, 42, 43, 44, 45, 46, 47, 48, 49, 51, 59, 60, 61, 62, 63, 64, 65, 66, 68, 69, 70, 81, 82, 83, 84, 86, 87, 88, 89, 90, 91, 92, 99, 101, 102, 103, 104, 105, 107, 111, 113, 114, 115, 117, 124, 127, 129, 131, 138, 139, 140, 149, 150, 158, 159, 161, 170, 179]"
Shakespeare,L100,short,86,17,69,3,0.5376,186,"[2, 3, 4, 5, 6, 7, 8, 9, 10, 11, 12, 13, 14, 15, 16, 18, 22, 27, 28, 29, 30, 32, 33, 34, 35, 36, 37, 40, 42, 48, 50, 51, 52, 53, 54, 57, 58, 59, 61, 62, 63, 64, 65, 66, 67, 69, 79, 81, 82, 83, 84, 85, 86, 87, 88, 90, 98, 99, 101, 103, 104, 106, 108, 109, 110, 113, 121, 122, 125, 132, 135, 141, 143, 146, 152, 153, 154, 156, 165, 166, 172, 174, 176, 182, 183, 184]"
Shakespeare,L100,short,85,42,43,6,0.5405,185,"[2, 3, 4, 7, 8, 9, 10, 11, 13, 14, 15, 16, 17, 18, 20, 25, 26, 28, 29, 31, 32, 34, 35, 37, 40, 44, 45, 46, 49, 51, 52, 53, 54, 55, 57, 58, 59, 67, 69, 70, 73, 76, 79, 80, 81, 82, 88, 89, 90, 92, 94, 95, 96, 99, 101, 102, 105, 106, 107, 112, 113, 114, 116, 117, 123, 124, 125, 126, 127, 130, 138, 139, 141, 147, 148, 149, 150, 157, 159, 160, 161, 169, 170, 174, 181]"
Shakespeare,L100,short,88,49,39,11,0.5319,188,"[0, 2, 5, 6, 8, 9, 10, 13, 15, 17, 19, 20, 21, 23, 24, 25, 26, 27, 29, 31, 36, 37, 38, 39, 41, 42, 43, 44, 45, 47, 50, 57, 59, 60, 62, 63, 64, 65, 66, 67, 68, 69, 71, 72, 73, 80, 81, 82, 83, 84, 85, 86, 87, 88, 90, 93, 94, 103, 104, 107, 108, 110, 111, 112, 114, 115, 122, 124, 126, 133, 134, 138, 144, 145, 146, 147, 148, 149, 157, 158, 159, 167, 168, 170, 171, 175, 182, 184]"
Shakespeare,L100,short,80,28,52,9,0.5556,180,"[0, 3, 5, 6, 7, 9, 12, 13, 14, 15, 16, 17, 19, 20, 22, 23, 24, 26, 27, 28, 30, 31, 32, 33, 35, 38, 44, 45, 46, 48, 49, 51, 52, 53, 55, 56, 62, 63, 65, 66, 67, 68, 69, 72, 73, 76, 77, 85, 88, 90, 92, 93, 96, 97, 98, 105, 106, 107, 109, 117, 124, 130, 131, 133, 138, 139, 141, 142, 143, 151, 153, 155, 160, 161, 163, 166, 171, 172, 173, 174]"
Shakespeare,L100,short,82,36,46,7,0.5495,182,"[2, 3, 4, 5, 6, 7, 8, 9, 10, 11, 12, 15, 19, 21, 22, 26, 31, 32, 33, 36, 37, 38, 39, 41, 42, 48, 49, 50, 53, 54, 55, 56, 57, 63, 76, 77, 78, 82, 83, 84, 86, 87, 91, 92, 93, 95, 96, 98, 101, 102, 103, 104, 105, 106, 108, 112, 115, 116, 117, 122, 123, 126, 127, 133, 135, 138, 144, 146, 151, 155, 157, 158, 163, 164, 167, 168, 173, 174, 175, 176, 177, 178]"
Shakespeare,L100,short,85,45,40,8,0.5405,185,"[2, 5, 11, 12, 13, 14, 15, 16, 17, 19, 20, 25, 28, 29, 30, 31, 33, 34, 35, 36, 37, 38, 41, 42, 44, 48, 49, 51, 52, 54, 55, 57, 58, 59, 60, 61, 62, 63, 64, 65, 71, 72, 73, 76, 77, 78, 79, 80, 83, 84, 86, 89, 95, 96, 97, 98, 99, 102, 103, 107, 110, 111, 118, 119, 120, 121, 123, 130, 131, 133, 141, 142, 143, 150, 151, 152, 154, 160, 162, 163, 165, 172, 173, 176, 182]"
Shakespeare,L100,short,82,59,23,7,0.5495,182,"[6, 7, 9, 12, 16, 17, 20, 21, 22, 23, 26, 27, 28, 29, 30, 31, 32, 33, 34, 35, 36, 37, 39, 41, 49, 52, 54, 56, 57, 58, 59, 60, 61, 62, 69, 70, 71, 73, 76, 78, 80, 82, 83, 84, 89, 90, 91, 92, 93, 94, 95, 96, 97, 98, 100, 102, 104, 105, 108, 115, 116, 117, 122, 124, 126, 127, 133, 134, 136, 137, 138, 140, 141, 142, 143, 145, 152, 154, 155, 166, 168, 177]"
Shakespeare,L100,short,84,27,57,8,0.5435,184,"[2, 3, 8, 9, 10, 11, 12, 13, 14, 15, 16, 17, 18, 20, 24, 25, 26, 28, 29, 30, 31, 33, 34, 35, 36, 37, 38, 40, 47, 49, 50, 51, 52, 53, 54, 55, 56, 58, 61, 69, 70, 71, 73, 74, 75, 76, 77, 78, 79, 80, 81, 82, 83, 91, 92, 93, 95, 99, 100, 105, 112, 113, 114, 121, 123, 124, 126, 133, 135, 137, 144, 145, 147, 148, 154, 155, 156, 159, 166, 167, 171, 174, 180, 181]"
Shakespeare,L100,short,82,51,31,9,0.5495,182,"[2, 4, 5, 10, 11, 12, 14, 15, 16, 17, 19, 21, 23, 24, 25, 27, 28, 29, 30, 31, 32, 33, 34, 38, 39, 40, 41, 42, 44, 45, 46, 48, 52, 53, 54, 61, 63, 66, 67, 68, 69, 70, 72, 74, 75, 85, 86, 87, 88, 89, 90, 91, 92, 93, 94, 97, 103, 104, 106, 110, 111, 113, 114, 116, 124, 125, 126, 133, 134, 135, 141, 147, 153, 156, 162, 163, 165, 166, 167, 168, 169, 179]"
Shakespeare,L100,short,84,48,36,4,0.5435,184,"[0, 1, 2, 3, 4, 6, 7, 8, 10, 14, 16, 19, 20, 22, 23, 25, 28, 29, 33, 34, 36, 37, 38, 39, 40, 41, 45, 46, 47, 48, 49, 50, 51, 58, 59, 61, 62, 65, 67, 68, 69, 71, 72, 79, 80, 81, 83, 84, 85, 88, 90, 91, 93, 95, 97, 103, 104, 105, 106, 107, 114, 115, 117, 118, 119, 126, 127, 129, 131, 138, 140, 146, 150, 156, 157, 160, 166, 167, 168, 169, 170, 177, 178, 180]"
Shakespeare,L100,short,88,41,47,9,0.5319,188,"[2, 3, 4, 6, 7, 8, 10, 11, 12, 13, 14, 16, 17, 18, 19, 24, 25, 27, 28, 29, 30, 31, 32, 33, 37, 40, 46, 48, 49, 50, 51, 52, 53, 54, 55, 56, 57, 58, 59, 66, 67, 68, 69, 71, 72, 73, 76, 78, 79, 88, 89, 90, 92, 93, 94, 95, 96, 97, 98, 101, 108, 111, 117, 118, 119, 121, 122, 128, 130, 133, 140, 141, 142, 143, 149, 150, 151, 152, 153, 161, 162, 163, 164, 169, 176, 183, 184, 185]"
Shakespeare,L100,short,83,45,38,5,0.5464,183,"[3, 5, 7, 8, 9, 10, 11, 13, 15, 16, 18, 19, 22, 24, 25, 26, 27, 28, 29, 30, 31, 32, 33, 38, 39, 41, 43, 51, 52, 53, 54, 55, 58, 61, 62, 63, 71, 72, 74, 75, 76, 77, 78, 79, 81, 82, 85, 90, 91, 92, 93, 94, 95, 97, 99, 100, 103, 106, 112, 113, 114, 115, 121, 124, 125, 134, 138, 144, 145, 150, 151, 152, 154, 155, 161, 162, 163, 165, 171, 175, 176, 177, 178]"
Shakespeare,L100,short,86,41,45,7,0.5376,186,"[2, 3, 4, 5, 6, 7, 8, 9, 11, 12, 13, 15, 16, 19, 20, 25, 26, 27, 28, 29, 30, 31, 34, 35, 36, 38, 40, 41, 46, 47, 49, 50, 53, 54, 55, 56, 57, 58, 59, 60, 61, 70, 71, 75, 76, 77, 79, 82, 89, 90, 91, 92, 93, 94, 96, 97, 98, 100, 101, 102, 103, 111, 112, 114, 120, 122, 123, 124, 132, 135, 141, 142, 143, 147, 155, 156, 157, 158, 159, 168, 169, 170, 176, 177, 178, 181]"
Shakespeare,L100,short,90,57,33,8,0.5263,190,"[2, 4, 5, 8, 9, 11, 14, 15, 16, 17, 18, 19, 20, 23, 24, 25, 27, 29, 31, 35, 36, 37, 38, 39, 40, 41, 43, 49, 51, 53, 54, 55, 56, 57, 58, 60, 61, 62, 63, 64, 65, 66, 73, 75, 77, 79, 80, 81, 82, 83, 84, 87, 88, 89, 92, 99, 101, 102, 104, 105, 106, 107, 108, 109, 110, 117, 118, 119, 120, 126, 127, 128, 129, 130, 131, 141, 150, 151, 152, 153, 160, 162, 163, 170, 172, 174, 181, 182, 184, 185]"
Shakespeare,L100,short,81,33,48,8,0.5525,181,"[2, 5, 6, 7, 9, 10, 11, 13, 15, 16, 17, 19, 21, 24, 25, 27, 30, 32, 33, 34, 36, 38, 40, 41, 46, 47, 48, 50, 51, 53, 54, 57, 58, 59, 62, 69, 71, 72, 74, 75, 76, 77, 78, 83, 84, 88, 90, 94, 96, 99, 100, 103, 104, 108, 109, 110, 111, 115, 121, 122, 123, 124, 126, 132, 134, 135, 140, 141, 143, 144, 146, 153, 156, 161, 162, 163, 166, 172, 173, 174, 176]"
Shakespeare,L100,short,81,29,52,7,0.5525,181,"[4, 6, 8, 9, 12, 15, 16, 17, 18, 19, 20, 22, 23, 24, 25, 28, 29, 32, 33, 34, 35, 36, 37, 38, 41, 42, 44, 50, 54, 55, 56, 58, 59, 60, 61, 62, 63, 64, 65, 72, 73, 74, 76, 79, 80, 81, 82, 83, 84, 86, 87, 93, 96, 99, 102, 103, 106, 107, 111, 116, 118, 119, 127, 129, 137, 138, 140, 145, 149, 151, 156, 157, 158, 159, 160, 161, 162, 169, 171, 173, 178]"
Shakespeare,L100,short,92,34,58,1,0.5208,192,"[2, 3, 4, 5, 7, 9, 10, 12, 14, 15, 16, 17, 18, 19, 21, 25, 27, 28, 29, 31, 32, 34, 36, 37, 38, 39, 40, 41, 46, 47, 48, 49, 51, 52, 53, 55, 56, 57, 58, 59, 60, 61, 62, 72, 73, 74, 76, 77, 78, 79, 80, 83, 84, 92, 95, 96, 97, 98, 99, 100, 102, 104, 105, 106, 114, 115, 116, 122, 123, 124, 125, 127, 135, 137, 144, 146, 148, 155, 158, 165, 166, 167, 168, 174, 175, 176, 177, 179, 185, 186, 187, 188]"
Shakespeare,L100,short,84,35,49,12,0.5435,184,"[0, 1, 2, 3, 4, 5, 7, 9, 14, 16, 17, 20, 22, 23, 24, 25, 26, 27, 29, 30, 35, 36, 37, 38, 39, 40, 41, 43, 44, 45, 46, 47, 48, 50, 51, 58, 61, 62, 63, 64, 65, 67, 68, 69, 71, 75, 84, 85, 86, 87, 88, 89, 91, 92, 99, 100, 101, 104, 107, 113, 115, 122, 124, 130, 131, 132, 133, 135, 138, 144, 145, 147, 153, 154, 157, 163, 164, 165, 166, 172, 175, 176, 177, 178]"
Shakespeare,L100,short,82,43,39,11,0.5495,182,"[0, 1, 2, 3, 7, 11, 15, 17, 19, 20, 22, 23, 26, 27, 28, 29, 33, 35, 36, 37, 39, 40, 41, 42, 44, 46, 47, 48, 50, 52, 58, 59, 60, 61, 64, 66, 68, 69, 71, 72, 79, 81, 82, 83, 84, 85, 88, 89, 94, 100, 101, 102, 103, 108, 110, 113, 114, 119, 121, 124, 125, 132, 134, 135, 136, 138, 141, 147, 148, 152, 158, 159, 161, 166, 167, 168, 169, 170, 175, 177, 178, 180]"
Shakespeare,L100,short,87,44,43,5,0.5348,187,"[0, 2, 3, 4, 5, 6, 9, 15, 16, 17, 18, 19, 20, 21, 22, 25, 26, 27, 29, 33, 35, 36, 37, 40, 42, 44, 47, 49, 55, 56, 58, 60, 62, 63, 65, 66, 68, 70, 71, 77, 78, 79, 80, 81, 82, 84, 85, 87, 88, 89, 90, 91, 92, 101, 102, 106, 108, 109, 110, 111, 112, 114, 119, 120, 121, 122, 123, 130, 131, 132, 135, 142, 145, 151, 153, 154, 155, 161, 163, 165, 166, 175, 176, 182, 183, 184, 185]"
Shakespeare,L100,short,83,35,48,8,0.5464,183,"[3, 4, 5, 6, 7, 8, 9, 10, 11, 12, 15, 16, 17, 20, 25, 26, 27, 28, 30, 31, 34, 36, 38, 40, 46, 47, 48, 50, 51, 60, 61, 65, 67, 68, 71, 72, 73, 74, 75, 76, 77, 78, 79, 83, 89, 90, 92, 95, 96, 97, 98, 100, 101, 102, 107, 108, 109, 110, 112, 113, 114, 119, 120, 122, 123, 124, 131, 133, 134, 135, 145, 152, 154, 156, 162, 164, 165, 167, 172, 173, 174, 175, 177]"
Shakespeare,L100,short,83,49,34,13,0.5464,183,"[0, 1, 2, 4, 5, 6, 8, 9, 10, 12, 15, 18, 19, 20, 21, 24, 26, 27, 30, 31, 32, 33, 34, 38, 39, 40, 47, 50, 51, 53, 54, 61, 62, 67, 68, 70, 72, 73, 74, 77, 82, 84, 86, 87, 89, 90, 91, 95, 96, 100, 101, 103, 105, 106, 110, 111, 112, 113, 114, 115, 116, 121, 123, 125, 127, 134, 135, 136, 137, 138, 145, 146, 147, 148, 155, 156, 158, 164, 166, 167, 170, 177, 178]"
Shakespeare,L100,short,84,35,49,6,0.5435,184,"[0, 3, 5, 6, 7, 8, 9, 16, 17, 18, 20, 21, 23, 24, 25, 27, 28, 29, 33, 34, 35, 37, 38, 40, 41, 44, 45, 46, 48, 50, 58, 61, 62, 63, 64, 65, 69, 70, 71, 72, 73, 80, 81, 83, 84, 85, 88, 89, 90, 91, 93, 99, 100, 103, 107, 108, 109, 113, 114, 115, 120, 123, 124, 125, 126, 127, 133, 134, 135, 139, 146, 148, 155, 156, 157, 162, 163, 164, 165, 166, 167, 173, 176, 179]"
Shakespeare,L100,short,91,46,45,7,0.5236,191,"[3, 4, 5, 6, 7, 8, 9, 10, 11, 12, 14, 16, 17, 18, 22, 25, 26, 27, 28, 29, 32, 36, 38, 41, 46, 47, 49, 52, 53, 54, 55, 57, 58, 59, 64, 66, 67, 68, 69, 70, 73, 74, 75, 76, 77, 78, 80, 82, 89, 92, 93, 95, 96, 97, 98, 99, 101, 102, 103, 110, 112, 114, 117, 123, 124, 125, 127, 128, 134, 137, 138, 146, 147, 149, 155, 156, 159, 160, 162, 168, 169, 170, 172, 173, 174, 175, 176, 184, 185, 186, 187]"
Shakespeare,L100,short,86,47,39,6,0.5376,186,"[2, 3, 4, 5, 6, 7, 9, 11, 12, 13, 14, 15, 17, 18, 19, 20, 25, 26, 27, 29, 30, 33, 34, 36, 38, 41, 49, 50, 52, 53, 56, 57, 59, 60, 61, 62, 67, 69, 70, 71, 73, 74, 75, 76, 77, 78, 80, 81, 82, 89, 91, 92, 93, 95, 99, 100, 102, 103, 109, 110, 111, 112, 113, 120, 121, 122, 125, 131, 132, 135, 136, 143, 145, 148, 154, 155, 157, 163, 165, 166, 167, 174, 175, 176, 177, 179]"
Shakespeare,L100,short,75,42,33,12,0.5714,175,"[3, 4, 6, 7, 8, 9, 11, 12, 13, 18, 19, 21, 23, 24, 27, 29, 31, 36, 37, 39, 40, 42, 45, 47, 52, 54, 55, 57, 58, 59, 60, 61, 64, 65, 66, 67, 71, 72, 73, 74, 75, 78, 79, 81, 82, 83, 84, 87, 93, 94, 97, 102, 104, 106, 108, 112, 113, 114, 115, 116, 117, 123, 124, 127, 133, 134, 140, 147, 152, 155, 156, 160, 165, 167, 170]"
Shakespeare,L100,short,84,42,42,10,0.5435,184,"[2, 5, 10, 14, 17, 21, 22, 23, 24, 25, 26, 27, 28, 30, 32, 33, 35, 38, 39, 41, 44, 45, 46, 47, 49, 51, 53, 54, 55, 61, 63, 66, 67, 68, 71, 72, 73, 76, 80, 83, 86, 87, 89, 92, 93, 96, 99, 100, 102, 103, 104, 108, 109, 111, 112, 113, 115, 120, 121, 122, 123, 126, 135, 140, 141, 142, 143, 145, 146, 148, 149, 154, 155, 157, 158, 159, 161, 167, 171, 177, 178, 179, 180, 181]"
Shakespeare,L100,short,85,46,39,6,0.5405,185,"[0, 1, 3, 4, 5, 6, 7, 8, 9, 11, 18, 20, 21, 22, 26, 28, 32, 35, 37, 38, 39, 40, 43, 44, 45, 46, 47, 50, 51, 52, 55, 61, 62, 63, 65, 66, 67, 68, 69, 70, 72, 73, 81, 84, 85, 86, 88, 89, 95, 97, 102, 106, 107, 111, 112, 113, 114, 117, 118, 119, 124, 125, 126, 127, 129, 135, 137, 138, 139, 140, 146, 147, 148, 149, 152, 158, 161, 167, 168, 170, 171, 177, 178, 179, 181]"
Shakespeare,L100,short,87,50,37,3,0.5348,187,"[2, 3, 4, 5, 7, 8, 9, 11, 13, 14, 18, 19, 20, 22, 23, 24, 28, 29, 31, 32, 33, 34, 35, 36, 40, 42, 43, 44, 45, 46, 52, 53, 54, 55, 56, 57, 58, 60, 62, 64, 65, 66, 73, 74, 75, 76, 77, 79, 81, 82, 86, 87, 94, 95, 96, 97, 99, 100, 102, 103, 104, 106, 107, 115, 118, 119, 120, 126, 129, 131, 138, 139, 141, 147, 148, 150, 153, 154, 158, 166, 167, 173, 175, 176, 177, 178, 185]"
Shakespeare,L100,short,89,41,48,10,0.5291,189,"[0, 1, 3, 4, 5, 8, 10, 13, 14, 15, 16, 17, 19, 20, 21, 22, 23, 24, 25, 27, 28, 29, 31, 35, 41, 42, 45, 46, 47, 48, 49, 50, 51, 53, 54, 55, 56, 63, 64, 65, 66, 67, 68, 70, 71, 72, 73, 74, 75, 76, 77, 78, 89, 90, 92, 93, 94, 95, 96, 99, 107, 108, 109, 110, 113, 118, 119, 120, 121, 122, 130, 131, 132, 133, 135, 143, 144, 146, 153, 154, 155, 162, 163, 167, 174, 177, 183, 184, 185]"
Shakespeare,L100,short,80,39,41,11,0.5556,180,"[3, 5, 6, 7, 8, 9, 10, 12, 13, 14, 15, 18, 23, 26, 27, 30, 31, 32, 33, 34, 35, 36, 37, 38, 39, 40, 45, 46, 47, 52, 54, 56, 57, 58, 59, 60, 66, 67, 69, 72, 73, 77, 78, 79, 80, 81, 85, 91, 94, 96, 100, 101, 103, 104, 107, 112, 114, 117, 122, 123, 124, 126, 132, 133, 134, 135, 137, 142, 143, 146, 149, 154, 155, 156, 159, 160, 162, 169, 171, 172]"
Shakespeare,L100,short,85,25,60,7,0.5405,185,"[2, 4, 5, 6, 7, 10, 12, 13, 15, 19, 20, 22, 23, 24, 26, 27, 29, 31, 32, 33, 35, 36, 39, 40, 46, 47, 48, 49, 50, 51, 53, 55, 56, 59, 60, 65, 66, 68, 69, 70, 71, 73, 77, 78, 79, 82, 88, 89, 90, 92, 93, 94, 95, 96, 97, 98, 99, 100, 101, 102, 103, 111, 112, 115, 120, 121, 123, 125, 132, 133, 134, 135, 142, 143, 144, 146, 153, 154, 155, 163, 164, 165, 175, 182, 183]"
Shakespeare,L100,short,85,48,37,3,0.5405,185,"[2, 3, 5, 6, 7, 8, 9, 10, 13, 14, 16, 18, 19, 23, 28, 30, 32, 33, 37, 40, 41, 44, 45, 46, 47, 52, 54, 55, 56, 57, 58, 59, 60, 62, 70, 71, 72, 73, 78, 79, 80, 82, 87, 88, 90, 93, 96, 97, 98, 100, 102, 106, 107, 108, 109, 111, 112, 113, 114, 115, 120, 124, 126, 132, 133, 134, 135, 136, 142, 143, 146, 147, 148, 154, 155, 157, 158, 159, 160, 168, 170, 177, 178, 179, 180]"
Shakespeare,L100,short,88,42,46,12,0.5319,188,"[2, 3, 4, 5, 7, 9, 10, 11, 12, 13, 14, 15, 16, 17, 19, 20, 27, 28, 31, 32, 34, 35, 37, 38, 40, 42, 46, 54, 55, 56, 57, 58, 59, 61, 62, 63, 70, 72, 74, 76, 77, 78, 80, 81, 82, 83, 87, 93, 94, 96, 97, 98, 99, 100, 101, 102, 103, 104, 110, 111, 114, 119, 120, 123, 124, 134, 140, 141, 142, 143, 145, 152, 153, 154, 160, 161, 162, 165, 171, 172, 173, 174, 179, 180, 181, 182, 183, 185]"
Shakespeare,L100,short,87,39,48,5,0.5348,187,"[2, 5, 6, 7, 8, 9, 11, 13, 15, 17, 20, 21, 23, 24, 26, 27, 29, 30, 33, 34, 35, 36, 37, 38, 39, 40, 41, 47, 49, 50, 51, 52, 53, 54, 56, 58, 60, 61, 68, 70, 71, 73, 75, 77, 80, 81, 87, 89, 90, 91, 92, 93, 94, 96, 97, 99, 101, 107, 112, 117, 118, 119, 120, 121, 123, 132, 138, 139, 140, 142, 143, 150, 151, 152, 154, 160, 161, 162, 163, 170, 171, 172, 173, 174, 181, 182, 184]"
Shakespeare,L100,short,80,35,45,7,0.5556,180,"[0, 1, 2, 4, 5, 6, 8, 10, 15, 16, 18, 19, 20, 21, 22, 23, 24, 26, 28, 29, 30, 31, 32, 33, 38, 40, 41, 42, 43, 44, 45, 46, 47, 48, 50, 51, 54, 55, 56, 57, 58, 67, 68, 71, 72, 73, 77, 78, 86, 88, 91, 92, 94, 97, 99, 106, 107, 109, 115, 117, 118, 119, 126, 127, 131, 132, 136, 141, 144, 150, 151, 152, 153, 159, 161, 163, 169, 170, 172, 174]"
Shakespeare,L100,short,86,36,50,6,0.5376,186,"[2, 4, 6, 7, 8, 10, 11, 13, 14, 15, 16, 17, 19, 20, 24, 25, 28, 29, 30, 32, 33, 34, 36, 37, 38, 40, 41, 43, 49, 50, 51, 52, 53, 54, 55, 56, 59, 62, 68, 69, 70, 71, 72, 74, 75, 76, 78, 79, 80, 81, 82, 83, 91, 92, 93, 94, 95, 96, 97, 98, 101, 103, 104, 105, 114, 115, 117, 125, 126, 133, 134, 136, 143, 144, 145, 146, 153, 155, 158, 165, 166, 168, 175, 176, 177, 180]"
Shakespeare,L100,short,85,36,49,6,0.5405,185,"[0, 1, 2, 5, 7, 8, 9, 14, 16, 17, 18, 19, 21, 22, 23, 24, 25, 27, 30, 34, 35, 37, 38, 41, 42, 43, 44, 45, 47, 48, 50, 57, 59, 60, 61, 65, 69, 71, 74, 78, 79, 81, 82, 83, 84, 86, 89, 91, 92, 93, 94, 100, 101, 102, 103, 105, 110, 112, 113, 114, 116, 123, 124, 126, 132, 133, 136, 141, 142, 143, 144, 145, 146, 152, 153, 154, 155, 156, 164, 167, 173, 176, 181, 182, 183]"
Shakespeare,L0,middle,43,22,21,2,0.6993,143,"[16, 18, 19, 20, 22, 26, 27, 28, 29, 30, 31, 32, 35, 36, 37, 38, 39, 55, 56, 58, 60, 70, 71, 72, 73, 75, 76, 77, 78, 79, 95, 97, 98, 99, 115, 116, 117, 119, 121, 133, 137, 138, 140]"
Shakespeare,L0,middle,35,11,24,7,0.7407,135,"[18, 19, 21, 23, 25, 28, 29, 30, 31, 33, 37, 38, 39, 41, 42, 57, 58, 60, 61, 66, 79, 81, 82, 84, 97, 98, 100, 101, 102, 103, 106, 121, 123, 124, 132]"
Shakespeare,L0,middle,38,16,22,3,0.7246,138,"[17, 18, 19, 20, 23, 25, 27, 29, 31, 32, 33, 34, 35, 36, 37, 40, 55, 57, 59, 61, 73, 74, 77, 78, 79, 81, 82, 97, 98, 99, 100, 101, 102, 117, 118, 121, 122, 125]"
Shakespeare,L0,middle,39,17,22,1,0.7194,139,"[3, 5, 8, 10, 12, 14, 16, 19, 35, 36, 38, 39, 44, 45, 47, 49, 50, 51, 52, 55, 57, 58, 59, 60, 77, 78, 80, 81, 83, 84, 100, 101, 103, 104, 105, 121, 123, 124, 126]"
Shakespeare,L0,middle,40,8,32,3,0.7143,140,"[2, 4, 5, 6, 7, 8, 9, 10, 11, 12, 13, 15, 20, 21, 39, 40, 42, 51, 53, 57, 59, 60, 61, 62, 63, 65, 81, 83, 86, 102, 104, 105, 106, 108, 120, 122, 123, 127, 128, 130]"
Shakespeare,L0,middle,36,19,17,5,0.7353,136,"[16, 17, 18, 19, 21, 22, 24, 25, 26, 27, 29, 30, 32, 34, 36, 37, 38, 39, 41, 46, 61, 63, 74, 75, 76, 78, 82, 97, 100, 101, 102, 118, 119, 121, 122, 133]"
Shakespeare,L0,middle,50,21,29,4,0.6667,150,"[2, 5, 7, 8, 9, 10, 12, 13, 15, 16, 18, 21, 39, 40, 43, 44, 46, 47, 48, 50, 51, 52, 53, 54, 56, 59, 60, 62, 65, 81, 82, 83, 84, 85, 101, 102, 103, 104, 105, 122, 123, 124, 125, 126, 141, 142, 143, 144, 145, 146]"
Shakespeare,L0,middle,35,17,18,13,0.7407,135,"[2, 4, 5, 6, 7, 8, 9, 10, 12, 13, 15, 16, 17, 18, 19, 24, 44, 52, 53, 54, 55, 56, 58, 59, 63, 78, 80, 83, 99, 100, 102, 115, 116, 118, 121]"
Shakespeare,L0,middle,43,15,28,3,0.6993,143,"[16, 18, 19, 20, 23, 24, 25, 26, 27, 28, 29, 31, 35, 36, 37, 38, 39, 40, 41, 43, 59, 62, 63, 76, 79, 81, 82, 83, 85, 100, 101, 102, 103, 104, 105, 108, 122, 123, 124, 125, 129, 140, 141]"
Shakespeare,L0,middle,46,28,18,5,0.6849,146,"[2, 4, 5, 6, 7, 9, 10, 12, 13, 15, 18, 19, 36, 37, 38, 41, 48, 49, 50, 51, 52, 53, 54, 56, 57, 58, 62, 78, 80, 95, 96, 98, 99, 102, 117, 118, 120, 121, 135, 136, 137, 138, 140, 142, 143, 144]"
Shakespeare,L0,middle,45,22,23,3,0.6897,145,"[17, 18, 22, 23, 25, 28, 29, 30, 32, 34, 35, 38, 39, 40, 43, 59, 61, 62, 63, 75, 76, 77, 80, 81, 82, 85, 101, 102, 104, 116, 117, 118, 120, 121, 122, 124, 134, 135, 136, 137, 138, 139, 141, 142, 143]"
Shakespeare,L0,middle,45,14,31,2,0.6897,145,"[19, 22, 23, 26, 27, 28, 29, 30, 31, 35, 40, 43, 56, 57, 58, 59, 60, 61, 62, 63, 64, 76, 77, 78, 79, 80, 81, 82, 83, 84, 85, 101, 102, 103, 104, 105, 121, 124, 125, 136, 139, 140, 141, 142, 143]"
Shakespeare,L0,middle,40,21,19,3,0.7143,140,"[6, 8, 9, 11, 13, 14, 15, 16, 18, 20, 36, 39, 40, 41, 46, 47, 48, 50, 52, 54, 55, 57, 58, 59, 60, 63, 79, 80, 81, 96, 97, 98, 99, 102, 116, 120, 122, 136, 137, 138]"
Shakespeare,L0,middle,42,19,23,3,0.7042,142,"[16, 17, 19, 20, 22, 25, 26, 27, 29, 30, 31, 33, 34, 35, 36, 38, 40, 41, 43, 60, 62, 63, 65, 78, 79, 80, 81, 82, 83, 85, 100, 101, 103, 105, 120, 122, 124, 125, 127, 137, 138, 140]"
Shakespeare,L0,middle,47,14,33,2,0.6803,147,"[2, 4, 5, 6, 7, 8, 10, 12, 14, 16, 17, 18, 20, 37, 40, 44, 46, 48, 50, 51, 53, 54, 55, 57, 58, 60, 61, 62, 79, 80, 81, 82, 98, 99, 101, 102, 118, 119, 120, 121, 122, 123, 138, 139, 140, 142, 144]"
Shakespeare,L0,middle,33,25,8,6,0.7519,133,"[2, 5, 6, 7, 8, 10, 11, 15, 16, 17, 18, 19, 36, 37, 38, 39, 40, 46, 54, 55, 56, 57, 60, 61, 62, 63, 79, 85, 101, 102, 104, 122, 124]"
Shakespeare,L0,middle,40,20,20,3,0.7143,140,"[16, 17, 18, 19, 21, 23, 24, 25, 26, 27, 28, 29, 31, 32, 35, 38, 41, 59, 61, 71, 72, 74, 75, 78, 80, 81, 95, 96, 98, 101, 119, 120, 121, 122, 132, 133, 134, 136, 137, 138]"
Shakespeare,L0,middle,39,27,12,2,0.7194,139,"[17, 18, 21, 24, 25, 30, 31, 36, 38, 40, 42, 58, 60, 61, 62, 64, 76, 77, 78, 79, 81, 82, 83, 84, 85, 98, 99, 100, 101, 103, 105, 106, 120, 121, 124, 125, 126, 135, 137]"
Shakespeare,L0,middle,41,30,11,2,0.7092,141,"[16, 17, 18, 20, 21, 22, 25, 27, 28, 29, 30, 31, 32, 33, 34, 37, 38, 39, 40, 42, 43, 44, 61, 63, 64, 65, 66, 68, 81, 82, 83, 84, 85, 86, 87, 104, 107, 125, 126, 127, 139]"
Shakespeare,L0,middle,44,27,17,6,0.6944,144,"[16, 18, 19, 20, 24, 25, 26, 28, 29, 30, 31, 34, 35, 36, 37, 38, 39, 40, 41, 58, 59, 60, 63, 75, 76, 77, 78, 79, 80, 82, 83, 84, 101, 102, 103, 104, 121, 122, 125, 137, 138, 139, 141, 142]"
Shakespeare,L0,middle,41,17,24,3,0.7092,141,"[16, 17, 18, 22, 26, 27, 28, 29, 30, 31, 32, 34, 35, 36, 37, 39, 40, 41, 58, 59, 60, 61, 71, 74, 76, 78, 82, 97, 99, 100, 101, 103, 118, 119, 120, 122, 131, 132, 133, 135, 136]"
Shakespeare,L0,middle,40,21,19,7,0.7143,140,"[3, 5, 7, 8, 9, 10, 12, 13, 15, 18, 19, 20, 38, 39, 40, 47, 48, 49, 51, 52, 53, 54, 55, 56, 58, 60, 65, 84, 99, 101, 113, 114, 116, 118, 120, 121, 134, 135, 137, 138]"
Shakespeare,L0,middle,49,27,22,2,0.6711,149,"[16, 18, 19, 21, 22, 23, 24, 27, 28, 31, 33, 35, 36, 37, 39, 54, 55, 56, 58, 60, 61, 73, 75, 76, 77, 78, 79, 80, 82, 97, 98, 99, 100, 101, 102, 117, 118, 119, 120, 121, 122, 125, 137, 138, 139, 140, 141, 142, 144]"
Shakespeare,L0,middle,41,22,19,3,0.7092,141,"[2, 4, 6, 7, 9, 10, 12, 13, 15, 16, 17, 18, 20, 37, 38, 40, 41, 43, 51, 53, 55, 56, 57, 59, 60, 63, 78, 79, 80, 81, 82, 98, 100, 101, 102, 104, 119, 120, 123, 138, 139]"
Shakespeare,L0,middle,37,18,19,6,0.7299,137,"[2, 4, 6, 7, 9, 14, 20, 35, 36, 38, 39, 40, 48, 49, 51, 54, 55, 58, 61, 74, 75, 77, 78, 82, 97, 98, 99, 102, 114, 115, 116, 117, 118, 119, 120, 133, 134]"
Shakespeare,L0,middle,46,27,19,1,0.6849,146,"[2, 5, 6, 7, 8, 9, 11, 12, 13, 14, 15, 16, 17, 20, 39, 43, 47, 48, 50, 51, 53, 54, 55, 59, 75, 76, 77, 78, 79, 95, 97, 99, 114, 115, 117, 119, 121, 122, 135, 136, 137, 139, 140, 141, 142, 143]"
Shakespeare,L0,middle,44,19,25,2,0.6944,144,"[2, 5, 6, 7, 8, 9, 10, 12, 13, 15, 16, 18, 19, 20, 39, 40, 44, 46, 47, 48, 49, 50, 53, 54, 57, 60, 61, 78, 81, 99, 100, 101, 114, 115, 116, 117, 118, 120, 123, 137, 138, 139, 140, 141]"
Shakespeare,L0,middle,40,13,27,7,0.7143,140,"[16, 19, 20, 21, 23, 26, 27, 28, 30, 31, 32, 33, 34, 36, 38, 39, 40, 41, 57, 58, 59, 60, 61, 65, 77, 78, 81, 84, 98, 99, 100, 101, 104, 119, 120, 121, 122, 133, 136, 138]"
Shakespeare,L0,middle,36,26,10,3,0.7353,136,"[19, 21, 23, 24, 25, 26, 27, 28, 30, 31, 35, 37, 41, 54, 56, 59, 60, 62, 74, 75, 78, 79, 82, 96, 97, 98, 99, 102, 104, 116, 118, 119, 120, 121, 123, 133]"
Shakespeare,L0,middle,37,26,11,8,0.7299,137,"[3, 5, 6, 7, 8, 9, 10, 12, 13, 15, 18, 19, 20, 24, 43, 51, 52, 53, 54, 56, 57, 61, 65, 81, 82, 83, 99, 100, 101, 102, 105, 117, 118, 119, 122, 123, 124]"
Shakespeare,L0,middle,41,26,15,2,0.7092,141,"[16, 18, 19, 20, 21, 22, 24, 25, 26, 27, 28, 29, 30, 32, 33, 34, 35, 37, 38, 39, 40, 41, 60, 63, 76, 77, 79, 80, 81, 97, 99, 100, 101, 116, 118, 119, 121, 131, 135, 136, 139]"
Shakespeare,L0,middle,44,22,22,3,0.6944,144,"[3, 5, 7, 8, 9, 12, 14, 15, 17, 18, 19, 21, 38, 39, 40, 41, 45, 50, 51, 52, 53, 54, 55, 56, 57, 59, 60, 61, 77, 78, 83, 101, 114, 116, 117, 118, 119, 121, 137, 138, 139, 140, 141, 142]"
Shakespeare,L0,middle,40,17,23,2,0.7143,140,"[17, 18, 19, 20, 21, 24, 25, 26, 27, 28, 29, 30, 31, 32, 33, 36, 37, 38, 39, 41, 43, 63, 74, 75, 77, 80, 81, 82, 99, 100, 102, 117, 118, 120, 121, 122, 133, 134, 135, 136]"
Shakespeare,L0,middle,44,19,25,0,0.6944,144,"[17, 19, 22, 24, 26, 28, 29, 30, 31, 33, 34, 35, 36, 37, 39, 42, 43, 57, 58, 60, 61, 63, 75, 78, 79, 80, 81, 83, 84, 99, 100, 101, 103, 104, 119, 123, 124, 135, 136, 137, 138, 139, 140, 142]"
Shakespeare,L0,middle,44,22,22,5,0.6944,144,"[2, 6, 8, 10, 11, 12, 13, 14, 15, 16, 17, 18, 20, 39, 44, 51, 52, 53, 54, 55, 56, 58, 59, 61, 76, 79, 80, 81, 97, 98, 99, 100, 101, 115, 117, 119, 120, 122, 135, 136, 137, 139, 140, 142]"
Shakespeare,L0,middle,45,19,26,4,0.6897,145,"[16, 19, 22, 23, 26, 27, 29, 30, 31, 32, 33, 35, 38, 39, 41, 55, 58, 60, 72, 73, 74, 75, 77, 78, 79, 81, 95, 96, 97, 98, 99, 102, 119, 120, 121, 130, 131, 133, 134, 135, 136, 138, 139, 140, 141]"
Shakespeare,L0,middle,47,16,31,2,0.6803,147,"[16, 17, 18, 19, 20, 23, 24, 26, 27, 28, 29, 30, 31, 33, 34, 35, 36, 37, 38, 41, 57, 59, 70, 72, 74, 75, 76, 78, 79, 80, 82, 101, 102, 118, 120, 121, 122, 123, 133, 134, 135, 136, 137, 138, 139, 140, 144]"
Shakespeare,L0,middle,42,24,18,2,0.7042,142,"[3, 5, 9, 10, 11, 14, 15, 18, 20, 36, 37, 38, 39, 42, 43, 45, 49, 50, 51, 52, 55, 57, 58, 59, 60, 78, 79, 82, 84, 86, 103, 104, 106, 107, 109, 121, 122, 123, 126, 127, 128, 130]"
Shakespeare,L0,middle,46,28,18,4,0.6849,146,"[20, 21, 23, 24, 25, 26, 27, 30, 32, 33, 34, 36, 38, 41, 56, 57, 58, 59, 74, 75, 76, 77, 79, 94, 95, 96, 98, 99, 100, 114, 115, 118, 119, 120, 121, 130, 131, 132, 133, 136, 137, 138, 139, 140, 141, 143]"
Shakespeare,L0,middle,35,22,13,5,0.7407,135,"[18, 21, 22, 23, 24, 28, 30, 31, 32, 33, 34, 35, 36, 37, 38, 39, 55, 57, 58, 60, 73, 79, 80, 93, 94, 95, 98, 99, 102, 115, 117, 118, 119, 121, 131]"
Shakespeare,L0,middle,40,21,19,4,0.7143,140,"[16, 17, 19, 20, 22, 23, 25, 26, 28, 29, 30, 32, 33, 35, 38, 39, 54, 55, 56, 57, 58, 60, 70, 71, 72, 74, 75, 76, 77, 78, 79, 82, 83, 100, 105, 121, 122, 124, 126, 137]"
Shakespeare,L0,middle,41,26,15,3,0.7092,141,"[16, 17, 18, 20, 21, 22, 23, 25, 27, 28, 29, 30, 32, 33, 35, 36, 37, 38, 39, 40, 41, 42, 44, 61, 62, 63, 74, 75, 76, 78, 79, 80, 81, 84, 101, 103, 106, 123, 125, 128, 138]"
Shakespeare,L0,middle,38,16,22,3,0.7246,138,"[17, 18, 21, 24, 26, 27, 29, 30, 31, 32, 34, 36, 37, 38, 40, 41, 56, 57, 58, 60, 61, 73, 76, 78, 79, 80, 82, 97, 98, 99, 100, 101, 103, 118, 120, 123, 134, 135]"
Shakespeare,L0,middle,43,26,17,9,0.6993,143,"[2, 5, 6, 8, 10, 11, 14, 15, 16, 17, 24, 40, 44, 45, 46, 48, 51, 53, 54, 55, 56, 57, 58, 61, 76, 77, 79, 81, 97, 98, 99, 100, 114, 115, 116, 119, 122, 135, 136, 137, 138, 139, 141]"
Shakespeare,L0,middle,41,18,23,4,0.7092,141,"[16, 17, 19, 20, 21, 22, 25, 27, 28, 29, 34, 36, 42, 56, 57, 58, 59, 69, 70, 73, 74, 78, 80, 94, 98, 100, 112, 113, 115, 116, 117, 120, 129, 130, 131, 133, 134, 135, 136, 137, 138]"
Shakespeare,L0,middle,41,11,30,5,0.7092,141,"[2, 4, 5, 6, 7, 10, 11, 12, 15, 16, 20, 38, 39, 42, 45, 46, 47, 48, 49, 50, 52, 53, 56, 57, 59, 76, 78, 80, 95, 96, 97, 98, 99, 102, 117, 120, 133, 136, 137, 138, 139]"
Shakespeare,L0,middle,38,16,22,5,0.7246,138,"[2, 4, 5, 6, 7, 8, 11, 12, 15, 17, 18, 19, 20, 37, 39, 41, 49, 50, 52, 53, 54, 56, 57, 58, 60, 61, 79, 80, 81, 96, 97, 98, 99, 100, 101, 117, 120, 127]"
Shakespeare,L0,middle,48,29,19,2,0.6757,148,"[16, 17, 18, 19, 20, 21, 22, 23, 25, 26, 27, 28, 29, 30, 31, 32, 33, 34, 36, 38, 40, 41, 59, 61, 72, 75, 76, 77, 78, 79, 80, 81, 82, 99, 101, 104, 119, 120, 122, 123, 134, 135, 136, 139, 141, 142, 143, 146]"
Shakespeare,L0,middle,49,35,14,3,0.6711,149,"[18, 19, 20, 21, 23, 24, 25, 27, 28, 29, 30, 31, 32, 33, 34, 36, 37, 38, 43, 61, 72, 73, 74, 75, 77, 78, 79, 80, 81, 97, 98, 99, 101, 104, 119, 121, 122, 123, 124, 134, 136, 137, 138, 140, 141, 142, 143, 144, 145]"
Shakespeare,L0,middle,47,23,24,4,0.6803,147,"[2, 4, 5, 6, 7, 8, 11, 12, 13, 15, 18, 19, 21, 38, 39, 40, 44, 46, 47, 50, 52, 53, 54, 55, 58, 60, 61, 78, 79, 81, 82, 83, 99, 100, 101, 103, 107, 122, 123, 124, 138, 139, 140, 142, 143, 144, 145]"
Shakespeare,L0,middle,43,24,19,4,0.6993,143,"[2, 7, 9, 10, 11, 12, 13, 16, 17, 19, 23, 39, 40, 41, 44, 52, 53, 54, 55, 57, 58, 60, 61, 63, 64, 80, 81, 83, 86, 102, 103, 104, 108, 110, 121, 122, 123, 125, 126, 127, 128, 129, 130]"
Shakespeare,L0,middle,44,27,17,2,0.6944,144,"[17, 20, 22, 23, 28, 29, 30, 33, 34, 35, 36, 37, 39, 40, 54, 55, 56, 57, 58, 60, 72, 75, 76, 77, 78, 80, 95, 96, 97, 98, 99, 100, 116, 118, 119, 121, 131, 132, 134, 135, 136, 137, 138, 142]"
Shakespeare,L0,middle,42,19,23,0,0.7042,142,"[3, 6, 7, 8, 9, 10, 11, 13, 14, 16, 17, 19, 37, 38, 39, 44, 46, 47, 48, 49, 52, 53, 56, 57, 58, 59, 75, 79, 94, 95, 96, 97, 98, 100, 115, 118, 119, 120, 134, 135, 137, 139]"
Shakespeare,L0,middle,46,20,26,5,0.6849,146,"[16, 17, 18, 19, 22, 24, 25, 26, 29, 30, 32, 33, 35, 36, 37, 38, 39, 40, 56, 60, 63, 75, 76, 77, 79, 80, 81, 82, 97, 98, 99, 100, 101, 105, 120, 121, 122, 134, 135, 136, 137, 138, 139, 140, 142, 143]"
Shakespeare,L0,middle,44,25,19,5,0.6944,144,"[16, 17, 18, 20, 22, 24, 25, 26, 27, 28, 29, 30, 32, 33, 34, 35, 36, 37, 38, 39, 56, 59, 60, 71, 72, 74, 75, 76, 77, 78, 79, 81, 99, 101, 116, 118, 119, 121, 132, 133, 135, 137, 139, 141]"
Shakespeare,L0,middle,41,24,17,4,0.7092,141,"[2, 4, 5, 6, 7, 10, 11, 13, 14, 16, 18, 19, 37, 38, 40, 44, 45, 46, 47, 48, 51, 53, 54, 55, 57, 58, 59, 60, 61, 77, 78, 80, 85, 104, 119, 121, 122, 123, 124, 138, 139]"
Shakespeare,L0,middle,41,15,26,2,0.7092,141,"[2, 4, 5, 8, 10, 11, 12, 13, 14, 15, 16, 17, 20, 38, 40, 47, 50, 51, 52, 54, 55, 57, 58, 59, 76, 77, 78, 79, 94, 95, 96, 98, 99, 114, 115, 116, 120, 136, 137, 138, 139]"
Shakespeare,L0,middle,48,24,24,2,0.6757,148,"[17, 19, 21, 23, 25, 26, 28, 29, 30, 31, 34, 35, 37, 38, 39, 40, 41, 42, 58, 59, 60, 62, 74, 75, 77, 79, 80, 82, 97, 98, 100, 101, 102, 116, 117, 118, 120, 121, 124, 126, 137, 139, 140, 141, 142, 144, 145, 146]"
Shakespeare,L0,middle,45,25,20,1,0.6897,145,"[2, 4, 5, 6, 8, 9, 12, 14, 17, 20, 36, 39, 44, 46, 47, 48, 49, 50, 51, 52, 54, 56, 57, 58, 60, 79, 80, 96, 97, 98, 99, 100, 101, 115, 116, 117, 118, 120, 121, 136, 137, 138, 139, 140, 141]"
Shakespeare,L0,middle,43,24,19,3,0.6993,143,"[3, 5, 6, 7, 8, 9, 10, 11, 12, 15, 16, 17, 20, 38, 39, 46, 47, 48, 49, 51, 54, 55, 57, 60, 75, 76, 77, 78, 79, 96, 97, 98, 100, 114, 115, 119, 132, 133, 134, 135, 136, 138, 139]"
Shakespeare,L0,middle,44,17,27,5,0.6944,144,"[17, 18, 20, 22, 23, 24, 25, 26, 29, 30, 31, 32, 33, 34, 37, 38, 39, 55, 56, 58, 60, 70, 71, 72, 74, 75, 77, 78, 79, 81, 97, 98, 100, 103, 120, 121, 123, 134, 135, 136, 138, 139, 140, 142]"
Shakespeare,L0,middle,35,20,15,5,0.7407,135,"[16, 17, 19, 20, 22, 24, 26, 27, 28, 29, 31, 33, 35, 36, 37, 39, 40, 41, 58, 61, 73, 75, 79, 80, 84, 99, 103, 116, 117, 119, 120, 121, 122, 124, 133]"
Shakespeare,L0,middle,43,28,15,3,0.6993,143,"[2, 5, 6, 8, 9, 11, 12, 15, 16, 17, 19, 35, 37, 38, 39, 43, 45, 48, 49, 51, 53, 54, 55, 56, 58, 59, 74, 75, 76, 77, 81, 101, 114, 116, 117, 119, 120, 134, 135, 136, 138, 139, 140]"
Shakespeare,L0,middle,42,20,22,2,0.7042,142,"[2, 4, 7, 8, 9, 10, 12, 17, 18, 20, 37, 38, 41, 49, 50, 53, 54, 55, 56, 57, 58, 59, 62, 76, 77, 78, 79, 80, 81, 82, 100, 101, 102, 103, 118, 119, 120, 121, 123, 137, 139, 140]"
Shakespeare,L0,middle,43,27,16,2,0.6993,143,"[2, 5, 6, 7, 8, 11, 12, 14, 15, 16, 19, 20, 21, 38, 39, 40, 41, 46, 47, 48, 49, 50, 51, 53, 54, 55, 56, 58, 60, 61, 78, 79, 81, 98, 100, 101, 117, 119, 120, 121, 136, 137, 139]"
Shakespeare,L0,middle,42,16,26,3,0.7042,142,"[16, 17, 18, 20, 23, 24, 25, 26, 27, 28, 29, 32, 33, 35, 36, 37, 38, 39, 55, 57, 58, 59, 61, 71, 73, 76, 77, 78, 80, 95, 98, 99, 100, 101, 102, 117, 120, 124, 136, 137, 139, 140]"
Shakespeare,L0,middle,37,21,16,6,0.7299,137,"[4, 6, 7, 9, 10, 12, 14, 15, 17, 18, 23, 39, 44, 46, 49, 50, 51, 52, 54, 55, 57, 61, 76, 77, 79, 80, 97, 98, 100, 111, 112, 114, 116, 117, 119, 120, 121]"
Shakespeare,L0,middle,45,23,22,3,0.6897,145,"[2, 4, 9, 10, 11, 14, 15, 19, 34, 35, 37, 38, 39, 41, 46, 48, 49, 50, 51, 52, 53, 55, 58, 59, 60, 81, 96, 97, 98, 99, 101, 103, 116, 117, 118, 119, 120, 121, 123, 137, 138, 139, 141, 142, 143]"
Shakespeare,L0,middle,47,18,29,0,0.6803,147,"[16, 17, 18, 19, 20, 22, 24, 25, 28, 29, 31, 33, 34, 35, 36, 37, 39, 41, 60, 61, 63, 76, 77, 78, 79, 80, 81, 82, 83, 84, 101, 102, 105, 121, 122, 123, 124, 125, 126, 128, 139, 140, 141, 142, 143, 144, 145]"
Shakespeare,L0,middle,49,22,27,2,0.6711,149,"[2, 4, 5, 7, 9, 10, 11, 13, 15, 17, 18, 20, 38, 39, 42, 43, 45, 46, 48, 50, 52, 55, 56, 57, 58, 59, 75, 77, 79, 80, 81, 84, 101, 102, 103, 104, 118, 119, 120, 121, 123, 124, 125, 126, 141, 142, 143, 144, 146]"
Shakespeare,L0,middle,45,28,17,4,0.6897,145,"[2, 4, 6, 7, 8, 9, 10, 11, 12, 14, 15, 16, 17, 18, 22, 40, 44, 45, 46, 47, 48, 50, 51, 54, 55, 56, 57, 60, 77, 78, 80, 97, 98, 99, 100, 101, 103, 119, 120, 122, 136, 137, 138, 139, 142]"
Shakespeare,L0,middle,42,20,22,2,0.7042,142,"[2, 4, 8, 9, 10, 11, 13, 14, 15, 20, 36, 40, 44, 46, 47, 48, 49, 50, 51, 52, 55, 56, 57, 58, 60, 62, 78, 79, 80, 81, 97, 99, 100, 102, 116, 117, 118, 119, 121, 122, 137, 138]"
Shakespeare,L0,middle,38,22,16,8,0.7246,138,"[2, 5, 7, 8, 9, 10, 12, 16, 17, 18, 19, 24, 40, 41, 43, 51, 53, 54, 55, 56, 58, 59, 60, 61, 62, 63, 78, 79, 80, 83, 87, 105, 118, 119, 121, 122, 123, 124]"
Shakespeare,L0,middle,39,15,24,1,0.7194,139,"[6, 7, 10, 11, 12, 13, 15, 17, 18, 19, 35, 37, 38, 39, 48, 50, 51, 52, 53, 54, 55, 57, 58, 61, 76, 77, 78, 80, 95, 96, 97, 98, 100, 114, 117, 120, 135, 136, 137]"
Shakespeare,L0,middle,44,27,17,1,0.6944,144,"[18, 19, 22, 23, 28, 29, 31, 32, 33, 34, 38, 40, 53, 54, 57, 59, 60, 70, 71, 72, 73, 74, 78, 80, 94, 95, 97, 98, 99, 100, 113, 114, 115, 116, 118, 119, 120, 121, 132, 136, 137, 139, 140, 142]"
Shakespeare,L0,middle,38,21,17,1,0.7246,138,"[2, 5, 6, 11, 15, 16, 17, 19, 20, 37, 42, 43, 49, 50, 51, 52, 53, 54, 55, 56, 57, 59, 60, 61, 62, 63, 64, 80, 81, 83, 85, 101, 103, 104, 118, 119, 123, 124]"
Shakespeare,L0,middle,43,18,25,2,0.6993,143,"[16, 17, 18, 19, 20, 21, 24, 27, 30, 31, 32, 33, 34, 35, 37, 38, 39, 40, 43, 44, 61, 62, 64, 65, 78, 79, 85, 101, 102, 103, 104, 107, 121, 122, 123, 124, 125, 126, 136, 137, 139, 140, 141]"
Shakespeare,L0,middle,45,24,21,4,0.6897,145,"[16, 17, 18, 19, 20, 21, 22, 23, 25, 26, 27, 28, 30, 31, 32, 33, 35, 37, 38, 40, 57, 59, 70, 72, 74, 76, 77, 78, 79, 95, 97, 98, 99, 100, 102, 117, 120, 121, 124, 134, 135, 137, 138, 139, 142]"
Shakespeare,L0,middle,47,29,18,2,0.6803,147,"[16, 17, 19, 20, 21, 22, 23, 24, 27, 28, 29, 30, 31, 32, 33, 35, 37, 39, 55, 56, 57, 58, 60, 71, 72, 73, 75, 78, 80, 97, 98, 99, 101, 115, 116, 117, 119, 120, 132, 134, 135, 137, 139, 140, 141, 142, 143]"
Shakespeare,L0,middle,44,20,24,1,0.6944,144,"[2, 6, 8, 9, 11, 12, 13, 15, 16, 17, 18, 19, 20, 37, 38, 39, 40, 45, 46, 47, 48, 49, 51, 53, 54, 56, 57, 59, 60, 79, 80, 98, 99, 100, 101, 103, 118, 119, 121, 122, 123, 124, 140, 141]"
Shakespeare,L0,middle,46,18,28,2,0.6849,146,"[3, 8, 9, 10, 13, 14, 16, 18, 20, 36, 37, 38, 39, 42, 43, 44, 45, 46, 47, 49, 50, 51, 52, 53, 55, 57, 58, 60, 77, 79, 96, 97, 98, 99, 114, 115, 116, 117, 119, 133, 134, 135, 136, 138, 139, 140]"
Shakespeare,L0,middle,48,29,19,5,0.6757,148,"[2, 5, 6, 8, 9, 10, 11, 12, 13, 15, 16, 17, 18, 20, 38, 41, 45, 46, 47, 49, 52, 53, 54, 55, 61, 77, 78, 79, 94, 95, 97, 98, 99, 100, 102, 103, 118, 119, 121, 122, 123, 137, 138, 139, 140, 141, 142, 143]"
Shakespeare,L0,middle,40,25,15,2,0.7143,140,"[2, 4, 7, 8, 9, 11, 12, 15, 16, 18, 20, 36, 37, 39, 43, 44, 45, 46, 47, 48, 51, 52, 54, 56, 57, 58, 59, 62, 80, 82, 99, 102, 103, 116, 117, 119, 120, 122, 124, 126]"
Shakespeare,L0,middle,49,15,34,1,0.6711,149,"[3, 5, 6, 9, 10, 11, 12, 13, 14, 15, 16, 17, 19, 37, 38, 39, 45, 46, 47, 48, 49, 50, 51, 53, 54, 55, 56, 57, 58, 59, 60, 62, 81, 82, 84, 101, 102, 103, 104, 105, 106, 123, 125, 127, 143, 144, 145, 146, 147]"
Shakespeare,L0,middle,41,12,29,2,0.7092,141,"[17, 18, 19, 21, 26, 28, 29, 30, 34, 36, 38, 40, 41, 55, 57, 58, 59, 61, 71, 72, 75, 76, 77, 78, 79, 80, 81, 96, 99, 100, 101, 117, 118, 119, 121, 123, 133, 135, 136, 137, 139]"
Shakespeare,L0,middle,46,25,21,3,0.6849,146,"[16, 18, 19, 20, 22, 25, 26, 28, 29, 30, 31, 32, 33, 35, 36, 37, 38, 42, 58, 59, 60, 61, 62, 64, 76, 77, 80, 81, 85, 100, 101, 104, 105, 119, 120, 121, 122, 123, 124, 125, 137, 139, 140, 141, 143, 144]"
Shakespeare,L0,middle,43,23,20,4,0.6993,143,"[18, 19, 21, 22, 23, 24, 25, 28, 29, 31, 32, 34, 35, 37, 40, 55, 56, 57, 60, 71, 72, 74, 75, 76, 77, 78, 81, 96, 97, 98, 99, 113, 116, 119, 120, 130, 132, 133, 134, 136, 137, 140, 141]"
Shakespeare,L0,middle,45,30,15,1,0.6897,145,"[16, 17, 18, 19, 20, 21, 22, 23, 29, 31, 32, 33, 34, 35, 36, 38, 39, 54, 55, 56, 57, 59, 70, 71, 72, 73, 74, 75, 76, 77, 78, 80, 97, 99, 100, 102, 120, 121, 133, 136, 137, 138, 139, 141, 143]"
Shakespeare,L0,middle,42,14,28,2,0.7042,142,"[2, 6, 7, 9, 10, 11, 12, 13, 15, 16, 17, 18, 19, 22, 39, 40, 44, 47, 51, 52, 53, 54, 55, 57, 58, 59, 61, 76, 77, 78, 80, 81, 98, 99, 100, 101, 102, 104, 120, 125, 126, 127]"
Shakespeare,L0,middle,45,33,12,2,0.6897,145,"[16, 17, 18, 19, 20, 21, 23, 27, 28, 29, 32, 33, 34, 35, 36, 38, 40, 56, 58, 59, 68, 69, 70, 71, 72, 73, 74, 75, 76, 77, 78, 80, 97, 98, 99, 116, 118, 119, 132, 134, 135, 137, 139, 140, 141]"
Shakespeare,L0,middle,43,30,13,4,0.6993,143,"[2, 5, 7, 9, 10, 11, 15, 16, 17, 18, 19, 20, 37, 40, 43, 47, 49, 50, 51, 52, 55, 58, 59, 61, 76, 77, 78, 79, 81, 96, 97, 98, 99, 100, 102, 117, 120, 121, 122, 123, 124, 125, 127]"
Shakespeare,L0,middle,38,22,16,4,0.7246,138,"[5, 7, 8, 12, 13, 16, 18, 19, 20, 21, 39, 41, 42, 43, 46, 55, 56, 61, 62, 63, 64, 79, 84, 99, 100, 103, 104, 107, 109, 121, 123, 125, 126, 127, 128, 129, 130, 133]"
Shakespeare,L0,middle,46,16,30,2,0.6849,146,"[16, 19, 20, 23, 24, 25, 26, 27, 30, 31, 32, 33, 35, 38, 39, 40, 55, 56, 57, 58, 60, 70, 72, 73, 74, 75, 76, 77, 78, 79, 80, 96, 97, 99, 101, 117, 118, 119, 120, 122, 134, 135, 137, 139, 140, 141]"
Shakespeare,L0,middle,45,30,15,11,0.6897,145,"[16, 17, 18, 27, 29, 30, 33, 34, 36, 37, 38, 40, 53, 54, 56, 57, 61, 70, 73, 75, 76, 77, 79, 92, 93, 94, 96, 97, 98, 100, 113, 114, 117, 118, 120, 129, 130, 131, 134, 135, 136, 137, 138, 139, 140]"
Shakespeare,L0,middle,38,18,20,4,0.7246,138,"[16, 17, 18, 19, 20, 22, 23, 25, 27, 28, 29, 30, 31, 32, 33, 38, 41, 57, 59, 61, 73, 74, 75, 76, 77, 80, 82, 97, 98, 101, 116, 118, 119, 120, 123, 134, 135, 136]"
Shakespeare,L0,middle,47,16,31,2,0.6803,147,"[16, 17, 18, 19, 21, 24, 26, 27, 29, 30, 31, 34, 35, 36, 38, 40, 55, 56, 57, 58, 59, 61, 71, 72, 73, 75, 76, 77, 78, 79, 80, 97, 99, 100, 116, 117, 119, 120, 132, 133, 134, 136, 137, 138, 139, 140, 141]"
Shakespeare,L0,middle,50,31,19,2,0.6667,150,"[2, 4, 5, 6, 7, 8, 9, 10, 12, 14, 15, 18, 19, 20, 38, 39, 40, 45, 47, 48, 49, 52, 54, 55, 56, 57, 60, 75, 76, 77, 78, 79, 81, 98, 99, 100, 115, 116, 117, 119, 120, 121, 122, 123, 124, 126, 143, 145, 146, 148]"
Shakespeare,L0,middle,44,23,21,5,0.6944,144,"[16, 17, 18, 19, 20, 21, 23, 25, 26, 27, 28, 30, 31, 32, 33, 35, 37, 38, 40, 56, 57, 58, 62, 75, 76, 77, 78, 80, 95, 97, 100, 114, 115, 116, 117, 118, 119, 122, 133, 134, 135, 137, 138, 142]"
Shakespeare,L0,middle,39,12,27,3,0.7194,139,"[2, 4, 5, 6, 7, 8, 9, 11, 13, 14, 15, 17, 18, 19, 20, 40, 47, 48, 51, 52, 53, 55, 56, 57, 58, 59, 62, 78, 79, 80, 96, 97, 100, 116, 118, 119, 123, 136, 137]"
Shakespeare,L0,middle,41,23,18,6,0.7092,141,"[16, 17, 19, 20, 22, 26, 27, 29, 31, 33, 34, 35, 38, 41, 55, 59, 61, 70, 71, 72, 73, 74, 76, 77, 78, 79, 80, 95, 96, 97, 98, 99, 102, 120, 129, 130, 131, 135, 137, 138, 139]"
Shakespeare,L50,middle,34,9,25,4,0.7463,134,"[2, 4, 5, 6, 7, 8, 9, 10, 11, 13, 14, 16, 18, 20, 40, 48, 49, 50, 52, 53, 54, 56, 57, 60, 63, 80, 83, 102, 103, 105, 120, 121, 122, 124]"
Shakespeare,L50,middle,31,15,16,6,0.7634,131,"[17, 18, 19, 22, 23, 24, 26, 27, 28, 29, 30, 31, 32, 34, 35, 36, 37, 42, 61, 74, 75, 76, 77, 78, 79, 80, 97, 98, 103, 119, 121]"
Shakespeare,L50,middle,34,9,25,0,0.7463,134,"[19, 20, 21, 24, 26, 27, 28, 29, 31, 32, 33, 34, 35, 37, 38, 39, 41, 59, 60, 61, 74, 75, 76, 77, 78, 79, 80, 82, 100, 101, 102, 120, 122, 123]"
Shakespeare,L50,middle,36,23,13,3,0.7353,136,"[2, 5, 6, 7, 8, 9, 10, 11, 13, 14, 16, 19, 37, 38, 40, 47, 49, 53, 54, 55, 57, 58, 59, 60, 63, 80, 81, 97, 100, 101, 116, 117, 118, 119, 120, 122]"
Shakespeare,L50,middle,35,15,20,3,0.7407,135,"[17, 18, 19, 20, 22, 23, 24, 26, 28, 29, 30, 31, 32, 33, 34, 36, 37, 38, 41, 59, 74, 76, 77, 78, 79, 80, 96, 97, 98, 99, 100, 117, 118, 119, 121]"
Shakespeare,L50,middle,34,18,16,2,0.7463,134,"[2, 7, 9, 10, 12, 13, 14, 15, 17, 21, 38, 40, 43, 54, 56, 57, 58, 61, 62, 78, 80, 82, 96, 97, 98, 99, 100, 101, 102, 118, 119, 120, 121, 122]"
Shakespeare,L50,middle,29,9,20,2,0.7752,129,"[18, 20, 22, 24, 25, 26, 28, 29, 30, 31, 32, 34, 35, 40, 56, 58, 59, 75, 77, 79, 94, 95, 96, 97, 100, 101, 116, 120, 121]"
Shakespeare,L50,middle,34,20,14,2,0.7463,134,"[17, 18, 19, 20, 21, 24, 25, 26, 27, 29, 31, 32, 33, 34, 35, 36, 37, 39, 40, 58, 59, 60, 61, 74, 75, 76, 78, 79, 80, 81, 99, 102, 120, 122]"
Shakespeare,L50,middle,31,19,12,1,0.7634,131,"[19, 20, 21, 22, 23, 25, 26, 27, 32, 33, 34, 35, 36, 37, 38, 39, 40, 58, 61, 62, 78, 80, 82, 83, 98, 99, 102, 104, 121, 122, 124]"
Shakespeare,L50,middle,30,17,13,4,0.7692,130,"[2, 4, 8, 11, 12, 14, 15, 16, 17, 18, 21, 39, 40, 48, 50, 51, 52, 53, 55, 58, 61, 62, 80, 81, 83, 99, 100, 102, 120, 123]"
Shakespeare,L50,middle,32,21,11,3,0.7576,132,"[3, 6, 7, 9, 15, 16, 18, 19, 21, 22, 39, 42, 52, 53, 55, 56, 57, 58, 59, 60, 62, 81, 83, 97, 98, 100, 102, 105, 119, 121, 122, 123]"
Shakespeare,L50,middle,31,18,13,15,0.7634,131,"[3, 5, 7, 8, 9, 11, 12, 13, 17, 18, 19, 20, 21, 30, 48, 58, 59, 62, 63, 64, 81, 86, 101, 103, 104, 119, 121, 122, 123, 124, 126]"
Shakespeare,L50,middle,32,10,22,12,0.7576,132,"[2, 4, 5, 6, 8, 10, 11, 13, 15, 16, 17, 18, 19, 20, 25, 44, 53, 55, 56, 58, 59, 61, 64, 82, 98, 99, 100, 102, 120, 122, 123, 127]"
Shakespeare,L50,middle,37,20,17,3,0.7299,137,"[3, 5, 8, 9, 10, 12, 14, 15, 19, 35, 38, 39, 45, 46, 47, 48, 49, 53, 55, 56, 57, 58, 59, 62, 79, 80, 81, 83, 98, 100, 101, 102, 104, 105, 107, 125, 126]"
Shakespeare,L50,middle,39,21,18,4,0.7194,139,"[4, 6, 7, 9, 10, 11, 13, 14, 15, 16, 17, 18, 19, 38, 42, 54, 55, 57, 58, 59, 60, 76, 78, 79, 80, 95, 99, 100, 101, 116, 117, 118, 120, 121, 122, 124, 125, 126, 128]"
Shakespeare,L50,middle,37,15,22,0,0.7299,137,"[19, 20, 21, 23, 24, 25, 26, 28, 29, 30, 31, 32, 33, 34, 35, 36, 38, 39, 40, 41, 42, 60, 62, 77, 78, 79, 80, 83, 99, 100, 101, 102, 103, 120, 121, 122, 123]"
Shakespeare,L50,middle,37,13,24,2,0.7299,137,"[3, 5, 8, 10, 11, 13, 14, 15, 18, 19, 36, 37, 38, 39, 41, 47, 48, 50, 51, 52, 53, 55, 57, 59, 60, 61, 80, 82, 98, 99, 100, 102, 118, 119, 120, 122, 123]"
Shakespeare,L50,middle,37,16,21,0,0.7299,137,"[3, 5, 6, 7, 10, 12, 15, 16, 18, 19, 37, 38, 39, 45, 46, 47, 48, 50, 51, 52, 53, 54, 57, 58, 59, 76, 77, 80, 82, 99, 102, 117, 118, 119, 121, 122, 123]"
Shakespeare,L50,middle,30,13,17,2,0.7692,130,"[17, 18, 19, 20, 24, 25, 26, 27, 28, 29, 30, 31, 34, 36, 37, 38, 39, 56, 59, 73, 74, 75, 81, 97, 98, 99, 116, 117, 118, 120]"
Shakespeare,L50,middle,36,11,25,2,0.7353,136,"[4, 5, 8, 9, 13, 14, 16, 17, 18, 20, 39, 40, 49, 51, 52, 53, 54, 55, 56, 57, 58, 59, 62, 63, 64, 65, 84, 86, 102, 103, 105, 121, 122, 123, 124, 125]"
Shakespeare,L50,middle,32,10,22,4,0.7576,132,"[18, 22, 23, 24, 26, 28, 32, 33, 34, 35, 37, 38, 39, 40, 41, 57, 58, 59, 60, 61, 74, 76, 78, 79, 80, 81, 98, 99, 100, 104, 120, 121]"
Shakespeare,L50,middle,29,18,11,4,0.7752,129,"[3, 5, 6, 7, 8, 9, 12, 15, 18, 19, 36, 37, 38, 39, 46, 48, 49, 50, 51, 52, 57, 58, 59, 78, 79, 95, 98, 103, 120]"
Shakespeare,L50,middle,32,18,14,2,0.7576,132,"[17, 18, 19, 24, 25, 26, 27, 29, 32, 33, 35, 36, 37, 38, 40, 57, 58, 59, 72, 73, 76, 77, 79, 81, 100, 101, 116, 117, 119, 120, 121, 122]"
Shakespeare,L50,middle,30,13,17,5,0.7692,130,"[17, 18, 19, 20, 21, 26, 28, 29, 31, 32, 33, 35, 37, 39, 56, 57, 61, 75, 76, 77, 81, 95, 96, 98, 99, 101, 116, 117, 120, 121]"
Shakespeare,L50,middle,29,19,10,3,0.7752,129,"[17, 18, 20, 22, 23, 25, 26, 27, 28, 29, 30, 31, 32, 33, 37, 39, 56, 57, 58, 60, 75, 78, 80, 97, 100, 102, 120, 121, 122]"
Shakespeare,L50,middle,34,25,9,4,0.7463,134,"[18, 21, 22, 23, 24, 25, 26, 27, 28, 29, 30, 31, 32, 33, 34, 36, 38, 39, 41, 59, 60, 75, 76, 82, 99, 100, 103, 120, 121, 122, 123, 124, 125, 126]"
Shakespeare,L50,middle,35,15,20,1,0.7407,135,"[17, 18, 19, 21, 22, 23, 24, 26, 27, 28, 30, 31, 32, 34, 35, 36, 39, 56, 57, 58, 59, 61, 76, 78, 79, 80, 83, 100, 101, 102, 103, 105, 122, 123, 124]"
Shakespeare,L50,middle,36,20,16,4,0.7353,136,"[2, 5, 7, 8, 9, 10, 11, 12, 15, 16, 17, 18, 19, 38, 40, 47, 48, 49, 50, 51, 52, 53, 54, 55, 56, 57, 60, 78, 79, 95, 96, 98, 99, 115, 118, 121]"
Shakespeare,L50,middle,32,18,14,5,0.7576,132,"[3, 5, 8, 9, 10, 11, 12, 15, 16, 17, 18, 20, 42, 49, 50, 52, 53, 54, 55, 57, 61, 79, 80, 94, 96, 97, 98, 100, 114, 115, 119, 122]"
Shakespeare,L50,middle,30,20,10,6,0.7692,130,"[17, 18, 19, 20, 22, 24, 25, 26, 27, 32, 34, 35, 37, 38, 39, 56, 57, 61, 73, 75, 76, 77, 78, 81, 97, 98, 99, 103, 119, 120]"
Shakespeare,L50,middle,35,17,18,1,0.7407,135,"[18, 19, 21, 23, 25, 26, 27, 29, 30, 31, 32, 33, 34, 35, 36, 37, 39, 40, 42, 60, 61, 62, 63, 78, 79, 81, 82, 84, 85, 102, 103, 104, 105, 124, 125]"
Shakespeare,L50,middle,34,16,18,0,0.7463,134,"[17, 18, 19, 21, 22, 23, 24, 25, 28, 29, 30, 31, 33, 34, 35, 39, 56, 59, 72, 74, 75, 76, 78, 79, 94, 95, 96, 98, 100, 118, 120, 121, 122, 123]"
Shakespeare,L50,middle,36,15,21,4,0.7353,136,"[3, 6, 7, 10, 11, 12, 13, 14, 15, 16, 17, 19, 37, 38, 39, 44, 45, 47, 49, 51, 53, 54, 55, 57, 59, 76, 77, 78, 79, 80, 96, 97, 99, 105, 123, 124]"
Shakespeare,L50,middle,30,9,21,12,0.7692,130,"[21, 22, 24, 28, 30, 33, 35, 37, 38, 40, 55, 57, 58, 59, 60, 64, 75, 76, 77, 78, 79, 80, 83, 97, 98, 99, 101, 117, 118, 126]"
Shakespeare,L50,middle,35,12,23,1,0.7407,135,"[17, 18, 19, 20, 23, 24, 25, 26, 27, 28, 30, 32, 34, 35, 36, 37, 38, 39, 57, 58, 59, 72, 74, 75, 76, 77, 79, 96, 98, 99, 116, 117, 118, 119, 121]"
Shakespeare,L50,middle,36,16,20,4,0.7353,136,"[2, 4, 5, 6, 7, 9, 15, 16, 17, 18, 20, 21, 38, 39, 40, 41, 43, 50, 54, 55, 56, 57, 58, 59, 60, 62, 82, 101, 102, 103, 105, 121, 122, 123, 124, 128]"
Shakespeare,L50,middle,38,16,22,3,0.7246,138,"[17, 18, 19, 20, 22, 24, 28, 29, 30, 31, 32, 33, 34, 35, 36, 37, 39, 40, 42, 43, 44, 45, 46, 48, 67, 68, 70, 85, 86, 88, 89, 106, 107, 109, 110, 131, 132, 133]"
Shakespeare,L50,middle,36,13,23,1,0.7353,136,"[2, 4, 5, 6, 9, 11, 12, 14, 16, 18, 20, 37, 39, 41, 50, 51, 52, 53, 54, 56, 57, 60, 61, 77, 78, 80, 82, 98, 99, 102, 117, 118, 119, 120, 121, 122]"
Shakespeare,L50,middle,30,11,19,1,0.7692,130,"[2, 7, 9, 10, 12, 13, 18, 19, 21, 23, 41, 42, 43, 52, 55, 57, 63, 80, 84, 98, 99, 100, 102, 103, 104, 105, 120, 121, 123, 125]"
Shakespeare,L50,middle,31,15,16,2,0.7634,131,"[17, 18, 19, 23, 25, 27, 28, 29, 30, 32, 33, 34, 35, 36, 37, 38, 39, 40, 58, 60, 75, 78, 79, 80, 81, 82, 83, 102, 105, 123, 126]"
Shakespeare,L50,middle,34,21,13,8,0.7463,134,"[2, 5, 6, 8, 11, 12, 13, 14, 16, 17, 19, 37, 39, 45, 46, 47, 48, 50, 51, 52, 53, 54, 56, 58, 59, 65, 84, 101, 102, 118, 119, 120, 121, 122]"
Shakespeare,L50,middle,32,6,26,3,0.7576,132,"[3, 7, 13, 14, 15, 16, 17, 18, 19, 35, 36, 37, 38, 39, 40, 47, 49, 51, 52, 53, 57, 58, 59, 62, 79, 80, 81, 97, 100, 103, 120, 121]"
Shakespeare,L50,middle,36,16,20,6,0.7353,136,"[2, 4, 7, 8, 9, 10, 13, 14, 16, 17, 18, 20, 38, 39, 46, 47, 51, 52, 53, 56, 57, 58, 62, 81, 82, 83, 85, 88, 106, 107, 108, 109, 126, 127, 128, 131]"
Shakespeare,L50,middle,31,21,10,2,0.7634,131,"[17, 18, 19, 21, 23, 25, 26, 27, 28, 30, 31, 32, 33, 34, 35, 37, 38, 40, 60, 73, 77, 78, 79, 80, 96, 97, 99, 100, 102, 120, 121]"
Shakespeare,L50,middle,36,13,23,6,0.7353,136,"[2, 4, 6, 8, 9, 11, 13, 14, 15, 16, 17, 18, 19, 20, 22, 23, 42, 43, 50, 52, 53, 54, 56, 58, 60, 61, 62, 65, 84, 99, 100, 102, 106, 123, 124, 126]"
Shakespeare,L50,middle,32,13,19,5,0.7576,132,"[17, 18, 20, 23, 24, 26, 27, 29, 30, 31, 34, 35, 36, 37, 39, 40, 58, 63, 76, 77, 78, 79, 81, 97, 98, 99, 100, 103, 119, 123, 124, 125]"
Shakespeare,L50,middle,36,12,24,3,0.7353,136,"[2, 4, 5, 8, 11, 12, 15, 16, 18, 19, 36, 39, 46, 47, 49, 50, 51, 53, 54, 55, 56, 58, 59, 77, 79, 81, 96, 97, 98, 99, 100, 118, 119, 120, 121, 124]"
Shakespeare,L50,middle,34,13,21,2,0.7463,134,"[18, 19, 21, 23, 25, 27, 28, 29, 31, 33, 35, 36, 38, 40, 41, 57, 58, 59, 61, 62, 74, 76, 78, 79, 80, 83, 99, 100, 101, 102, 103, 121, 122, 123]"
Shakespeare,L50,middle,30,10,20,4,0.7692,130,"[17, 18, 21, 24, 26, 27, 28, 29, 30, 31, 32, 33, 34, 36, 38, 39, 56, 58, 60, 73, 74, 75, 79, 94, 99, 116, 117, 119, 120, 123]"
Shakespeare,L50,middle,33,23,10,4,0.7519,133,"[17, 18, 19, 21, 22, 24, 25, 26, 27, 28, 30, 31, 33, 34, 35, 36, 40, 41, 42, 60, 61, 62, 66, 84, 99, 100, 102, 103, 105, 122, 123, 124, 126]"
Shakespeare,L50,middle,33,20,13,4,0.7519,133,"[18, 20, 22, 23, 24, 25, 26, 27, 28, 29, 30, 31, 32, 33, 34, 36, 40, 41, 42, 44, 62, 63, 65, 78, 82, 83, 84, 101, 102, 103, 106, 124, 126]"
Shakespeare,L50,middle,31,12,19,6,0.7634,131,"[17, 18, 22, 23, 24, 26, 27, 30, 33, 35, 36, 38, 39, 55, 57, 58, 59, 60, 73, 76, 77, 79, 82, 98, 99, 100, 101, 118, 119, 120, 122]"
Shakespeare,L50,middle,28,14,14,1,0.7812,128,"[17, 19, 20, 22, 23, 24, 25, 26, 27, 29, 30, 31, 33, 34, 35, 36, 39, 56, 58, 59, 75, 77, 80, 96, 97, 99, 117, 120]"
Shakespeare,L50,middle,31,14,17,3,0.7634,131,"[2, 5, 8, 9, 10, 11, 13, 15, 16, 18, 21, 38, 39, 46, 49, 51, 52, 53, 55, 56, 57, 58, 60, 61, 78, 81, 97, 98, 99, 103, 122]"
Shakespeare,L50,middle,35,20,15,3,0.7407,135,"[17, 19, 20, 21, 22, 23, 24, 25, 27, 29, 30, 31, 33, 34, 36, 37, 38, 39, 58, 59, 75, 77, 78, 79, 94, 97, 98, 99, 100, 101, 103, 104, 107, 126, 130]"
Shakespeare,L50,middle,38,9,29,2,0.7246,138,"[2, 4, 5, 6, 7, 8, 10, 11, 13, 17, 18, 19, 20, 39, 40, 49, 50, 51, 52, 53, 54, 55, 56, 58, 61, 79, 80, 94, 97, 99, 100, 101, 118, 119, 120, 121, 122, 124]"
Shakespeare,L50,middle,33,17,16,4,0.7519,133,"[18, 19, 20, 22, 24, 25, 26, 27, 28, 29, 30, 32, 33, 34, 35, 37, 38, 39, 40, 42, 62, 75, 77, 79, 81, 96, 97, 99, 100, 101, 103, 121, 123]"
Shakespeare,L50,middle,34,10,24,3,0.7463,134,"[2, 5, 11, 12, 13, 15, 17, 18, 19, 20, 21, 38, 39, 43, 54, 56, 57, 59, 60, 61, 79, 80, 81, 97, 100, 102, 116, 118, 119, 120, 121, 122, 123, 125]"
Shakespeare,L50,middle,34,15,19,3,0.7463,134,"[2, 5, 7, 8, 10, 11, 12, 14, 15, 16, 19, 20, 40, 47, 48, 49, 52, 53, 54, 57, 60, 61, 77, 78, 79, 82, 96, 98, 99, 100, 102, 117, 120, 122]"
Shakespeare,L50,middle,34,9,25,5,0.7463,134,"[2, 4, 5, 6, 7, 8, 10, 11, 15, 16, 17, 18, 20, 42, 50, 51, 52, 54, 57, 58, 59, 76, 77, 78, 79, 81, 96, 97, 98, 99, 100, 117, 119, 120]"
Shakespeare,L50,middle,40,19,21,3,0.7143,140,"[2, 4, 9, 10, 12, 13, 15, 16, 17, 18, 19, 20, 21, 40, 41, 42, 48, 49, 50, 51, 52, 53, 56, 57, 58, 59, 60, 61, 63, 64, 65, 86, 102, 104, 105, 107, 108, 110, 128, 131]"
Shakespeare,L50,middle,29,10,19,2,0.7752,129,"[17, 18, 19, 21, 23, 24, 26, 29, 30, 31, 34, 36, 38, 39, 40, 58, 61, 75, 77, 78, 80, 82, 96, 97, 98, 100, 103, 121, 123]"
Shakespeare,L50,middle,33,21,12,5,0.7519,133,"[3, 5, 6, 7, 8, 9, 10, 11, 13, 14, 16, 17, 18, 19, 38, 39, 42, 49, 50, 51, 53, 54, 55, 57, 58, 61, 80, 81, 98, 101, 103, 120, 123]"
Shakespeare,L50,middle,36,10,26,2,0.7353,136,"[2, 7, 9, 10, 11, 12, 13, 14, 15, 16, 17, 18, 19, 20, 21, 41, 42, 49, 51, 53, 54, 56, 58, 59, 60, 62, 80, 81, 82, 99, 103, 118, 119, 121, 122, 124]"
Shakespeare,L50,middle,31,12,19,5,0.7634,131,"[2, 4, 5, 7, 8, 10, 11, 12, 13, 16, 17, 18, 19, 20, 41, 48, 49, 51, 55, 56, 57, 59, 61, 77, 78, 80, 84, 103, 119, 120, 121]"
Shakespeare,L50,middle,32,18,14,8,0.7576,132,"[3, 5, 7, 8, 12, 13, 14, 17, 20, 37, 39, 40, 48, 51, 52, 56, 57, 58, 59, 63, 79, 81, 96, 97, 98, 99, 100, 101, 118, 119, 120, 124]"
Shakespeare,L50,middle,31,7,24,0,0.7634,131,"[17, 19, 20, 21, 22, 23, 24, 25, 28, 29, 34, 37, 38, 39, 56, 57, 58, 60, 72, 73, 75, 77, 80, 96, 97, 99, 100, 117, 118, 120, 124]"
Shakespeare,L50,middle,29,15,14,1,0.7752,129,"[17, 21, 26, 27, 29, 31, 32, 33, 35, 37, 38, 40, 55, 57, 59, 60, 75, 76, 77, 78, 79, 80, 95, 96, 97, 99, 100, 118, 120]"
Shakespeare,L50,middle,33,8,25,0,0.7519,133,"[17, 18, 19, 20, 22, 23, 24, 25, 27, 28, 29, 30, 32, 33, 36, 37, 38, 39, 40, 58, 60, 75, 76, 77, 78, 79, 80, 81, 101, 119, 120, 121, 123]"
Shakespeare,L50,middle,33,19,14,2,0.7519,133,"[19, 20, 22, 23, 25, 27, 31, 34, 35, 37, 39, 40, 41, 42, 44, 60, 62, 65, 77, 79, 80, 82, 83, 85, 86, 102, 103, 104, 105, 107, 125, 126, 127]"
Shakespeare,L50,middle,32,17,15,3,0.7576,132,"[17, 18, 19, 20, 21, 22, 23, 25, 26, 27, 28, 29, 32, 33, 34, 35, 38, 39, 40, 41, 61, 77, 78, 81, 82, 99, 101, 103, 119, 121, 122, 125]"
Shakespeare,L50,middle,30,13,17,2,0.7692,130,"[17, 18, 19, 26, 27, 29, 32, 33, 34, 36, 38, 40, 55, 58, 59, 70, 71, 72, 73, 75, 76, 77, 79, 94, 95, 96, 99, 101, 119, 120]"
Shakespeare,L50,middle,34,18,16,0,0.7463,134,"[2, 5, 9, 11, 12, 13, 14, 15, 16, 17, 18, 19, 37, 40, 41, 48, 49, 50, 52, 53, 55, 56, 57, 58, 61, 79, 81, 97, 98, 99, 101, 119, 120, 121]"
Shakespeare,L50,middle,34,10,24,2,0.7463,134,"[17, 18, 20, 22, 23, 25, 27, 28, 30, 31, 32, 33, 34, 36, 37, 39, 56, 58, 59, 60, 74, 76, 77, 78, 79, 80, 96, 97, 98, 99, 100, 118, 119, 123]"
Shakespeare,L50,middle,32,17,15,4,0.7576,132,"[17, 19, 20, 21, 24, 26, 30, 31, 32, 33, 37, 38, 39, 41, 58, 60, 62, 75, 76, 77, 79, 80, 81, 97, 100, 102, 118, 119, 120, 121, 122, 126]"
Shakespeare,L50,middle,34,11,23,0,0.7463,134,"[18, 19, 20, 22, 23, 24, 25, 26, 27, 31, 32, 34, 35, 36, 37, 39, 40, 58, 59, 60, 74, 75, 77, 78, 79, 81, 97, 98, 99, 101, 119, 120, 121, 122]"
Shakespeare,L50,middle,31,6,25,6,0.7634,131,"[17, 18, 24, 26, 27, 30, 31, 32, 34, 35, 36, 37, 38, 39, 40, 57, 58, 59, 60, 73, 74, 76, 77, 78, 79, 80, 96, 97, 101, 119, 120]"
Shakespeare,L50,middle,34,12,22,2,0.7463,134,"[17, 18, 19, 20, 21, 23, 24, 26, 27, 28, 29, 31, 32, 33, 34, 36, 37, 42, 61, 62, 63, 79, 80, 81, 83, 99, 100, 101, 102, 103, 120, 121, 123, 124]"
Shakespeare,L50,middle,37,13,24,3,0.7299,137,"[2, 4, 5, 6, 7, 8, 9, 11, 13, 14, 15, 17, 18, 19, 20, 42, 48, 49, 50, 51, 52, 53, 54, 57, 59, 60, 61, 62, 63, 64, 85, 101, 103, 104, 120, 123, 124]"
Shakespeare,L50,middle,33,19,14,3,0.7519,133,"[22, 24, 25, 27, 28, 29, 30, 33, 34, 35, 37, 39, 40, 41, 43, 60, 61, 62, 63, 64, 79, 81, 82, 83, 85, 86, 88, 105, 106, 108, 124, 126, 128]"
Shakespeare,L50,middle,35,15,20,5,0.7407,135,"[2, 5, 7, 8, 11, 12, 16, 17, 18, 19, 36, 39, 45, 46, 47, 50, 52, 53, 54, 55, 56, 58, 59, 78, 79, 95, 96, 97, 99, 102, 117, 118, 119, 120, 124]"
Shakespeare,L50,middle,35,15,20,2,0.7407,135,"[3, 5, 6, 7, 9, 11, 13, 15, 16, 17, 21, 38, 40, 46, 47, 48, 49, 51, 53, 56, 57, 58, 60, 77, 79, 80, 81, 97, 98, 100, 101, 117, 118, 120, 121]"
Shakespeare,L50,middle,30,14,16,1,0.7692,130,"[17, 18, 20, 22, 24, 26, 28, 30, 31, 32, 33, 35, 36, 37, 38, 39, 56, 57, 58, 59, 74, 75, 77, 80, 98, 99, 100, 117, 119, 120]"
Shakespeare,L50,middle,33,17,16,2,0.7519,133,"[2, 6, 7, 8, 9, 10, 11, 12, 14, 17, 19, 38, 39, 45, 47, 49, 50, 51, 53, 54, 56, 57, 59, 60, 78, 79, 80, 94, 95, 97, 99, 101, 123]"
Shakespeare,L50,middle,38,16,22,1,0.7246,138,"[2, 4, 5, 6, 7, 8, 9, 10, 12, 13, 14, 15, 17, 18, 19, 38, 40, 48, 49, 50, 54, 55, 57, 59, 60, 79, 80, 94, 96, 97, 98, 99, 101, 102, 120, 121, 122, 124]"
Shakespeare,L50,middle,33,10,23,3,0.7519,133,"[18, 19, 20, 23, 24, 25, 26, 27, 29, 30, 32, 33, 35, 36, 37, 38, 39, 40, 59, 61, 74, 75, 76, 77, 78, 79, 81, 97, 98, 99, 100, 119, 121]"
Shakespeare,L50,middle,33,20,13,6,0.7519,133,"[2, 4, 5, 6, 8, 9, 10, 11, 12, 13, 14, 15, 16, 17, 18, 19, 20, 21, 22, 42, 49, 51, 52, 54, 56, 57, 58, 61, 64, 84, 104, 122, 123]"
Shakespeare,L50,middle,33,9,24,4,0.7519,133,"[17, 20, 21, 22, 23, 24, 25, 26, 27, 28, 31, 32, 33, 36, 37, 39, 40, 59, 62, 77, 78, 80, 81, 82, 83, 99, 101, 102, 104, 120, 121, 122, 125]"
Shakespeare,L50,middle,36,17,19,0,0.7353,136,"[17, 18, 19, 20, 21, 23, 25, 26, 27, 29, 31, 32, 33, 34, 37, 38, 40, 58, 59, 60, 74, 76, 77, 79, 80, 81, 97, 98, 99, 100, 101, 117, 118, 120, 121, 122]"
Shakespeare,L50,middle,30,15,15,3,0.7692,130,"[17, 18, 20, 22, 23, 24, 26, 27, 29, 30, 33, 35, 36, 38, 39, 56, 57, 58, 59, 73, 75, 76, 77, 79, 95, 96, 100, 117, 118, 120]"
Shakespeare,L50,middle,35,15,20,5,0.7407,135,"[2, 4, 6, 8, 11, 12, 16, 17, 18, 19, 21, 38, 39, 41, 47, 48, 53, 54, 55, 56, 58, 59, 60, 61, 63, 82, 83, 84, 85, 86, 88, 106, 107, 110, 128]"
Shakespeare,L50,middle,37,11,26,4,0.7299,137,"[3, 5, 6, 9, 11, 15, 16, 17, 18, 19, 36, 37, 38, 39, 47, 48, 49, 51, 53, 54, 55, 56, 57, 58, 60, 80, 96, 97, 98, 100, 102, 118, 120, 121, 122, 123, 126]"
Shakespeare,L50,middle,33,13,20,2,0.7519,133,"[17, 18, 19, 21, 22, 24, 26, 28, 30, 31, 32, 33, 34, 35, 37, 38, 39, 41, 42, 43, 45, 46, 65, 66, 67, 85, 88, 106, 107, 109, 125, 126, 128]"
Shakespeare,L50,middle,36,14,22,4,0.7353,136,"[3, 5, 6, 7, 8, 9, 11, 12, 13, 15, 17, 18, 19, 20, 39, 40, 47, 48, 49, 50, 51, 52, 55, 58, 59, 61, 82, 97, 98, 99, 101, 117, 118, 119, 121, 124]"
Shakespeare,L50,middle,35,21,14,1,0.7407,135,"[19, 20, 21, 23, 24, 25, 26, 27, 28, 29, 31, 32, 34, 36, 38, 39, 41, 59, 61, 62, 74, 75, 77, 79, 80, 81, 82, 83, 99, 101, 102, 103, 105, 123, 124]"
Shakespeare,L50,middle,34,13,21,0,0.7463,134,"[17, 18, 20, 21, 22, 24, 25, 26, 27, 29, 31, 32, 33, 35, 36, 37, 38, 39, 41, 43, 63, 76, 79, 80, 81, 85, 100, 102, 103, 105, 121, 122, 123, 125]"
Shakespeare,L50,middle,33,22,11,1,0.7519,133,"[17, 18, 19, 20, 21, 22, 23, 24, 25, 26, 27, 28, 30, 31, 33, 35, 36, 37, 39, 40, 41, 42, 61, 62, 78, 80, 81, 83, 99, 100, 101, 103, 124]"
Shakespeare,L50,middle,32,8,24,6,0.7576,132,"[3, 5, 8, 9, 11, 13, 15, 17, 18, 19, 20, 21, 22, 24, 47, 57, 58, 59, 60, 61, 63, 79, 80, 81, 82, 83, 100, 102, 104, 121, 122, 123]"
Shakespeare,L50,middle,36,16,20,1,0.7353,136,"[2, 4, 5, 6, 7, 8, 9, 10, 11, 12, 14, 15, 16, 17, 18, 19, 40, 46, 47, 48, 49, 50, 54, 57, 58, 59, 60, 83, 98, 100, 101, 104, 123, 124, 125, 127]"
Shakespeare,L50,middle,30,12,18,3,0.7692,130,"[18, 19, 20, 21, 24, 26, 27, 28, 29, 31, 33, 35, 36, 40, 41, 43, 59, 60, 61, 64, 81, 82, 96, 97, 102, 118, 120, 121, 122, 123]"
Shakespeare,L100,middle,26,15,11,3,0.7937,126,"[15, 16, 17, 20, 25, 26, 31, 32, 33, 35, 37, 39, 40, 56, 57, 59, 60, 76, 79, 81, 97, 98, 101, 115, 117, 120]"
Shakespeare,L100,middle,33,26,7,2,0.7519,133,"[15, 16, 17, 19, 20, 21, 23, 24, 25, 26, 29, 31, 32, 33, 35, 36, 37, 38, 39, 58, 60, 77, 78, 79, 99, 113, 114, 115, 117, 118, 119, 120, 122]"
Shakespeare,L100,middle,31,18,13,5,0.7634,131,"[15, 16, 17, 18, 20, 21, 22, 23, 24, 26, 27, 29, 31, 32, 33, 34, 36, 37, 38, 39, 40, 41, 60, 63, 80, 81, 84, 101, 106, 121, 123]"
Shakespeare,L100,middle,32,18,14,1,0.7576,132,"[4, 9, 10, 11, 12, 13, 14, 15, 17, 19, 36, 37, 38, 39, 47, 48, 49, 50, 52, 56, 58, 60, 80, 81, 82, 83, 101, 102, 104, 122, 123, 124]"
Shakespeare,L100,middle,31,20,11,7,0.7634,131,"[15, 16, 18, 19, 20, 21, 23, 24, 25, 28, 29, 30, 33, 35, 36, 38, 40, 59, 75, 76, 77, 78, 79, 96, 98, 104, 118, 119, 120, 121, 123]"
Shakespeare,L100,middle,29,13,16,6,0.7752,129,"[15, 16, 18, 20, 24, 25, 27, 28, 30, 31, 32, 33, 34, 37, 41, 57, 58, 60, 63, 79, 82, 98, 99, 100, 103, 117, 120, 121, 122]"
Shakespeare,L100,middle,31,12,19,4,0.7634,131,"[5, 12, 13, 15, 16, 18, 19, 34, 35, 36, 37, 38, 39, 41, 54, 56, 59, 61, 76, 77, 79, 81, 97, 98, 99, 100, 102, 117, 119, 120, 122]"
Shakespeare,L100,middle,31,13,18,3,0.7634,131,"[16, 18, 20, 23, 24, 25, 26, 27, 29, 30, 31, 33, 34, 35, 36, 38, 41, 59, 61, 78, 79, 80, 81, 97, 98, 99, 102, 116, 118, 120, 121]"
Shakespeare,L100,middle,32,16,16,0,0.7576,132,"[16, 17, 19, 20, 21, 25, 27, 28, 29, 31, 32, 33, 34, 36, 37, 38, 40, 56, 57, 58, 60, 62, 81, 82, 98, 99, 101, 102, 120, 121, 122, 123]"
Shakespeare,L100,middle,31,17,14,2,0.7634,131,"[15, 16, 17, 19, 20, 21, 22, 25, 26, 27, 28, 29, 30, 33, 34, 35, 36, 37, 40, 57, 58, 61, 78, 80, 81, 100, 101, 103, 120, 122, 123]"
Shakespeare,L100,middle,32,10,22,1,0.7576,132,"[15, 19, 22, 23, 24, 25, 26, 27, 31, 32, 33, 35, 36, 40, 42, 57, 58, 59, 60, 61, 62, 79, 80, 81, 82, 99, 100, 102, 118, 119, 120, 123]"
Shakespeare,L100,middle,30,16,14,2,0.7692,130,"[4, 9, 10, 11, 12, 13, 16, 17, 18, 19, 36, 37, 39, 40, 50, 51, 56, 57, 58, 59, 61, 79, 80, 98, 100, 114, 116, 117, 119, 121]"
Shakespeare,L100,middle,28,17,11,4,0.7812,128,"[4, 11, 12, 15, 16, 19, 36, 39, 53, 54, 55, 56, 57, 59, 60, 76, 77, 78, 80, 82, 98, 101, 104, 117, 120, 121, 122, 124]"
Shakespeare,L100,middle,30,9,21,0,0.7692,130,"[7, 10, 11, 13, 14, 15, 16, 19, 35, 36, 37, 38, 39, 50, 52, 55, 56, 59, 76, 77, 78, 79, 96, 98, 99, 113, 115, 116, 118, 120]"
Shakespeare,L100,middle,33,18,15,3,0.7519,133,"[15, 16, 17, 18, 19, 20, 21, 22, 24, 25, 27, 29, 30, 31, 34, 36, 37, 38, 40, 43, 44, 46, 66, 85, 87, 90, 106, 109, 124, 126, 127, 128, 129]"
Shakespeare,L100,middle,32,15,17,2,0.7576,132,"[15, 16, 18, 20, 21, 22, 23, 26, 27, 30, 31, 36, 37, 38, 39, 41, 58, 59, 60, 61, 77, 79, 80, 81, 99, 100, 101, 116, 117, 120, 121, 123]"
Shakespeare,L100,middle,30,17,13,3,0.7692,130,"[15, 19, 20, 21, 24, 27, 28, 30, 34, 35, 36, 40, 41, 58, 59, 61, 64, 81, 82, 97, 100, 101, 102, 103, 116, 117, 118, 120, 121, 124]"
Shakespeare,L100,middle,31,14,17,3,0.7634,131,"[4, 9, 13, 15, 16, 19, 20, 38, 39, 40, 51, 52, 54, 55, 57, 58, 60, 75, 76, 77, 78, 79, 82, 98, 100, 103, 118, 119, 120, 121, 122]"
Shakespeare,L100,middle,35,15,20,2,0.7407,135,"[15, 16, 17, 18, 19, 21, 22, 26, 27, 28, 31, 32, 34, 35, 37, 38, 39, 40, 56, 57, 59, 61, 78, 79, 80, 81, 82, 100, 101, 104, 119, 120, 121, 123, 124]"
Shakespeare,L100,middle,33,22,11,2,0.7519,133,"[15, 16, 18, 19, 20, 21, 22, 24, 29, 30, 31, 32, 33, 34, 39, 40, 43, 44, 61, 62, 63, 65, 66, 83, 84, 85, 87, 104, 106, 107, 125, 126, 128]"
Shakespeare,L100,middle,30,17,13,4,0.7692,130,"[16, 17, 18, 19, 22, 25, 26, 27, 29, 30, 31, 32, 33, 34, 35, 36, 42, 59, 61, 77, 79, 83, 99, 102, 116, 120, 121, 122, 123, 124]"
Shakespeare,L100,middle,35,23,12,1,0.7407,135,"[4, 9, 10, 11, 12, 13, 14, 16, 17, 18, 20, 37, 39, 40, 50, 51, 52, 53, 55, 56, 57, 58, 59, 60, 61, 79, 80, 81, 99, 100, 101, 102, 119, 122, 123]"
Shakespeare,L100,middle,27,18,9,2,0.7874,127,"[15, 17, 18, 19, 20, 21, 23, 24, 28, 29, 30, 33, 36, 37, 39, 57, 59, 77, 78, 79, 94, 97, 98, 101, 118, 119, 121]"
Shakespeare,L100,middle,33,23,10,1,0.7519,133,"[7, 9, 10, 11, 12, 13, 17, 19, 20, 21, 22, 40, 41, 42, 54, 55, 58, 59, 60, 62, 80, 81, 82, 83, 100, 101, 103, 104, 119, 120, 121, 122, 125]"
Shakespeare,L100,middle,30,15,15,3,0.7692,130,"[5, 10, 12, 15, 16, 17, 18, 19, 35, 36, 37, 38, 40, 50, 54, 55, 58, 61, 76, 80, 82, 99, 100, 101, 115, 116, 117, 118, 121, 122]"
Shakespeare,L100,middle,37,16,21,1,0.7299,137,"[9, 10, 11, 12, 15, 16, 17, 19, 20, 36, 37, 39, 40, 50, 51, 52, 53, 54, 56, 57, 58, 59, 61, 77, 78, 79, 80, 97, 98, 99, 100, 116, 117, 118, 120, 122, 123]"
Shakespeare,L100,middle,29,13,16,0,0.7752,129,"[4, 9, 10, 14, 15, 16, 20, 37, 40, 41, 42, 55, 56, 58, 59, 61, 63, 79, 81, 82, 83, 99, 101, 103, 117, 118, 120, 121, 123]"
Shakespeare,L100,middle,33,23,10,4,0.7519,133,"[15, 16, 17, 18, 20, 21, 26, 27, 31, 33, 34, 35, 36, 37, 38, 39, 40, 43, 60, 61, 77, 78, 79, 80, 81, 98, 99, 100, 102, 117, 118, 120, 122]"
Shakespeare,L100,middle,32,26,6,3,0.7576,132,"[17, 18, 19, 20, 21, 22, 26, 27, 29, 30, 31, 33, 34, 38, 39, 41, 58, 59, 62, 80, 81, 82, 98, 99, 100, 101, 102, 116, 117, 118, 121, 124]"
Shakespeare,L100,middle,32,25,7,2,0.7576,132,"[16, 17, 18, 19, 20, 21, 22, 23, 24, 25, 29, 30, 31, 33, 34, 35, 36, 37, 38, 39, 58, 61, 78, 79, 80, 98, 100, 116, 117, 118, 121, 122]"
Shakespeare,L100,middle,35,21,14,1,0.7407,135,"[16, 18, 19, 20, 21, 25, 28, 29, 30, 31, 32, 33, 34, 36, 37, 38, 39, 41, 57, 58, 60, 61, 62, 63, 80, 81, 82, 84, 101, 103, 118, 119, 120, 122, 123]"
Shakespeare,L100,middle,34,15,19,4,0.7463,134,"[15, 16, 18, 19, 20, 23, 26, 29, 30, 32, 33, 34, 35, 36, 38, 40, 41, 59, 60, 63, 79, 80, 81, 82, 99, 100, 101, 103, 117, 118, 119, 120, 121, 122]"
Shakespeare,L100,middle,34,22,12,2,0.7463,134,"[4, 9, 10, 11, 12, 13, 14, 15, 16, 17, 18, 20, 40, 50, 51, 52, 53, 54, 57, 58, 59, 62, 80, 81, 83, 100, 102, 103, 104, 120, 121, 122, 123, 124]"
Shakespeare,L100,middle,28,17,11,7,0.7812,128,"[7, 9, 11, 12, 15, 17, 18, 20, 21, 25, 44, 61, 64, 79, 81, 83, 85, 100, 101, 103, 106, 117, 118, 120, 121, 122, 124, 125]"
Shakespeare,L100,middle,34,18,16,1,0.7463,134,"[15, 16, 17, 18, 19, 20, 21, 22, 24, 26, 27, 31, 32, 33, 35, 36, 37, 38, 39, 43, 45, 63, 64, 65, 66, 67, 69, 87, 89, 109, 124, 126, 129, 130]"
Shakespeare,L100,middle,31,13,18,6,0.7634,131,"[15, 16, 17, 18, 22, 25, 27, 29, 30, 31, 36, 38, 41, 58, 60, 76, 77, 78, 79, 80, 81, 82, 99, 100, 102, 116, 117, 118, 119, 123, 125]"
Shakespeare,L100,middle,35,21,14,4,0.7407,135,"[15, 19, 20, 23, 24, 25, 26, 27, 28, 30, 31, 33, 36, 37, 38, 39, 42, 59, 60, 61, 77, 78, 79, 82, 98, 99, 100, 101, 116, 117, 118, 119, 120, 121, 124]"
Shakespeare,L100,middle,31,15,16,3,0.7634,131,"[4, 10, 11, 13, 14, 18, 22, 37, 38, 39, 41, 55, 56, 57, 58, 59, 61, 76, 77, 78, 79, 80, 81, 82, 83, 100, 103, 119, 120, 121, 124]"
Shakespeare,L100,middle,29,22,7,6,0.7752,129,"[4, 9, 10, 11, 12, 13, 14, 15, 17, 19, 21, 37, 38, 42, 54, 55, 56, 57, 58, 59, 60, 76, 77, 79, 81, 98, 99, 102, 120]"
Shakespeare,L100,middle,36,19,17,2,0.7353,136,"[15, 16, 19, 20, 21, 22, 23, 28, 29, 30, 31, 32, 33, 34, 35, 36, 37, 38, 39, 41, 58, 59, 60, 77, 78, 79, 80, 82, 99, 100, 102, 118, 119, 120, 121, 123]"
Shakespeare,L100,middle,34,17,17,3,0.7463,134,"[15, 16, 17, 19, 20, 21, 22, 24, 26, 27, 29, 30, 31, 32, 34, 35, 36, 37, 41, 58, 59, 76, 77, 79, 80, 98, 99, 100, 101, 102, 119, 121, 122, 124]"
Shakespeare,L100,middle,31,10,21,2,0.7634,131,"[16, 17, 20, 23, 24, 25, 26, 27, 28, 32, 33, 34, 35, 36, 37, 40, 58, 59, 60, 78, 79, 80, 96, 98, 101, 116, 117, 118, 119, 120, 121]"
Shakespeare,L100,middle,35,21,14,4,0.7407,135,"[16, 18, 20, 21, 22, 25, 26, 27, 28, 29, 30, 31, 32, 33, 34, 36, 37, 39, 40, 41, 42, 43, 44, 46, 66, 84, 87, 104, 105, 106, 107, 108, 124, 127, 128]"
Shakespeare,L100,middle,32,17,15,0,0.7576,132,"[4, 9, 10, 11, 12, 13, 17, 19, 35, 36, 39, 51, 52, 54, 55, 58, 59, 60, 61, 77, 78, 81, 98, 100, 101, 102, 117, 118, 119, 120, 121, 122]"
Shakespeare,L100,middle,29,17,12,4,0.7752,129,"[4, 9, 11, 12, 14, 16, 17, 19, 36, 38, 39, 42, 56, 57, 58, 59, 60, 75, 76, 77, 78, 79, 80, 98, 99, 102, 118, 120, 121]"
Shakespeare,L100,middle,34,15,19,4,0.7463,134,"[4, 10, 12, 13, 15, 16, 17, 18, 20, 36, 37, 38, 39, 49, 50, 51, 52, 53, 54, 55, 56, 57, 58, 60, 78, 79, 80, 97, 98, 100, 116, 117, 119, 122]"
Shakespeare,L100,middle,34,18,16,3,0.7463,134,"[15, 16, 20, 31, 32, 33, 34, 36, 38, 39, 40, 41, 60, 63, 78, 79, 81, 82, 96, 98, 99, 100, 101, 102, 103, 104, 118, 119, 120, 121, 122, 123, 124, 125]"
Shakespeare,L100,middle,29,14,15,3,0.7752,129,"[15, 18, 19, 20, 21, 22, 26, 27, 28, 29, 33, 34, 35, 36, 38, 39, 42, 59, 60, 77, 79, 81, 97, 98, 100, 102, 121, 122, 123]"
Shakespeare,L100,middle,34,21,13,5,0.7463,134,"[15, 17, 19, 20, 21, 22, 23, 24, 25, 28, 30, 31, 33, 34, 35, 39, 55, 56, 57, 58, 59, 60, 61, 63, 80, 84, 101, 103, 104, 118, 119, 122, 123, 126]"
Shakespeare,L100,middle,29,14,15,2,0.7752,129,"[15, 16, 17, 20, 21, 25, 26, 27, 28, 29, 30, 32, 33, 34, 37, 38, 39, 55, 56, 57, 58, 59, 60, 78, 81, 100, 102, 117, 121]"
Shakespeare,L100,middle,32,25,7,3,0.7576,132,"[4, 9, 11, 12, 13, 14, 18, 20, 35, 37, 38, 39, 45, 58, 59, 60, 63, 65, 81, 82, 83, 84, 86, 87, 104, 105, 106, 109, 124, 126, 127, 128]"
Shakespeare,L100,middle,31,20,11,4,0.7634,131,"[15, 17, 18, 19, 21, 25, 26, 27, 29, 30, 31, 33, 35, 36, 37, 38, 42, 60, 78, 79, 94, 95, 96, 99, 113, 114, 115, 116, 117, 118, 119]"
Shakespeare,L100,middle,28,10,18,4,0.7812,128,"[4, 9, 11, 13, 15, 16, 17, 18, 19, 20, 39, 40, 41, 53, 54, 57, 58, 59, 60, 61, 84, 99, 100, 101, 104, 120, 121, 122]"
Shakespeare,L100,middle,32,17,15,3,0.7576,132,"[15, 16, 17, 18, 20, 21, 22, 24, 25, 26, 28, 30, 32, 34, 35, 37, 38, 39, 56, 57, 58, 59, 76, 79, 96, 97, 98, 99, 101, 117, 119, 121]"
Shakespeare,L100,middle,29,6,23,5,0.7752,129,"[4, 16, 17, 18, 20, 35, 36, 37, 38, 39, 50, 52, 53, 55, 56, 57, 58, 59, 76, 77, 78, 80, 97, 101, 115, 116, 117, 118, 121]"
Shakespeare,L100,middle,32,20,12,2,0.7576,132,"[15, 17, 18, 19, 20, 21, 23, 24, 25, 26, 30, 32, 33, 34, 35, 36, 39, 40, 56, 57, 58, 61, 79, 80, 83, 99, 100, 103, 118, 119, 121, 123]"
Shakespeare,L100,middle,32,14,18,3,0.7576,132,"[15, 16, 17, 19, 20, 25, 26, 27, 28, 30, 31, 32, 33, 35, 36, 37, 41, 59, 60, 61, 78, 79, 80, 82, 98, 99, 100, 102, 117, 118, 119, 122]"
Shakespeare,L100,middle,36,21,15,4,0.7353,136,"[4, 9, 10, 11, 13, 15, 17, 18, 19, 21, 39, 40, 41, 54, 56, 57, 58, 61, 62, 63, 64, 65, 81, 82, 84, 87, 104, 105, 120, 121, 124, 125, 128, 130, 131, 133]"
Shakespeare,L100,middle,31,16,15,1,0.7634,131,"[4, 9, 10, 11, 12, 13, 14, 15, 16, 17, 19, 37, 38, 39, 51, 52, 53, 54, 55, 57, 58, 59, 76, 77, 79, 96, 97, 98, 99, 116, 120]"
Shakespeare,L100,middle,35,13,22,0,0.7407,135,"[4, 9, 11, 12, 14, 15, 16, 17, 18, 19, 20, 21, 38, 40, 41, 51, 53, 54, 55, 56, 57, 58, 60, 61, 78, 79, 80, 81, 99, 100, 101, 102, 119, 121, 122]"
Shakespeare,L100,middle,35,22,13,2,0.7407,135,"[5, 9, 10, 11, 13, 14, 15, 18, 19, 20, 36, 38, 39, 40, 41, 43, 56, 57, 58, 59, 60, 61, 62, 78, 81, 83, 100, 101, 102, 117, 118, 119, 121, 122, 123]"
Shakespeare,L100,middle,33,18,15,5,0.7519,133,"[4, 9, 10, 12, 13, 14, 15, 17, 18, 19, 21, 37, 38, 39, 40, 52, 54, 57, 59, 63, 79, 81, 97, 98, 99, 101, 102, 104, 105, 120, 123, 124, 126]"
Shakespeare,L100,middle,32,15,17,2,0.7576,132,"[16, 17, 18, 19, 25, 27, 28, 29, 30, 31, 33, 36, 37, 38, 39, 40, 58, 59, 60, 76, 77, 79, 80, 100, 101, 105, 120, 121, 123, 124, 125, 126]"
Shakespeare,L100,middle,33,20,13,2,0.7519,133,"[4, 9, 10, 12, 13, 14, 15, 16, 17, 18, 21, 39, 40, 50, 52, 53, 54, 55, 56, 57, 61, 79, 80, 97, 98, 99, 100, 115, 116, 117, 118, 119, 120]"
Shakespeare,L100,middle,29,12,17,2,0.7752,129,"[16, 17, 18, 19, 21, 26, 27, 30, 31, 32, 33, 34, 35, 36, 37, 38, 40, 56, 57, 58, 60, 78, 79, 97, 98, 99, 115, 117, 119]"
Shakespeare,L100,middle,30,12,18,2,0.7692,130,"[4, 10, 12, 13, 15, 16, 18, 19, 34, 36, 38, 39, 48, 52, 53, 54, 55, 56, 57, 58, 61, 79, 96, 99, 113, 114, 115, 117, 119, 120]"
Shakespeare,L100,middle,35,25,10,2,0.7407,135,"[16, 17, 18, 19, 20, 22, 23, 24, 25, 26, 27, 30, 31, 32, 34, 35, 36, 37, 38, 40, 42, 60, 63, 80, 81, 82, 100, 102, 104, 118, 119, 120, 122, 123, 125]"
Shakespeare,L100,middle,34,21,13,1,0.7463,134,"[4, 9, 13, 14, 15, 19, 35, 36, 37, 39, 50, 51, 52, 53, 54, 55, 56, 58, 59, 60, 61, 62, 63, 64, 65, 83, 85, 102, 103, 104, 105, 122, 123, 126]"
Shakespeare,L100,middle,29,20,9,2,0.7752,129,"[9, 10, 14, 16, 17, 18, 19, 20, 38, 40, 43, 55, 56, 57, 58, 59, 61, 76, 79, 82, 98, 100, 101, 102, 117, 118, 119, 120, 122]"
Shakespeare,L100,middle,27,18,9,3,0.7874,127,"[4, 9, 10, 11, 12, 13, 15, 17, 20, 36, 37, 39, 49, 50, 51, 53, 54, 57, 60, 77, 78, 81, 99, 100, 116, 117, 120]"
Shakespeare,L100,middle,24,11,13,2,0.8065,124,"[4, 9, 11, 14, 18, 19, 35, 36, 39, 56, 57, 58, 59, 74, 76, 79, 95, 96, 99, 102, 114, 117, 118, 120]"
Shakespeare,L100,middle,31,9,22,2,0.7634,131,"[4, 9, 11, 14, 15, 16, 18, 19, 35, 36, 37, 38, 41, 54, 56, 58, 59, 61, 76, 77, 78, 79, 80, 81, 82, 99, 100, 101, 102, 120, 122]"
Shakespeare,L100,middle,28,12,16,2,0.7812,128,"[4, 10, 12, 14, 15, 18, 19, 34, 35, 37, 41, 55, 57, 58, 59, 75, 76, 79, 81, 97, 98, 99, 100, 101, 115, 116, 118, 121]"
Shakespeare,L100,middle,33,12,21,5,0.7519,133,"[4, 11, 12, 13, 14, 15, 17, 18, 19, 23, 40, 41, 42, 45, 64, 83, 84, 99, 100, 101, 104, 105, 106, 119, 120, 121, 123, 124, 126, 127, 128, 129, 131]"
Shakespeare,L100,middle,32,23,9,2,0.7576,132,"[4, 9, 10, 11, 12, 14, 15, 16, 17, 19, 36, 37, 41, 42, 43, 55, 56, 58, 59, 60, 61, 63, 64, 65, 83, 85, 102, 106, 120, 121, 123, 126]"
Shakespeare,L100,middle,28,20,8,7,0.7812,128,"[4, 9, 10, 11, 12, 13, 14, 15, 16, 17, 18, 19, 24, 42, 43, 56, 57, 60, 61, 65, 82, 83, 84, 102, 108, 121, 123, 126]"
Shakespeare,L100,middle,31,15,16,7,0.7634,131,"[5, 9, 12, 13, 17, 18, 21, 37, 38, 39, 50, 51, 52, 53, 54, 55, 56, 57, 58, 59, 63, 79, 81, 98, 99, 101, 116, 118, 119, 120, 121]"
Shakespeare,L100,middle,32,18,14,1,0.7576,132,"[19, 21, 22, 24, 25, 26, 27, 29, 30, 31, 33, 34, 35, 38, 39, 42, 58, 60, 62, 78, 79, 81, 83, 100, 102, 103, 118, 119, 120, 121, 122, 123]"
Shakespeare,L100,middle,31,23,8,4,0.7634,131,"[17, 18, 21, 23, 24, 25, 27, 28, 29, 30, 32, 35, 37, 38, 39, 40, 41, 59, 60, 61, 77, 78, 80, 82, 100, 101, 115, 116, 117, 120, 122]"
Shakespeare,L100,middle,32,16,16,2,0.7576,132,"[5, 9, 10, 11, 13, 14, 15, 16, 18, 20, 36, 38, 39, 41, 51, 53, 54, 55, 56, 58, 60, 76, 78, 79, 81, 99, 100, 101, 117, 118, 120, 121]"
Shakespeare,L100,middle,28,16,12,1,0.7812,128,"[4, 9, 11, 12, 14, 16, 19, 20, 35, 36, 37, 38, 39, 40, 50, 54, 55, 57, 59, 60, 77, 78, 79, 80, 81, 100, 102, 121]"
Shakespeare,L100,middle,32,22,10,3,0.7576,132,"[15, 16, 18, 19, 20, 21, 22, 23, 24, 26, 27, 29, 30, 32, 33, 34, 35, 37, 38, 40, 59, 62, 80, 96, 97, 98, 99, 100, 117, 118, 119, 120]"
Shakespeare,L100,middle,33,21,12,1,0.7519,133,"[15, 16, 17, 18, 19, 21, 22, 23, 25, 26, 27, 28, 29, 30, 31, 32, 33, 35, 36, 40, 58, 59, 76, 79, 80, 97, 98, 99, 100, 116, 117, 119, 121]"
Shakespeare,L100,middle,31,14,17,2,0.7634,131,"[15, 16, 17, 18, 20, 21, 26, 27, 28, 32, 33, 35, 36, 37, 39, 40, 58, 59, 60, 78, 79, 80, 96, 97, 98, 99, 101, 116, 117, 118, 122]"
Shakespeare,L100,middle,33,22,11,5,0.7519,133,"[4, 9, 10, 11, 12, 13, 16, 17, 18, 19, 21, 37, 38, 39, 40, 43, 56, 58, 59, 62, 80, 81, 82, 83, 84, 85, 102, 106, 121, 122, 123, 124, 125]"
Shakespeare,L100,middle,31,14,17,0,0.7634,131,"[5, 9, 10, 11, 12, 13, 14, 17, 18, 19, 38, 39, 48, 49, 50, 57, 58, 59, 60, 61, 79, 80, 81, 82, 99, 100, 102, 117, 118, 120, 122]"
Shakespeare,L100,middle,36,11,25,1,0.7353,136,"[4, 9, 10, 11, 12, 14, 15, 16, 18, 19, 36, 37, 38, 40, 41, 51, 54, 55, 56, 57, 58, 59, 60, 61, 78, 79, 80, 81, 83, 101, 102, 118, 119, 120, 121, 122]"
Shakespeare,L100,middle,30,13,17,2,0.7692,130,"[4, 11, 12, 14, 16, 18, 19, 34, 37, 41, 56, 57, 58, 59, 75, 77, 78, 80, 96, 97, 100, 101, 102, 103, 117, 118, 120, 121, 123, 124]"
Shakespeare,L100,middle,30,14,16,3,0.7692,130,"[7, 13, 14, 15, 16, 17, 18, 20, 22, 23, 40, 42, 43, 44, 58, 59, 60, 61, 63, 65, 82, 84, 100, 102, 103, 106, 119, 122, 123, 124]"
Shakespeare,L100,middle,32,20,12,2,0.7576,132,"[17, 18, 20, 23, 24, 25, 26, 29, 31, 32, 35, 36, 39, 57, 58, 59, 75, 76, 78, 80, 95, 97, 98, 99, 100, 114, 115, 116, 118, 119, 120, 122]"
Shakespeare,L100,middle,32,15,17,7,0.7576,132,"[15, 16, 17, 18, 19, 25, 26, 27, 29, 31, 32, 33, 34, 36, 37, 44, 61, 77, 78, 79, 94, 95, 96, 97, 98, 99, 114, 115, 116, 117, 118, 119]"
Shakespeare,L100,middle,31,18,13,1,0.7634,131,"[4, 11, 13, 16, 17, 19, 35, 38, 40, 54, 57, 59, 60, 75, 77, 78, 79, 80, 95, 96, 99, 100, 102, 115, 117, 118, 119, 120, 121, 122, 124]"
Shakespeare,L100,middle,32,16,16,1,0.7576,132,"[4, 9, 10, 11, 12, 13, 14, 16, 18, 20, 37, 39, 48, 49, 51, 52, 54, 55, 56, 58, 59, 75, 76, 78, 79, 96, 97, 99, 115, 116, 118, 119]"
Shakespeare,L100,middle,32,11,21,5,0.7576,132,"[4, 10, 13, 14, 15, 16, 17, 20, 35, 37, 38, 40, 54, 55, 57, 60, 64, 79, 80, 81, 82, 83, 99, 101, 102, 104, 119, 121, 122, 123, 125, 127]"
Shakespeare,L100,middle,34,14,20,1,0.7463,134,"[4, 11, 14, 16, 17, 18, 19, 20, 39, 40, 51, 52, 53, 56, 58, 59, 60, 75, 77, 78, 79, 80, 96, 98, 99, 100, 101, 102, 118, 119, 120, 122, 123, 125]"
Shakespeare,L100,middle,33,15,18,6,0.7519,133,"[4, 9, 14, 15, 16, 17, 18, 23, 38, 40, 41, 55, 59, 60, 61, 62, 78, 79, 80, 81, 83, 99, 100, 101, 102, 103, 118, 119, 121, 122, 123, 124, 127]"
Shakespeare,L100,middle,31,23,8,2,0.7634,131,"[15, 17, 19, 21, 24, 26, 27, 28, 29, 30, 31, 32, 36, 38, 39, 40, 59, 61, 78, 79, 80, 81, 97, 98, 102, 116, 117, 119, 120, 121, 122]"
Shakespeare,L100,middle,34,17,17,3,0.7463,134,"[15, 16, 17, 18, 19, 21, 23, 24, 26, 27, 29, 30, 31, 32, 34, 36, 37, 38, 39, 57, 59, 77, 80, 96, 97, 99, 100, 101, 104, 118, 119, 120, 121, 122]"
Shakespeare,L100,middle,37,23,14,5,0.7299,137,"[16, 17, 18, 20, 21, 22, 27, 28, 29, 30, 31, 33, 34, 35, 36, 37, 39, 41, 57, 58, 59, 60, 61, 62, 79, 81, 82, 83, 101, 102, 103, 104, 105, 107, 123, 124, 129]"
Shakespeare,L100,middle,35,30,5,2,0.7407,135,"[16, 17, 19, 20, 21, 22, 23, 24, 25, 29, 30, 31, 32, 33, 34, 37, 38, 39, 41, 58, 61, 78, 79, 80, 81, 98, 99, 100, 101, 102, 118, 119, 120, 121, 122]"
Shakespeare,L0,long,24,13,11,5,0.8065,124,"[14, 28, 30, 51, 52, 53, 54, 55, 56, 58, 60, 85, 87, 88, 90, 109, 110, 111, 112, 115, 116, 117, 118, 121]"
Shakespeare,L0,long,24,15,9,2,0.8065,124,"[24, 25, 26, 27, 28, 29, 30, 31, 54, 56, 57, 58, 59, 60, 63, 85, 86, 89, 90, 91, 117, 118, 119, 121]"
Shakespeare,L0,long,20,15,5,1,0.8333,120,"[14, 28, 30, 52, 53, 54, 55, 56, 57, 58, 59, 85, 87, 89, 110, 111, 112, 113, 114, 117]"
Shakespeare,L0,long,26,15,11,1,0.7937,126,"[14, 28, 29, 30, 52, 53, 54, 55, 56, 57, 59, 61, 86, 88, 89, 90, 111, 112, 114, 116, 117, 118, 119, 120, 121, 122]"
Shakespeare,L0,long,25,12,13,0,0.8,125,"[14, 28, 29, 53, 54, 57, 58, 59, 83, 84, 86, 87, 88, 89, 90, 109, 110, 111, 112, 113, 115, 117, 118, 119, 120]"
Shakespeare,L0,long,23,5,18,2,0.813,123,"[15, 31, 54, 56, 59, 60, 84, 85, 86, 87, 88, 89, 90, 91, 109, 110, 111, 113, 114, 115, 118, 120, 121]"
Shakespeare,L0,long,23,12,11,2,0.813,123,"[16, 30, 53, 56, 57, 59, 83, 84, 85, 86, 87, 88, 90, 107, 108, 109, 110, 112, 113, 114, 115, 117, 119]"
Shakespeare,L0,long,19,11,8,0,0.8403,119,"[24, 25, 27, 28, 29, 51, 54, 57, 59, 61, 81, 82, 83, 84, 85, 87, 88, 89, 91]"
Shakespeare,L0,long,20,14,6,2,0.8333,120,"[14, 28, 29, 51, 52, 53, 54, 55, 56, 61, 87, 88, 89, 107, 110, 112, 113, 114, 116, 118]"
Shakespeare,L0,long,26,18,8,4,0.7937,126,"[24, 25, 26, 27, 28, 29, 31, 51, 52, 53, 54, 57, 58, 59, 60, 61, 62, 85, 86, 87, 88, 91, 94, 119, 121, 124]"
Shakespeare,L0,long,22,12,10,1,0.8197,122,"[14, 30, 51, 52, 56, 57, 58, 59, 83, 84, 88, 89, 107, 108, 111, 112, 113, 114, 115, 117, 118, 119]"
Shakespeare,L0,long,25,11,14,2,0.8,125,"[24, 25, 28, 31, 49, 50, 52, 56, 57, 58, 60, 61, 82, 83, 84, 85, 87, 88, 89, 90, 93, 118, 119, 121, 122]"
Shakespeare,L0,long,16,5,11,0,0.8621,116,"[14, 29, 30, 51, 53, 55, 57, 58, 59, 60, 90, 105, 106, 111, 112, 114]"
Shakespeare,L0,long,17,11,6,0,0.8547,117,"[14, 29, 31, 52, 53, 54, 55, 56, 58, 60, 61, 88, 89, 90, 92, 112, 114]"
Shakespeare,L0,long,24,8,16,2,0.8065,124,"[14, 30, 52, 54, 55, 57, 58, 59, 60, 84, 85, 86, 87, 88, 90, 91, 93, 112, 117, 118, 119, 120, 121, 122]"
Shakespeare,L0,long,26,16,10,0,0.7937,126,"[24, 25, 26, 28, 30, 31, 50, 51, 52, 55, 56, 58, 59, 60, 62, 84, 87, 88, 89, 91, 92, 117, 118, 120, 121, 122]"
Shakespeare,L0,long,21,2,19,3,0.8264,121,"[14, 28, 29, 30, 33, 56, 57, 58, 59, 60, 61, 63, 90, 91, 92, 109, 110, 112, 117, 118, 119]"
Shakespeare,L0,long,26,10,16,2,0.7937,126,"[14, 28, 29, 30, 31, 32, 54, 56, 57, 58, 59, 60, 61, 63, 89, 90, 92, 93, 113, 116, 118, 120, 121, 122, 123, 124]"
Shakespeare,L0,long,24,6,18,1,0.8065,124,"[14, 29, 51, 53, 56, 57, 58, 61, 62, 87, 88, 89, 90, 91, 93, 109, 110, 111, 112, 113, 115, 116, 117, 119]"
Shakespeare,L0,long,25,16,9,1,0.8,125,"[14, 28, 29, 51, 52, 54, 55, 57, 59, 60, 87, 88, 89, 90, 91, 93, 112, 113, 114, 116, 117, 118, 119, 121, 122]"
Shakespeare,L0,long,16,8,8,4,0.8621,116,"[24, 25, 27, 30, 51, 52, 54, 56, 58, 59, 62, 84, 86, 88, 89, 91]"
Shakespeare,L0,long,25,14,11,1,0.8,125,"[24, 25, 26, 27, 28, 29, 50, 51, 52, 54, 55, 57, 58, 59, 61, 86, 87, 88, 90, 91, 116, 119, 120, 121, 123]"
Shakespeare,L0,long,20,15,5,3,0.8333,120,"[14, 28, 30, 52, 53, 54, 59, 60, 64, 88, 91, 92, 108, 109, 110, 111, 113, 114, 117, 118]"
Shakespeare,L0,long,25,11,14,2,0.8,125,"[14, 28, 31, 52, 53, 54, 57, 59, 61, 88, 89, 90, 106, 107, 108, 109, 111, 112, 113, 115, 116, 117, 119, 120, 122]"
Shakespeare,L0,long,24,10,14,0,0.8065,124,"[14, 29, 50, 53, 55, 56, 58, 59, 84, 85, 86, 88, 89, 107, 108, 110, 111, 112, 115, 117, 118, 119, 120, 122]"
Shakespeare,L0,long,24,11,13,0,0.8065,124,"[14, 28, 29, 30, 31, 53, 54, 55, 56, 58, 60, 61, 88, 89, 90, 91, 110, 111, 112, 113, 114, 117, 119, 121]"
Shakespeare,L0,long,22,16,6,1,0.8197,122,"[24, 25, 27, 28, 30, 49, 50, 51, 52, 54, 57, 58, 60, 82, 84, 85, 88, 89, 91, 115, 117, 120]"
Shakespeare,L0,long,20,10,10,0,0.8333,120,"[14, 28, 29, 30, 52, 53, 55, 56, 58, 61, 87, 88, 89, 91, 92, 110, 112, 113, 117, 118]"
Shakespeare,L0,long,22,10,12,3,0.8197,122,"[15, 31, 53, 54, 55, 57, 58, 59, 60, 84, 85, 88, 89, 91, 108, 111, 112, 114, 115, 117, 118, 120]"
Shakespeare,L0,long,17,10,7,1,0.8547,117,"[24, 25, 27, 29, 48, 49, 51, 53, 54, 56, 57, 59, 85, 87, 88, 91, 93]"
Shakespeare,L0,long,24,14,10,7,0.8065,124,"[18, 33, 54, 55, 56, 57, 58, 60, 85, 86, 87, 88, 89, 107, 108, 109, 110, 111, 113, 114, 115, 117, 118, 121]"
Shakespeare,L0,long,25,22,3,1,0.8,125,"[24, 25, 26, 27, 28, 30, 50, 51, 52, 53, 55, 56, 57, 58, 60, 83, 84, 86, 87, 88, 91, 118, 119, 120, 122]"
Shakespeare,L0,long,24,20,4,1,0.8065,124,"[24, 25, 26, 27, 28, 29, 30, 51, 52, 53, 54, 55, 56, 57, 59, 61, 84, 88, 89, 90, 116, 117, 118, 120]"
Shakespeare,L0,long,22,14,8,4,0.8197,122,"[25, 26, 29, 48, 50, 52, 54, 55, 57, 61, 81, 82, 84, 86, 87, 90, 113, 114, 115, 116, 118, 120]"
Shakespeare,L0,long,22,15,7,1,0.8197,122,"[26, 27, 28, 30, 48, 49, 50, 51, 52, 53, 54, 55, 56, 58, 59, 84, 85, 87, 89, 116, 117, 119]"
Shakespeare,L0,long,27,15,12,0,0.7874,127,"[26, 27, 28, 30, 48, 49, 50, 51, 53, 54, 55, 56, 57, 58, 61, 84, 86, 87, 89, 90, 91, 92, 118, 120, 121, 122, 125]"
Shakespeare,L0,long,20,14,6,1,0.8333,120,"[24, 25, 26, 27, 29, 32, 34, 55, 56, 60, 62, 63, 65, 87, 88, 89, 90, 93, 94, 95]"
Shakespeare,L0,long,24,15,9,1,0.8065,124,"[24, 25, 28, 29, 30, 50, 51, 52, 53, 54, 56, 57, 59, 60, 83, 84, 85, 88, 91, 115, 116, 117, 119, 121]"
Shakespeare,L0,long,25,8,17,0,0.8,125,"[14, 28, 29, 51, 52, 54, 55, 58, 59, 83, 84, 85, 86, 87, 88, 89, 107, 108, 110, 111, 112, 114, 116, 118, 119]"
Shakespeare,L0,long,25,9,16,2,0.8,125,"[14, 30, 51, 52, 53, 55, 57, 58, 59, 61, 88, 89, 90, 91, 94, 110, 111, 113, 114, 115, 118, 119, 120, 121, 122]"
Shakespeare,L0,long,22,4,18,0,0.8197,122,"[15, 29, 53, 54, 55, 56, 57, 58, 59, 60, 85, 86, 88, 89, 91, 109, 111, 115, 116, 117, 118, 120]"
Shakespeare,L0,long,24,17,7,0,0.8065,124,"[24, 25, 28, 29, 48, 49, 52, 53, 54, 55, 59, 80, 81, 82, 83, 84, 86, 89, 114, 115, 116, 117, 118, 119]"
Shakespeare,L0,long,24,20,4,5,0.8065,124,"[15, 30, 51, 52, 53, 54, 55, 56, 58, 62, 90, 105, 108, 109, 110, 111, 113, 114, 115, 116, 117, 118, 119, 121]"
Shakespeare,L0,long,25,18,7,2,0.8,125,"[24, 25, 27, 28, 29, 49, 50, 51, 52, 54, 56, 57, 58, 59, 60, 83, 84, 85, 88, 89, 92, 117, 118, 119, 120]"
Shakespeare,L0,long,23,5,18,3,0.813,123,"[15, 31, 54, 56, 57, 59, 60, 85, 87, 89, 90, 105, 106, 107, 108, 109, 110, 112, 113, 114, 115, 116, 121]"
Shakespeare,L0,long,26,17,9,2,0.7937,126,"[24, 25, 26, 27, 28, 30, 52, 53, 55, 57, 59, 60, 81, 82, 83, 85, 86, 87, 88, 90, 116, 117, 118, 119, 121, 123]"
Shakespeare,L0,long,23,15,8,0,0.813,123,"[24, 25, 27, 28, 29, 30, 51, 52, 53, 54, 55, 57, 60, 82, 83, 84, 86, 87, 88, 89, 90, 119, 120]"
Shakespeare,L0,long,23,10,13,5,0.813,123,"[15, 29, 32, 55, 56, 59, 62, 86, 88, 89, 91, 105, 106, 107, 108, 109, 110, 111, 114, 116, 117, 120, 121]"
Shakespeare,L0,long,19,12,7,0,0.8403,119,"[14, 29, 50, 51, 53, 54, 55, 59, 84, 85, 86, 88, 89, 91, 108, 109, 111, 112, 116]"
Shakespeare,L0,long,23,10,13,2,0.813,123,"[24, 28, 30, 48, 50, 51, 52, 54, 55, 56, 59, 83, 84, 86, 87, 89, 91, 114, 115, 117, 118, 119, 120]"
Shakespeare,L0,long,24,20,4,4,0.8065,124,"[24, 25, 28, 30, 48, 49, 50, 51, 52, 53, 54, 56, 57, 58, 59, 63, 88, 89, 90, 91, 117, 118, 121, 122]"
Shakespeare,L0,long,22,9,13,1,0.8197,122,"[14, 28, 29, 30, 53, 55, 56, 57, 58, 61, 87, 88, 89, 90, 108, 109, 111, 112, 114, 115, 117, 120]"
Shakespeare,L0,long,25,17,8,0,0.8,125,"[24, 25, 26, 27, 28, 30, 52, 53, 54, 55, 56, 57, 59, 60, 82, 83, 84, 86, 87, 88, 89, 90, 118, 119, 120]"
Shakespeare,L0,long,19,12,7,1,0.8403,119,"[14, 29, 50, 51, 52, 53, 55, 57, 60, 84, 85, 87, 89, 90, 108, 110, 111, 113, 114]"
Shakespeare,L0,long,25,21,4,0,0.8,125,"[24, 25, 26, 27, 29, 49, 50, 51, 52, 54, 56, 58, 59, 60, 82, 83, 85, 86, 87, 88, 89, 90, 118, 119, 121]"
Shakespeare,L0,long,23,15,8,2,0.813,123,"[24, 27, 28, 29, 50, 53, 54, 56, 57, 58, 61, 82, 83, 85, 86, 87, 88, 89, 90, 115, 116, 118, 120]"
Shakespeare,L0,long,21,4,17,0,0.8264,121,"[14, 28, 29, 31, 53, 55, 57, 58, 60, 63, 65, 66, 93, 96, 112, 113, 114, 115, 117, 118, 119]"
Shakespeare,L0,long,17,9,8,1,0.8547,117,"[24, 30, 33, 34, 36, 58, 59, 65, 84, 85, 86, 88, 90, 91, 92, 94, 95]"
Shakespeare,L0,long,17,7,10,3,0.8547,117,"[24, 26, 27, 30, 55, 56, 58, 59, 62, 83, 84, 86, 87, 88, 89, 91, 93]"
Shakespeare,L0,long,23,12,11,3,0.813,123,"[14, 29, 52, 53, 54, 57, 60, 85, 87, 88, 90, 105, 106, 109, 110, 111, 112, 113, 114, 115, 116, 118, 120]"
Shakespeare,L0,long,20,7,13,4,0.8333,120,"[14, 28, 30, 52, 58, 59, 83, 85, 86, 88, 91, 106, 107, 108, 109, 111, 112, 113, 116, 118]"
Shakespeare,L0,long,22,10,12,1,0.8197,122,"[24, 25, 28, 30, 49, 51, 53, 54, 55, 57, 58, 60, 81, 82, 84, 85, 87, 88, 89, 91, 117, 120]"
Shakespeare,L0,long,23,12,11,0,0.813,123,"[24, 25, 26, 28, 29, 49, 50, 54, 55, 56, 59, 80, 83, 84, 85, 87, 90, 91, 115, 116, 119, 120, 121]"
Shakespeare,L0,long,14,6,8,6,0.8772,114,"[24, 26, 28, 34, 57, 58, 60, 81, 82, 83, 84, 86, 88, 89]"
Shakespeare,L0,long,22,14,8,3,0.8197,122,"[14, 29, 51, 52, 53, 54, 55, 57, 58, 62, 88, 89, 107, 108, 111, 112, 113, 114, 115, 116, 117, 119]"
Shakespeare,L0,long,10,3,7,7,0.9091,110,"[14, 28, 30, 54, 58, 60, 66, 91, 94, 107]"
Shakespeare,L0,long,26,15,11,4,0.7937,126,"[26, 27, 28, 29, 30, 49, 50, 51, 52, 53, 57, 58, 59, 60, 62, 84, 85, 86, 87, 88, 89, 92, 118, 119, 120, 123]"
Shakespeare,L0,long,25,13,12,1,0.8,125,"[14, 28, 29, 51, 52, 53, 54, 55, 56, 57, 58, 59, 86, 87, 88, 91, 110, 111, 113, 114, 115, 117, 118, 120, 122]"
Shakespeare,L0,long,24,16,8,1,0.8065,124,"[16, 31, 54, 55, 57, 58, 59, 61, 86, 87, 89, 90, 91, 94, 111, 112, 113, 114, 115, 116, 117, 118, 119, 122]"
Shakespeare,L0,long,22,16,6,3,0.8197,122,"[24, 25, 26, 27, 28, 29, 50, 51, 52, 53, 54, 56, 57, 58, 60, 83, 86, 87, 88, 90, 117, 120]"
Shakespeare,L0,long,24,6,18,2,0.8065,124,"[14, 28, 30, 53, 54, 55, 56, 57, 58, 60, 85, 86, 87, 88, 89, 91, 111, 113, 114, 115, 116, 119, 120, 121]"
Shakespeare,L0,long,24,11,13,1,0.8065,124,"[14, 28, 29, 52, 53, 55, 56, 57, 59, 86, 88, 90, 106, 108, 109, 110, 112, 113, 114, 115, 116, 117, 118, 119]"
Shakespeare,L0,long,24,15,9,0,0.8065,124,"[14, 29, 51, 54, 56, 58, 59, 87, 88, 89, 90, 106, 107, 108, 110, 111, 112, 113, 114, 115, 118, 119, 120, 121]"
Shakespeare,L0,long,16,12,4,2,0.8621,116,"[16, 30, 51, 52, 53, 54, 55, 56, 58, 59, 84, 90, 108, 110, 111, 112]"
Shakespeare,L0,long,20,9,11,2,0.8333,120,"[24, 26, 27, 28, 30, 50, 51, 54, 55, 56, 57, 59, 80, 83, 84, 85, 86, 88, 89, 116]"
Shakespeare,L0,long,24,17,7,1,0.8065,124,"[14, 28, 30, 51, 52, 54, 55, 56, 57, 58, 59, 85, 86, 87, 88, 89, 109, 113, 114, 116, 117, 118, 119, 120]"
Shakespeare,L0,long,22,8,14,3,0.8197,122,"[14, 30, 52, 53, 54, 55, 56, 57, 58, 61, 87, 88, 89, 91, 108, 110, 111, 113, 114, 116, 119, 120]"
Shakespeare,L0,long,26,8,18,1,0.7937,126,"[14, 28, 30, 31, 52, 53, 54, 57, 58, 59, 60, 61, 86, 87, 88, 90, 91, 111, 112, 113, 114, 115, 118, 119, 121, 123]"
Shakespeare,L0,long,22,6,16,2,0.8197,122,"[16, 30, 53, 54, 55, 56, 57, 60, 85, 87, 88, 89, 106, 108, 109, 112, 113, 115, 116, 117, 118, 119]"
Shakespeare,L0,long,22,15,7,3,0.8197,122,"[14, 29, 50, 51, 52, 53, 54, 55, 56, 57, 58, 59, 60, 61, 64, 93, 111, 112, 114, 116, 119, 120]"
Shakespeare,L0,long,28,12,16,2,0.7812,128,"[26, 28, 29, 31, 49, 50, 51, 52, 53, 54, 56, 57, 58, 59, 61, 84, 85, 86, 87, 89, 90, 92, 93, 94, 95, 122, 124, 126]"
Shakespeare,L0,long,23,10,13,3,0.813,123,"[16, 30, 53, 54, 58, 59, 84, 85, 86, 87, 88, 90, 106, 108, 110, 111, 112, 113, 114, 116, 117, 118, 121]"
Shakespeare,L0,long,26,20,6,3,0.7937,126,"[24, 26, 27, 28, 29, 31, 50, 51, 52, 53, 54, 55, 57, 58, 59, 60, 61, 64, 89, 90, 91, 92, 118, 119, 120, 122]"
Shakespeare,L0,long,24,7,17,3,0.8065,124,"[25, 27, 28, 30, 48, 50, 51, 52, 53, 54, 56, 57, 58, 60, 84, 85, 86, 87, 88, 89, 90, 91, 93, 122]"
Shakespeare,L0,long,28,21,7,0,0.7812,128,"[24, 26, 27, 28, 29, 30, 50, 51, 52, 53, 58, 59, 60, 84, 85, 86, 87, 88, 89, 90, 92, 93, 94, 119, 121, 122, 123, 124]"
Shakespeare,L0,long,16,7,9,2,0.8621,116,"[25, 26, 28, 31, 51, 52, 56, 57, 58, 59, 81, 83, 85, 86, 87, 89]"
Shakespeare,L0,long,27,4,23,0,0.7874,127,"[14, 28, 29, 52, 53, 55, 56, 60, 86, 87, 88, 89, 90, 91, 92, 109, 110, 111, 112, 113, 114, 115, 116, 117, 118, 120, 122]"
Shakespeare,L0,long,19,15,4,2,0.8403,119,"[27, 29, 46, 48, 51, 53, 54, 55, 56, 57, 58, 59, 80, 81, 84, 87, 88, 89, 92]"
Shakespeare,L0,long,22,13,9,2,0.8197,122,"[14, 29, 30, 54, 56, 57, 58, 60, 62, 87, 88, 90, 91, 107, 109, 111, 113, 114, 115, 116, 117, 118]"
Shakespeare,L0,long,25,17,8,4,0.8,125,"[24, 25, 26, 27, 28, 31, 51, 52, 53, 55, 56, 58, 59, 63, 85, 88, 89, 90, 91, 116, 117, 118, 119, 120, 122]"
Shakespeare,L0,long,20,11,9,3,0.8333,120,"[14, 28, 29, 51, 55, 56, 60, 85, 86, 88, 90, 107, 108, 109, 110, 111, 112, 113, 114, 116]"
Shakespeare,L0,long,23,5,18,1,0.813,123,"[14, 28, 29, 51, 52, 54, 57, 58, 59, 60, 61, 86, 88, 91, 92, 109, 110, 112, 114, 117, 118, 119, 120]"
Shakespeare,L0,long,22,15,7,1,0.8197,122,"[24, 25, 26, 28, 29, 49, 50, 52, 53, 55, 57, 58, 59, 61, 85, 86, 89, 90, 114, 115, 116, 120]"
Shakespeare,L0,long,25,14,11,3,0.8,125,"[14, 29, 31, 52, 53, 54, 55, 56, 57, 58, 59, 60, 62, 89, 90, 92, 111, 112, 113, 114, 115, 116, 120, 121, 123]"
Shakespeare,L0,long,26,20,6,1,0.7937,126,"[24, 25, 28, 29, 48, 49, 51, 52, 53, 55, 56, 58, 59, 81, 82, 83, 84, 85, 86, 87, 88, 89, 91, 119, 120, 121]"
Shakespeare,L0,long,20,12,8,2,0.8333,120,"[24, 25, 26, 28, 30, 49, 50, 53, 54, 56, 58, 59, 60, 61, 62, 84, 86, 88, 89, 94]"
Shakespeare,L0,long,19,9,10,5,0.8403,119,"[24, 26, 28, 29, 49, 50, 51, 53, 54, 58, 60, 81, 82, 83, 85, 86, 88, 89, 94]"
Shakespeare,L0,long,21,15,6,3,0.8264,121,"[24, 26, 27, 28, 29, 49, 50, 51, 53, 55, 58, 59, 61, 83, 85, 86, 89, 91, 115, 116, 118]"
Shakespeare,L0,long,28,15,13,1,0.7812,128,"[25, 26, 27, 29, 30, 32, 51, 52, 53, 54, 55, 56, 57, 58, 60, 61, 84, 86, 88, 90, 91, 92, 93, 95, 121, 123, 124, 125]"
Shakespeare,L0,long,18,10,8,0,0.8475,118,"[14, 28, 29, 51, 52, 54, 55, 56, 59, 83, 85, 88, 89, 110, 111, 112, 115, 116]"
Shakespeare,L50,long,19,13,6,0,0.8403,119,"[25, 26, 27, 29, 47, 48, 51, 52, 53, 54, 55, 56, 57, 59, 60, 61, 88, 89, 91]"
Shakespeare,L50,long,17,9,8,0,0.8547,117,"[25, 26, 27, 29, 47, 48, 49, 52, 53, 54, 56, 57, 59, 83, 87, 88, 89]"
Shakespeare,L50,long,17,2,15,2,0.8547,117,"[14, 28, 29, 30, 31, 55, 56, 58, 59, 60, 62, 86, 87, 88, 89, 90, 92]"
Shakespeare,L50,long,20,11,9,2,0.8333,120,"[25, 27, 28, 29, 30, 48, 49, 52, 53, 54, 55, 56, 57, 58, 59, 60, 86, 87, 88, 92]"
Shakespeare,L50,long,11,0,11,4,0.9009,111,"[14, 27, 28, 29, 54, 55, 57, 58, 59, 63, 93]"
Shakespeare,L50,long,7,3,4,8,0.9346,107,"[18, 31, 58, 64, 87, 89, 92]"
Shakespeare,L50,long,12,6,6,2,0.8929,112,"[14, 28, 29, 55, 56, 57, 58, 61, 86, 88, 90, 91]"
Shakespeare,L50,long,13,1,12,1,0.885,113,"[14, 28, 29, 53, 58, 59, 60, 62, 86, 87, 89, 90, 92]"
Shakespeare,L50,long,21,2,19,0,0.8264,121,"[27, 28, 29, 46, 47, 51, 53, 54, 55, 56, 58, 59, 82, 83, 85, 86, 87, 88, 89, 118, 119]"
Shakespeare,L50,long,17,9,8,1,0.8547,117,"[27, 28, 30, 49, 51, 52, 53, 54, 56, 57, 58, 59, 83, 85, 87, 88, 89]"
Shakespeare,L50,long,19,8,11,2,0.8403,119,"[25, 27, 28, 29, 30, 33, 52, 53, 55, 56, 58, 60, 61, 62, 87, 88, 91, 92, 93]"
Shakespeare,L50,long,18,2,16,2,0.8475,118,"[25, 27, 29, 30, 50, 52, 53, 54, 55, 56, 57, 58, 60, 84, 85, 86, 87, 92]"
Shakespeare,L50,long,9,1,8,8,0.9174,109,"[19, 35, 60, 82, 83, 84, 85, 87, 90]"
Shakespeare,L50,long,17,1,16,0,0.8547,117,"[14, 27, 28, 29, 54, 55, 56, 60, 86, 88, 89, 90, 111, 112, 113, 114, 115]"
Shakespeare,L50,long,9,2,7,3,0.9174,109,"[16, 31, 57, 60, 86, 88, 89, 90, 91]"
Shakespeare,L50,long,17,11,6,0,0.8547,117,"[25, 28, 29, 46, 47, 48, 50, 52, 53, 54, 55, 56, 59, 86, 87, 88, 89]"
Shakespeare,L50,long,15,2,13,1,0.8696,115,"[15, 28, 29, 53, 54, 55, 56, 57, 58, 59, 62, 89, 91, 92, 94]"
Shakespeare,L50,long,18,1,17,1,0.8475,118,"[14, 27, 28, 32, 58, 59, 61, 85, 86, 87, 88, 89, 90, 91, 113, 114, 115, 116]"
Shakespeare,L50,long,17,1,16,4,0.8547,117,"[14, 27, 28, 29, 30, 32, 56, 57, 59, 60, 61, 62, 86, 88, 89, 91, 95]"
Shakespeare,L50,long,11,6,5,2,0.9009,111,"[14, 29, 53, 54, 55, 57, 58, 60, 61, 88, 94]"
Shakespeare,L50,long,11,2,9,3,0.9009,111,"[16, 32, 56, 57, 58, 59, 60, 86, 87, 88, 90]"
Shakespeare,L50,long,16,1,15,0,0.8621,116,"[14, 27, 28, 29, 54, 56, 57, 58, 61, 87, 88, 89, 90, 91, 113, 114]"
Shakespeare,L50,long,17,7,10,1,0.8547,117,"[25, 26, 28, 30, 51, 52, 54, 55, 56, 58, 61, 85, 86, 87, 88, 89, 92]"
Shakespeare,L50,long,18,10,8,2,0.8475,118,"[25, 26, 28, 30, 50, 52, 53, 54, 56, 57, 58, 60, 83, 84, 86, 87, 88, 89]"
Shakespeare,L50,long,17,11,6,0,0.8547,117,"[27, 28, 30, 49, 51, 53, 55, 56, 57, 58, 60, 84, 85, 86, 87, 88, 90]"
Shakespeare,L50,long,10,3,7,4,0.9091,110,"[16, 33, 56, 57, 58, 60, 63, 89, 90, 91]"
Shakespeare,L50,long,20,15,5,0,0.8333,120,"[25, 26, 27, 29, 47, 49, 50, 51, 52, 53, 55, 56, 57, 59, 60, 61, 89, 90, 91, 92]"
Shakespeare,L50,long,12,3,9,3,0.8929,112,"[16, 31, 57, 58, 61, 84, 85, 86, 87, 88, 89, 91]"
Shakespeare,L50,long,17,4,13,0,0.8547,117,"[14, 27, 28, 29, 54, 56, 57, 58, 59, 60, 84, 86, 88, 89, 90, 91, 115]"
Shakespeare,L50,long,20,7,13,0,0.8333,120,"[26, 27, 28, 29, 30, 31, 49, 52, 53, 54, 55, 57, 58, 59, 61, 62, 87, 89, 91, 92]"
Shakespeare,L50,long,15,2,13,4,0.8696,115,"[25, 27, 28, 33, 51, 52, 53, 54, 58, 59, 60, 85, 86, 87, 90]"
Shakespeare,L50,long,18,13,5,0,0.8475,118,"[26, 27, 28, 31, 32, 33, 52, 53, 56, 58, 59, 60, 61, 62, 63, 92, 93, 94]"
Shakespeare,L50,long,20,8,12,1,0.8333,120,"[26, 27, 28, 29, 47, 48, 51, 52, 54, 56, 57, 60, 61, 84, 85, 87, 88, 89, 91, 94]"
Shakespeare,L50,long,13,6,7,0,0.885,113,"[15, 28, 29, 55, 56, 57, 58, 59, 61, 87, 88, 89, 91]"
Shakespeare,L50,long,21,5,16,0,0.8264,121,"[25, 26, 27, 28, 29, 47, 48, 49, 51, 52, 53, 54, 55, 59, 85, 86, 87, 88, 89, 90, 91]"
Shakespeare,L50,long,17,0,17,0,0.8547,117,"[14, 27, 28, 29, 54, 55, 56, 57, 58, 59, 84, 85, 86, 87, 89, 90, 91]"
Shakespeare,L50,long,12,4,8,0,0.8929,112,"[14, 28, 30, 32, 33, 59, 60, 64, 90, 92, 93, 94]"
Shakespeare,L50,long,17,6,11,3,0.8547,117,"[26, 27, 28, 29, 47, 48, 50, 51, 52, 55, 57, 59, 60, 84, 85, 86, 93]"
Shakespeare,L50,long,16,1,15,0,0.8621,116,"[14, 27, 28, 29, 30, 55, 59, 61, 86, 87, 88, 89, 90, 91, 92, 94]"
Shakespeare,L50,long,8,1,7,4,0.9259,108,"[16, 32, 56, 57, 58, 60, 88, 89]"
Shakespeare,L50,long,10,4,6,0,0.9091,110,"[15, 27, 28, 29, 55, 56, 58, 60, 61, 93]"
Shakespeare,L50,long,19,14,5,4,0.8403,119,"[25, 26, 27, 30, 52, 53, 54, 56, 58, 59, 81, 83, 84, 85, 86, 87, 88, 89, 93]"
Shakespeare,L50,long,16,2,14,2,0.8621,116,"[14, 27, 28, 29, 30, 55, 56, 57, 58, 59, 61, 85, 86, 89, 91, 114]"
Shakespeare,L50,long,14,0,14,0,0.8772,114,"[14, 27, 28, 29, 30, 56, 57, 61, 62, 88, 89, 90, 91, 92]"
Shakespeare,L50,long,20,5,15,2,0.8333,120,"[26, 27, 28, 29, 30, 31, 49, 51, 52, 53, 54, 57, 59, 60, 63, 89, 90, 91, 92, 93]"
Shakespeare,L50,long,18,5,13,0,0.8475,118,"[25, 27, 28, 29, 47, 48, 49, 50, 51, 53, 54, 56, 58, 59, 84, 85, 87, 89]"
Shakespeare,L50,long,13,2,11,1,0.885,113,"[14, 27, 28, 30, 55, 57, 60, 85, 87, 88, 89, 90, 92]"
Shakespeare,L50,long,15,3,12,0,0.8696,115,"[14, 29, 52, 53, 55, 57, 59, 62, 63, 87, 88, 89, 90, 92, 93]"
Shakespeare,L50,long,19,4,15,1,0.8403,119,"[15, 28, 30, 56, 57, 58, 60, 85, 86, 87, 88, 90, 111, 112, 113, 114, 115, 116, 117]"
Shakespeare,L50,long,18,7,11,2,0.8475,118,"[25, 26, 27, 29, 31, 33, 34, 53, 54, 55, 56, 57, 58, 60, 62, 63, 66, 95]"
Shakespeare,L50,long,14,2,12,1,0.8772,114,"[15, 27, 29, 53, 57, 58, 60, 61, 63, 87, 89, 90, 91, 92]"
Shakespeare,L50,long,18,8,10,0,0.8475,118,"[25, 26, 28, 29, 30, 48, 49, 50, 52, 54, 55, 58, 59, 61, 63, 90, 91, 93]"
Shakespeare,L50,long,12,6,6,1,0.8929,112,"[14, 28, 29, 54, 56, 57, 58, 60, 83, 86, 87, 89]"
Shakespeare,L50,long,15,1,14,0,0.8696,115,"[14, 27, 28, 29, 54, 55, 57, 59, 86, 87, 89, 110, 111, 112, 113]"
Shakespeare,L50,long,16,10,6,1,0.8621,116,"[14, 29, 30, 53, 54, 56, 58, 60, 83, 85, 86, 87, 88, 89, 91, 114]"
Shakespeare,L50,long,22,3,19,1,0.8197,122,"[27, 28, 29, 46, 47, 48, 49, 50, 51, 52, 53, 54, 55, 56, 57, 58, 59, 60, 87, 88, 89, 92]"
Shakespeare,L50,long,13,3,10,2,0.885,113,"[14, 27, 29, 31, 57, 59, 60, 85, 86, 87, 88, 90, 92]"
Shakespeare,L50,long,17,7,10,3,0.8547,117,"[25, 26, 27, 32, 50, 51, 52, 54, 55, 56, 57, 59, 61, 63, 88, 90, 92]"
Shakespeare,L50,long,9,4,5,3,0.9174,109,"[16, 31, 56, 57, 60, 84, 85, 88, 89]"
Shakespeare,L50,long,12,6,6,2,0.8929,112,"[17, 31, 56, 57, 60, 83, 85, 87, 88, 90, 91, 93]"
Shakespeare,L50,long,20,12,8,0,0.8333,120,"[25, 27, 28, 29, 48, 49, 51, 53, 55, 58, 59, 60, 83, 84, 85, 87, 88, 89, 90, 91]"
Shakespeare,L50,long,19,1,18,3,0.8403,119,"[14, 27, 29, 53, 54, 55, 56, 57, 58, 60, 84, 86, 88, 91, 113, 114, 115, 116, 117]"
Shakespeare,L50,long,14,4,10,2,0.8772,114,"[14, 27, 28, 29, 55, 57, 59, 82, 83, 84, 85, 87, 89, 92]"
Shakespeare,L50,long,8,2,6,1,0.9259,108,"[14, 27, 28, 29, 56, 58, 60, 89]"
Shakespeare,L50,long,15,5,10,5,0.8696,115,"[26, 27, 28, 32, 51, 53, 55, 59, 82, 83, 84, 85, 86, 87, 91]"
Shakespeare,L50,long,16,7,9,1,0.8621,116,"[25, 26, 30, 50, 52, 53, 56, 60, 82, 83, 85, 86, 87, 88, 89, 91]"
Shakespeare,L50,long,12,4,8,2,0.8929,112,"[16, 31, 56, 59, 60, 83, 84, 85, 86, 88, 89, 91]"
Shakespeare,L50,long,14,2,12,0,0.8772,114,"[14, 27, 28, 30, 31, 56, 57, 58, 59, 61, 62, 89, 90, 92]"
Shakespeare,L50,long,13,4,9,4,0.885,113,"[14, 27, 28, 31, 55, 56, 57, 58, 59, 61, 85, 87, 92]"
Shakespeare,L50,long,11,1,10,2,0.9009,111,"[15, 31, 56, 57, 58, 60, 62, 89, 90, 91, 92]"
Shakespeare,L50,long,23,5,18,0,0.813,123,"[25, 26, 27, 28, 29, 47, 49, 50, 51, 52, 53, 54, 55, 59, 60, 86, 87, 88, 89, 90, 119, 120, 121]"
Shakespeare,L50,long,16,9,7,1,0.8621,116,"[27, 29, 31, 49, 50, 51, 52, 55, 56, 58, 59, 60, 61, 84, 88, 91]"
Shakespeare,L50,long,18,2,16,0,0.8475,118,"[14, 27, 28, 29, 54, 55, 56, 57, 59, 83, 85, 86, 89, 90, 113, 114, 115, 116]"
Shakespeare,L50,long,12,0,12,4,0.8929,112,"[14, 27, 28, 29, 31, 32, 56, 57, 59, 60, 64, 94]"
Shakespeare,L50,long,17,11,6,3,0.8547,117,"[25, 26, 27, 28, 29, 49, 53, 56, 58, 59, 60, 84, 85, 86, 87, 89, 95]"
Shakespeare,L50,long,19,7,12,2,0.8403,119,"[26, 27, 28, 31, 50, 51, 56, 57, 58, 59, 60, 84, 87, 89, 91, 92, 93, 94, 96]"
Shakespeare,L50,long,18,8,10,1,0.8475,118,"[25, 26, 28, 30, 51, 52, 53, 55, 56, 57, 58, 59, 82, 83, 85, 86, 87, 89]"
Shakespeare,L50,long,20,2,18,1,0.8333,120,"[14, 28, 30, 53, 54, 55, 56, 57, 60, 83, 84, 85, 86, 87, 88, 89, 91, 92, 117, 118]"
Shakespeare,L50,long,18,1,17,0,0.8475,118,"[15, 27, 29, 30, 31, 55, 56, 57, 58, 59, 60, 61, 62, 87, 89, 90, 91, 93]"
Shakespeare,L50,long,19,7,12,1,0.8403,119,"[26, 27, 29, 46, 47, 48, 50, 51, 52, 53, 55, 56, 58, 59, 84, 86, 87, 88, 90]"
Shakespeare,L50,long,8,2,6,3,0.9259,108,"[14, 28, 30, 62, 87, 88, 89, 92]"
Shakespeare,L50,long,18,6,12,0,0.8475,118,"[25, 26, 27, 28, 31, 51, 52, 53, 54, 55, 58, 60, 62, 87, 88, 90, 91, 92]"
Shakespeare,L50,long,17,8,9,6,0.8547,117,"[26, 27, 28, 32, 50, 51, 52, 55, 56, 57, 58, 59, 60, 63, 92, 93, 96]"
Shakespeare,L50,long,18,13,5,0,0.8475,118,"[25, 26, 27, 29, 47, 48, 49, 51, 53, 54, 55, 56, 59, 85, 86, 87, 88, 89]"
Shakespeare,L50,long,16,7,9,1,0.8621,116,"[25, 27, 29, 30, 50, 51, 52, 54, 59, 62, 85, 87, 88, 89, 90, 91]"
Shakespeare,L50,long,14,3,11,3,0.8772,114,"[14, 28, 29, 30, 34, 59, 60, 62, 86, 88, 89, 91, 92, 94]"
Shakespeare,L50,long,21,5,16,0,0.8264,121,"[26, 27, 28, 31, 32, 33, 52, 53, 54, 55, 56, 57, 59, 60, 61, 62, 64, 90, 92, 93, 94]"
Shakespeare,L50,long,20,3,17,0,0.8333,120,"[15, 27, 29, 53, 55, 56, 57, 59, 82, 83, 84, 85, 86, 88, 90, 91, 115, 116, 117, 118]"
Shakespeare,L50,long,17,2,15,1,0.8547,117,"[15, 30, 53, 54, 55, 56, 57, 58, 59, 83, 84, 85, 86, 88, 90, 114, 115]"
Shakespeare,L50,long,16,5,11,1,0.8621,116,"[25, 27, 30, 49, 51, 54, 56, 57, 58, 60, 84, 85, 87, 88, 90, 91]"
Shakespeare,L50,long,19,16,3,3,0.8403,119,"[25, 26, 27, 29, 30, 33, 54, 55, 56, 57, 59, 60, 61, 86, 87, 88, 89, 90, 92]"
Shakespeare,L50,long,15,7,8,0,0.8696,115,"[25, 28, 29, 51, 52, 54, 56, 57, 58, 59, 60, 85, 88, 89, 90]"
Shakespeare,L50,long,16,1,15,2,0.8621,116,"[25, 27, 32, 50, 51, 55, 56, 57, 58, 60, 84, 86, 87, 88, 89, 90]"
Shakespeare,L50,long,16,8,8,1,0.8621,116,"[25, 27, 28, 30, 52, 53, 54, 58, 59, 61, 62, 85, 86, 88, 90, 92]"
Shakespeare,L50,long,18,8,10,6,0.8475,118,"[26, 27, 28, 29, 30, 35, 56, 59, 60, 61, 62, 63, 86, 88, 90, 91, 92, 96]"
Shakespeare,L50,long,13,3,10,1,0.885,113,"[14, 28, 29, 53, 54, 55, 57, 59, 61, 87, 89, 90, 92]"
Shakespeare,L50,long,12,6,6,0,0.8929,112,"[14, 27, 29, 30, 54, 57, 58, 60, 61, 62, 88, 92]"
Shakespeare,L50,long,18,11,7,3,0.8475,118,"[25, 26, 28, 31, 50, 51, 52, 54, 56, 57, 58, 59, 83, 84, 86, 87, 88, 90]"
Shakespeare,L50,long,14,2,12,3,0.8772,114,"[17, 31, 57, 58, 60, 83, 84, 86, 87, 88, 89, 110, 111, 112]"
Shakespeare,L50,long,19,4,15,2,0.8403,119,"[25, 26, 27, 30, 50, 51, 53, 54, 55, 56, 57, 58, 62, 88, 89, 90, 91, 92, 94]"
Shakespeare,L100,long,15,5,10,2,0.8696,115,"[13, 25, 28, 30, 31, 33, 57, 58, 59, 60, 61, 64, 90, 91, 94]"
Shakespeare,L100,long,15,6,9,1,0.8696,115,"[13, 25, 26, 28, 29, 55, 56, 57, 58, 60, 85, 86, 87, 89, 112]"
Shakespeare,L100,long,15,11,4,2,0.8696,115,"[25, 28, 29, 33, 56, 57, 58, 59, 60, 61, 85, 87, 89, 90, 91]"
Shakespeare,L100,long,16,1,15,2,0.8621,116,"[27, 28, 31, 53, 54, 55, 56, 58, 59, 83, 85, 86, 87, 88, 89, 90]"
Shakespeare,L100,long,10,4,6,3,0.9091,110,"[25, 27, 31, 53, 54, 58, 60, 85, 86, 89]"
Shakespeare,L100,long,17,8,9,2,0.8547,117,"[25, 27, 29, 51, 52, 53, 54, 56, 57, 58, 61, 85, 86, 87, 88, 89, 91]"
Shakespeare,L100,long,23,12,11,1,0.813,123,"[25, 26, 27, 28, 29, 50, 52, 54, 55, 56, 57, 59, 83, 84, 85, 88, 89, 114, 115, 116, 118, 119, 121]"
Shakespeare,L100,long,16,12,4,0,0.8621,116,"[28, 29, 49, 50, 53, 54, 57, 59, 82, 85, 86, 87, 88, 90, 91, 92]"
Shakespeare,L100,long,14,11,3,1,0.8772,114,"[15, 30, 31, 55, 56, 57, 58, 60, 61, 86, 87, 89, 90, 93]"
Shakespeare,L100,long,16,6,10,0,0.8621,116,"[15, 29, 52, 53, 54, 55, 56, 59, 83, 85, 86, 87, 89, 111, 113, 114]"
Shakespeare,L100,long,15,11,4,0,0.8696,115,"[25, 26, 27, 28, 29, 54, 58, 59, 82, 84, 85, 86, 88, 90, 91]"
Shakespeare,L100,long,15,8,7,3,0.8696,115,"[25, 26, 27, 28, 29, 50, 52, 53, 54, 55, 58, 61, 86, 88, 90]"
Shakespeare,L100,long,14,5,9,2,0.8772,114,"[13, 26, 27, 28, 30, 55, 56, 57, 59, 60, 61, 86, 89, 92]"
Shakespeare,L100,long,13,10,3,3,0.885,113,"[26, 29, 49, 52, 53, 54, 58, 60, 61, 62, 66, 91, 94]"
Shakespeare,L100,long,18,9,9,0,0.8475,118,"[13, 25, 28, 29, 54, 55, 56, 58, 59, 85, 86, 87, 88, 90, 91, 92, 115, 116]"
Shakespeare,L100,long,17,1,16,2,0.8547,117,"[26, 27, 28, 30, 51, 54, 56, 58, 59, 83, 84, 85, 86, 87, 88, 89, 91]"
Shakespeare,L100,long,12,3,9,3,0.8929,112,"[13, 28, 30, 54, 55, 56, 57, 62, 86, 87, 89, 92]"
Shakespeare,L100,long,11,2,9,1,0.9009,111,"[15, 29, 53, 56, 58, 60, 85, 86, 87, 88, 89]"
Shakespeare,L100,long,10,7,3,5,0.9091,110,"[19, 34, 57, 60, 84, 85, 86, 88, 89, 91]"
Shakespeare,L100,long,15,9,6,4,0.8696,115,"[25, 27, 29, 50, 51, 54, 55, 56, 57, 59, 62, 86, 88, 90, 94]"
Shakespeare,L100,long,16,5,11,1,0.8621,116,"[15, 29, 54, 55, 56, 58, 60, 85, 86, 87, 88, 89, 111, 112, 113, 114]"
Shakespeare,L100,long,15,6,9,0,0.8696,115,"[25, 26, 29, 51, 53, 54, 56, 57, 59, 83, 84, 85, 86, 87, 90]"
Shakespeare,L100,long,11,7,4,5,0.9009,111,"[15, 30, 53, 55, 56, 58, 59, 84, 86, 88, 94]"
Shakespeare,L100,long,24,17,7,1,0.8065,124,"[13, 25, 26, 27, 28, 29, 53, 54, 55, 57, 58, 59, 85, 86, 88, 89, 90, 114, 115, 116, 117, 118, 119, 121]"
Shakespeare,L100,long,14,5,9,1,0.8772,114,"[25, 27, 28, 29, 52, 53, 57, 58, 59, 83, 84, 85, 88, 90]"
Shakespeare,L100,long,19,12,7,1,0.8403,119,"[25, 26, 27, 28, 29, 50, 52, 53, 54, 55, 56, 57, 60, 85, 86, 87, 88, 89, 92]"
Shakespeare,L100,long,18,9,9,0,0.8475,118,"[13, 25, 27, 28, 29, 30, 56, 57, 58, 60, 85, 86, 87, 89, 90, 92, 115, 116]"
Shakespeare,L100,long,13,9,4,0,0.885,113,"[13, 25, 27, 28, 29, 55, 58, 60, 85, 86, 88, 90, 91]"
Shakespeare,L100,long,14,5,9,2,0.8772,114,"[25, 27, 29, 50, 51, 56, 57, 59, 82, 83, 86, 87, 88, 91]"
Shakespeare,L100,long,15,11,4,2,0.8696,115,"[15, 31, 55, 56, 57, 58, 59, 60, 85, 86, 87, 88, 89, 91, 113]"
Shakespeare,L100,long,17,10,7,1,0.8547,117,"[27, 28, 29, 50, 51, 54, 55, 56, 57, 58, 59, 60, 85, 86, 87, 89, 91]"
Shakespeare,L100,long,12,5,7,1,0.8929,112,"[13, 26, 28, 30, 54, 56, 57, 58, 59, 61, 90, 91]"
Shakespeare,L100,long,13,3,10,4,0.885,113,"[15, 29, 30, 31, 34, 60, 61, 62, 86, 88, 89, 90, 94]"
Shakespeare,L100,long,19,11,8,0,0.8403,119,"[26, 29, 49, 51, 53, 54, 55, 57, 58, 59, 60, 84, 85, 86, 87, 88, 89, 91, 92]"
Shakespeare,L100,long,10,7,3,2,0.9091,110,"[13, 26, 27, 31, 55, 56, 57, 59, 84, 89]"
Shakespeare,L100,long,17,8,9,1,0.8547,117,"[25, 26, 27, 28, 30, 53, 54, 56, 58, 60, 84, 85, 86, 87, 88, 89, 92]"
Shakespeare,L100,long,17,3,14,1,0.8547,117,"[25, 27, 29, 50, 52, 53, 56, 57, 58, 59, 61, 85, 86, 87, 88, 89, 90]"
Shakespeare,L100,long,12,9,3,1,0.8929,112,"[15, 29, 30, 31, 32, 34, 59, 63, 89, 90, 92, 93]"
Shakespeare,L100,long,18,2,16,2,0.8475,118,"[25, 26, 28, 29, 50, 51, 52, 53, 54, 55, 56, 57, 59, 84, 85, 86, 87, 91]"
Shakespeare,L100,long,15,10,5,0,0.8696,115,"[13, 25, 26, 27, 28, 30, 31, 34, 35, 60, 63, 65, 91, 93, 95]"
Shakespeare,L100,long,17,11,6,3,0.8547,117,"[25, 27, 30, 51, 55, 56, 57, 59, 60, 61, 85, 87, 88, 89, 90, 91, 94]"
Shakespeare,L100,long,11,5,6,2,0.9009,111,"[15, 31, 58, 59, 82, 84, 85, 86, 88, 89, 90]"
Shakespeare,L100,long,17,3,14,0,0.8547,117,"[25, 27, 28, 29, 50, 51, 52, 53, 54, 56, 57, 58, 59, 84, 86, 88, 90]"
Shakespeare,L100,long,12,11,1,1,0.8929,112,"[15, 29, 31, 55, 56, 58, 59, 60, 85, 89, 90, 91]"
Shakespeare,L100,long,14,2,12,2,0.8772,114,"[27, 30, 56, 57, 58, 62, 84, 85, 86, 87, 88, 89, 90, 91]"
Shakespeare,L100,long,9,7,2,2,0.9174,109,"[13, 25, 30, 56, 59, 85, 87, 90, 92]"
Shakespeare,L100,long,17,7,10,0,0.8547,117,"[25, 26, 28, 31, 32, 54, 55, 57, 58, 59, 60, 61, 62, 87, 88, 89, 92]"
Shakespeare,L100,long,11,5,6,3,0.9009,111,"[13, 31, 33, 58, 59, 61, 65, 90, 92, 93, 94]"
Shakespeare,L100,long,17,14,3,2,0.8547,117,"[25, 26, 29, 50, 53, 54, 55, 57, 60, 85, 86, 87, 88, 89, 90, 91, 93]"
Shakespeare,L100,long,19,11,8,1,0.8403,119,"[25, 26, 27, 28, 30, 51, 52, 53, 54, 55, 57, 59, 60, 61, 87, 88, 89, 90, 92]"
Shakespeare,L100,long,22,8,14,4,0.8197,122,"[13, 25, 26, 27, 28, 29, 33, 58, 59, 60, 85, 86, 87, 89, 91, 114, 115, 116, 117, 118, 119, 120]"
Shakespeare,L100,long,18,5,13,2,0.8475,118,"[25, 26, 28, 30, 51, 52, 53, 54, 55, 57, 59, 60, 62, 87, 88, 89, 90, 92]"
Shakespeare,L100,long,15,9,6,0,0.8696,115,"[26, 28, 29, 30, 52, 56, 57, 59, 60, 61, 87, 88, 89, 90, 91]"
Shakespeare,L100,long,12,10,2,0,0.8929,112,"[13, 25, 26, 27, 28, 29, 56, 57, 60, 61, 90, 91]"
Shakespeare,L100,long,19,11,8,1,0.8403,119,"[13, 26, 27, 28, 29, 54, 55, 56, 57, 58, 59, 61, 86, 87, 89, 90, 114, 115, 117]"
Shakespeare,L100,long,12,6,6,3,0.8929,112,"[13, 25, 27, 28, 30, 56, 58, 59, 62, 87, 89, 90]"
Shakespeare,L100,long,16,7,9,1,0.8621,116,"[25, 26, 28, 32, 33, 55, 56, 57, 58, 59, 62, 64, 89, 91, 92, 93]"
Shakespeare,L100,long,14,10,4,0,0.8772,114,"[25, 26, 27, 28, 29, 52, 54, 58, 59, 83, 86, 87, 88, 90]"
Shakespeare,L100,long,12,8,4,1,0.8929,112,"[13, 25, 26, 27, 28, 29, 57, 59, 61, 87, 89, 90]"
Shakespeare,L100,long,13,5,8,3,0.885,113,"[13, 26, 27, 28, 30, 32, 56, 59, 63, 88, 89, 90, 91]"
Shakespeare,L100,long,20,7,13,6,0.8333,120,"[27, 28, 29, 30, 31, 32, 53, 54, 55, 56, 58, 59, 62, 63, 64, 67, 93, 94, 95, 100]"
Shakespeare,L100,long,18,3,15,0,0.8475,118,"[25, 27, 28, 29, 50, 51, 53, 54, 55, 58, 59, 61, 86, 87, 88, 90, 91, 92]"
Shakespeare,L100,long,16,11,5,0,0.8621,116,"[13, 26, 27, 28, 30, 55, 57, 59, 61, 88, 89, 91, 92, 93, 94, 96]"
Shakespeare,L100,long,21,12,9,1,0.8264,121,"[13, 25, 26, 28, 29, 54, 55, 56, 57, 58, 60, 87, 89, 111, 112, 114, 115, 116, 117, 118, 119]"
Shakespeare,L100,long,13,10,3,1,0.885,113,"[13, 25, 27, 30, 56, 58, 59, 60, 85, 86, 87, 89, 90]"
Shakespeare,L100,long,9,3,6,4,0.9174,109,"[16, 33, 56, 58, 59, 83, 84, 86, 89]"
Shakespeare,L100,long,16,7,9,4,0.8621,116,"[25, 26, 27, 28, 32, 54, 56, 57, 59, 83, 84, 85, 86, 88, 89, 91]"
Shakespeare,L100,long,20,17,3,1,0.8333,120,"[26, 27, 29, 51, 52, 53, 54, 55, 56, 57, 58, 60, 84, 85, 86, 88, 89, 90, 91, 92]"
Shakespeare,L100,long,25,18,7,1,0.8,125,"[25, 26, 27, 28, 30, 51, 52, 53, 55, 56, 58, 59, 60, 85, 86, 87, 88, 89, 90, 91, 117, 118, 119, 120, 122]"
Shakespeare,L100,long,15,7,8,2,0.8696,115,"[13, 25, 26, 27, 28, 29, 53, 54, 55, 56, 59, 62, 90, 112, 113]"
Shakespeare,L100,long,23,14,9,0,0.813,123,"[25, 26, 27, 28, 29, 51, 52, 53, 54, 56, 57, 59, 60, 85, 86, 87, 88, 89, 90, 116, 118, 119, 120]"
Shakespeare,L100,long,14,10,4,5,0.8772,114,"[27, 29, 30, 52, 54, 56, 59, 60, 84, 85, 87, 88, 89, 95]"
Shakespeare,L100,long,16,7,9,1,0.8621,116,"[25, 27, 28, 29, 50, 51, 52, 53, 54, 57, 58, 60, 84, 85, 89, 92]"
Shakespeare,L100,long,17,7,10,2,0.8547,117,"[26, 27, 28, 30, 51, 52, 53, 54, 56, 57, 58, 59, 83, 85, 86, 88, 90]"
Shakespeare,L100,long,16,6,10,3,0.8621,116,"[25, 26, 27, 29, 51, 52, 53, 54, 55, 57, 58, 61, 87, 88, 89, 91]"
Shakespeare,L100,long,14,8,6,1,0.8772,114,"[25, 26, 28, 29, 55, 56, 58, 59, 83, 84, 86, 87, 88, 90]"
Shakespeare,L100,long,26,17,9,3,0.7937,126,"[25, 26, 27, 28, 29, 31, 52, 53, 55, 56, 57, 58, 59, 60, 63, 88, 89, 90, 91, 116, 117, 118, 119, 120, 121, 122]"
Shakespeare,L100,long,12,5,7,2,0.8929,112,"[13, 26, 27, 29, 30, 56, 57, 58, 61, 87, 89, 91]"
Shakespeare,L100,long,24,19,5,3,0.8065,124,"[25, 27, 28, 29, 30, 53, 54, 55, 56, 58, 59, 60, 84, 85, 86, 87, 88, 89, 91, 116, 117, 118, 119, 122]"
Shakespeare,L100,long,16,8,8,1,0.8621,116,"[25, 28, 29, 50, 52, 53, 56, 58, 60, 83, 84, 87, 88, 89, 90, 93]"
Shakespeare,L100,long,17,4,13,1,0.8547,117,"[13, 25, 26, 29, 54, 55, 56, 57, 58, 59, 61, 86, 87, 88, 91, 114, 115]"
Shakespeare,L100,long,13,9,4,4,0.885,113,"[27, 28, 31, 54, 56, 57, 58, 61, 84, 85, 87, 88, 89]"
Shakespeare,L100,long,13,8,5,3,0.885,113,"[16, 30, 53, 55, 57, 58, 59, 60, 62, 88, 89, 90, 92]"
Shakespeare,L100,long,11,4,7,1,0.9009,111,"[13, 26, 27, 29, 54, 55, 56, 61, 87, 88, 90]"
Shakespeare,L100,long,25,17,8,0,0.8,125,"[25, 26, 27, 28, 29, 52, 53, 54, 55, 57, 58, 59, 60, 85, 87, 88, 89, 90, 91, 116, 117, 119, 120, 121, 123]"
Shakespeare,L100,long,10,8,2,7,0.9091,110,"[16, 34, 58, 59, 60, 61, 87, 89, 90, 94]"
Shakespeare,L100,long,12,1,11,0,0.8929,112,"[15, 29, 52, 53, 55, 59, 84, 85, 86, 87, 88, 89]"
Shakespeare,L100,long,23,8,15,0,0.813,123,"[13, 25, 26, 28, 29, 54, 55, 56, 58, 59, 85, 86, 87, 88, 89, 90, 91, 115, 116, 118, 119, 120, 121]"
Shakespeare,L100,long,12,10,2,3,0.8929,112,"[13, 28, 31, 54, 56, 57, 58, 60, 85, 86, 87, 91]"
Shakespeare,L100,long,11,3,8,6,0.9009,111,"[17, 33, 56, 58, 59, 83, 84, 86, 87, 88, 91]"
Shakespeare,L100,long,19,11,8,1,0.8403,119,"[13, 25, 26, 28, 30, 55, 56, 58, 61, 86, 87, 88, 89, 90, 91, 114, 115, 116, 117]"
Shakespeare,L100,long,24,8,16,1,0.8065,124,"[25, 27, 28, 29, 50, 51, 52, 53, 54, 55, 56, 57, 59, 60, 85, 86, 88, 89, 90, 116, 117, 118, 119, 121]"
Shakespeare,L100,long,14,5,9,1,0.8772,114,"[25, 27, 30, 54, 55, 56, 58, 59, 83, 84, 85, 86, 87, 89]"
Shakespeare,L100,long,13,7,6,3,0.885,113,"[27, 28, 30, 51, 52, 53, 55, 56, 59, 83, 84, 89, 92]"
Shakespeare,L100,long,15,3,12,1,0.8696,115,"[26, 27, 29, 50, 51, 52, 53, 55, 56, 59, 84, 85, 86, 87, 90]"
Shakespeare,L100,long,14,13,1,3,0.8772,114,"[29, 50, 54, 55, 57, 58, 59, 82, 84, 85, 87, 88, 89, 94]"
Shakespeare,L100,long,13,7,6,2,0.885,113,"[13, 28, 31, 54, 57, 58, 59, 60, 86, 88, 89, 90, 92]"
Shakespeare,L100,long,12,5,7,0,0.8929,112,"[29, 51, 52, 54, 56, 57, 59, 82, 83, 86, 88, 89]"
Shakespeare,L100,long,19,10,9,1,0.8403,119,"[25, 26, 27, 28, 29, 50, 52, 55, 56, 57, 59, 61, 86, 87, 88, 89, 90, 91, 93]"
Shakespeare,L100,long,17,3,14,1,0.8547,117,"[25, 26, 27, 29, 31, 52, 53, 54, 55, 56, 57, 58, 59, 60, 88, 89, 90]"
