agent_name,layout,event_update_level,num_attention_switches,num_attention_switches_margins,num_attention_switches_middle,inform_loss,reading_speed,total_steps,attention_switches_time_steps_list
Shakespeare,L0,short,14,8,6,18,0.8772,114,"[10, 19, 29, 40, 48, 49, 58, 60, 69, 70, 75, 85, 94, 108]"
Shakespeare,L0,short,13,10,3,37,0.885,113,"[4, 9, 11, 21, 30, 36, 47, 56, 65, 77, 86, 96, 105]"
Shakespeare,L0,short,18,15,3,3,0.8475,118,"[9, 19, 30, 31, 33, 42, 51, 52, 61, 62, 71, 72, 81, 82, 92, 93, 104, 114]"
Shakespeare,L0,short,12,8,4,18,0.8929,112,"[4, 12, 22, 32, 42, 53, 62, 72, 80, 82, 93, 102]"
Shakespeare,L0,short,18,13,5,5,0.8475,118,"[4, 9, 20, 30, 31, 41, 50, 52, 62, 72, 82, 83, 92, 93, 94, 96, 105, 106]"
Shakespeare,L0,short,19,6,13,4,0.8403,119,"[4, 9, 19, 20, 32, 41, 53, 62, 71, 80, 81, 90, 91, 100, 101, 102, 111, 112, 113]"
Shakespeare,L0,short,21,10,11,3,0.8264,121,"[4, 11, 20, 30, 39, 41, 51, 60, 61, 70, 71, 80, 81, 82, 92, 101, 102, 103, 112, 113, 114]"
Shakespeare,L0,short,18,6,12,8,0.8475,118,"[4, 10, 20, 30, 39, 40, 41, 43, 55, 66, 75, 76, 86, 88, 97, 106, 107, 111]"
Shakespeare,L0,short,10,5,5,50,0.9091,110,"[15, 26, 34, 46, 55, 64, 73, 84, 92, 102]"
Shakespeare,L0,short,15,8,7,31,0.8696,115,"[9, 11, 12, 21, 24, 33, 35, 44, 49, 58, 71, 81, 91, 100, 109]"
Shakespeare,L0,short,20,10,10,3,0.8333,120,"[9, 12, 14, 24, 34, 44, 53, 56, 65, 76, 77, 78, 87, 88, 89, 91, 92, 102, 111, 112]"
Shakespeare,L0,short,19,15,4,3,0.8403,119,"[9, 11, 21, 31, 40, 49, 50, 51, 61, 71, 81, 91, 92, 93, 103, 104, 113, 114, 115]"
Shakespeare,L0,short,20,13,7,2,0.8333,120,"[10, 19, 21, 31, 32, 41, 43, 52, 61, 62, 63, 73, 83, 84, 86, 96, 105, 106, 114, 117]"
Shakespeare,L0,short,17,9,8,7,0.8547,117,"[4, 9, 19, 29, 30, 34, 44, 55, 65, 66, 75, 76, 86, 95, 96, 105, 106]"
Shakespeare,L0,short,13,9,4,20,0.885,113,"[7, 14, 23, 34, 44, 53, 62, 72, 80, 82, 93, 102, 105]"
Shakespeare,L0,short,19,4,15,2,0.8403,119,"[5, 10, 20, 21, 22, 32, 33, 43, 53, 63, 72, 73, 83, 92, 93, 102, 103, 104, 116]"
Shakespeare,L0,short,19,12,7,10,0.8403,119,"[4, 9, 19, 29, 30, 33, 42, 43, 52, 56, 65, 75, 76, 78, 79, 88, 90, 100, 113]"
Shakespeare,L0,short,20,13,7,4,0.8333,120,"[9, 11, 21, 31, 40, 42, 51, 52, 53, 62, 64, 73, 75, 86, 95, 96, 105, 106, 116, 117]"
Shakespeare,L0,short,15,9,6,12,0.8696,115,"[9, 13, 23, 33, 46, 55, 58, 67, 77, 86, 88, 97, 105, 106, 108]"
Shakespeare,L0,short,16,14,2,15,0.8621,116,"[9, 18, 19, 20, 29, 34, 43, 54, 64, 73, 82, 91, 92, 101, 103, 113]"
Shakespeare,L0,short,14,6,8,6,0.8772,114,"[4, 10, 20, 30, 39, 40, 50, 59, 62, 72, 81, 92, 101, 103]"
Shakespeare,L0,short,12,6,6,19,0.8929,112,"[10, 22, 35, 45, 53, 63, 71, 73, 82, 91, 94, 103]"
Shakespeare,L0,short,18,13,5,12,0.8475,118,"[4, 10, 15, 24, 34, 44, 54, 64, 73, 74, 77, 86, 96, 105, 106, 107, 108, 111]"
Shakespeare,L0,short,17,7,10,5,0.8547,117,"[5, 9, 19, 20, 30, 39, 40, 41, 51, 61, 64, 73, 75, 84, 93, 95, 104]"
Shakespeare,L0,short,14,9,5,8,0.8772,114,"[10, 19, 30, 39, 41, 50, 59, 61, 71, 80, 82, 91, 100, 101]"
Shakespeare,L0,short,20,14,6,6,0.8333,120,"[4, 10, 21, 30, 39, 40, 41, 43, 52, 61, 62, 71, 72, 81, 83, 92, 101, 102, 111, 113]"
Shakespeare,L0,short,18,13,5,8,0.8475,118,"[10, 19, 21, 23, 32, 41, 43, 52, 62, 71, 74, 83, 92, 94, 103, 104, 105, 110]"
Shakespeare,L0,short,17,3,14,14,0.8547,117,"[9, 11, 20, 32, 42, 50, 53, 54, 63, 64, 73, 74, 83, 84, 93, 97, 107]"
Shakespeare,L0,short,14,11,3,9,0.8772,114,"[11, 21, 30, 39, 41, 49, 51, 61, 64, 74, 83, 91, 93, 104]"
Shakespeare,L0,short,19,8,11,1,0.8403,119,"[5, 9, 21, 31, 40, 41, 50, 52, 61, 63, 72, 73, 83, 92, 93, 102, 103, 112, 113]"
Shakespeare,L0,short,21,12,9,11,0.8264,121,"[6, 12, 22, 32, 41, 42, 43, 53, 55, 64, 66, 76, 85, 86, 87, 96, 98, 99, 108, 109, 113]"
Shakespeare,L0,short,17,9,8,7,0.8547,117,"[9, 11, 23, 33, 43, 52, 53, 54, 64, 65, 74, 75, 76, 85, 87, 97, 107]"
Shakespeare,L0,short,18,10,8,4,0.8475,118,"[5, 9, 10, 21, 30, 41, 50, 52, 61, 70, 73, 82, 91, 92, 101, 102, 113, 114]"
Shakespeare,L0,short,12,6,6,20,0.8929,112,"[4, 9, 10, 20, 31, 43, 56, 66, 75, 84, 94, 103]"
Shakespeare,L0,short,13,2,11,17,0.885,113,"[5, 11, 20, 29, 31, 40, 52, 65, 74, 82, 92, 101, 103]"
Shakespeare,L0,short,14,4,10,9,0.8772,114,"[10, 20, 21, 32, 42, 50, 53, 65, 76, 85, 93, 102, 103, 104]"
Shakespeare,L0,short,19,12,7,7,0.8403,119,"[5, 9, 10, 20, 21, 33, 42, 51, 55, 64, 73, 84, 93, 102, 103, 105, 106, 116, 117]"
Shakespeare,L0,short,18,14,4,1,0.8475,118,"[9, 19, 31, 40, 49, 50, 51, 52, 61, 62, 71, 72, 82, 91, 93, 103, 104, 114]"
Shakespeare,L0,short,17,14,3,6,0.8547,117,"[9, 18, 19, 28, 30, 40, 51, 61, 72, 81, 90, 91, 100, 101, 102, 103, 113]"
Shakespeare,L0,short,15,12,3,10,0.8696,115,"[9, 11, 20, 30, 33, 42, 51, 52, 61, 62, 63, 75, 84, 94, 106]"
Shakespeare,L0,short,14,11,3,5,0.8772,114,"[4, 11, 21, 31, 41, 50, 53, 63, 64, 73, 75, 87, 96, 106]"
Shakespeare,L0,short,16,6,10,7,0.8621,116,"[4, 10, 20, 31, 43, 52, 53, 54, 63, 65, 74, 83, 86, 95, 104, 105]"
Shakespeare,L0,short,19,7,12,5,0.8403,119,"[5, 9, 19, 20, 21, 22, 23, 33, 43, 55, 65, 74, 83, 92, 93, 102, 103, 112, 113]"
Shakespeare,L0,short,13,8,5,24,0.885,113,"[6, 12, 23, 34, 45, 54, 63, 74, 76, 85, 94, 96, 106]"
Shakespeare,L0,short,17,8,9,8,0.8547,117,"[4, 11, 20, 31, 40, 49, 52, 61, 70, 79, 80, 81, 82, 93, 102, 104, 113]"
Shakespeare,L0,short,18,12,6,5,0.8475,118,"[9, 19, 20, 31, 40, 42, 52, 61, 71, 80, 82, 83, 92, 93, 102, 104, 112, 114]"
Shakespeare,L0,short,20,13,7,5,0.8333,120,"[9, 18, 20, 31, 40, 49, 53, 62, 63, 64, 66, 75, 76, 85, 86, 87, 96, 98, 108, 109]"
Shakespeare,L0,short,16,8,8,9,0.8621,116,"[4, 9, 19, 22, 31, 34, 46, 55, 64, 74, 76, 85, 94, 95, 105, 106]"
Shakespeare,L0,short,16,7,9,10,0.8621,116,"[9, 11, 20, 22, 32, 43, 52, 62, 63, 64, 74, 83, 84, 93, 97, 107]"
Shakespeare,L0,short,18,12,6,5,0.8475,118,"[4, 9, 19, 20, 22, 32, 33, 44, 55, 64, 66, 76, 85, 86, 87, 89, 100, 109]"
Shakespeare,L0,short,14,8,6,18,0.8772,114,"[6, 13, 23, 33, 43, 52, 63, 72, 81, 90, 91, 100, 102, 112]"
Shakespeare,L0,short,16,10,6,1,0.8621,116,"[10, 11, 20, 23, 33, 34, 43, 45, 57, 66, 67, 68, 79, 88, 98, 108]"
Shakespeare,L0,short,15,9,6,7,0.8696,115,"[9, 18, 19, 22, 34, 45, 54, 56, 66, 77, 79, 88, 98, 107, 108]"
Shakespeare,L0,short,17,11,6,5,0.8547,117,"[10, 19, 29, 40, 48, 49, 58, 59, 68, 70, 80, 88, 90, 100, 102, 111, 112]"
Shakespeare,L0,short,17,10,7,10,0.8547,117,"[9, 19, 21, 31, 42, 50, 59, 60, 70, 79, 80, 84, 92, 101, 102, 111, 114]"
Shakespeare,L0,short,15,5,10,4,0.8696,115,"[9, 19, 29, 41, 51, 52, 61, 62, 72, 73, 85, 94, 95, 105, 106]"
Shakespeare,L0,short,16,12,4,20,0.8621,116,"[5, 13, 24, 35, 44, 53, 62, 63, 72, 73, 74, 84, 85, 95, 104, 106]"
Shakespeare,L0,short,19,14,5,8,0.8403,119,"[11, 20, 30, 39, 41, 49, 51, 60, 61, 70, 72, 82, 91, 93, 102, 103, 104, 113, 114]"
Shakespeare,L0,short,11,5,6,14,0.9009,111,"[10, 20, 33, 42, 52, 62, 70, 73, 83, 94, 103]"
Shakespeare,L0,short,15,8,7,10,0.8696,115,"[4, 10, 20, 32, 41, 51, 59, 61, 70, 79, 81, 90, 101, 102, 103]"
Shakespeare,L0,short,17,7,10,7,0.8547,117,"[4, 9, 19, 20, 21, 32, 43, 54, 63, 72, 81, 82, 91, 92, 101, 102, 112]"
Shakespeare,L0,short,14,9,5,5,0.8772,114,"[9, 18, 20, 32, 41, 49, 51, 61, 71, 74, 75, 85, 95, 105]"
Shakespeare,L0,short,18,11,7,6,0.8475,118,"[10, 11, 20, 22, 32, 33, 34, 44, 45, 49, 58, 67, 77, 87, 96, 97, 108, 109]"
Shakespeare,L0,short,15,11,4,12,0.8696,115,"[4, 9, 19, 30, 40, 41, 42, 43, 52, 54, 68, 77, 86, 97, 107]"
Shakespeare,L0,short,17,8,9,14,0.8547,117,"[4, 12, 22, 32, 40, 49, 52, 61, 62, 71, 72, 81, 83, 92, 94, 103, 104]"
Shakespeare,L0,short,18,4,14,4,0.8475,118,"[10, 20, 31, 40, 43, 54, 64, 65, 74, 75, 84, 85, 86, 95, 97, 98, 101, 111]"
Shakespeare,L0,short,20,11,9,6,0.8333,120,"[9, 11, 20, 22, 32, 41, 52, 61, 62, 71, 72, 81, 84, 93, 102, 111, 112, 113, 114, 115]"
Shakespeare,L0,short,18,10,8,11,0.8475,118,"[9, 20, 31, 41, 49, 50, 51, 60, 61, 63, 64, 65, 67, 77, 87, 90, 101, 111]"
Shakespeare,L0,short,19,10,9,5,0.8403,119,"[5, 9, 19, 29, 30, 39, 42, 51, 61, 62, 71, 72, 81, 83, 92, 101, 102, 111, 113]"
Shakespeare,L0,short,16,9,7,5,0.8621,116,"[9, 18, 19, 29, 30, 31, 41, 51, 62, 71, 82, 91, 93, 94, 103, 106]"
Shakespeare,L0,short,14,7,7,12,0.8772,114,"[4, 9, 19, 20, 30, 43, 53, 63, 72, 81, 84, 93, 103, 104]"
Shakespeare,L0,short,17,11,6,6,0.8547,117,"[9, 19, 22, 31, 41, 49, 51, 62, 71, 80, 84, 92, 101, 102, 103, 112, 114]"
Shakespeare,L0,short,14,11,3,27,0.8772,114,"[4, 11, 22, 34, 43, 54, 63, 72, 81, 90, 98, 100, 109, 110]"
Shakespeare,L0,short,19,8,11,3,0.8403,119,"[4, 9, 19, 31, 41, 50, 52, 53, 62, 64, 73, 74, 75, 77, 86, 89, 98, 100, 109]"
Shakespeare,L0,short,15,8,7,5,0.8696,115,"[10, 19, 29, 41, 49, 58, 59, 61, 70, 82, 90, 91, 92, 102, 112]"
Shakespeare,L0,short,14,8,6,9,0.8772,114,"[9, 18, 20, 31, 42, 50, 59, 69, 78, 79, 87, 89, 100, 110]"
Shakespeare,L0,short,23,19,4,6,0.813,123,"[4, 10, 21, 31, 40, 41, 51, 52, 53, 56, 65, 74, 76, 85, 86, 87, 96, 97, 106, 108, 117, 118, 119]"
Shakespeare,L0,short,18,9,9,8,0.8475,118,"[4, 9, 13, 23, 33, 42, 51, 54, 63, 67, 76, 78, 87, 90, 99, 101, 109, 112]"
Shakespeare,L0,short,17,5,12,2,0.8547,117,"[4, 11, 12, 14, 24, 34, 44, 55, 65, 76, 77, 86, 87, 96, 97, 106, 107]"
Shakespeare,L0,short,17,10,7,7,0.8547,117,"[4, 9, 19, 30, 39, 49, 50, 59, 60, 70, 79, 82, 83, 86, 96, 105, 115]"
Shakespeare,L0,short,16,10,6,6,0.8621,116,"[4, 9, 19, 29, 38, 40, 50, 60, 69, 70, 79, 80, 89, 92, 101, 110]"
Shakespeare,L0,short,16,6,10,12,0.8621,116,"[9, 18, 19, 30, 40, 42, 51, 54, 63, 64, 73, 74, 83, 87, 96, 106]"
Shakespeare,L0,short,15,8,7,4,0.8696,115,"[9, 18, 19, 28, 30, 40, 50, 59, 70, 79, 80, 89, 90, 101, 110]"
Shakespeare,L0,short,14,11,3,31,0.8772,114,"[8, 16, 26, 36, 44, 53, 62, 72, 80, 81, 83, 93, 103, 105]"
Shakespeare,L0,short,12,5,7,24,0.8929,112,"[4, 10, 21, 30, 39, 40, 55, 66, 75, 84, 94, 103]"
Shakespeare,L0,short,17,13,4,1,0.8547,117,"[9, 18, 19, 28, 29, 30, 40, 50, 60, 70, 79, 80, 90, 92, 102, 111, 112]"
Shakespeare,L0,short,18,12,6,17,0.8475,118,"[9, 19, 33, 42, 53, 63, 71, 80, 88, 89, 90, 91, 100, 101, 102, 103, 106, 116]"
Shakespeare,L0,short,22,14,8,3,0.8197,122,"[4, 9, 19, 29, 31, 41, 50, 52, 53, 63, 65, 67, 76, 78, 87, 96, 97, 99, 100, 102, 103, 113]"
Shakespeare,L0,short,18,13,5,8,0.8475,118,"[9, 20, 22, 24, 33, 34, 35, 36, 37, 39, 50, 59, 68, 70, 80, 90, 99, 109]"
Shakespeare,L0,short,15,9,6,5,0.8696,115,"[10, 19, 30, 39, 43, 52, 62, 65, 74, 85, 94, 95, 104, 106, 107]"
Shakespeare,L0,short,14,8,6,7,0.8772,114,"[5, 11, 20, 29, 40, 51, 61, 71, 72, 81, 83, 92, 95, 106]"
Shakespeare,L0,short,18,8,10,9,0.8475,118,"[4, 9, 10, 20, 31, 40, 42, 51, 54, 63, 72, 73, 76, 79, 88, 90, 102, 110]"
Shakespeare,L0,short,19,14,5,3,0.8403,119,"[4, 9, 19, 21, 30, 39, 41, 51, 60, 70, 71, 80, 81, 82, 91, 92, 101, 102, 112]"
Shakespeare,L0,short,22,10,12,3,0.8197,122,"[5, 10, 20, 30, 32, 41, 42, 51, 53, 62, 71, 72, 82, 83, 92, 93, 102, 103, 112, 113, 114, 116]"
Shakespeare,L0,short,12,7,5,16,0.8929,112,"[4, 10, 20, 31, 43, 52, 64, 74, 84, 94, 103, 104]"
Shakespeare,L0,short,21,15,6,2,0.8264,121,"[9, 18, 19, 20, 29, 30, 40, 42, 52, 61, 63, 73, 82, 84, 85, 95, 104, 105, 114, 115, 116]"
Shakespeare,L0,short,13,6,7,18,0.885,113,"[4, 9, 22, 33, 42, 51, 59, 61, 70, 79, 83, 92, 103]"
Shakespeare,L0,short,22,15,7,5,0.8197,122,"[4, 10, 20, 29, 39, 49, 50, 52, 61, 62, 71, 72, 81, 82, 83, 92, 96, 105, 116, 117, 118, 119]"
Shakespeare,L0,short,19,10,9,3,0.8403,119,"[4, 9, 19, 20, 30, 40, 41, 51, 60, 62, 71, 72, 82, 84, 93, 96, 106, 116, 117]"
Shakespeare,L0,short,16,11,5,10,0.8621,116,"[9, 18, 19, 20, 29, 31, 42, 52, 64, 73, 82, 83, 86, 95, 105, 106]"
Shakespeare,L50,short,14,9,5,7,0.8772,114,"[4, 9, 19, 29, 39, 49, 58, 62, 71, 80, 91, 100, 109, 110]"
Shakespeare,L50,short,18,8,10,10,0.8475,118,"[5, 12, 22, 32, 41, 42, 52, 62, 63, 72, 74, 84, 93, 95, 104, 114, 115, 116]"
Shakespeare,L50,short,15,10,5,10,0.8696,115,"[5, 9, 10, 20, 30, 39, 41, 51, 61, 70, 80, 84, 93, 102, 113]"
Shakespeare,L50,short,21,8,13,3,0.8264,121,"[10, 19, 30, 41, 42, 43, 44, 54, 64, 65, 74, 75, 76, 77, 86, 89, 98, 108, 109, 110, 111]"
Shakespeare,L50,short,15,5,10,12,0.8696,115,"[4, 10, 20, 29, 31, 40, 41, 51, 53, 63, 72, 74, 87, 98, 108]"
Shakespeare,L50,short,17,5,12,5,0.8547,117,"[10, 12, 21, 22, 33, 43, 52, 55, 57, 67, 76, 77, 87, 88, 97, 100, 109]"
Shakespeare,L50,short,14,10,4,11,0.8772,114,"[4, 9, 21, 33, 41, 50, 58, 62, 72, 81, 90, 92, 93, 104]"
Shakespeare,L50,short,13,8,5,12,0.885,113,"[5, 9, 10, 12, 22, 33, 42, 53, 64, 74, 84, 93, 102]"
Shakespeare,L50,short,10,8,2,36,0.9091,110,"[10, 20, 35, 47, 56, 65, 75, 83, 92, 101]"
Shakespeare,L50,short,19,7,12,2,0.8403,119,"[10, 11, 20, 21, 22, 32, 43, 53, 62, 64, 73, 75, 84, 85, 94, 96, 105, 107, 117]"
Shakespeare,L50,short,15,7,8,13,0.8696,115,"[10, 21, 30, 40, 48, 52, 61, 70, 71, 81, 90, 93, 102, 110, 113]"
Shakespeare,L50,short,14,4,10,15,0.8772,114,"[10, 19, 29, 39, 42, 50, 60, 61, 62, 71, 74, 85, 94, 105]"
Shakespeare,L50,short,14,4,10,9,0.8772,114,"[10, 19, 21, 31, 33, 43, 53, 64, 74, 83, 85, 94, 96, 107]"
Shakespeare,L50,short,17,6,11,8,0.8547,117,"[10, 19, 20, 21, 31, 41, 52, 53, 62, 64, 73, 74, 76, 86, 90, 99, 108]"
Shakespeare,L50,short,18,12,6,6,0.8475,118,"[11, 22, 31, 41, 49, 50, 52, 53, 62, 65, 74, 83, 84, 93, 95, 104, 113, 115]"
Shakespeare,L50,short,19,18,1,8,0.8403,119,"[4, 10, 20, 32, 41, 50, 58, 60, 72, 81, 82, 91, 93, 102, 103, 112, 113, 114, 115]"
Shakespeare,L50,short,14,6,8,19,0.8772,114,"[6, 13, 23, 34, 43, 54, 63, 72, 82, 91, 99, 101, 110, 111]"
Shakespeare,L50,short,20,15,5,2,0.8333,120,"[4, 9, 10, 12, 23, 32, 34, 44, 45, 55, 66, 75, 84, 86, 95, 96, 105, 106, 108, 118]"
Shakespeare,L50,short,15,7,8,3,0.8696,115,"[4, 9, 19, 29, 38, 41, 52, 63, 65, 74, 76, 85, 95, 96, 108]"
Shakespeare,L50,short,19,14,5,11,0.8403,119,"[4, 9, 10, 11, 21, 31, 33, 46, 56, 66, 75, 84, 95, 96, 98, 99, 100, 109, 111]"
Shakespeare,L50,short,15,3,12,10,0.8696,115,"[10, 19, 29, 42, 51, 60, 69, 78, 80, 88, 89, 91, 100, 103, 113]"
Shakespeare,L50,short,19,11,8,3,0.8403,119,"[10, 19, 20, 31, 32, 42, 50, 52, 54, 55, 65, 74, 75, 86, 95, 104, 105, 106, 115]"
Shakespeare,L50,short,17,7,10,8,0.8547,117,"[5, 9, 11, 22, 33, 42, 43, 44, 54, 55, 65, 78, 90, 99, 108, 109, 110]"
Shakespeare,L50,short,20,11,9,6,0.8333,120,"[11, 20, 31, 41, 50, 59, 60, 69, 71, 81, 90, 91, 93, 102, 103, 104, 105, 106, 115, 117]"
Shakespeare,L50,short,17,12,5,5,0.8547,117,"[11, 12, 21, 22, 32, 34, 45, 55, 64, 73, 74, 84, 85, 93, 95, 99, 108]"
Shakespeare,L50,short,21,6,15,1,0.8264,121,"[10, 19, 29, 39, 48, 49, 60, 61, 70, 71, 81, 82, 83, 92, 93, 94, 103, 104, 114, 115, 116]"
Shakespeare,L50,short,15,12,3,12,0.8696,115,"[12, 22, 31, 41, 49, 60, 69, 71, 80, 81, 90, 92, 101, 110, 111]"
Shakespeare,L50,short,18,9,9,4,0.8475,118,"[4, 9, 10, 11, 24, 34, 44, 54, 64, 75, 76, 85, 87, 96, 105, 106, 109, 110]"
Shakespeare,L50,short,14,6,8,15,0.8772,114,"[10, 19, 29, 40, 48, 49, 50, 52, 66, 75, 84, 92, 94, 104]"
Shakespeare,L50,short,16,14,2,8,0.8621,116,"[4, 10, 21, 31, 40, 50, 59, 60, 69, 70, 79, 80, 89, 90, 100, 112]"
Shakespeare,L50,short,17,10,7,10,0.8547,117,"[12, 22, 31, 41, 49, 51, 60, 61, 70, 71, 73, 83, 92, 101, 102, 111, 112]"
Shakespeare,L50,short,15,3,12,9,0.8696,115,"[10, 22, 32, 41, 53, 63, 72, 81, 82, 83, 91, 93, 94, 95, 105]"
Shakespeare,L50,short,15,7,8,15,0.8696,115,"[10, 22, 31, 41, 50, 59, 60, 61, 71, 72, 75, 84, 92, 97, 106]"
Shakespeare,L50,short,18,6,12,4,0.8475,118,"[5, 12, 22, 32, 41, 43, 53, 62, 63, 72, 74, 84, 94, 103, 104, 105, 115, 116]"
Shakespeare,L50,short,22,12,10,4,0.8197,122,"[10, 19, 20, 21, 31, 32, 35, 45, 55, 56, 66, 75, 76, 85, 86, 87, 97, 98, 99, 100, 102, 113]"
Shakespeare,L50,short,15,10,5,10,0.8696,115,"[4, 11, 21, 31, 32, 41, 43, 53, 63, 73, 82, 83, 86, 98, 106]"
Shakespeare,L50,short,13,10,3,34,0.885,113,"[7, 17, 29, 39, 48, 57, 66, 75, 84, 85, 96, 104, 105]"
Shakespeare,L50,short,16,8,8,7,0.8621,116,"[11, 20, 30, 40, 48, 49, 59, 69, 78, 80, 89, 91, 100, 102, 104, 114]"
Shakespeare,L50,short,17,5,12,8,0.8547,117,"[10, 21, 31, 41, 49, 51, 60, 61, 70, 71, 81, 90, 91, 100, 102, 111, 114]"
Shakespeare,L50,short,19,14,5,12,0.8403,119,"[4, 9, 10, 23, 33, 42, 53, 62, 63, 64, 73, 75, 85, 94, 95, 104, 105, 114, 115]"
Shakespeare,L50,short,18,9,9,7,0.8475,118,"[10, 19, 30, 41, 50, 59, 60, 61, 70, 72, 75, 76, 77, 78, 90, 99, 108, 109]"
Shakespeare,L50,short,21,13,8,4,0.8264,121,"[10, 11, 21, 22, 32, 42, 46, 55, 57, 66, 67, 68, 69, 70, 79, 82, 93, 104, 105, 114, 117]"
Shakespeare,L50,short,15,9,6,10,0.8696,115,"[12, 22, 31, 41, 50, 61, 62, 65, 74, 83, 86, 95, 96, 105, 109]"
Shakespeare,L50,short,14,12,2,7,0.8772,114,"[5, 10, 24, 33, 44, 53, 54, 64, 76, 85, 94, 95, 104, 105]"
Shakespeare,L50,short,16,7,9,6,0.8621,116,"[4, 9, 20, 29, 33, 43, 53, 62, 63, 73, 82, 84, 94, 95, 104, 107]"
Shakespeare,L50,short,22,11,11,5,0.8197,122,"[6, 10, 20, 29, 39, 40, 41, 42, 44, 54, 55, 56, 65, 67, 77, 87, 97, 98, 99, 108, 110, 120]"
Shakespeare,L50,short,14,5,9,9,0.8772,114,"[10, 11, 20, 22, 33, 43, 52, 62, 71, 81, 82, 92, 101, 103]"
Shakespeare,L50,short,15,10,5,11,0.8696,115,"[10, 19, 29, 32, 44, 53, 62, 71, 81, 89, 91, 100, 102, 110, 113]"
Shakespeare,L50,short,17,9,8,4,0.8547,117,"[10, 19, 29, 30, 41, 49, 51, 60, 69, 70, 80, 81, 90, 92, 102, 111, 112]"
Shakespeare,L50,short,18,9,9,5,0.8475,118,"[10, 11, 20, 21, 31, 32, 42, 51, 52, 53, 55, 57, 67, 78, 87, 96, 99, 109]"
Shakespeare,L50,short,19,12,7,2,0.8403,119,"[4, 10, 20, 30, 39, 41, 51, 60, 61, 70, 71, 72, 82, 84, 94, 95, 105, 107, 117]"
Shakespeare,L50,short,17,6,11,3,0.8547,117,"[10, 19, 29, 30, 31, 42, 51, 60, 61, 70, 72, 82, 91, 92, 93, 103, 114]"
Shakespeare,L50,short,14,8,6,7,0.8772,114,"[11, 20, 30, 40, 48, 51, 60, 61, 72, 81, 83, 91, 94, 106]"
Shakespeare,L50,short,17,12,5,9,0.8547,117,"[4, 9, 21, 31, 40, 43, 54, 63, 64, 65, 74, 76, 85, 86, 96, 105, 107]"
Shakespeare,L50,short,15,7,8,5,0.8696,115,"[4, 10, 21, 31, 40, 51, 60, 61, 70, 72, 81, 90, 92, 102, 111]"
Shakespeare,L50,short,15,8,7,21,0.8696,115,"[10, 11, 24, 33, 35, 46, 54, 63, 64, 66, 68, 81, 92, 102, 111]"
Shakespeare,L50,short,14,2,12,6,0.8772,114,"[10, 19, 29, 30, 40, 43, 52, 62, 74, 84, 92, 93, 103, 105]"
Shakespeare,L50,short,14,4,10,9,0.8772,114,"[10, 19, 20, 22, 32, 42, 51, 61, 70, 72, 83, 93, 102, 112]"
Shakespeare,L50,short,15,10,5,4,0.8696,115,"[10, 20, 30, 40, 48, 49, 50, 59, 61, 70, 81, 90, 100, 101, 112]"
Shakespeare,L50,short,23,16,7,13,0.813,123,"[4, 9, 12, 22, 31, 33, 34, 35, 36, 37, 46, 47, 48, 58, 67, 69, 71, 81, 82, 84, 95, 108, 118]"
Shakespeare,L50,short,15,12,3,24,0.8696,115,"[8, 16, 26, 36, 45, 54, 65, 74, 84, 85, 94, 95, 96, 105, 107]"
Shakespeare,L50,short,19,8,11,3,0.8403,119,"[11, 20, 21, 31, 42, 50, 52, 62, 63, 72, 73, 74, 84, 85, 94, 95, 104, 105, 116]"
Shakespeare,L50,short,16,13,3,5,0.8621,116,"[4, 9, 19, 29, 40, 50, 58, 61, 72, 82, 91, 99, 101, 110, 111, 114]"
Shakespeare,L50,short,14,9,5,12,0.8772,114,"[4, 9, 19, 29, 30, 40, 50, 59, 63, 72, 82, 91, 100, 105]"
Shakespeare,L50,short,12,9,3,24,0.8929,112,"[10, 20, 30, 41, 49, 58, 59, 63, 73, 86, 94, 104]"
Shakespeare,L50,short,16,8,8,6,0.8621,116,"[10, 19, 29, 40, 48, 49, 59, 68, 69, 78, 81, 90, 99, 100, 109, 111]"
Shakespeare,L50,short,17,9,8,4,0.8547,117,"[5, 10, 20, 29, 31, 40, 41, 51, 53, 62, 71, 73, 82, 84, 94, 103, 113]"
Shakespeare,L50,short,16,6,10,26,0.8621,116,"[12, 22, 31, 41, 49, 58, 60, 69, 70, 71, 72, 73, 74, 88, 99, 109]"
Shakespeare,L50,short,14,6,8,9,0.8772,114,"[5, 9, 19, 29, 30, 42, 52, 61, 70, 72, 81, 84, 94, 105]"
Shakespeare,L50,short,15,9,6,7,0.8696,115,"[6, 10, 21, 30, 32, 41, 44, 55, 64, 76, 85, 96, 104, 105, 106]"
Shakespeare,L50,short,17,4,13,5,0.8547,117,"[10, 20, 21, 22, 32, 43, 52, 62, 63, 64, 73, 74, 84, 94, 95, 97, 107]"
Shakespeare,L50,short,13,8,5,9,0.885,113,"[5, 10, 20, 29, 41, 50, 59, 60, 72, 83, 93, 102, 104]"
Shakespeare,L50,short,19,11,8,12,0.8403,119,"[10, 11, 20, 21, 25, 34, 44, 54, 64, 73, 83, 92, 93, 94, 95, 96, 105, 107, 117]"
Shakespeare,L50,short,19,11,8,10,0.8403,119,"[5, 9, 10, 20, 33, 42, 52, 61, 70, 72, 81, 92, 94, 96, 98, 99, 108, 109, 113]"
Shakespeare,L50,short,17,7,10,5,0.8547,117,"[10, 20, 30, 41, 42, 43, 52, 54, 63, 65, 67, 68, 77, 79, 91, 100, 110]"
Shakespeare,L50,short,13,5,8,16,0.885,113,"[10, 20, 31, 36, 46, 54, 64, 73, 82, 83, 91, 94, 104]"
Shakespeare,L50,short,13,6,7,18,0.885,113,"[10, 19, 20, 22, 33, 45, 54, 64, 75, 84, 92, 95, 104]"
Shakespeare,L50,short,17,13,4,1,0.8547,117,"[10, 19, 21, 31, 41, 49, 51, 60, 62, 73, 82, 91, 92, 101, 102, 111, 112]"
Shakespeare,L50,short,13,8,5,9,0.885,113,"[10, 21, 30, 40, 43, 52, 62, 71, 72, 83, 91, 94, 104]"
Shakespeare,L50,short,17,11,6,31,0.8547,117,"[5, 13, 24, 36, 44, 53, 62, 71, 80, 81, 90, 92, 102, 103, 112, 113, 114]"
Shakespeare,L50,short,16,6,10,5,0.8621,116,"[10, 20, 31, 41, 50, 51, 61, 70, 71, 72, 82, 83, 84, 94, 103, 105]"
Shakespeare,L50,short,18,10,8,5,0.8475,118,"[5, 9, 10, 22, 31, 41, 52, 62, 63, 72, 74, 83, 85, 95, 96, 99, 108, 110]"
Shakespeare,L50,short,19,11,8,9,0.8403,119,"[4, 9, 12, 22, 31, 41, 52, 61, 62, 63, 67, 76, 85, 94, 103, 104, 105, 114, 116]"
Shakespeare,L50,short,13,2,11,17,0.885,113,"[10, 20, 32, 41, 51, 56, 65, 74, 84, 92, 93, 103, 106]"
Shakespeare,L50,short,18,10,8,6,0.8475,118,"[5, 10, 20, 29, 31, 40, 42, 53, 63, 72, 74, 75, 76, 85, 86, 95, 97, 108]"
Shakespeare,L50,short,15,9,6,7,0.8696,115,"[4, 9, 19, 33, 41, 50, 58, 61, 70, 80, 89, 90, 92, 102, 111]"
Shakespeare,L50,short,18,10,8,4,0.8475,118,"[10, 11, 20, 23, 24, 33, 34, 44, 45, 56, 66, 76, 86, 87, 95, 97, 99, 109]"
Shakespeare,L50,short,14,7,7,8,0.8772,114,"[11, 20, 25, 34, 44, 54, 63, 64, 73, 75, 84, 94, 105, 106]"
Shakespeare,L50,short,17,7,10,18,0.8547,117,"[5, 9, 10, 20, 21, 34, 43, 54, 66, 75, 84, 93, 94, 103, 104, 105, 115]"
Shakespeare,L50,short,15,9,6,8,0.8696,115,"[4, 9, 11, 21, 25, 36, 46, 56, 65, 74, 76, 85, 87, 97, 108]"
Shakespeare,L50,short,15,11,4,6,0.8696,115,"[4, 9, 11, 23, 33, 42, 43, 53, 64, 73, 74, 75, 86, 96, 105]"
Shakespeare,L50,short,17,7,10,5,0.8547,117,"[10, 19, 29, 30, 33, 44, 54, 63, 72, 73, 84, 92, 94, 96, 97, 98, 108]"
Shakespeare,L50,short,15,3,12,14,0.8696,115,"[12, 23, 32, 41, 49, 59, 68, 69, 78, 80, 89, 98, 99, 100, 111]"
Shakespeare,L50,short,14,4,10,12,0.8772,114,"[10, 20, 21, 31, 44, 55, 65, 74, 83, 92, 93, 94, 104, 105]"
Shakespeare,L50,short,15,9,6,16,0.8696,115,"[10, 11, 21, 31, 44, 53, 62, 63, 64, 66, 77, 80, 91, 101, 112]"
Shakespeare,L50,short,17,13,4,12,0.8547,117,"[10, 19, 22, 32, 42, 53, 62, 71, 80, 81, 83, 91, 93, 102, 103, 104, 114]"
Shakespeare,L50,short,16,7,9,9,0.8621,116,"[12, 22, 33, 42, 52, 61, 70, 71, 74, 84, 93, 94, 95, 96, 106, 109]"
Shakespeare,L50,short,19,16,3,1,0.8403,119,"[10, 20, 30, 31, 32, 42, 43, 52, 53, 55, 66, 75, 85, 93, 95, 104, 105, 114, 115]"
Shakespeare,L50,short,24,10,14,1,0.8065,124,"[4, 10, 11, 21, 30, 32, 41, 51, 52, 61, 62, 63, 74, 83, 84, 94, 95, 96, 97, 106, 107, 108, 110, 120]"
Shakespeare,L50,short,14,8,6,12,0.8772,114,"[11, 21, 31, 41, 49, 50, 51, 60, 63, 72, 82, 91, 94, 104]"
Shakespeare,L100,short,17,11,6,3,0.8547,117,"[10, 20, 29, 39, 48, 50, 59, 62, 63, 73, 82, 83, 92, 93, 103, 104, 114]"
Shakespeare,L100,short,19,10,9,2,0.8403,119,"[5, 10, 20, 29, 30, 34, 43, 44, 55, 56, 57, 66, 67, 68, 79, 88, 89, 101, 110]"
Shakespeare,L100,short,13,4,9,14,0.885,113,"[7, 13, 23, 33, 43, 52, 54, 66, 75, 83, 93, 102, 104]"
Shakespeare,L100,short,16,6,10,4,0.8621,116,"[10, 19, 28, 29, 39, 48, 50, 59, 68, 70, 79, 88, 90, 100, 109, 110]"
Shakespeare,L100,short,20,13,7,12,0.8333,120,"[4, 9, 11, 21, 30, 32, 41, 42, 44, 54, 63, 64, 67, 78, 87, 96, 105, 106, 115, 118]"
Shakespeare,L100,short,15,5,10,20,0.8696,115,"[4, 14, 24, 34, 43, 52, 61, 70, 71, 79, 80, 82, 92, 101, 111]"
Shakespeare,L100,short,17,6,11,13,0.8547,117,"[4, 9, 11, 21, 30, 39, 41, 52, 62, 72, 80, 89, 90, 92, 101, 104, 113]"
Shakespeare,L100,short,17,6,11,7,0.8547,117,"[10, 19, 28, 29, 42, 50, 59, 61, 62, 63, 73, 83, 84, 93, 95, 97, 107]"
Shakespeare,L100,short,16,8,8,9,0.8621,116,"[10, 19, 20, 21, 23, 32, 42, 45, 56, 66, 75, 85, 93, 97, 106, 108]"
Shakespeare,L100,short,19,7,12,5,0.8403,119,"[4, 9, 19, 21, 30, 40, 43, 52, 61, 62, 73, 82, 91, 92, 101, 102, 103, 104, 116]"
Shakespeare,L100,short,19,3,16,9,0.8403,119,"[10, 19, 21, 22, 23, 32, 35, 45, 54, 55, 65, 66, 69, 79, 88, 96, 98, 108, 109]"
Shakespeare,L100,short,17,6,11,12,0.8547,117,"[10, 11, 20, 23, 34, 44, 53, 63, 72, 82, 84, 92, 93, 103, 112, 113, 114]"
Shakespeare,L100,short,13,10,3,9,0.885,113,"[12, 22, 33, 43, 53, 62, 71, 81, 89, 90, 91, 92, 102]"
Shakespeare,L100,short,19,5,14,4,0.8403,119,"[10, 19, 20, 29, 33, 43, 52, 53, 63, 73, 74, 83, 86, 94, 104, 113, 114, 115, 116]"
Shakespeare,L100,short,14,6,8,13,0.8772,114,"[7, 13, 23, 33, 44, 54, 64, 66, 75, 76, 85, 87, 97, 107]"
Shakespeare,L100,short,18,8,10,7,0.8475,118,"[5, 10, 21, 30, 32, 43, 53, 54, 55, 65, 66, 67, 76, 79, 88, 97, 99, 110]"
Shakespeare,L100,short,18,12,6,4,0.8475,118,"[4, 9, 10, 11, 22, 31, 41, 51, 52, 62, 71, 73, 82, 84, 94, 103, 105, 114]"
Shakespeare,L100,short,16,10,6,12,0.8621,116,"[4, 9, 23, 33, 43, 52, 54, 63, 72, 73, 81, 82, 87, 97, 106, 107]"
Shakespeare,L100,short,16,6,10,17,0.8621,116,"[5, 9, 11, 21, 30, 35, 44, 54, 63, 73, 81, 90, 91, 100, 102, 111]"
Shakespeare,L100,short,18,7,11,7,0.8475,118,"[10, 11, 20, 21, 22, 33, 43, 45, 46, 55, 58, 68, 77, 79, 88, 96, 98, 114]"
Shakespeare,L100,short,19,13,6,13,0.8403,119,"[5, 10, 20, 29, 38, 39, 40, 44, 56, 65, 74, 83, 93, 94, 95, 96, 105, 106, 108]"
Shakespeare,L100,short,15,4,11,13,0.8696,115,"[10, 11, 21, 30, 33, 44, 53, 63, 71, 80, 83, 91, 94, 104, 113]"
Shakespeare,L100,short,14,8,6,11,0.8772,114,"[6, 10, 20, 29, 30, 42, 53, 64, 73, 81, 85, 95, 105, 106]"
Shakespeare,L100,short,13,2,11,10,0.885,113,"[6, 10, 20, 29, 38, 40, 50, 62, 71, 75, 84, 98, 107]"
Shakespeare,L100,short,16,10,6,4,0.8621,116,"[11, 21, 23, 32, 33, 35, 36, 46, 48, 58, 68, 79, 89, 99, 102, 111]"
Shakespeare,L100,short,17,11,6,7,0.8547,117,"[4, 11, 21, 30, 39, 41, 50, 59, 60, 63, 74, 83, 84, 93, 95, 96, 106]"
Shakespeare,L100,short,18,12,6,7,0.8475,118,"[4, 9, 11, 22, 31, 40, 50, 59, 60, 70, 72, 82, 92, 94, 103, 104, 113, 115]"
Shakespeare,L100,short,16,3,13,4,0.8621,116,"[10, 19, 21, 32, 43, 44, 53, 54, 65, 74, 84, 93, 94, 103, 105, 114]"
Shakespeare,L100,short,19,13,6,1,0.8403,119,"[5, 10, 21, 31, 33, 45, 56, 66, 67, 69, 78, 87, 88, 89, 100, 109, 112, 113, 114]"
Shakespeare,L100,short,17,8,9,5,0.8547,117,"[11, 19, 21, 30, 40, 50, 51, 52, 62, 63, 72, 74, 84, 93, 94, 95, 106]"
Shakespeare,L100,short,19,7,12,6,0.8403,119,"[10, 19, 20, 30, 40, 49, 50, 59, 62, 71, 81, 82, 83, 84, 85, 94, 97, 98, 110]"
Shakespeare,L100,short,14,4,10,10,0.8772,114,"[10, 19, 20, 33, 43, 52, 62, 63, 71, 72, 75, 85, 93, 104]"
Shakespeare,L100,short,19,7,12,4,0.8403,119,"[6, 10, 20, 30, 40, 41, 50, 52, 61, 71, 72, 82, 83, 92, 93, 94, 103, 104, 114]"
Shakespeare,L100,short,15,3,12,11,0.8696,115,"[10, 19, 28, 29, 30, 40, 43, 52, 62, 75, 84, 92, 102, 111, 112]"
Shakespeare,L100,short,18,11,7,4,0.8475,118,"[4, 9, 11, 13, 22, 24, 34, 36, 45, 55, 64, 65, 75, 77, 86, 87, 97, 109]"
Shakespeare,L100,short,16,5,11,12,0.8621,116,"[10, 20, 29, 30, 40, 50, 59, 62, 70, 79, 80, 88, 89, 95, 104, 113]"
Shakespeare,L100,short,14,11,3,9,0.8772,114,"[11, 22, 32, 43, 52, 62, 71, 72, 73, 82, 84, 92, 93, 106]"
Shakespeare,L100,short,15,8,7,6,0.8696,115,"[4, 10, 20, 29, 38, 39, 51, 62, 71, 74, 83, 92, 100, 102, 104]"
Shakespeare,L100,short,16,11,5,10,0.8621,116,"[10, 19, 22, 32, 42, 50, 54, 63, 71, 74, 83, 91, 92, 102, 111, 113]"
Shakespeare,L100,short,19,11,8,4,0.8403,119,"[4, 9, 19, 30, 39, 49, 50, 59, 60, 61, 63, 72, 81, 83, 92, 94, 103, 112, 113]"
Shakespeare,L100,short,18,12,6,3,0.8475,118,"[11, 19, 31, 40, 48, 49, 50, 60, 69, 70, 79, 80, 81, 94, 104, 113, 114, 115]"
Shakespeare,L100,short,14,4,10,7,0.8772,114,"[10, 19, 20, 29, 30, 41, 51, 61, 71, 73, 82, 94, 103, 112]"
Shakespeare,L100,short,14,5,9,7,0.8772,114,"[11, 19, 22, 31, 42, 50, 59, 61, 70, 71, 81, 82, 93, 103]"
Shakespeare,L100,short,14,6,8,10,0.8772,114,"[4, 9, 10, 22, 31, 40, 43, 52, 62, 75, 83, 93, 95, 104]"
Shakespeare,L100,short,16,6,10,16,0.8621,116,"[4, 9, 21, 30, 32, 41, 43, 52, 58, 67, 77, 86, 95, 104, 105, 106]"
Shakespeare,L100,short,17,12,5,17,0.8547,117,"[10, 20, 22, 31, 32, 42, 43, 52, 53, 54, 55, 58, 68, 81, 91, 101, 110]"
Shakespeare,L100,short,21,9,12,2,0.8264,121,"[11, 19, 28, 29, 39, 48, 49, 50, 60, 69, 71, 72, 81, 82, 83, 91, 93, 103, 112, 114, 115]"
Shakespeare,L100,short,16,10,6,12,0.8621,116,"[11, 19, 23, 32, 36, 47, 55, 64, 75, 77, 86, 95, 96, 98, 100, 109]"
Shakespeare,L100,short,15,6,9,11,0.8696,115,"[4, 10, 21, 30, 42, 52, 61, 70, 71, 73, 81, 83, 92, 93, 105]"
Shakespeare,L100,short,19,7,12,5,0.8403,119,"[11, 22, 31, 33, 43, 44, 45, 47, 56, 66, 68, 77, 78, 87, 88, 96, 98, 99, 110]"
Shakespeare,L100,short,14,10,4,32,0.8772,114,"[7, 13, 23, 36, 45, 54, 64, 73, 81, 90, 91, 99, 101, 111]"
Shakespeare,L100,short,19,6,13,5,0.8403,119,"[4, 10, 20, 22, 31, 40, 41, 42, 52, 61, 62, 72, 82, 83, 92, 93, 102, 104, 116]"
Shakespeare,L100,short,17,8,9,5,0.8547,117,"[4, 9, 21, 30, 41, 51, 59, 62, 71, 73, 74, 83, 84, 87, 96, 105, 106]"
Shakespeare,L100,short,13,5,8,11,0.885,113,"[11, 19, 29, 39, 50, 51, 54, 63, 71, 75, 86, 96, 107]"
Shakespeare,L100,short,17,4,13,7,0.8547,117,"[10, 11, 21, 30, 31, 41, 50, 52, 62, 71, 81, 90, 91, 92, 95, 105, 114]"
Shakespeare,L100,short,15,9,6,14,0.8696,115,"[10, 19, 20, 21, 30, 32, 42, 44, 53, 54, 70, 80, 89, 97, 106]"
Shakespeare,L100,short,14,11,3,16,0.8772,114,"[5, 11, 22, 32, 41, 50, 54, 64, 73, 81, 83, 93, 101, 104]"
Shakespeare,L100,short,12,5,7,11,0.8929,112,"[10, 19, 28, 29, 39, 50, 59, 70, 72, 81, 94, 105]"
Shakespeare,L100,short,18,10,8,3,0.8475,118,"[4, 9, 10, 20, 22, 31, 33, 34, 45, 55, 56, 69, 79, 89, 99, 108, 109, 110]"
Shakespeare,L100,short,17,12,5,5,0.8547,117,"[4, 9, 10, 22, 31, 41, 42, 43, 53, 62, 63, 64, 74, 84, 94, 104, 106]"
Shakespeare,L100,short,10,9,1,21,0.9091,110,"[10, 22, 31, 44, 52, 62, 75, 84, 92, 101]"
Shakespeare,L100,short,19,11,8,9,0.8403,119,"[10, 14, 25, 34, 35, 36, 46, 55, 56, 57, 58, 68, 77, 79, 88, 96, 99, 110, 111]"
Shakespeare,L100,short,17,9,8,5,0.8547,117,"[4, 9, 19, 21, 30, 32, 43, 52, 54, 55, 57, 68, 77, 86, 88, 97, 108]"
Shakespeare,L100,short,20,8,12,8,0.8333,120,"[4, 9, 20, 30, 31, 40, 43, 52, 54, 63, 64, 74, 75, 76, 77, 79, 88, 90, 101, 111]"
Shakespeare,L100,short,15,11,4,7,0.8696,115,"[11, 22, 33, 43, 52, 61, 63, 72, 73, 82, 83, 91, 93, 104, 113]"
Shakespeare,L100,short,16,9,7,3,0.8621,116,"[12, 22, 24, 33, 43, 52, 53, 63, 72, 73, 82, 83, 92, 93, 104, 113]"
Shakespeare,L100,short,12,10,2,23,0.8929,112,"[13, 25, 34, 43, 52, 61, 71, 72, 81, 86, 96, 106]"
Shakespeare,L100,short,22,9,13,5,0.8197,122,"[10, 19, 28, 30, 40, 41, 43, 44, 53, 54, 55, 65, 66, 75, 76, 77, 87, 88, 98, 100, 102, 112]"
Shakespeare,L100,short,19,11,8,6,0.8403,119,"[10, 21, 30, 31, 41, 49, 51, 52, 53, 63, 64, 65, 74, 75, 78, 81, 91, 101, 111]"
Shakespeare,L100,short,20,8,12,9,0.8333,120,"[10, 19, 28, 29, 39, 40, 49, 50, 52, 53, 63, 64, 65, 67, 68, 77, 79, 89, 99, 111]"
Shakespeare,L100,short,21,11,10,7,0.8264,121,"[4, 11, 12, 14, 23, 33, 42, 43, 44, 45, 55, 64, 65, 75, 76, 78, 87, 88, 90, 100, 111]"
Shakespeare,L100,short,13,6,7,38,0.885,113,"[4, 11, 12, 15, 25, 38, 48, 54, 64, 75, 85, 94, 104]"
Shakespeare,L100,short,15,8,7,7,0.8696,115,"[10, 19, 28, 30, 40, 49, 50, 51, 52, 53, 64, 73, 84, 93, 104]"
Shakespeare,L100,short,13,8,5,9,0.885,113,"[10, 20, 31, 40, 43, 54, 63, 72, 73, 85, 95, 105, 107]"
Shakespeare,L100,short,15,8,7,15,0.8696,115,"[12, 23, 33, 44, 52, 61, 69, 70, 72, 81, 83, 92, 102, 111, 112]"
Shakespeare,L100,short,14,3,11,15,0.8772,114,"[10, 20, 21, 30, 31, 32, 42, 56, 66, 75, 84, 93, 102, 105]"
Shakespeare,L100,short,20,7,13,7,0.8333,120,"[6, 10, 20, 22, 31, 35, 44, 54, 63, 65, 74, 75, 77, 86, 95, 97, 107, 108, 109, 110]"
Shakespeare,L100,short,17,8,9,16,0.8547,117,"[5, 12, 21, 30, 39, 40, 41, 42, 52, 53, 62, 65, 77, 86, 95, 104, 114]"
Shakespeare,L100,short,13,5,8,15,0.885,113,"[10, 24, 33, 45, 53, 62, 73, 82, 91, 92, 95, 104, 105]"
Shakespeare,L100,short,12,4,8,22,0.8929,112,"[5, 9, 10, 22, 31, 43, 56, 65, 75, 84, 93, 103]"
Shakespeare,L100,short,18,7,11,4,0.8475,118,"[4, 9, 19, 29, 38, 40, 50, 59, 62, 72, 73, 82, 83, 84, 86, 96, 106, 107]"
Shakespeare,L100,short,18,9,9,5,0.8475,118,"[10, 11, 21, 33, 43, 52, 54, 63, 65, 74, 83, 84, 85, 93, 95, 105, 114, 115]"
Shakespeare,L100,short,17,9,8,2,0.8547,117,"[4, 9, 19, 29, 30, 31, 32, 33, 43, 53, 62, 63, 76, 88, 97, 107, 108]"
Shakespeare,L100,short,17,13,4,4,0.8547,117,"[5, 9, 19, 29, 39, 41, 42, 43, 53, 62, 63, 64, 76, 85, 86, 97, 107]"
Shakespeare,L100,short,21,9,12,5,0.8264,121,"[11, 20, 21, 22, 23, 24, 25, 26, 36, 39, 50, 51, 60, 61, 72, 81, 82, 93, 102, 112, 113]"
Shakespeare,L100,short,17,11,6,11,0.8547,117,"[12, 22, 31, 41, 49, 50, 51, 60, 63, 73, 82, 91, 93, 103, 104, 113, 114]"
Shakespeare,L100,short,16,11,5,7,0.8621,116,"[4, 9, 10, 11, 22, 31, 35, 46, 48, 58, 69, 79, 88, 97, 99, 110]"
Shakespeare,L100,short,17,4,13,1,0.8547,117,"[5, 9, 19, 29, 39, 49, 60, 69, 78, 79, 89, 90, 99, 100, 101, 110, 111]"
Shakespeare,L100,short,17,10,7,3,0.8547,117,"[5, 9, 10, 20, 30, 31, 41, 52, 61, 62, 64, 75, 84, 94, 104, 105, 115]"
Shakespeare,L100,short,14,4,10,14,0.8772,114,"[10, 21, 30, 33, 43, 52, 54, 64, 66, 75, 76, 89, 98, 107]"
Shakespeare,L100,short,19,6,13,2,0.8403,119,"[10, 11, 20, 21, 30, 32, 42, 43, 52, 54, 64, 73, 74, 85, 94, 105, 114, 116, 117]"
Shakespeare,L100,short,22,11,11,2,0.8197,122,"[10, 19, 20, 21, 30, 33, 43, 44, 45, 46, 55, 56, 66, 75, 76, 86, 87, 97, 107, 108, 117, 119]"
Shakespeare,L100,short,17,10,7,5,0.8547,117,"[10, 11, 21, 30, 31, 42, 51, 52, 53, 63, 75, 84, 92, 94, 95, 105, 109]"
Shakespeare,L100,short,22,12,10,4,0.8197,122,"[10, 19, 20, 29, 31, 41, 43, 52, 54, 64, 65, 67, 69, 80, 90, 91, 100, 101, 102, 104, 114, 117]"
Shakespeare,L100,short,21,12,9,7,0.8264,121,"[10, 19, 28, 29, 30, 31, 41, 44, 55, 65, 74, 83, 84, 93, 94, 95, 96, 106, 107, 109, 113]"
Shakespeare,L100,short,17,11,6,3,0.8547,117,"[6, 10, 20, 29, 31, 42, 51, 62, 72, 80, 82, 91, 92, 94, 103, 112, 113]"
Shakespeare,L100,short,19,11,8,7,0.8403,119,"[11, 20, 30, 41, 49, 58, 61, 70, 72, 81, 90, 91, 92, 102, 103, 104, 114, 115, 116]"
Shakespeare,L100,short,21,12,9,2,0.8264,121,"[4, 9, 19, 30, 39, 40, 41, 51, 60, 61, 63, 73, 74, 76, 85, 94, 96, 97, 106, 108, 117]"
Shakespeare,L100,short,20,8,12,5,0.8333,120,"[10, 20, 31, 40, 48, 49, 50, 53, 64, 65, 76, 85, 93, 95, 96, 105, 106, 115, 116, 118]"
Shakespeare,L100,short,19,7,12,5,0.8403,119,"[10, 11, 21, 22, 31, 33, 43, 52, 53, 63, 64, 66, 75, 76, 86, 95, 97, 107, 117]"
Shakespeare,L0,middle,9,3,6,1,0.9174,109,"[11, 19, 20, 41, 60, 78, 80, 98, 100]"
Shakespeare,L0,middle,10,6,4,2,0.9091,110,"[12, 20, 38, 40, 41, 61, 79, 81, 99, 103]"
Shakespeare,L0,middle,9,4,5,2,0.9174,109,"[19, 36, 40, 60, 78, 80, 98, 99, 100]"
Shakespeare,L0,middle,9,6,3,2,0.9174,109,"[20, 38, 40, 59, 60, 79, 80, 99, 101]"
Shakespeare,L0,middle,14,5,9,0,0.8772,114,"[19, 20, 37, 41, 42, 43, 62, 65, 66, 85, 87, 104, 106, 109]"
Shakespeare,L0,middle,10,7,3,6,0.9091,110,"[21, 39, 43, 63, 64, 82, 84, 100, 103, 105]"
Shakespeare,L0,middle,11,6,5,3,0.9009,111,"[11, 19, 21, 39, 41, 62, 81, 82, 100, 101, 103]"
Shakespeare,L0,middle,7,2,5,14,0.9346,107,"[11, 19, 38, 44, 63, 83, 101]"
Shakespeare,L0,middle,9,4,5,12,0.9174,109,"[11, 23, 42, 60, 78, 80, 98, 99, 103]"
Shakespeare,L0,middle,8,6,2,8,0.9259,108,"[13, 23, 42, 60, 79, 81, 99, 100]"
Shakespeare,L0,middle,8,5,3,5,0.9259,108,"[19, 21, 39, 44, 64, 83, 99, 102]"
Shakespeare,L0,middle,11,7,4,2,0.9009,111,"[19, 37, 40, 41, 42, 61, 62, 80, 84, 102, 103]"
Shakespeare,L0,middle,9,5,4,1,0.9174,109,"[20, 39, 40, 59, 61, 79, 81, 99, 101]"
Shakespeare,L0,middle,13,6,7,3,0.885,113,"[21, 39, 41, 42, 61, 63, 81, 84, 87, 89, 90, 108, 110]"
Shakespeare,L0,middle,7,4,3,1,0.9346,107,"[19, 37, 41, 59, 61, 83, 102]"
Shakespeare,L0,middle,7,2,5,11,0.9346,107,"[20, 43, 63, 81, 99, 100, 101]"
Shakespeare,L0,middle,9,6,3,2,0.9174,109,"[21, 39, 59, 78, 79, 97, 98, 99, 100]"
Shakespeare,L0,middle,10,5,5,2,0.9091,110,"[19, 20, 37, 41, 60, 61, 79, 82, 100, 102]"
Shakespeare,L0,middle,7,3,4,7,0.9346,107,"[22, 42, 61, 79, 82, 100, 102]"
Shakespeare,L0,middle,7,4,3,8,0.9346,107,"[13, 23, 42, 60, 79, 98, 100]"
Shakespeare,L0,middle,9,6,3,4,0.9174,109,"[12, 20, 38, 40, 59, 77, 79, 98, 101]"
Shakespeare,L0,middle,13,9,4,1,0.885,113,"[11, 19, 38, 39, 40, 41, 59, 62, 81, 83, 102, 103, 104]"
Shakespeare,L0,middle,11,4,7,4,0.9009,111,"[11, 19, 38, 41, 61, 79, 81, 82, 100, 101, 104]"
Shakespeare,L0,middle,8,3,5,5,0.9259,108,"[11, 19, 40, 59, 63, 82, 100, 103]"
Shakespeare,L0,middle,10,5,5,2,0.9091,110,"[11, 20, 39, 59, 77, 79, 80, 98, 100, 102]"
Shakespeare,L0,middle,8,2,6,1,0.9259,108,"[19, 36, 40, 60, 78, 80, 98, 101]"
Shakespeare,L0,middle,10,5,5,0,0.9091,110,"[11, 19, 20, 39, 40, 58, 61, 81, 100, 101]"
Shakespeare,L0,middle,9,3,6,3,0.9174,109,"[19, 36, 40, 59, 78, 80, 99, 100, 102]"
Shakespeare,L0,middle,7,3,4,10,0.9346,107,"[13, 24, 43, 63, 82, 100, 101]"
Shakespeare,L0,middle,9,6,3,5,0.9174,109,"[19, 38, 42, 60, 78, 80, 98, 99, 101]"
Shakespeare,L0,middle,11,8,3,4,0.9009,111,"[11, 19, 38, 39, 57, 61, 81, 99, 100, 101, 102]"
Shakespeare,L0,middle,7,3,4,7,0.9346,107,"[19, 37, 40, 62, 81, 98, 100]"
Shakespeare,L0,middle,9,3,6,1,0.9174,109,"[11, 19, 39, 58, 60, 79, 80, 98, 100]"
Shakespeare,L0,middle,12,5,7,4,0.8929,112,"[19, 20, 23, 27, 45, 64, 82, 84, 86, 104, 105, 106]"
Shakespeare,L0,middle,11,6,5,3,0.9009,111,"[11, 19, 38, 43, 62, 65, 84, 102, 104, 105, 106]"
Shakespeare,L0,middle,9,6,3,2,0.9174,109,"[19, 36, 40, 59, 60, 62, 82, 99, 101]"
Shakespeare,L0,middle,11,6,5,3,0.9009,111,"[20, 39, 40, 59, 61, 79, 83, 102, 104, 105, 108]"
Shakespeare,L0,middle,11,4,7,5,0.9009,111,"[19, 20, 37, 41, 61, 80, 81, 82, 84, 101, 107]"
Shakespeare,L0,middle,11,6,5,1,0.9009,111,"[11, 19, 20, 39, 40, 58, 62, 81, 99, 101, 102]"
Shakespeare,L0,middle,9,6,3,3,0.9174,109,"[12, 20, 38, 40, 60, 78, 81, 99, 102]"
Shakespeare,L0,middle,10,7,3,2,0.9091,110,"[21, 40, 58, 60, 61, 62, 81, 82, 101, 102]"
Shakespeare,L0,middle,9,5,4,1,0.9174,109,"[11, 19, 38, 39, 58, 60, 78, 80, 100]"
Shakespeare,L0,middle,12,5,7,0,0.8929,112,"[11, 19, 39, 58, 60, 62, 81, 83, 85, 103, 104, 105]"
Shakespeare,L0,middle,11,7,4,2,0.9009,111,"[11, 19, 38, 39, 57, 60, 78, 80, 81, 83, 102]"
Shakespeare,L0,middle,9,4,5,7,0.9174,109,"[19, 25, 44, 64, 82, 84, 102, 103, 107]"
Shakespeare,L0,middle,8,5,3,6,0.9259,108,"[11, 21, 38, 41, 60, 78, 80, 99]"
Shakespeare,L0,middle,10,3,7,3,0.9091,110,"[19, 36, 40, 41, 61, 63, 81, 83, 100, 103]"
Shakespeare,L0,middle,10,6,4,2,0.9091,110,"[11, 20, 38, 40, 61, 79, 81, 83, 101, 102]"
Shakespeare,L0,middle,11,6,5,3,0.9009,111,"[21, 39, 41, 59, 61, 79, 81, 83, 100, 102, 104]"
Shakespeare,L0,middle,9,6,3,2,0.9174,109,"[19, 37, 40, 59, 77, 80, 98, 99, 100]"
Shakespeare,L0,middle,11,6,5,1,0.9009,111,"[20, 39, 40, 42, 60, 62, 63, 82, 84, 101, 104]"
Shakespeare,L0,middle,12,8,4,1,0.8929,112,"[11, 20, 38, 40, 41, 42, 62, 81, 82, 102, 103, 104]"
Shakespeare,L0,middle,11,5,6,3,0.9009,111,"[19, 36, 41, 60, 78, 80, 98, 99, 101, 102, 105]"
Shakespeare,L0,middle,11,4,7,1,0.9009,111,"[19, 36, 40, 41, 60, 61, 79, 81, 99, 100, 102]"
Shakespeare,L0,middle,10,4,6,3,0.9091,110,"[11, 19, 39, 58, 60, 62, 80, 82, 101, 103]"
Shakespeare,L0,middle,8,3,5,3,0.9259,108,"[19, 36, 40, 60, 78, 80, 98, 99]"
Shakespeare,L0,middle,9,6,3,4,0.9174,109,"[20, 38, 40, 59, 78, 79, 82, 99, 101]"
Shakespeare,L0,middle,9,5,4,1,0.9174,109,"[11, 19, 38, 39, 60, 79, 81, 99, 100]"
Shakespeare,L0,middle,10,4,6,4,0.9091,110,"[19, 20, 37, 41, 60, 62, 63, 85, 101, 104]"
Shakespeare,L0,middle,10,6,4,1,0.9091,110,"[19, 37, 40, 59, 61, 80, 81, 83, 100, 105]"
Shakespeare,L0,middle,15,5,10,5,0.8696,115,"[12, 21, 38, 41, 60, 63, 81, 83, 103, 104, 105, 106, 107, 108, 109]"
Shakespeare,L0,middle,9,5,4,4,0.9174,109,"[20, 39, 41, 59, 61, 79, 81, 99, 100]"
Shakespeare,L0,middle,11,4,7,2,0.9009,111,"[11, 19, 20, 39, 40, 59, 61, 79, 82, 100, 102]"
Shakespeare,L0,middle,10,5,5,3,0.9091,110,"[20, 39, 42, 60, 79, 80, 81, 99, 101, 103]"
Shakespeare,L0,middle,8,6,2,4,0.9259,108,"[20, 39, 42, 60, 78, 81, 98, 100]"
Shakespeare,L0,middle,9,3,6,2,0.9174,109,"[11, 19, 20, 40, 59, 62, 80, 98, 100]"
Shakespeare,L0,middle,11,3,8,2,0.9009,111,"[12, 20, 39, 58, 61, 79, 81, 102, 103, 104, 105]"
Shakespeare,L0,middle,9,6,3,3,0.9174,109,"[19, 37, 40, 59, 77, 81, 99, 100, 102]"
Shakespeare,L0,middle,11,8,3,1,0.9009,111,"[19, 21, 39, 41, 60, 61, 62, 80, 83, 102, 103]"
Shakespeare,L0,middle,11,6,5,1,0.9009,111,"[11, 19, 20, 39, 40, 58, 61, 80, 81, 99, 102]"
Shakespeare,L0,middle,10,6,4,2,0.9091,110,"[12, 20, 38, 40, 60, 78, 80, 81, 99, 102]"
Shakespeare,L0,middle,11,7,4,5,0.9009,111,"[19, 22, 40, 43, 62, 81, 82, 83, 101, 102, 105]"
Shakespeare,L0,middle,11,5,6,2,0.9009,111,"[19, 37, 40, 59, 60, 78, 80, 82, 100, 103, 104]"
Shakespeare,L0,middle,10,7,3,8,0.9091,110,"[21, 22, 23, 42, 44, 62, 67, 85, 101, 104]"
Shakespeare,L0,middle,6,3,3,16,0.9434,106,"[13, 24, 44, 63, 83, 101]"
Shakespeare,L0,middle,10,2,8,5,0.9091,110,"[20, 38, 40, 61, 62, 63, 81, 85, 87, 91]"
Shakespeare,L0,middle,12,5,7,4,0.8929,112,"[11, 19, 21, 39, 43, 61, 64, 82, 85, 104, 107, 108]"
Shakespeare,L0,middle,7,3,4,6,0.9346,107,"[20, 39, 58, 61, 82, 98, 101]"
Shakespeare,L0,middle,8,4,4,3,0.9259,108,"[20, 38, 41, 63, 81, 83, 101, 102]"
Shakespeare,L0,middle,10,5,5,0,0.9091,110,"[19, 36, 40, 59, 60, 79, 80, 99, 100, 101]"
Shakespeare,L0,middle,14,9,5,1,0.8772,114,"[22, 23, 41, 44, 63, 65, 83, 86, 104, 105, 106, 107, 108, 109]"
Shakespeare,L0,middle,13,9,4,4,0.885,113,"[19, 21, 22, 24, 42, 44, 62, 64, 83, 85, 102, 104, 105]"
Shakespeare,L0,middle,10,8,2,8,0.9091,110,"[19, 21, 39, 41, 64, 82, 98, 100, 101, 102]"
Shakespeare,L0,middle,9,7,2,2,0.9174,109,"[12, 20, 38, 40, 59, 77, 79, 80, 100]"
Shakespeare,L0,middle,12,9,3,4,0.8929,112,"[12, 20, 38, 40, 59, 62, 81, 99, 100, 101, 102, 103]"
Shakespeare,L0,middle,8,6,2,5,0.9259,108,"[19, 37, 43, 62, 80, 98, 99, 100]"
Shakespeare,L0,middle,9,2,7,5,0.9174,109,"[19, 39, 40, 64, 82, 98, 101, 102, 103]"
Shakespeare,L0,middle,11,6,5,1,0.9009,111,"[19, 36, 40, 61, 79, 81, 98, 100, 101, 102, 103]"
Shakespeare,L0,middle,14,3,11,0,0.8772,114,"[19, 20, 37, 41, 60, 61, 79, 81, 82, 83, 101, 102, 103, 104]"
Shakespeare,L0,middle,12,5,7,4,0.8929,112,"[11, 19, 21, 39, 42, 61, 63, 64, 83, 84, 103, 106]"
Shakespeare,L0,middle,11,7,4,3,0.9009,111,"[19, 21, 39, 41, 60, 61, 79, 81, 84, 101, 104]"
Shakespeare,L0,middle,15,7,8,2,0.8696,115,"[11, 19, 21, 41, 60, 62, 80, 82, 83, 84, 102, 103, 104, 105, 106]"
Shakespeare,L0,middle,9,3,6,3,0.9174,109,"[11, 20, 39, 59, 78, 79, 97, 99, 102]"
Shakespeare,L0,middle,12,6,6,1,0.8929,112,"[11, 21, 40, 41, 42, 43, 62, 64, 83, 101, 102, 103]"
Shakespeare,L0,middle,8,5,3,5,0.9259,108,"[12, 20, 40, 59, 61, 80, 99, 103]"
Shakespeare,L0,middle,10,5,5,7,0.9091,110,"[20, 39, 58, 59, 78, 79, 81, 85, 101, 105]"
Shakespeare,L0,middle,14,7,7,11,0.8772,114,"[13, 25, 42, 60, 64, 82, 100, 101, 102, 104, 105, 106, 107, 109]"
Shakespeare,L0,middle,8,6,2,3,0.9259,108,"[21, 41, 60, 79, 81, 97, 101, 104]"
Shakespeare,L0,middle,7,3,4,4,0.9346,107,"[19, 39, 58, 61, 80, 97, 100]"
Shakespeare,L0,middle,8,5,3,3,0.9259,108,"[12, 20, 38, 40, 59, 78, 80, 99]"
Shakespeare,L50,middle,7,5,2,5,0.9346,107,"[20, 40, 43, 63, 83, 101, 102]"
Shakespeare,L50,middle,8,5,3,1,0.9259,108,"[19, 37, 40, 61, 80, 97, 99, 100]"
Shakespeare,L50,middle,9,4,5,4,0.9174,109,"[11, 20, 38, 45, 64, 84, 86, 88, 107]"
Shakespeare,L50,middle,8,3,5,2,0.9259,108,"[11, 19, 39, 58, 60, 79, 81, 100]"
Shakespeare,L50,middle,12,5,7,1,0.8929,112,"[11, 19, 20, 39, 40, 59, 61, 80, 82, 83, 102, 104]"
Shakespeare,L50,middle,10,7,3,8,0.9091,110,"[13, 23, 42, 61, 79, 81, 82, 100, 101, 105]"
Shakespeare,L50,middle,10,7,3,6,0.9091,110,"[11, 21, 39, 40, 42, 61, 79, 83, 101, 104]"
Shakespeare,L50,middle,8,5,3,5,0.9259,108,"[20, 41, 59, 62, 80, 82, 100, 101]"
Shakespeare,L50,middle,9,6,3,2,0.9174,109,"[12, 20, 39, 40, 60, 61, 79, 81, 102]"
Shakespeare,L50,middle,11,6,5,3,0.9009,111,"[11, 19, 21, 39, 41, 42, 43, 63, 66, 86, 105]"
Shakespeare,L50,middle,9,5,4,5,0.9174,109,"[21, 39, 57, 60, 61, 80, 82, 99, 103]"
Shakespeare,L50,middle,9,5,4,1,0.9174,109,"[20, 39, 40, 59, 60, 61, 80, 82, 101]"
Shakespeare,L50,middle,6,4,2,17,0.9434,106,"[19, 38, 46, 64, 83, 101]"
Shakespeare,L50,middle,8,4,4,3,0.9259,108,"[11, 19, 41, 60, 78, 81, 99, 100]"
Shakespeare,L50,middle,7,2,5,3,0.9346,107,"[19, 36, 40, 59, 78, 82, 100]"
Shakespeare,L50,middle,11,6,5,3,0.9009,111,"[22, 39, 43, 62, 80, 82, 83, 85, 103, 105, 106]"
Shakespeare,L50,middle,8,4,4,2,0.9259,108,"[20, 39, 59, 79, 82, 100, 101, 103]"
Shakespeare,L50,middle,14,9,5,3,0.8772,114,"[20, 21, 23, 41, 43, 61, 64, 84, 85, 86, 87, 104, 106, 107]"
Shakespeare,L50,middle,8,4,4,1,0.9259,108,"[11, 19, 39, 62, 81, 82, 99, 102]"
Shakespeare,L50,middle,9,5,4,4,0.9174,109,"[19, 36, 41, 59, 62, 81, 99, 100, 101]"
Shakespeare,L50,middle,10,6,4,1,0.9091,110,"[20, 39, 40, 59, 60, 80, 81, 99, 100, 101]"
Shakespeare,L50,middle,9,4,5,3,0.9174,109,"[11, 20, 38, 41, 62, 80, 98, 99, 100]"
Shakespeare,L50,middle,9,0,9,8,0.9174,109,"[19, 20, 21, 22, 26, 44, 65, 85, 103]"
Shakespeare,L50,middle,9,3,6,5,0.9174,109,"[11, 19, 38, 39, 58, 60, 62, 85, 103]"
Shakespeare,L50,middle,8,6,2,4,0.9259,108,"[12, 21, 39, 58, 61, 79, 98, 99]"
Shakespeare,L50,middle,9,4,5,1,0.9174,109,"[19, 36, 40, 41, 62, 81, 98, 100, 101]"
Shakespeare,L50,middle,8,4,4,9,0.9259,108,"[12, 20, 38, 42, 63, 81, 99, 101]"
Shakespeare,L50,middle,9,3,6,2,0.9174,109,"[19, 36, 40, 42, 60, 62, 81, 83, 103]"
Shakespeare,L50,middle,9,4,5,3,0.9174,109,"[19, 20, 38, 41, 60, 79, 81, 99, 101]"
Shakespeare,L50,middle,9,6,3,4,0.9174,109,"[12, 20, 38, 40, 59, 61, 79, 82, 101]"
Shakespeare,L50,middle,11,6,5,1,0.9009,111,"[11, 19, 38, 39, 40, 59, 61, 79, 82, 101, 103]"
Shakespeare,L50,middle,11,8,3,2,0.9009,111,"[20, 39, 40, 59, 60, 62, 81, 83, 100, 102, 103]"
Shakespeare,L50,middle,9,5,4,10,0.9174,109,"[13, 24, 42, 61, 79, 81, 99, 100, 102]"
Shakespeare,L50,middle,9,5,4,2,0.9174,109,"[20, 39, 57, 59, 78, 80, 98, 100, 101]"
Shakespeare,L50,middle,10,7,3,3,0.9091,110,"[20, 22, 40, 42, 60, 62, 81, 99, 100, 101]"
Shakespeare,L50,middle,12,7,5,4,0.8929,112,"[11, 19, 21, 39, 41, 42, 61, 63, 81, 83, 102, 104]"
Shakespeare,L50,middle,11,5,6,1,0.9009,111,"[11, 19, 22, 23, 42, 44, 63, 82, 83, 101, 103]"
Shakespeare,L50,middle,11,4,7,3,0.9009,111,"[11, 19, 20, 21, 40, 41, 60, 62, 80, 83, 102]"
Shakespeare,L50,middle,11,7,4,2,0.9009,111,"[20, 21, 22, 41, 43, 61, 64, 83, 85, 102, 105]"
Shakespeare,L50,middle,9,4,5,1,0.9174,109,"[11, 19, 21, 39, 41, 61, 81, 100, 102]"
Shakespeare,L50,middle,8,4,4,6,0.9259,108,"[19, 36, 41, 62, 80, 82, 99, 104]"
Shakespeare,L50,middle,8,5,3,4,0.9259,108,"[11, 21, 39, 58, 60, 78, 80, 99]"
Shakespeare,L50,middle,9,6,3,5,0.9174,109,"[20, 41, 59, 62, 80, 82, 100, 101, 104]"
Shakespeare,L50,middle,11,8,3,2,0.9009,111,"[19, 22, 40, 59, 61, 81, 82, 99, 101, 102, 104]"
Shakespeare,L50,middle,10,4,6,7,0.9091,110,"[11, 19, 38, 39, 59, 60, 62, 81, 86, 105]"
Shakespeare,L50,middle,10,4,6,10,0.9091,110,"[19, 21, 40, 41, 60, 62, 63, 82, 87, 108]"
Shakespeare,L50,middle,8,5,3,0,0.9259,108,"[11, 19, 38, 39, 59, 77, 79, 99]"
Shakespeare,L50,middle,9,4,5,3,0.9174,109,"[11, 20, 39, 58, 62, 80, 82, 100, 101]"
Shakespeare,L50,middle,8,4,4,2,0.9259,108,"[19, 36, 40, 59, 78, 81, 98, 100]"
Shakespeare,L50,middle,10,7,3,7,0.9091,110,"[13, 23, 42, 43, 64, 68, 86, 103, 105, 107]"
Shakespeare,L50,middle,12,5,7,4,0.8929,112,"[21, 39, 42, 61, 63, 64, 65, 84, 85, 102, 104, 105]"
Shakespeare,L50,middle,12,6,6,2,0.8929,112,"[11, 19, 21, 40, 42, 61, 64, 82, 100, 102, 103, 104]"
Shakespeare,L50,middle,14,10,4,3,0.8772,114,"[20, 39, 40, 43, 61, 80, 82, 83, 100, 102, 103, 104, 105, 107]"
Shakespeare,L50,middle,8,4,4,2,0.9259,108,"[19, 36, 40, 59, 61, 82, 99, 102]"
Shakespeare,L50,middle,6,3,3,3,0.9434,106,"[20, 40, 59, 80, 98, 99]"
Shakespeare,L50,middle,7,2,5,11,0.9346,107,"[19, 20, 22, 41, 66, 87, 103]"
Shakespeare,L50,middle,10,5,5,7,0.9091,110,"[11, 21, 22, 24, 46, 65, 83, 85, 103, 104]"
Shakespeare,L50,middle,10,6,4,0,0.9091,110,"[20, 39, 41, 60, 61, 81, 98, 100, 102, 103]"
Shakespeare,L50,middle,10,4,6,3,0.9091,110,"[11, 19, 20, 22, 41, 60, 63, 81, 100, 101]"
Shakespeare,L50,middle,10,3,7,4,0.9091,110,"[19, 20, 21, 38, 42, 64, 82, 100, 101, 103]"
Shakespeare,L50,middle,12,7,5,1,0.8929,112,"[19, 21, 40, 41, 42, 62, 63, 64, 83, 85, 102, 104]"
Shakespeare,L50,middle,10,4,6,3,0.9091,110,"[12, 20, 39, 42, 61, 79, 81, 84, 102, 103]"
Shakespeare,L50,middle,12,3,9,2,0.8929,112,"[11, 20, 39, 40, 41, 63, 65, 85, 103, 104, 105, 106]"
Shakespeare,L50,middle,10,3,7,3,0.9091,110,"[11, 19, 21, 24, 43, 45, 64, 82, 84, 104]"
Shakespeare,L50,middle,8,5,3,5,0.9259,108,"[19, 37, 41, 59, 61, 82, 99, 101]"
Shakespeare,L50,middle,8,1,7,4,0.9259,108,"[19, 36, 40, 60, 63, 83, 101, 102]"
Shakespeare,L50,middle,9,2,7,1,0.9174,109,"[19, 20, 37, 41, 43, 61, 64, 85, 104]"
Shakespeare,L50,middle,11,8,3,4,0.9009,111,"[12, 20, 39, 41, 60, 64, 82, 100, 101, 102, 103]"
Shakespeare,L50,middle,12,7,5,0,0.8929,112,"[20, 39, 40, 41, 62, 63, 82, 83, 84, 101, 103, 104]"
Shakespeare,L50,middle,11,7,4,1,0.9009,111,"[11, 19, 39, 58, 62, 81, 82, 100, 101, 102, 103]"
Shakespeare,L50,middle,10,4,6,3,0.9091,110,"[11, 19, 38, 39, 58, 60, 61, 80, 83, 102]"
Shakespeare,L50,middle,7,2,5,7,0.9346,107,"[11, 22, 41, 60, 62, 83, 101]"
Shakespeare,L50,middle,9,6,3,6,0.9174,109,"[12, 20, 38, 41, 60, 78, 80, 99, 101]"
Shakespeare,L50,middle,12,6,6,1,0.8929,112,"[19, 20, 21, 39, 42, 61, 62, 81, 83, 101, 102, 103]"
Shakespeare,L50,middle,10,8,2,2,0.9091,110,"[12, 21, 39, 58, 60, 61, 79, 81, 100, 101]"
Shakespeare,L50,middle,9,5,4,6,0.9174,109,"[20, 40, 43, 61, 63, 81, 84, 103, 104]"
Shakespeare,L50,middle,8,3,5,4,0.9259,108,"[19, 20, 37, 41, 61, 81, 99, 101]"
Shakespeare,L50,middle,8,7,1,2,0.9259,108,"[11, 21, 39, 59, 80, 97, 99, 100]"
Shakespeare,L50,middle,8,4,4,2,0.9259,108,"[11, 19, 40, 59, 77, 79, 98, 100]"
Shakespeare,L50,middle,12,6,6,2,0.8929,112,"[19, 23, 42, 44, 63, 66, 85, 86, 88, 89, 107, 109]"
Shakespeare,L50,middle,8,5,3,3,0.9259,108,"[12, 20, 38, 40, 60, 79, 80, 100]"
Shakespeare,L50,middle,8,3,5,8,0.9259,108,"[13, 24, 42, 61, 79, 81, 100, 101]"
Shakespeare,L50,middle,9,3,6,5,0.9174,109,"[11, 19, 20, 40, 59, 62, 81, 99, 102]"
Shakespeare,L50,middle,8,4,4,6,0.9259,108,"[11, 19, 38, 41, 60, 78, 81, 100]"
Shakespeare,L50,middle,14,8,6,1,0.8772,114,"[19, 20, 22, 23, 25, 43, 46, 64, 67, 86, 88, 106, 108, 109]"
Shakespeare,L50,middle,8,3,5,2,0.9259,108,"[19, 36, 40, 59, 78, 80, 98, 99]"
Shakespeare,L50,middle,8,5,3,10,0.9259,108,"[13, 23, 42, 61, 79, 97, 98, 100]"
Shakespeare,L50,middle,8,4,4,6,0.9259,108,"[19, 37, 41, 59, 78, 81, 98, 101]"
Shakespeare,L50,middle,11,5,6,4,0.9009,111,"[12, 21, 40, 59, 62, 80, 82, 84, 102, 103, 104]"
Shakespeare,L50,middle,7,5,2,6,0.9346,107,"[20, 45, 63, 65, 84, 101, 105]"
Shakespeare,L50,middle,8,1,7,6,0.9259,108,"[11, 21, 41, 61, 79, 83, 101, 102]"
Shakespeare,L50,middle,8,5,3,4,0.9259,108,"[12, 21, 39, 58, 60, 79, 99, 101]"
Shakespeare,L50,middle,7,5,2,7,0.9346,107,"[12, 21, 39, 58, 61, 82, 100]"
Shakespeare,L50,middle,9,6,3,3,0.9174,109,"[11, 19, 38, 39, 41, 62, 80, 99, 100]"
Shakespeare,L50,middle,12,6,6,1,0.8929,112,"[11, 19, 38, 39, 40, 59, 61, 79, 81, 100, 101, 103]"
Shakespeare,L50,middle,8,3,5,1,0.9259,108,"[19, 36, 40, 59, 79, 80, 99, 100]"
Shakespeare,L50,middle,6,3,3,6,0.9434,106,"[20, 39, 58, 62, 82, 101]"
Shakespeare,L50,middle,7,3,4,6,0.9346,107,"[19, 36, 41, 59, 81, 99, 102]"
Shakespeare,L50,middle,7,3,4,5,0.9346,107,"[20, 40, 58, 61, 80, 99, 100]"
Shakespeare,L50,middle,9,5,4,1,0.9174,109,"[19, 37, 41, 59, 61, 80, 82, 99, 102]"
Shakespeare,L100,middle,8,6,2,19,0.9259,108,"[16, 28, 47, 66, 84, 102, 103, 104]"
Shakespeare,L100,middle,8,4,4,3,0.9259,108,"[10, 19, 38, 40, 59, 77, 81, 99]"
Shakespeare,L100,middle,8,5,3,11,0.9259,108,"[13, 24, 42, 60, 78, 80, 98, 100]"
Shakespeare,L100,middle,9,5,4,1,0.9174,109,"[19, 35, 39, 40, 41, 62, 81, 98, 101]"
Shakespeare,L100,middle,9,3,6,3,0.9174,109,"[19, 36, 39, 57, 59, 61, 81, 100, 102]"
Shakespeare,L100,middle,12,6,6,1,0.8929,112,"[10, 19, 38, 39, 60, 77, 80, 81, 82, 101, 103, 105]"
Shakespeare,L100,middle,11,3,8,3,0.9009,111,"[19, 35, 40, 58, 60, 62, 81, 84, 102, 103, 105]"
Shakespeare,L100,middle,8,4,4,7,0.9259,108,"[19, 20, 37, 40, 58, 61, 83, 103]"
Shakespeare,L100,middle,12,6,6,4,0.8929,112,"[10, 19, 21, 39, 40, 59, 62, 79, 82, 83, 102, 104]"
Shakespeare,L100,middle,11,8,3,2,0.9009,111,"[10, 19, 20, 39, 40, 41, 59, 63, 81, 101, 102]"
Shakespeare,L100,middle,10,7,3,4,0.9091,110,"[10, 20, 38, 39, 40, 41, 59, 63, 82, 102]"
Shakespeare,L100,middle,8,3,5,4,0.9259,108,"[11, 19, 21, 42, 61, 78, 80, 100]"
Shakespeare,L100,middle,9,4,5,1,0.9174,109,"[11, 19, 38, 40, 59, 77, 79, 98, 99]"
Shakespeare,L100,middle,9,4,5,2,0.9174,109,"[21, 39, 41, 59, 61, 63, 82, 101, 103]"
Shakespeare,L100,middle,9,3,6,5,0.9174,109,"[19, 35, 39, 61, 80, 98, 101, 102, 106]"
Shakespeare,L100,middle,10,4,6,5,0.9091,110,"[19, 35, 39, 40, 58, 61, 79, 82, 99, 103]"
Shakespeare,L100,middle,10,6,4,2,0.9091,110,"[10, 19, 20, 40, 41, 62, 79, 82, 100, 102]"
Shakespeare,L100,middle,9,3,6,5,0.9174,109,"[11, 19, 20, 40, 59, 64, 82, 100, 102]"
Shakespeare,L100,middle,8,6,2,8,0.9259,108,"[19, 21, 39, 43, 61, 80, 83, 104]"
Shakespeare,L100,middle,9,3,6,8,0.9174,109,"[22, 41, 61, 79, 81, 99, 100, 101, 102]"
Shakespeare,L100,middle,9,5,4,2,0.9174,109,"[10, 19, 38, 40, 59, 77, 80, 99, 100]"
Shakespeare,L100,middle,9,4,5,3,0.9174,109,"[19, 37, 41, 59, 62, 81, 83, 101, 102]"
Shakespeare,L100,middle,12,7,5,0,0.8929,112,"[20, 21, 39, 41, 42, 60, 62, 80, 82, 100, 102, 103]"
Shakespeare,L100,middle,9,6,3,4,0.9174,109,"[11, 21, 39, 40, 59, 62, 79, 81, 100]"
Shakespeare,L100,middle,13,8,5,2,0.885,113,"[11, 19, 38, 39, 40, 58, 62, 63, 64, 83, 84, 103, 106]"
Shakespeare,L100,middle,13,3,10,1,0.885,113,"[19, 35, 40, 58, 61, 63, 64, 65, 84, 86, 104, 105, 106]"
Shakespeare,L100,middle,11,5,6,2,0.9009,111,"[19, 20, 36, 40, 58, 61, 80, 98, 100, 101, 103]"
Shakespeare,L100,middle,7,3,4,5,0.9346,107,"[19, 36, 39, 58, 62, 81, 99]"
Shakespeare,L100,middle,13,6,7,0,0.885,113,"[19, 35, 39, 58, 59, 78, 81, 83, 84, 102, 104, 105, 108]"
Shakespeare,L100,middle,12,5,7,2,0.8929,112,"[19, 36, 40, 41, 60, 61, 62, 63, 82, 84, 101, 104]"
Shakespeare,L100,middle,9,3,6,6,0.9174,109,"[19, 36, 39, 57, 59, 65, 83, 101, 102]"
Shakespeare,L100,middle,10,3,7,6,0.9091,110,"[19, 20, 23, 41, 43, 62, 81, 82, 99, 106]"
Shakespeare,L100,middle,12,6,6,0,0.8929,112,"[11, 19, 20, 22, 41, 42, 61, 63, 81, 84, 103, 104]"
Shakespeare,L100,middle,10,7,3,5,0.9091,110,"[20, 21, 22, 40, 42, 61, 65, 83, 89, 107]"
Shakespeare,L100,middle,12,9,3,3,0.8929,112,"[20, 38, 41, 59, 61, 80, 82, 83, 85, 103, 106, 108]"
Shakespeare,L100,middle,10,5,5,8,0.9091,110,"[13, 25, 44, 63, 80, 83, 84, 85, 103, 105]"
Shakespeare,L100,middle,13,6,7,3,0.885,113,"[10, 20, 39, 40, 59, 61, 62, 79, 82, 83, 85, 103, 107]"
Shakespeare,L100,middle,7,2,5,6,0.9346,107,"[19, 35, 43, 62, 80, 99, 101]"
Shakespeare,L100,middle,7,3,4,7,0.9346,107,"[13, 23, 41, 59, 76, 80, 100]"
Shakespeare,L100,middle,12,5,7,2,0.8929,112,"[19, 20, 22, 40, 43, 62, 64, 83, 85, 103, 105, 109]"
Shakespeare,L100,middle,7,5,2,5,0.9346,107,"[20, 38, 42, 61, 80, 84, 102]"
Shakespeare,L100,middle,8,3,5,4,0.9259,108,"[11, 19, 39, 40, 59, 64, 83, 102]"
Shakespeare,L100,middle,10,6,4,0,0.9091,110,"[19, 35, 39, 57, 59, 77, 79, 80, 81, 101]"
Shakespeare,L100,middle,8,5,3,10,0.9259,108,"[11, 19, 38, 40, 59, 65, 82, 103]"
Shakespeare,L100,middle,9,4,5,2,0.9174,109,"[22, 40, 42, 44, 62, 64, 82, 85, 104]"
Shakespeare,L100,middle,9,5,4,1,0.9174,109,"[10, 19, 39, 59, 76, 79, 80, 99, 101]"
Shakespeare,L100,middle,9,5,4,1,0.9174,109,"[10, 19, 38, 39, 57, 60, 78, 81, 100]"
Shakespeare,L100,middle,12,5,7,2,0.8929,112,"[19, 35, 39, 58, 59, 60, 63, 64, 83, 85, 103, 105]"
Shakespeare,L100,middle,12,4,8,1,0.8929,112,"[19, 35, 39, 40, 41, 59, 61, 80, 82, 100, 101, 102]"
Shakespeare,L100,middle,9,4,5,3,0.9174,109,"[10, 19, 40, 60, 77, 79, 99, 100, 102]"
Shakespeare,L100,middle,13,9,4,5,0.885,113,"[12, 21, 41, 59, 61, 78, 80, 81, 83, 102, 103, 104, 105]"
Shakespeare,L100,middle,11,6,5,2,0.9009,111,"[10, 19, 20, 39, 41, 42, 61, 63, 81, 83, 102]"
Shakespeare,L100,middle,8,2,6,8,0.9259,108,"[10, 23, 41, 59, 61, 79, 80, 101]"
Shakespeare,L100,middle,8,2,6,5,0.9259,108,"[10, 19, 20, 42, 60, 63, 82, 102]"
Shakespeare,L100,middle,8,3,5,7,0.9259,108,"[19, 37, 39, 41, 59, 63, 82, 102]"
Shakespeare,L100,middle,10,3,7,4,0.9091,110,"[19, 20, 36, 41, 62, 63, 82, 84, 102, 105]"
Shakespeare,L100,middle,9,7,2,3,0.9174,109,"[11, 19, 38, 39, 40, 41, 62, 83, 101]"
Shakespeare,L100,middle,8,3,5,0,0.9259,108,"[10, 19, 38, 39, 59, 79, 80, 100]"
Shakespeare,L100,middle,7,3,4,8,0.9346,107,"[11, 20, 41, 63, 80, 83, 102]"
Shakespeare,L100,middle,13,2,11,2,0.885,113,"[19, 20, 21, 37, 41, 43, 61, 64, 83, 100, 104, 105, 106]"
Shakespeare,L100,middle,9,6,3,0,0.9174,109,"[10, 19, 39, 40, 41, 61, 78, 81, 101]"
Shakespeare,L100,middle,12,4,8,1,0.8929,112,"[19, 20, 36, 40, 41, 59, 62, 80, 82, 100, 101, 102]"
Shakespeare,L100,middle,8,4,4,5,0.9259,108,"[10, 21, 40, 60, 77, 79, 97, 100]"
Shakespeare,L100,middle,9,4,5,7,0.9174,109,"[19, 36, 39, 42, 60, 78, 80, 84, 103]"
Shakespeare,L100,middle,10,5,5,3,0.9091,110,"[10, 20, 38, 39, 40, 41, 60, 62, 83, 101]"
Shakespeare,L100,middle,10,7,3,7,0.9091,110,"[13, 23, 41, 59, 76, 80, 98, 100, 101, 102]"
Shakespeare,L100,middle,12,4,8,2,0.8929,112,"[19, 35, 40, 58, 60, 78, 80, 82, 99, 102, 103, 105]"
Shakespeare,L100,middle,9,4,5,0,0.9174,109,"[10, 19, 39, 58, 60, 62, 82, 101, 102]"
Shakespeare,L100,middle,8,4,4,11,0.9259,108,"[20, 38, 40, 41, 60, 66, 85, 102]"
Shakespeare,L100,middle,11,5,6,5,0.9009,111,"[19, 22, 41, 59, 61, 80, 81, 98, 101, 102, 104]"
Shakespeare,L100,middle,11,7,4,6,0.9009,111,"[10, 19, 38, 39, 57, 61, 79, 81, 82, 86, 107]"
Shakespeare,L100,middle,9,5,4,11,0.9174,109,"[10, 19, 38, 40, 59, 66, 83, 101, 104]"
Shakespeare,L100,middle,10,6,4,3,0.9091,110,"[10, 19, 38, 40, 59, 61, 78, 81, 100, 102]"
Shakespeare,L100,middle,9,3,6,4,0.9174,109,"[19, 35, 39, 41, 59, 62, 81, 98, 101]"
Shakespeare,L100,middle,11,7,4,2,0.9009,111,"[10, 19, 38, 39, 57, 60, 78, 80, 81, 100, 102]"
Shakespeare,L100,middle,11,5,6,3,0.9009,111,"[21, 39, 57, 59, 60, 78, 80, 81, 82, 100, 103]"
Shakespeare,L100,middle,9,2,7,3,0.9174,109,"[11, 19, 42, 61, 79, 80, 81, 99, 102]"
Shakespeare,L100,middle,9,3,6,2,0.9174,109,"[11, 20, 40, 60, 77, 80, 81, 99, 103]"
Shakespeare,L100,middle,10,4,6,1,0.9091,110,"[19, 20, 39, 41, 59, 61, 79, 81, 99, 101]"
Shakespeare,L100,middle,11,5,6,2,0.9009,111,"[21, 22, 40, 42, 60, 65, 83, 101, 102, 103, 104]"
Shakespeare,L100,middle,9,5,4,2,0.9174,109,"[10, 19, 38, 39, 57, 60, 78, 82, 101]"
Shakespeare,L100,middle,8,5,3,4,0.9259,108,"[19, 35, 39, 44, 62, 81, 83, 103]"
Shakespeare,L100,middle,8,5,3,4,0.9259,108,"[19, 21, 24, 42, 45, 65, 86, 104]"
Shakespeare,L100,middle,14,5,9,3,0.8772,114,"[10, 19, 38, 41, 60, 62, 79, 81, 83, 101, 104, 105, 106, 107]"
Shakespeare,L100,middle,11,4,7,1,0.9009,111,"[19, 20, 21, 42, 60, 62, 63, 82, 83, 100, 103]"
Shakespeare,L100,middle,9,3,6,0,0.9174,109,"[19, 36, 39, 59, 78, 79, 96, 98, 100]"
Shakespeare,L100,middle,13,4,9,0,0.885,113,"[19, 22, 40, 42, 60, 62, 82, 101, 102, 103, 104, 105, 106]"
Shakespeare,L100,middle,8,5,3,1,0.9259,108,"[10, 19, 38, 40, 59, 77, 79, 99]"
Shakespeare,L100,middle,11,5,6,3,0.9009,111,"[20, 38, 40, 41, 42, 60, 62, 81, 83, 101, 103]"
Shakespeare,L100,middle,8,4,4,1,0.9259,108,"[10, 19, 38, 40, 59, 77, 80, 100]"
Shakespeare,L100,middle,13,6,7,1,0.885,113,"[20, 39, 40, 58, 60, 61, 62, 80, 82, 83, 84, 102, 104]"
Shakespeare,L100,middle,12,5,7,1,0.8929,112,"[10, 19, 21, 39, 40, 42, 61, 79, 81, 100, 101, 102]"
Shakespeare,L100,middle,11,6,5,6,0.9009,111,"[10, 19, 20, 21, 40, 41, 59, 62, 80, 85, 103]"
Shakespeare,L100,middle,12,3,9,2,0.8929,112,"[19, 20, 36, 41, 60, 79, 80, 81, 83, 101, 103, 105]"
Shakespeare,L100,middle,9,5,4,4,0.9174,109,"[21, 41, 60, 78, 80, 81, 82, 101, 106]"
Shakespeare,L100,middle,10,7,3,1,0.9091,110,"[11, 19, 38, 40, 60, 77, 80, 99, 101, 102]"
Shakespeare,L100,middle,10,5,5,3,0.9091,110,"[10, 19, 39, 40, 42, 61, 63, 80, 83, 103]"
Shakespeare,L100,middle,9,3,6,5,0.9174,109,"[19, 35, 40, 58, 60, 78, 80, 97, 101]"
Shakespeare,L100,middle,9,4,5,2,0.9174,109,"[12, 20, 40, 41, 60, 62, 79, 81, 103]"
Shakespeare,L100,middle,11,7,4,2,0.9009,111,"[10, 19, 39, 59, 60, 61, 62, 63, 81, 84, 104]"
Shakespeare,L0,long,6,5,1,0,0.9434,106,"[16, 29, 31, 60, 61, 91]"
Shakespeare,L0,long,7,4,3,2,0.9346,107,"[28, 31, 58, 61, 88, 91, 94]"
Shakespeare,L0,long,5,4,1,11,0.9524,105,"[28, 29, 36, 64, 92]"
Shakespeare,L0,long,5,4,1,3,0.9524,105,"[16, 30, 58, 61, 89]"
Shakespeare,L0,long,6,5,1,2,0.9434,106,"[16, 29, 57, 60, 88, 90]"
Shakespeare,L0,long,6,4,2,0,0.9434,106,"[16, 29, 57, 59, 87, 89]"
Shakespeare,L0,long,7,4,3,1,0.9346,107,"[16, 29, 59, 87, 90, 91, 93]"
Shakespeare,L0,long,5,2,3,4,0.9524,105,"[16, 29, 57, 62, 90]"
Shakespeare,L0,long,9,7,2,7,0.9174,109,"[16, 34, 62, 90, 92, 94, 95, 96, 98]"
Shakespeare,L0,long,6,4,2,12,0.9434,106,"[17, 29, 35, 64, 91, 95]"
Shakespeare,L0,long,5,3,2,2,0.9524,105,"[16, 30, 61, 90, 92]"
Shakespeare,L0,long,6,5,1,1,0.9434,106,"[29, 57, 59, 61, 88, 90]"
Shakespeare,L0,long,6,4,2,5,0.9434,106,"[16, 29, 57, 63, 90, 93]"
Shakespeare,L0,long,6,6,0,0,0.9434,106,"[28, 29, 55, 59, 88, 89]"
Shakespeare,L0,long,7,6,1,0,0.9346,107,"[28, 29, 55, 59, 60, 61, 92]"
Shakespeare,L0,long,6,5,1,2,0.9434,106,"[28, 29, 55, 59, 60, 92]"
Shakespeare,L0,long,8,3,5,1,0.9259,108,"[28, 29, 57, 60, 62, 91, 92, 93]"
Shakespeare,L0,long,12,9,3,3,0.8929,112,"[16, 29, 31, 33, 60, 65, 93, 95, 96, 97, 100, 103]"
Shakespeare,L0,long,6,6,0,1,0.9434,106,"[28, 29, 55, 60, 88, 89]"
Shakespeare,L0,long,4,2,2,8,0.9615,104,"[19, 34, 62, 89]"
Shakespeare,L0,long,6,1,5,2,0.9434,106,"[30, 59, 61, 87, 90, 91]"
Shakespeare,L0,long,8,4,4,4,0.9259,108,"[17, 31, 58, 62, 63, 65, 93, 95]"
Shakespeare,L0,long,5,5,0,3,0.9524,105,"[28, 29, 55, 59, 93]"
Shakespeare,L0,long,8,8,0,0,0.9259,108,"[28, 29, 30, 56, 60, 61, 90, 91]"
Shakespeare,L0,long,6,4,2,3,0.9434,106,"[28, 29, 57, 59, 88, 92]"
Shakespeare,L0,long,6,5,1,1,0.9434,106,"[16, 29, 55, 59, 87, 90]"
Shakespeare,L0,long,9,8,1,1,0.9174,109,"[28, 29, 55, 59, 60, 61, 62, 91, 94]"
Shakespeare,L0,long,7,7,0,0,0.9346,107,"[29, 57, 59, 87, 89, 90, 91]"
Shakespeare,L0,long,8,7,1,0,0.9259,108,"[16, 29, 55, 59, 60, 88, 90, 92]"
Shakespeare,L0,long,9,8,1,0,0.9174,109,"[16, 29, 55, 59, 60, 61, 89, 91, 92]"
Shakespeare,L0,long,5,4,1,0,0.9524,105,"[16, 29, 57, 59, 89]"
Shakespeare,L0,long,10,9,1,3,0.9091,110,"[16, 29, 30, 31, 32, 33, 34, 63, 65, 96]"
Shakespeare,L0,long,8,7,1,0,0.9259,108,"[17, 29, 55, 59, 60, 61, 89, 92]"
Shakespeare,L0,long,6,5,1,3,0.9434,106,"[17, 30, 58, 60, 88, 92]"
Shakespeare,L0,long,7,4,3,2,0.9346,107,"[18, 30, 58, 60, 61, 91, 93]"
Shakespeare,L0,long,7,6,1,3,0.9346,107,"[17, 29, 55, 59, 60, 62, 93]"
Shakespeare,L0,long,6,5,1,2,0.9434,106,"[16, 30, 58, 60, 89, 91]"
Shakespeare,L0,long,8,5,3,0,0.9259,108,"[16, 29, 30, 56, 61, 91, 92, 93]"
Shakespeare,L0,long,8,8,0,0,0.9259,108,"[28, 29, 55, 60, 61, 89, 90, 91]"
Shakespeare,L0,long,5,4,1,4,0.9524,105,"[17, 33, 59, 87, 90]"
Shakespeare,L0,long,5,3,2,2,0.9524,105,"[28, 29, 57, 61, 89]"
Shakespeare,L0,long,7,7,0,2,0.9346,107,"[16, 30, 58, 60, 88, 90, 91]"
Shakespeare,L0,long,5,1,4,5,0.9524,105,"[29, 31, 61, 90, 95]"
Shakespeare,L0,long,6,4,2,6,0.9434,106,"[17, 30, 58, 62, 90, 94]"
Shakespeare,L0,long,7,5,2,1,0.9346,107,"[29, 57, 60, 87, 89, 90, 92]"
Shakespeare,L0,long,5,3,2,4,0.9524,105,"[17, 30, 60, 88, 91]"
Shakespeare,L0,long,7,3,4,1,0.9346,107,"[28, 29, 58, 61, 90, 91, 93]"
Shakespeare,L0,long,6,5,1,0,0.9434,106,"[16, 29, 55, 59, 87, 89]"
Shakespeare,L0,long,5,3,2,6,0.9524,105,"[18, 32, 58, 63, 92]"
Shakespeare,L0,long,6,3,3,1,0.9434,106,"[18, 33, 61, 63, 90, 94]"
Shakespeare,L0,long,9,5,4,1,0.9174,109,"[29, 31, 58, 61, 62, 90, 91, 92, 94]"
Shakespeare,L0,long,7,6,1,2,0.9346,107,"[28, 29, 55, 59, 60, 89, 92]"
Shakespeare,L0,long,9,9,0,0,0.9174,109,"[28, 29, 30, 31, 57, 61, 63, 92, 93]"
Shakespeare,L0,long,6,3,3,2,0.9434,106,"[30, 57, 60, 87, 89, 92]"
Shakespeare,L0,long,7,7,0,1,0.9346,107,"[16, 29, 30, 32, 61, 90, 91]"
Shakespeare,L0,long,8,7,1,2,0.9259,108,"[28, 29, 30, 33, 61, 89, 90, 91]"
Shakespeare,L0,long,5,2,3,7,0.9524,105,"[28, 31, 58, 62, 91]"
Shakespeare,L0,long,6,4,2,2,0.9434,106,"[17, 29, 55, 59, 62, 92]"
Shakespeare,L0,long,8,8,0,1,0.9259,108,"[29, 57, 59, 60, 61, 89, 90, 92]"
Shakespeare,L0,long,6,4,2,0,0.9434,106,"[17, 29, 57, 59, 87, 89]"
Shakespeare,L0,long,8,7,1,1,0.9259,108,"[16, 29, 30, 31, 32, 34, 63, 93]"
Shakespeare,L0,long,5,3,2,8,0.9524,105,"[16, 31, 58, 63, 91]"
Shakespeare,L0,long,6,5,1,1,0.9434,106,"[16, 29, 55, 59, 87, 90]"
Shakespeare,L0,long,8,7,1,0,0.9259,108,"[28, 29, 57, 59, 60, 61, 90, 91]"
Shakespeare,L0,long,6,3,3,4,0.9434,106,"[28, 31, 58, 63, 91, 92]"
Shakespeare,L0,long,7,6,1,1,0.9346,107,"[16, 31, 58, 60, 61, 90, 91]"
Shakespeare,L0,long,6,5,1,0,0.9434,106,"[17, 29, 55, 59, 87, 89]"
Shakespeare,L0,long,5,4,1,1,0.9524,105,"[28, 29, 55, 59, 90]"
Shakespeare,L0,long,7,6,1,0,0.9346,107,"[17, 29, 55, 59, 60, 88, 90]"
Shakespeare,L0,long,6,5,1,0,0.9434,106,"[17, 29, 55, 59, 87, 89]"
Shakespeare,L0,long,6,4,2,3,0.9434,106,"[17, 29, 55, 61, 89, 91]"
Shakespeare,L0,long,5,3,2,4,0.9524,105,"[16, 30, 58, 61, 90]"
Shakespeare,L0,long,8,7,1,0,0.9259,108,"[29, 30, 31, 32, 60, 62, 91, 93]"
Shakespeare,L0,long,7,6,1,0,0.9346,107,"[18, 30, 58, 60, 88, 90, 91]"
Shakespeare,L0,long,6,4,2,4,0.9434,106,"[16, 29, 31, 59, 62, 91]"
Shakespeare,L0,long,6,5,1,1,0.9434,106,"[16, 30, 58, 60, 61, 92]"
Shakespeare,L0,long,7,6,1,3,0.9346,107,"[16, 31, 58, 60, 88, 90, 91]"
Shakespeare,L0,long,6,3,3,6,0.9434,106,"[16, 31, 59, 62, 90, 93]"
Shakespeare,L0,long,8,5,3,2,0.9259,108,"[28, 31, 60, 88, 89, 90, 91, 94]"
Shakespeare,L0,long,5,4,1,2,0.9524,105,"[16, 29, 55, 61, 92]"
Shakespeare,L0,long,6,4,2,3,0.9434,106,"[16, 30, 58, 61, 89, 91]"
Shakespeare,L0,long,4,2,2,3,0.9615,104,"[16, 30, 61, 89]"
Shakespeare,L0,long,6,4,2,2,0.9434,106,"[17, 29, 55, 59, 87, 91]"
Shakespeare,L0,long,6,6,0,0,0.9434,106,"[28, 29, 55, 59, 89, 90]"
Shakespeare,L0,long,7,4,3,2,0.9346,107,"[16, 29, 32, 59, 61, 91, 92]"
Shakespeare,L0,long,4,3,1,6,0.9615,104,"[29, 58, 65, 91]"
Shakespeare,L0,long,7,5,2,3,0.9346,107,"[28, 29, 55, 59, 62, 90, 93]"
Shakespeare,L0,long,7,6,1,2,0.9346,107,"[28, 29, 30, 32, 64, 90, 93]"
Shakespeare,L0,long,7,7,0,1,0.9346,107,"[16, 29, 55, 60, 88, 90, 91]"
Shakespeare,L0,long,7,7,0,0,0.9346,107,"[16, 29, 30, 59, 61, 90, 91]"
Shakespeare,L0,long,9,9,0,0,0.9174,109,"[28, 29, 30, 32, 60, 62, 90, 91, 92]"
Shakespeare,L0,long,7,6,1,0,0.9346,107,"[16, 29, 55, 59, 87, 89, 90]"
Shakespeare,L0,long,7,2,5,1,0.9346,107,"[30, 57, 60, 87, 90, 91, 93]"
Shakespeare,L0,long,11,9,2,0,0.9009,111,"[16, 29, 57, 59, 60, 61, 62, 63, 91, 93, 94]"
Shakespeare,L0,long,6,4,2,7,0.9434,106,"[18, 33, 59, 63, 90, 93]"
Shakespeare,L0,long,7,6,1,0,0.9346,107,"[28, 29, 57, 59, 60, 89, 90]"
Shakespeare,L0,long,6,3,3,2,0.9434,106,"[28, 31, 58, 62, 88, 92]"
Shakespeare,L0,long,5,3,2,5,0.9524,105,"[28, 31, 58, 62, 89]"
Shakespeare,L0,long,5,3,2,6,0.9524,105,"[16, 31, 58, 62, 93]"
Shakespeare,L0,long,6,3,3,2,0.9434,106,"[16, 30, 31, 62, 90, 92]"
Shakespeare,L50,long,7,6,1,0,0.9346,107,"[28, 29, 57, 59, 85, 89, 90]"
Shakespeare,L50,long,8,6,2,2,0.9259,108,"[29, 30, 31, 60, 63, 89, 91, 93]"
Shakespeare,L50,long,5,3,2,3,0.9524,105,"[30, 58, 62, 88, 91]"
Shakespeare,L50,long,7,2,5,1,0.9346,107,"[30, 31, 32, 60, 63, 90, 93]"
Shakespeare,L50,long,6,4,2,0,0.9434,106,"[28, 29, 57, 59, 87, 89]"
Shakespeare,L50,long,9,7,2,2,0.9174,109,"[16, 30, 58, 59, 60, 61, 89, 91, 94]"
Shakespeare,L50,long,6,5,1,3,0.9434,106,"[17, 29, 55, 60, 88, 92]"
Shakespeare,L50,long,6,5,1,1,0.9434,106,"[17, 29, 58, 59, 87, 90]"
Shakespeare,L50,long,5,4,1,5,0.9524,105,"[17, 33, 59, 63, 91]"
Shakespeare,L50,long,5,3,2,2,0.9524,105,"[28, 29, 57, 61, 89]"
Shakespeare,L50,long,8,7,1,1,0.9259,108,"[16, 29, 31, 59, 60, 61, 89, 91]"
Shakespeare,L50,long,6,6,0,1,0.9434,106,"[16, 29, 31, 60, 88, 90]"
Shakespeare,L50,long,10,9,1,1,0.9091,110,"[28, 29, 57, 60, 89, 90, 91, 92, 93, 94]"
Shakespeare,L50,long,6,5,1,0,0.9434,106,"[28, 29, 57, 59, 85, 89]"
Shakespeare,L50,long,7,4,3,4,0.9346,107,"[16, 30, 58, 61, 89, 91, 93]"
Shakespeare,L50,long,7,7,0,2,0.9346,107,"[16, 30, 58, 60, 88, 90, 91]"
Shakespeare,L50,long,5,5,0,0,0.9524,105,"[17, 29, 55, 59, 89]"
Shakespeare,L50,long,6,6,0,0,0.9434,106,"[29, 57, 59, 87, 88, 90]"
Shakespeare,L50,long,7,5,2,1,0.9346,107,"[28, 30, 58, 60, 63, 89, 92]"
Shakespeare,L50,long,5,3,2,3,0.9524,105,"[16, 32, 59, 87, 90]"
Shakespeare,L50,long,7,6,1,1,0.9346,107,"[16, 30, 58, 60, 61, 90, 93]"
Shakespeare,L50,long,4,2,2,6,0.9615,104,"[30, 58, 64, 91]"
Shakespeare,L50,long,6,2,4,2,0.9434,106,"[16, 30, 60, 89, 90, 91]"
Shakespeare,L50,long,5,3,2,3,0.9524,105,"[18, 30, 58, 61, 89]"
Shakespeare,L50,long,8,2,6,3,0.9259,108,"[28, 29, 33, 62, 90, 91, 92, 93]"
Shakespeare,L50,long,10,6,4,2,0.9091,110,"[16, 29, 31, 59, 60, 63, 91, 93, 94, 96]"
Shakespeare,L50,long,6,5,1,0,0.9434,106,"[17, 29, 55, 59, 87, 90]"
Shakespeare,L50,long,8,5,3,1,0.9259,108,"[29, 31, 61, 87, 89, 90, 91, 93]"
Shakespeare,L50,long,11,9,2,3,0.9009,111,"[28, 29, 30, 31, 59, 61, 62, 63, 66, 93, 95]"
Shakespeare,L50,long,6,5,1,3,0.9434,106,"[16, 29, 55, 59, 61, 92]"
Shakespeare,L50,long,7,5,2,3,0.9346,107,"[28, 29, 57, 59, 62, 89, 91]"
Shakespeare,L50,long,6,4,2,4,0.9434,106,"[17, 31, 58, 60, 88, 92]"
Shakespeare,L50,long,12,12,0,0,0.8929,112,"[16, 30, 58, 59, 60, 61, 62, 63, 92, 93, 94, 95]"
Shakespeare,L50,long,7,7,0,4,0.9346,107,"[17, 30, 34, 63, 92, 93, 95]"
Shakespeare,L50,long,7,7,0,1,0.9346,107,"[16, 29, 31, 59, 60, 89, 90]"
Shakespeare,L50,long,7,6,1,1,0.9346,107,"[29, 57, 59, 61, 88, 90, 91]"
Shakespeare,L50,long,8,6,2,0,0.9259,108,"[17, 30, 58, 60, 61, 89, 92, 93]"
Shakespeare,L50,long,8,4,4,1,0.9259,108,"[30, 31, 32, 60, 63, 89, 91, 92]"
Shakespeare,L50,long,5,3,2,3,0.9524,105,"[30, 58, 63, 92, 94]"
Shakespeare,L50,long,6,5,1,2,0.9434,106,"[28, 29, 57, 60, 88, 90]"
Shakespeare,L50,long,5,4,1,6,0.9524,105,"[16, 29, 55, 63, 91]"
Shakespeare,L50,long,9,9,0,1,0.9174,109,"[16, 29, 31, 59, 61, 89, 91, 92, 93]"
Shakespeare,L50,long,6,3,3,5,0.9434,106,"[28, 29, 60, 87, 90, 96]"
Shakespeare,L50,long,6,5,1,4,0.9434,106,"[16, 30, 58, 60, 88, 91]"
Shakespeare,L50,long,4,2,2,4,0.9615,104,"[31, 59, 62, 91]"
Shakespeare,L50,long,4,3,1,3,0.9615,104,"[28, 31, 59, 91]"
Shakespeare,L50,long,6,5,1,1,0.9434,106,"[28, 29, 57, 60, 88, 89]"
Shakespeare,L50,long,5,2,3,5,0.9524,105,"[28, 31, 60, 65, 93]"
Shakespeare,L50,long,8,6,2,0,0.9259,108,"[29, 30, 59, 62, 88, 90, 91, 93]"
Shakespeare,L50,long,5,4,1,2,0.9524,105,"[28, 30, 58, 60, 90]"
Shakespeare,L50,long,9,8,1,1,0.9174,109,"[28, 29, 57, 59, 60, 62, 90, 91, 93]"
Shakespeare,L50,long,6,5,1,0,0.9434,106,"[16, 29, 55, 59, 87, 90]"
Shakespeare,L50,long,6,5,1,1,0.9434,106,"[28, 29, 57, 59, 85, 90]"
Shakespeare,L50,long,5,5,0,11,0.9524,105,"[17, 29, 35, 64, 92]"
Shakespeare,L50,long,6,4,2,3,0.9434,106,"[28, 31, 61, 87, 89, 90]"
Shakespeare,L50,long,6,6,0,1,0.9434,106,"[16, 30, 58, 59, 60, 90]"
Shakespeare,L50,long,5,3,2,3,0.9524,105,"[28, 31, 60, 88, 89]"
Shakespeare,L50,long,8,6,2,2,0.9259,108,"[28, 29, 57, 59, 61, 62, 90, 94]"
Shakespeare,L50,long,6,4,2,1,0.9434,106,"[16, 30, 58, 59, 87, 91]"
Shakespeare,L50,long,4,3,1,12,0.9615,104,"[28, 35, 63, 91]"
Shakespeare,L50,long,6,3,3,2,0.9434,106,"[16, 29, 34, 62, 91, 92]"
Shakespeare,L50,long,7,7,0,1,0.9346,107,"[28, 30, 59, 60, 88, 89, 90]"
Shakespeare,L50,long,7,6,1,6,0.9346,107,"[17, 29, 34, 60, 64, 92, 94]"
Shakespeare,L50,long,6,5,1,0,0.9434,106,"[28, 29, 57, 59, 88, 89]"
Shakespeare,L50,long,7,7,0,4,0.9346,107,"[28, 29, 31, 59, 64, 90, 94]"
Shakespeare,L50,long,9,9,0,1,0.9174,109,"[28, 29, 30, 31, 61, 89, 90, 91, 93]"
Shakespeare,L50,long,7,4,3,2,0.9346,107,"[17, 29, 34, 36, 67, 95, 96]"
Shakespeare,L50,long,5,4,1,0,0.9524,105,"[28, 29, 59, 60, 90]"
Shakespeare,L50,long,6,5,1,7,0.9434,106,"[17, 29, 34, 60, 64, 92]"
Shakespeare,L50,long,7,6,1,1,0.9346,107,"[16, 29, 31, 59, 60, 88, 90]"
Shakespeare,L50,long,6,6,0,0,0.9434,106,"[16, 30, 59, 60, 88, 90]"
Shakespeare,L50,long,8,7,1,1,0.9259,108,"[28, 29, 60, 87, 89, 90, 91, 92]"
Shakespeare,L50,long,7,6,1,1,0.9346,107,"[28, 29, 57, 59, 61, 89, 90]"
Shakespeare,L50,long,6,5,1,2,0.9434,106,"[28, 29, 32, 60, 88, 90]"
Shakespeare,L50,long,6,6,0,5,0.9434,106,"[28, 30, 31, 60, 65, 94]"
Shakespeare,L50,long,8,8,0,4,0.9259,108,"[16, 29, 31, 59, 60, 61, 63, 96]"
Shakespeare,L50,long,9,9,0,0,0.9174,109,"[16, 29, 55, 59, 60, 61, 62, 63, 93]"
Shakespeare,L50,long,7,7,0,0,0.9346,107,"[29, 57, 59, 87, 88, 89, 90]"
Shakespeare,L50,long,6,5,1,1,0.9434,106,"[29, 57, 59, 61, 89, 90]"
Shakespeare,L50,long,7,3,4,3,0.9346,107,"[30, 31, 59, 62, 88, 90, 93]"
Shakespeare,L50,long,9,8,1,0,0.9174,109,"[16, 29, 31, 59, 60, 61, 89, 92, 93]"
Shakespeare,L50,long,8,6,2,2,0.9259,108,"[28, 29, 30, 58, 60, 61, 90, 93]"
Shakespeare,L50,long,7,5,2,1,0.9346,107,"[29, 57, 59, 60, 62, 90, 92]"
Shakespeare,L50,long,6,5,1,0,0.9434,106,"[17, 29, 57, 59, 88, 89]"
Shakespeare,L50,long,9,8,1,3,0.9174,109,"[17, 30, 58, 59, 60, 61, 62, 64, 94]"
Shakespeare,L50,long,5,4,1,6,0.9524,105,"[28, 30, 58, 63, 91]"
Shakespeare,L50,long,9,9,0,1,0.9174,109,"[28, 29, 58, 59, 60, 61, 63, 91, 92]"
Shakespeare,L50,long,6,4,2,2,0.9434,106,"[29, 32, 60, 63, 89, 93]"
Shakespeare,L50,long,6,4,2,3,0.9434,106,"[16, 30, 59, 60, 63, 91]"
Shakespeare,L50,long,6,4,2,3,0.9434,106,"[29, 57, 61, 87, 89, 91]"
Shakespeare,L50,long,7,7,0,0,0.9346,107,"[16, 29, 55, 60, 88, 90, 91]"
Shakespeare,L50,long,7,6,1,3,0.9346,107,"[16, 31, 59, 60, 61, 89, 94]"
Shakespeare,L50,long,5,3,2,2,0.9524,105,"[16, 29, 60, 88, 90]"
Shakespeare,L50,long,5,2,3,2,0.9524,105,"[18, 30, 58, 62, 90]"
Shakespeare,L50,long,6,5,1,1,0.9434,106,"[17, 29, 55, 59, 87, 90]"
Shakespeare,L50,long,5,2,3,5,0.9524,105,"[16, 29, 33, 62, 91]"
Shakespeare,L50,long,5,5,0,0,0.9524,105,"[29, 57, 59, 87, 89]"
Shakespeare,L50,long,5,2,3,1,0.9524,105,"[29, 31, 60, 87, 90]"
Shakespeare,L50,long,5,5,0,1,0.9524,105,"[28, 30, 59, 88, 89]"
Shakespeare,L50,long,5,1,4,3,0.9524,105,"[31, 59, 87, 89, 91]"
Shakespeare,L100,long,5,3,2,3,0.9524,105,"[17, 30, 57, 61, 89]"
Shakespeare,L100,long,6,5,1,2,0.9434,106,"[16, 30, 58, 61, 88, 90]"
Shakespeare,L100,long,6,5,1,0,0.9434,106,"[28, 30, 60, 87, 89, 90]"
Shakespeare,L100,long,6,3,3,2,0.9434,106,"[29, 56, 59, 86, 88, 91]"
Shakespeare,L100,long,5,4,1,7,0.9524,105,"[29, 33, 59, 64, 90]"
Shakespeare,L100,long,7,6,1,2,0.9346,107,"[28, 30, 58, 60, 87, 89, 90]"
Shakespeare,L100,long,9,8,1,0,0.9174,109,"[28, 29, 30, 56, 60, 61, 88, 91, 92]"
Shakespeare,L100,long,7,4,3,4,0.9346,107,"[28, 29, 33, 59, 64, 91, 93]"
Shakespeare,L100,long,5,1,4,2,0.9524,105,"[30, 57, 61, 89, 90]"
Shakespeare,L100,long,6,4,2,6,0.9434,106,"[29, 32, 58, 64, 90, 93]"
Shakespeare,L100,long,7,4,3,5,0.9346,107,"[17, 31, 59, 61, 89, 91, 94]"
Shakespeare,L100,long,6,4,2,1,0.9434,106,"[16, 30, 57, 60, 88, 91]"
Shakespeare,L100,long,6,4,2,3,0.9434,106,"[18, 30, 57, 60, 88, 90]"
Shakespeare,L100,long,5,4,1,2,0.9524,105,"[16, 29, 55, 60, 90]"
Shakespeare,L100,long,7,4,3,4,0.9346,107,"[28, 32, 58, 64, 90, 93, 96]"
Shakespeare,L100,long,6,4,2,1,0.9434,106,"[28, 29, 55, 60, 87, 91]"
Shakespeare,L100,long,7,6,1,0,0.9346,107,"[28, 29, 31, 60, 61, 88, 91]"
Shakespeare,L100,long,6,6,0,4,0.9434,106,"[17, 29, 34, 60, 88, 90]"
Shakespeare,L100,long,8,5,3,2,0.9259,108,"[28, 29, 31, 60, 63, 89, 92, 93]"
Shakespeare,L100,long,6,2,4,1,0.9434,106,"[29, 56, 59, 62, 90, 92]"
Shakespeare,L100,long,7,6,1,0,0.9346,107,"[28, 29, 56, 59, 60, 86, 90]"
Shakespeare,L100,long,6,5,1,2,0.9434,106,"[16, 30, 57, 60, 89, 90]"
Shakespeare,L100,long,6,5,1,0,0.9434,106,"[16, 29, 55, 59, 87, 89]"
Shakespeare,L100,long,7,5,2,2,0.9346,107,"[16, 29, 56, 59, 61, 89, 92]"
Shakespeare,L100,long,6,4,2,6,0.9434,106,"[16, 29, 33, 59, 63, 90]"
Shakespeare,L100,long,7,5,2,1,0.9346,107,"[16, 29, 31, 58, 61, 62, 92]"
Shakespeare,L100,long,8,7,1,0,0.9259,108,"[16, 29, 31, 58, 61, 65, 94, 96]"
Shakespeare,L100,long,7,6,1,1,0.9346,107,"[28, 29, 55, 60, 87, 89, 90]"
Shakespeare,L100,long,6,5,1,0,0.9434,106,"[16, 29, 55, 59, 87, 89]"
Shakespeare,L100,long,9,7,2,1,0.9174,109,"[17, 29, 56, 59, 87, 89, 90, 91, 93]"
Shakespeare,L100,long,8,6,2,4,0.9259,108,"[28, 29, 31, 59, 61, 64, 90, 93]"
Shakespeare,L100,long,8,6,2,1,0.9259,108,"[28, 29, 56, 59, 86, 89, 90, 92]"
Shakespeare,L100,long,8,7,1,1,0.9259,108,"[17, 30, 34, 61, 64, 66, 94, 95]"
Shakespeare,L100,long,7,6,1,2,0.9346,107,"[28, 29, 30, 56, 61, 88, 91]"
Shakespeare,L100,long,7,6,1,2,0.9346,107,"[16, 30, 57, 60, 89, 90, 91]"
Shakespeare,L100,long,5,2,3,5,0.9524,105,"[31, 57, 61, 88, 90]"
Shakespeare,L100,long,7,7,0,7,0.9346,107,"[28, 30, 31, 36, 64, 90, 95]"
Shakespeare,L100,long,5,4,1,6,0.9524,105,"[28, 30, 62, 88, 91]"
Shakespeare,L100,long,7,7,0,3,0.9346,107,"[28, 29, 31, 59, 61, 89, 91]"
Shakespeare,L100,long,8,6,2,10,0.9259,108,"[28, 29, 30, 33, 60, 64, 90, 96]"
Shakespeare,L100,long,6,3,3,4,0.9434,106,"[18, 30, 57, 60, 88, 91]"
Shakespeare,L100,long,6,5,1,0,0.9434,106,"[17, 29, 55, 59, 87, 89]"
Shakespeare,L100,long,7,7,0,0,0.9346,107,"[28, 29, 55, 59, 85, 89, 90]"
Shakespeare,L100,long,7,6,1,2,0.9346,107,"[28, 29, 30, 56, 61, 88, 91]"
Shakespeare,L100,long,6,5,1,3,0.9434,106,"[16, 29, 33, 60, 89, 90]"
Shakespeare,L100,long,6,4,2,1,0.9434,106,"[17, 29, 56, 59, 87, 90]"
Shakespeare,L100,long,7,3,4,1,0.9346,107,"[28, 29, 57, 60, 90, 91, 92]"
Shakespeare,L100,long,6,5,1,3,0.9434,106,"[28, 29, 30, 64, 90, 93]"
Shakespeare,L100,long,8,8,0,0,0.9259,108,"[16, 29, 55, 59, 60, 89, 90, 91]"
Shakespeare,L100,long,7,5,2,0,0.9346,107,"[28, 29, 30, 58, 61, 88, 91]"
Shakespeare,L100,long,7,6,1,1,0.9346,107,"[28, 30, 58, 60, 87, 89, 91]"
Shakespeare,L100,long,6,5,1,1,0.9434,106,"[28, 29, 31, 60, 87, 90]"
Shakespeare,L100,long,10,9,1,1,0.9091,110,"[28, 29, 31, 59, 62, 89, 91, 92, 93, 94]"
Shakespeare,L100,long,7,6,1,0,0.9346,107,"[29, 30, 58, 60, 61, 89, 92]"
Shakespeare,L100,long,9,7,2,3,0.9174,109,"[28, 29, 30, 31, 57, 61, 64, 91, 94]"
Shakespeare,L100,long,5,1,4,2,0.9524,105,"[30, 60, 86, 89, 90]"
Shakespeare,L100,long,11,7,4,1,0.9009,111,"[16, 29, 31, 32, 34, 61, 65, 92, 95, 96, 98]"
Shakespeare,L100,long,5,2,3,3,0.9524,105,"[18, 30, 60, 87, 90]"
Shakespeare,L100,long,6,4,2,4,0.9434,106,"[28, 29, 55, 62, 88, 91]"
Shakespeare,L100,long,6,5,1,1,0.9434,106,"[16, 29, 55, 59, 87, 90]"
Shakespeare,L100,long,7,5,2,2,0.9346,107,"[17, 31, 59, 61, 88, 90, 91]"
Shakespeare,L100,long,5,3,2,8,0.9524,105,"[16, 31, 58, 63, 91]"
Shakespeare,L100,long,6,5,1,0,0.9434,106,"[29, 56, 59, 87, 88, 89]"
Shakespeare,L100,long,6,3,3,7,0.9434,106,"[16, 29, 33, 59, 63, 92]"
Shakespeare,L100,long,6,5,1,1,0.9434,106,"[16, 29, 55, 61, 88, 90]"
Shakespeare,L100,long,6,4,2,4,0.9434,106,"[16, 29, 55, 61, 88, 91]"
Shakespeare,L100,long,9,7,2,0,0.9174,109,"[16, 29, 56, 60, 61, 62, 63, 64, 94]"
Shakespeare,L100,long,5,3,2,7,0.9524,105,"[18, 34, 61, 88, 92]"
Shakespeare,L100,long,6,6,0,0,0.9434,106,"[16, 29, 55, 59, 88, 89]"
Shakespeare,L100,long,7,6,1,0,0.9346,107,"[28, 30, 31, 59, 61, 88, 91]"
Shakespeare,L100,long,6,5,1,3,0.9434,106,"[16, 30, 57, 60, 88, 90]"
Shakespeare,L100,long,6,5,1,2,0.9434,106,"[16, 30, 57, 60, 88, 90]"
Shakespeare,L100,long,7,6,1,1,0.9346,107,"[16, 29, 55, 60, 61, 89, 92]"
Shakespeare,L100,long,10,10,0,0,0.9091,110,"[16, 30, 31, 32, 33, 34, 62, 64, 92, 94]"
Shakespeare,L100,long,7,5,2,2,0.9346,107,"[16, 29, 56, 61, 88, 90, 94]"
Shakespeare,L100,long,7,6,1,0,0.9346,107,"[28, 30, 31, 59, 61, 88, 91]"
Shakespeare,L100,long,6,3,3,4,0.9434,106,"[28, 31, 58, 62, 88, 92]"
Shakespeare,L100,long,7,5,2,0,0.9346,107,"[18, 30, 57, 60, 88, 90, 91]"
Shakespeare,L100,long,5,2,3,4,0.9524,105,"[28, 31, 58, 62, 90]"
Shakespeare,L100,long,7,7,0,1,0.9346,107,"[16, 29, 31, 59, 61, 89, 91]"
Shakespeare,L100,long,5,4,1,4,0.9524,105,"[18, 33, 59, 87, 89]"
Shakespeare,L100,long,6,5,1,7,0.9434,106,"[28, 32, 58, 63, 89, 93]"
Shakespeare,L100,long,6,4,2,0,0.9434,106,"[29, 30, 58, 61, 89, 91]"
Shakespeare,L100,long,8,5,3,3,0.9259,108,"[28, 29, 30, 33, 60, 64, 90, 93]"
Shakespeare,L100,long,6,3,3,5,0.9434,106,"[28, 29, 57, 62, 88, 91]"
Shakespeare,L100,long,9,5,4,3,0.9174,109,"[28, 29, 30, 33, 61, 64, 90, 93, 94]"
Shakespeare,L100,long,6,5,1,10,0.9434,106,"[16, 29, 33, 59, 65, 93]"
Shakespeare,L100,long,10,7,3,3,0.9091,110,"[16, 29, 31, 59, 61, 64, 65, 66, 69, 98]"
Shakespeare,L100,long,6,6,0,0,0.9434,106,"[16, 29, 55, 59, 88, 89]"
Shakespeare,L100,long,6,4,2,2,0.9434,106,"[29, 56, 59, 61, 89, 93]"
Shakespeare,L100,long,7,4,3,0,0.9346,107,"[29, 56, 59, 86, 88, 90, 93]"
Shakespeare,L100,long,7,4,3,2,0.9346,107,"[17, 30, 58, 60, 62, 92, 93]"
Shakespeare,L100,long,5,3,2,4,0.9524,105,"[30, 58, 62, 88, 91]"
Shakespeare,L100,long,10,3,7,4,0.9091,110,"[16, 29, 33, 59, 63, 91, 93, 94, 95, 96]"
Shakespeare,L100,long,8,3,5,1,0.9259,108,"[29, 31, 59, 62, 88, 91, 92, 93]"
Shakespeare,L100,long,9,7,2,0,0.9174,109,"[16, 29, 55, 60, 61, 62, 64, 66, 97]"
Shakespeare,L100,long,7,4,3,3,0.9346,107,"[28, 29, 56, 59, 61, 88, 92]"
Shakespeare,L100,long,6,6,0,4,0.9434,106,"[16, 29, 34, 60, 88, 90]"
Shakespeare,L100,long,6,5,1,0,0.9434,106,"[16, 29, 55, 59, 87, 89]"
Shakespeare,L100,long,7,5,2,5,0.9346,107,"[16, 29, 55, 59, 63, 90, 93]"
