agent_name,layout,event_update_level,num_attention_switches,num_attention_switches_margins,num_attention_switches_middle,inform_loss,reading_speed,total_steps,attention_switches_time_steps_list
agent_c,L0,short,96,44,52,11,0.5102,196,"[1, 3, 4, 5, 6, 7, 8, 9, 11, 12, 13, 14, 15, 16, 17, 18, 19, 20, 22, 23, 24, 25, 26, 27, 28, 32, 33, 34, 35, 37, 38, 39, 40, 46, 48, 49, 50, 52, 53, 55, 56, 57, 58, 59, 60, 67, 68, 69, 71, 72, 74, 76, 77, 80, 83, 86, 87, 89, 90, 93, 96, 97, 98, 99, 100, 101, 102, 109, 110, 111, 112, 114, 120, 122, 123, 129, 130, 131, 132, 134, 135, 136, 146, 156, 157, 158, 167, 168, 172, 179, 180, 185, 186, 187, 190, 192]"
agent_c,L0,short,94,49,45,9,0.5155,194,"[1, 3, 4, 8, 12, 13, 14, 15, 17, 18, 20, 21, 22, 23, 24, 25, 26, 27, 29, 31, 32, 33, 35, 37, 39, 40, 44, 46, 47, 49, 50, 51, 54, 56, 57, 62, 63, 66, 67, 71, 72, 73, 74, 75, 76, 79, 80, 81, 82, 83, 85, 87, 88, 89, 90, 93, 94, 96, 100, 101, 102, 103, 105, 107, 110, 111, 114, 115, 116, 121, 122, 123, 124, 129, 134, 135, 136, 138, 146, 147, 154, 155, 157, 163, 164, 166, 168, 175, 176, 178, 184, 185, 187, 190]"
agent_c,L0,short,93,51,42,12,0.5181,193,"[2, 3, 5, 8, 10, 11, 12, 13, 15, 18, 19, 20, 21, 22, 23, 25, 26, 27, 28, 29, 31, 32, 33, 34, 35, 36, 37, 39, 40, 41, 42, 45, 47, 48, 50, 51, 52, 53, 54, 60, 61, 62, 63, 64, 65, 67, 69, 71, 72, 74, 77, 84, 85, 86, 87, 88, 89, 90, 91, 92, 93, 94, 95, 102, 106, 110, 111, 112, 114, 116, 117, 118, 124, 125, 126, 131, 137, 138, 141, 147, 148, 151, 160, 166, 167, 169, 170, 178, 179, 180, 187, 189, 190]"
agent_c,L0,short,96,52,44,8,0.5102,196,"[0, 1, 3, 4, 5, 6, 7, 8, 9, 11, 13, 15, 17, 18, 20, 21, 22, 23, 25, 26, 27, 28, 29, 30, 31, 32, 35, 36, 37, 38, 39, 40, 42, 43, 44, 48, 50, 51, 52, 53, 54, 55, 56, 57, 59, 61, 66, 67, 68, 69, 70, 72, 73, 75, 76, 77, 78, 80, 82, 89, 90, 92, 94, 96, 100, 101, 102, 104, 112, 113, 114, 119, 120, 121, 123, 125, 131, 132, 133, 136, 145, 153, 155, 156, 163, 164, 166, 167, 174, 175, 176, 177, 184, 186, 187, 188]"
agent_c,L0,short,96,45,51,3,0.5102,196,"[0, 1, 4, 5, 6, 8, 9, 11, 12, 13, 14, 15, 16, 17, 18, 20, 21, 24, 25, 26, 27, 28, 30, 33, 37, 38, 39, 40, 42, 43, 44, 46, 47, 48, 49, 50, 52, 53, 54, 56, 57, 59, 60, 61, 62, 63, 69, 70, 71, 72, 73, 74, 75, 77, 78, 79, 80, 81, 82, 84, 90, 92, 93, 94, 96, 98, 99, 100, 102, 104, 107, 113, 115, 116, 117, 118, 126, 129, 137, 138, 139, 146, 149, 155, 156, 157, 158, 159, 168, 170, 179, 180, 187, 188, 189, 190]"
agent_c,L0,short,96,41,55,10,0.5102,196,"[3, 5, 6, 7, 8, 10, 13, 14, 15, 16, 18, 19, 20, 21, 23, 25, 28, 32, 33, 34, 35, 36, 37, 38, 39, 40, 41, 43, 44, 45, 46, 47, 49, 50, 52, 53, 56, 59, 61, 62, 63, 64, 65, 67, 69, 73, 75, 76, 77, 78, 79, 81, 82, 83, 84, 85, 87, 91, 92, 94, 96, 98, 99, 103, 104, 106, 107, 108, 109, 115, 116, 118, 119, 120, 124, 133, 139, 140, 141, 142, 150, 151, 154, 160, 162, 163, 164, 172, 173, 174, 184, 189, 190, 191, 193, 194]"
agent_c,L0,short,93,38,55,10,0.5181,193,"[0, 2, 3, 4, 6, 8, 9, 14, 15, 17, 19, 21, 22, 24, 25, 26, 27, 28, 29, 31, 33, 35, 36, 37, 39, 42, 43, 44, 48, 49, 50, 52, 53, 54, 55, 57, 59, 60, 62, 64, 65, 67, 68, 69, 70, 74, 77, 78, 79, 80, 81, 82, 83, 84, 86, 89, 90, 91, 93, 94, 95, 96, 97, 98, 100, 101, 108, 109, 112, 117, 118, 119, 120, 121, 122, 129, 130, 131, 132, 139, 141, 143, 145, 153, 154, 157, 165, 167, 175, 176, 183, 184, 187]"
agent_c,L0,short,93,41,52,11,0.5181,193,"[1, 4, 5, 7, 8, 9, 12, 13, 14, 16, 18, 19, 20, 23, 24, 25, 26, 28, 30, 31, 32, 34, 35, 37, 38, 39, 40, 41, 42, 43, 44, 45, 46, 47, 48, 49, 51, 52, 53, 55, 56, 59, 60, 63, 65, 66, 67, 68, 70, 71, 72, 74, 75, 76, 81, 83, 84, 86, 87, 88, 89, 90, 91, 94, 95, 98, 104, 106, 109, 111, 112, 116, 117, 118, 123, 129, 136, 137, 141, 147, 148, 149, 150, 158, 159, 160, 167, 169, 170, 181, 188, 189, 190]"
agent_c,L0,short,92,51,41,9,0.5208,192,"[0, 2, 3, 4, 5, 6, 7, 8, 9, 11, 12, 14, 15, 16, 17, 19, 20, 21, 23, 24, 25, 26, 27, 28, 29, 31, 33, 34, 36, 38, 40, 41, 42, 45, 46, 47, 48, 49, 50, 51, 52, 53, 54, 56, 57, 59, 60, 63, 67, 68, 69, 70, 71, 72, 74, 75, 77, 78, 79, 80, 82, 91, 92, 95, 97, 98, 99, 101, 102, 103, 109, 110, 114, 120, 121, 123, 125, 132, 133, 135, 143, 146, 153, 154, 155, 163, 167, 173, 174, 175, 178, 187]"
agent_c,L0,short,94,55,39,6,0.5155,194,"[0, 1, 2, 3, 4, 5, 7, 9, 11, 13, 14, 15, 16, 17, 18, 19, 21, 22, 23, 24, 25, 27, 28, 30, 31, 32, 33, 34, 35, 37, 38, 39, 40, 42, 44, 46, 48, 49, 50, 52, 53, 54, 55, 56, 58, 59, 60, 61, 63, 70, 72, 73, 75, 76, 78, 80, 81, 82, 83, 89, 90, 92, 94, 95, 96, 97, 98, 103, 110, 112, 113, 120, 123, 129, 130, 131, 134, 141, 143, 150, 151, 152, 153, 160, 161, 163, 171, 172, 175, 176, 178, 186, 187, 191]"
agent_c,L0,short,92,47,45,3,0.5208,192,"[0, 1, 2, 5, 6, 7, 8, 9, 10, 11, 12, 15, 16, 18, 19, 22, 23, 24, 28, 32, 33, 34, 37, 38, 39, 41, 42, 43, 44, 46, 48, 49, 51, 52, 54, 55, 56, 57, 61, 62, 64, 65, 66, 70, 71, 72, 77, 78, 80, 82, 86, 88, 89, 90, 91, 92, 94, 96, 97, 98, 100, 102, 103, 104, 105, 106, 107, 113, 115, 116, 117, 122, 123, 124, 126, 127, 128, 135, 138, 146, 148, 155, 156, 157, 158, 165, 167, 169, 177, 178, 184, 188]"
agent_c,L0,short,98,39,59,6,0.5051,198,"[0, 1, 2, 4, 5, 7, 8, 9, 11, 12, 13, 14, 15, 17, 19, 21, 22, 23, 24, 26, 29, 30, 32, 33, 34, 35, 37, 38, 39, 40, 42, 43, 44, 45, 46, 49, 51, 52, 53, 54, 55, 57, 58, 59, 60, 61, 65, 69, 71, 74, 75, 77, 78, 81, 82, 83, 84, 88, 89, 90, 92, 94, 95, 96, 97, 99, 100, 102, 103, 104, 105, 113, 114, 115, 118, 120, 127, 129, 136, 137, 138, 140, 141, 143, 145, 153, 154, 162, 163, 164, 173, 177, 185, 186, 193, 194, 195, 196]"
agent_c,L0,short,95,54,41,8,0.5128,195,"[0, 1, 3, 5, 7, 9, 10, 11, 13, 15, 17, 18, 20, 22, 23, 24, 25, 26, 27, 28, 29, 30, 31, 32, 33, 34, 35, 36, 38, 41, 42, 43, 44, 46, 47, 48, 49, 50, 51, 52, 54, 55, 59, 61, 66, 70, 71, 73, 74, 76, 77, 78, 82, 83, 84, 87, 91, 92, 93, 94, 95, 98, 99, 101, 102, 104, 105, 110, 111, 113, 115, 121, 122, 123, 124, 126, 132, 133, 134, 135, 144, 146, 153, 155, 156, 164, 165, 166, 173, 174, 175, 177, 185, 187, 188]"
agent_c,L0,short,98,49,49,3,0.5051,198,"[0, 1, 2, 3, 5, 8, 9, 10, 11, 13, 15, 18, 19, 21, 22, 24, 25, 26, 27, 29, 30, 32, 33, 35, 37, 38, 39, 40, 42, 43, 44, 45, 47, 48, 50, 52, 53, 54, 55, 56, 57, 61, 63, 64, 65, 67, 71, 75, 76, 78, 81, 82, 83, 84, 85, 86, 87, 90, 92, 99, 100, 101, 103, 104, 105, 106, 107, 108, 110, 111, 116, 117, 118, 120, 121, 127, 128, 129, 130, 131, 139, 140, 141, 142, 153, 160, 161, 162, 163, 164, 165, 173, 174, 175, 184, 186, 194, 196]"
agent_c,L0,short,95,52,43,12,0.5128,195,"[1, 2, 4, 9, 11, 12, 13, 15, 16, 17, 19, 20, 22, 25, 28, 29, 32, 34, 35, 36, 37, 38, 42, 43, 44, 45, 46, 47, 48, 49, 50, 53, 54, 56, 57, 58, 59, 61, 62, 63, 64, 65, 66, 68, 69, 70, 71, 74, 76, 77, 78, 79, 83, 87, 92, 93, 94, 95, 96, 97, 99, 100, 102, 103, 108, 109, 110, 111, 112, 113, 114, 120, 121, 123, 124, 130, 131, 132, 133, 136, 137, 140, 148, 149, 150, 153, 163, 170, 171, 172, 173, 181, 182, 184, 193]"
agent_c,L0,short,93,44,49,6,0.5181,193,"[0, 1, 2, 3, 4, 7, 9, 12, 13, 15, 16, 17, 18, 19, 21, 24, 26, 28, 29, 30, 32, 33, 37, 39, 40, 41, 42, 43, 44, 45, 46, 47, 49, 50, 51, 53, 55, 56, 57, 58, 59, 61, 62, 66, 67, 68, 69, 71, 72, 75, 76, 77, 80, 81, 84, 89, 90, 92, 93, 94, 95, 96, 97, 98, 101, 102, 103, 104, 107, 112, 115, 116, 121, 126, 127, 133, 134, 136, 140, 147, 149, 156, 157, 158, 166, 167, 168, 169, 176, 178, 179, 187, 189]"
agent_c,L0,short,97,49,48,10,0.5076,197,"[0, 1, 3, 5, 6, 7, 8, 9, 10, 14, 17, 19, 21, 22, 23, 25, 26, 27, 28, 29, 30, 31, 32, 33, 35, 36, 37, 39, 40, 42, 43, 44, 46, 49, 50, 51, 53, 54, 58, 59, 62, 64, 66, 68, 70, 71, 72, 74, 78, 79, 81, 82, 85, 86, 89, 90, 91, 93, 94, 95, 96, 97, 98, 99, 101, 107, 108, 109, 112, 118, 119, 120, 121, 122, 123, 124, 125, 133, 135, 143, 144, 145, 151, 153, 154, 160, 167, 173, 174, 175, 177, 179, 186, 187, 188, 189, 190]"
agent_c,L0,short,99,58,41,11,0.5025,199,"[1, 2, 3, 4, 5, 6, 7, 9, 10, 11, 14, 15, 16, 17, 18, 20, 21, 22, 23, 24, 25, 26, 27, 28, 30, 31, 32, 33, 36, 37, 38, 40, 42, 44, 45, 51, 52, 53, 54, 56, 57, 59, 63, 64, 67, 68, 69, 72, 75, 76, 77, 78, 80, 83, 85, 86, 87, 88, 90, 92, 93, 99, 100, 101, 102, 103, 106, 109, 110, 111, 112, 113, 114, 120, 122, 123, 125, 132, 133, 134, 135, 142, 143, 144, 145, 146, 155, 156, 157, 165, 166, 167, 169, 178, 179, 188, 189, 192, 197]"
agent_c,L0,short,94,53,41,4,0.5155,194,"[0, 1, 10, 11, 12, 13, 14, 15, 17, 18, 19, 20, 23, 24, 25, 26, 28, 29, 30, 32, 34, 35, 36, 39, 40, 41, 43, 45, 48, 50, 51, 53, 54, 55, 56, 57, 58, 60, 62, 63, 64, 65, 66, 69, 72, 73, 76, 77, 78, 79, 80, 81, 82, 84, 85, 87, 90, 92, 94, 95, 98, 99, 102, 103, 105, 107, 109, 110, 111, 113, 114, 115, 121, 122, 123, 124, 125, 133, 136, 143, 146, 153, 154, 155, 156, 163, 165, 167, 175, 178, 184, 187, 191, 192]"
agent_c,L0,short,101,48,53,11,0.495,200,"[0, 2, 3, 4, 6, 7, 9, 10, 12, 16, 17, 19, 20, 21, 24, 25, 26, 28, 29, 30, 32, 33, 34, 35, 36, 38, 39, 40, 41, 42, 43, 44, 45, 47, 48, 49, 50, 54, 57, 60, 62, 63, 64, 65, 67, 68, 69, 70, 71, 75, 76, 77, 78, 79, 81, 84, 85, 86, 87, 88, 89, 90, 94, 101, 102, 104, 108, 109, 111, 114, 120, 123, 125, 130, 131, 132, 135, 141, 142, 143, 145, 153, 154, 155, 164, 165, 172, 173, 176, 177, 184, 185, 187, 188, 192, 193, 194, 195, 196, 197, 199]"
agent_c,L0,short,93,43,50,8,0.5181,193,"[2, 3, 5, 6, 7, 10, 11, 12, 16, 18, 23, 25, 26, 27, 28, 30, 31, 34, 35, 36, 38, 39, 40, 42, 43, 46, 47, 48, 50, 53, 54, 55, 56, 57, 60, 61, 63, 64, 65, 66, 67, 70, 71, 73, 74, 75, 76, 77, 78, 79, 81, 85, 86, 88, 89, 91, 92, 93, 94, 95, 96, 98, 99, 101, 106, 107, 109, 111, 115, 116, 117, 118, 119, 122, 130, 131, 137, 138, 139, 141, 142, 143, 150, 151, 152, 153, 155, 164, 171, 174, 183, 184, 191]"
agent_c,L0,short,94,32,62,8,0.5155,194,"[0, 1, 3, 4, 5, 6, 8, 9, 10, 11, 12, 13, 14, 15, 16, 17, 18, 19, 20, 21, 22, 23, 24, 25, 26, 27, 28, 29, 30, 34, 35, 36, 37, 39, 40, 42, 43, 47, 48, 49, 50, 54, 55, 56, 57, 59, 60, 61, 62, 63, 64, 65, 67, 75, 76, 77, 79, 81, 83, 86, 87, 88, 89, 98, 99, 101, 103, 105, 107, 108, 110, 111, 119, 121, 126, 127, 128, 129, 134, 141, 142, 143, 150, 151, 153, 155, 162, 168, 176, 183, 185, 186, 190, 191]"
agent_c,L0,short,95,27,68,10,0.5128,195,"[0, 2, 3, 4, 6, 7, 8, 9, 11, 12, 13, 14, 15, 16, 17, 18, 19, 20, 22, 23, 26, 28, 29, 31, 33, 35, 36, 37, 38, 40, 44, 45, 47, 48, 49, 50, 51, 52, 53, 54, 55, 56, 57, 58, 59, 60, 61, 62, 63, 64, 66, 67, 69, 72, 73, 78, 83, 84, 87, 88, 89, 90, 91, 92, 93, 96, 104, 105, 108, 109, 110, 112, 113, 114, 115, 122, 123, 124, 125, 126, 134, 135, 136, 145, 146, 154, 156, 165, 167, 178, 185, 186, 190, 191, 192]"
agent_c,L0,short,95,47,48,16,0.5128,195,"[0, 2, 3, 5, 6, 7, 8, 9, 10, 11, 13, 14, 15, 16, 19, 20, 21, 23, 24, 25, 26, 28, 29, 30, 31, 32, 34, 35, 36, 37, 38, 39, 41, 42, 43, 44, 45, 46, 48, 49, 50, 51, 53, 55, 56, 57, 58, 59, 60, 67, 74, 75, 76, 77, 78, 80, 81, 87, 89, 91, 92, 93, 96, 97, 99, 100, 101, 103, 105, 112, 113, 114, 115, 116, 123, 125, 126, 133, 134, 135, 136, 141, 149, 155, 156, 157, 165, 167, 174, 176, 178, 185, 186, 187, 188]"
agent_c,L0,short,92,28,64,15,0.5208,192,"[1, 2, 3, 4, 5, 6, 7, 8, 10, 11, 12, 13, 14, 15, 16, 17, 19, 20, 21, 22, 23, 24, 25, 26, 27, 28, 29, 30, 31, 32, 34, 35, 39, 41, 45, 47, 48, 49, 52, 53, 55, 56, 57, 58, 62, 64, 65, 66, 68, 69, 73, 77, 78, 79, 80, 81, 82, 83, 84, 85, 91, 96, 97, 98, 99, 101, 102, 103, 104, 108, 110, 117, 119, 125, 128, 133, 141, 149, 155, 156, 157, 160, 169, 172, 178, 179, 180, 181, 186, 187, 188, 190]"
agent_c,L0,short,92,45,47,10,0.5208,192,"[1, 2, 3, 4, 5, 7, 8, 9, 10, 12, 13, 14, 19, 20, 21, 23, 25, 26, 27, 28, 29, 31, 32, 38, 40, 41, 42, 44, 45, 47, 48, 49, 50, 51, 58, 59, 60, 61, 63, 65, 66, 68, 70, 71, 72, 74, 75, 76, 77, 78, 79, 82, 83, 87, 90, 94, 96, 98, 99, 101, 103, 106, 108, 111, 112, 115, 118, 119, 120, 123, 124, 125, 130, 132, 133, 138, 145, 147, 153, 154, 155, 159, 165, 166, 167, 169, 176, 177, 179, 185, 186, 188]"
agent_c,L0,short,96,42,54,7,0.5102,196,"[0, 2, 4, 5, 6, 7, 8, 9, 10, 11, 13, 14, 16, 17, 18, 19, 20, 21, 22, 23, 24, 26, 27, 29, 31, 32, 33, 36, 37, 39, 40, 41, 43, 44, 50, 51, 52, 53, 54, 55, 57, 59, 60, 61, 63, 67, 68, 69, 70, 71, 72, 73, 74, 76, 77, 79, 80, 82, 83, 85, 88, 95, 96, 97, 98, 100, 102, 104, 107, 108, 116, 117, 118, 124, 125, 127, 128, 130, 138, 141, 153, 158, 159, 160, 167, 168, 169, 170, 171, 178, 179, 180, 181, 188, 189, 191]"
agent_c,L0,short,96,42,54,3,0.5102,196,"[0, 1, 3, 4, 6, 7, 8, 9, 10, 12, 13, 15, 17, 19, 20, 22, 23, 24, 25, 27, 28, 29, 30, 35, 37, 38, 39, 40, 41, 42, 43, 44, 45, 46, 47, 48, 49, 51, 52, 54, 55, 56, 59, 62, 63, 64, 66, 67, 69, 70, 76, 78, 79, 80, 81, 82, 84, 86, 90, 93, 94, 95, 96, 97, 98, 99, 101, 105, 106, 107, 108, 109, 111, 119, 120, 121, 129, 130, 131, 138, 140, 143, 150, 151, 152, 160, 161, 162, 170, 172, 179, 181, 182, 188, 190, 192]"
agent_c,L0,short,91,51,40,9,0.5236,191,"[0, 1, 2, 4, 6, 7, 11, 14, 15, 16, 18, 19, 20, 21, 22, 23, 25, 26, 27, 28, 30, 32, 33, 34, 35, 37, 38, 40, 42, 43, 44, 45, 46, 48, 51, 54, 55, 58, 59, 60, 62, 66, 68, 69, 71, 74, 76, 77, 78, 80, 82, 84, 85, 88, 91, 94, 95, 96, 97, 99, 101, 102, 103, 104, 106, 108, 109, 111, 112, 113, 119, 120, 121, 123, 124, 125, 132, 133, 134, 135, 142, 145, 154, 156, 164, 165, 174, 176, 183, 186, 189]"
agent_c,L0,short,95,37,58,11,0.5128,195,"[0, 3, 4, 7, 8, 9, 10, 11, 12, 13, 14, 15, 17, 18, 19, 21, 22, 23, 24, 25, 27, 28, 29, 30, 31, 34, 35, 41, 42, 43, 44, 45, 46, 47, 48, 49, 51, 52, 53, 54, 55, 56, 57, 58, 59, 60, 61, 64, 66, 68, 70, 72, 74, 75, 76, 77, 78, 84, 85, 86, 87, 89, 90, 91, 92, 93, 94, 95, 96, 98, 102, 109, 115, 117, 121, 122, 123, 125, 132, 133, 134, 136, 138, 147, 148, 158, 166, 167, 168, 176, 177, 178, 182, 188, 189]"
agent_c,L0,short,94,55,39,13,0.5155,194,"[2, 4, 5, 6, 7, 9, 10, 11, 12, 14, 15, 16, 18, 19, 21, 22, 28, 32, 33, 34, 36, 37, 40, 43, 46, 47, 48, 49, 50, 52, 53, 54, 55, 57, 59, 60, 61, 63, 65, 66, 68, 70, 71, 72, 76, 77, 78, 79, 80, 81, 82, 83, 85, 86, 87, 88, 89, 90, 91, 92, 93, 99, 100, 102, 104, 107, 108, 110, 113, 114, 115, 116, 117, 120, 127, 128, 133, 140, 146, 147, 148, 149, 150, 159, 160, 161, 170, 172, 178, 179, 180, 182, 190, 191]"
agent_c,L0,short,93,43,50,8,0.5181,193,"[1, 2, 3, 4, 5, 7, 9, 11, 12, 13, 14, 16, 18, 20, 21, 23, 24, 25, 26, 27, 28, 29, 30, 31, 34, 36, 37, 38, 39, 40, 41, 42, 43, 45, 47, 48, 49, 50, 51, 52, 54, 55, 56, 57, 58, 60, 61, 62, 65, 71, 72, 73, 74, 75, 76, 77, 78, 79, 80, 81, 83, 84, 94, 96, 97, 98, 99, 101, 102, 103, 106, 113, 114, 115, 122, 123, 124, 125, 132, 133, 135, 144, 145, 146, 153, 155, 156, 164, 165, 166, 175, 179, 187]"
agent_c,L0,short,95,58,37,7,0.5128,195,"[0, 1, 3, 4, 5, 7, 8, 9, 10, 11, 12, 13, 15, 17, 18, 19, 20, 21, 22, 23, 25, 26, 27, 28, 29, 30, 32, 33, 34, 37, 38, 39, 41, 42, 43, 44, 45, 47, 51, 52, 53, 54, 55, 57, 58, 60, 61, 62, 65, 66, 74, 75, 76, 78, 79, 80, 81, 82, 83, 84, 85, 86, 88, 94, 95, 97, 98, 103, 104, 107, 110, 117, 118, 124, 125, 127, 128, 136, 138, 139, 147, 149, 155, 157, 158, 159, 167, 169, 177, 179, 184, 186, 187, 188, 189]"
agent_c,L0,short,99,50,49,12,0.5025,199,"[2, 4, 5, 6, 7, 8, 9, 10, 11, 12, 13, 14, 16, 18, 19, 20, 21, 22, 23, 24, 25, 26, 27, 29, 30, 32, 33, 35, 37, 38, 40, 42, 44, 45, 46, 47, 48, 50, 51, 52, 53, 55, 56, 57, 58, 59, 60, 65, 66, 70, 71, 72, 73, 74, 75, 76, 77, 79, 80, 88, 92, 95, 97, 98, 99, 100, 105, 110, 114, 118, 120, 122, 128, 131, 138, 139, 141, 142, 147, 148, 149, 151, 152, 153, 160, 161, 162, 163, 165, 172, 174, 176, 183, 184, 186, 193, 194, 195, 196]"
agent_c,L0,short,94,42,52,11,0.5155,194,"[1, 3, 4, 5, 6, 9, 12, 13, 14, 16, 17, 18, 22, 23, 28, 29, 30, 32, 34, 35, 37, 38, 39, 40, 41, 45, 47, 49, 50, 51, 53, 54, 55, 56, 59, 60, 61, 64, 65, 69, 71, 72, 73, 74, 76, 77, 78, 80, 82, 83, 84, 85, 86, 88, 92, 96, 98, 102, 103, 106, 107, 108, 110, 111, 112, 114, 119, 120, 121, 123, 129, 132, 133, 142, 146, 151, 153, 154, 157, 163, 164, 165, 166, 168, 174, 176, 177, 178, 180, 182, 188, 189, 190, 191]"
agent_c,L0,short,92,43,49,9,0.5208,192,"[0, 1, 2, 3, 4, 5, 7, 8, 9, 10, 12, 15, 16, 17, 20, 21, 22, 23, 24, 26, 27, 28, 30, 32, 33, 35, 36, 37, 38, 40, 44, 45, 46, 47, 48, 49, 50, 51, 54, 58, 60, 63, 64, 67, 69, 70, 74, 75, 78, 79, 80, 81, 82, 83, 84, 87, 89, 90, 92, 94, 95, 96, 97, 101, 103, 105, 106, 107, 113, 114, 115, 116, 119, 125, 127, 136, 137, 143, 144, 148, 155, 156, 159, 165, 167, 174, 175, 177, 183, 184, 186, 187]"
agent_c,L0,short,95,49,46,7,0.5128,195,"[0, 4, 5, 6, 7, 9, 11, 12, 13, 14, 15, 19, 20, 21, 23, 25, 26, 27, 28, 29, 33, 34, 35, 36, 37, 39, 40, 41, 42, 43, 48, 49, 50, 51, 52, 53, 57, 58, 61, 63, 64, 66, 67, 70, 71, 72, 73, 76, 77, 79, 80, 81, 83, 84, 85, 89, 90, 92, 93, 96, 97, 98, 99, 101, 102, 103, 104, 107, 113, 114, 116, 120, 121, 122, 123, 126, 132, 133, 134, 135, 136, 146, 153, 155, 156, 158, 167, 173, 174, 175, 177, 184, 185, 186, 187]"
agent_c,L0,short,94,62,32,6,0.5155,194,"[0, 1, 2, 3, 5, 9, 10, 11, 12, 16, 17, 19, 20, 22, 23, 24, 25, 26, 28, 29, 30, 31, 32, 33, 37, 38, 39, 40, 41, 42, 43, 45, 48, 49, 50, 51, 52, 53, 54, 55, 56, 58, 59, 60, 61, 66, 68, 71, 73, 74, 75, 76, 77, 78, 79, 81, 87, 88, 89, 90, 94, 95, 97, 98, 99, 100, 102, 109, 110, 111, 115, 116, 117, 118, 120, 121, 128, 130, 132, 140, 141, 142, 150, 151, 152, 161, 162, 170, 171, 174, 181, 182, 189, 192]"
agent_c,L0,short,98,44,54,8,0.5051,198,"[2, 4, 6, 7, 9, 10, 11, 12, 15, 16, 18, 21, 23, 25, 29, 31, 34, 36, 37, 38, 39, 40, 42, 43, 44, 46, 48, 49, 52, 53, 54, 55, 56, 57, 58, 59, 60, 61, 63, 69, 70, 71, 72, 74, 75, 77, 78, 79, 80, 81, 82, 83, 87, 90, 92, 93, 94, 95, 96, 97, 98, 100, 101, 104, 105, 106, 107, 109, 111, 112, 120, 122, 128, 129, 130, 131, 133, 140, 141, 142, 144, 152, 153, 154, 163, 164, 171, 173, 174, 176, 183, 186, 187, 188, 192, 194, 195, 196]"
agent_c,L0,short,97,42,55,7,0.5076,197,"[0, 1, 2, 3, 6, 7, 8, 9, 11, 12, 13, 14, 15, 16, 17, 19, 20, 21, 22, 25, 26, 27, 28, 30, 31, 33, 34, 35, 37, 39, 40, 42, 43, 44, 45, 46, 47, 48, 49, 50, 51, 53, 57, 58, 60, 61, 62, 63, 66, 67, 69, 70, 71, 72, 74, 81, 82, 83, 84, 85, 86, 87, 89, 91, 92, 93, 101, 104, 108, 109, 111, 112, 113, 119, 120, 121, 123, 130, 131, 132, 134, 141, 144, 152, 153, 155, 162, 163, 164, 165, 167, 176, 177, 181, 188, 190, 193]"
agent_c,L0,short,95,56,39,8,0.5128,195,"[0, 2, 3, 4, 8, 9, 10, 11, 13, 14, 15, 16, 18, 19, 21, 22, 23, 25, 26, 27, 28, 29, 31, 32, 34, 35, 37, 42, 43, 45, 46, 47, 49, 50, 51, 54, 56, 57, 58, 59, 61, 63, 64, 66, 70, 71, 72, 73, 77, 79, 80, 81, 82, 88, 89, 92, 94, 97, 99, 100, 102, 104, 105, 106, 107, 112, 113, 118, 119, 120, 122, 123, 128, 129, 130, 131, 135, 136, 139, 148, 156, 157, 162, 163, 164, 166, 167, 176, 177, 178, 179, 185, 186, 189, 190]"
agent_c,L0,short,96,30,66,13,0.5102,196,"[0, 1, 3, 5, 6, 7, 8, 9, 10, 11, 12, 13, 15, 17, 19, 21, 22, 24, 25, 26, 27, 28, 30, 31, 32, 33, 35, 37, 38, 39, 41, 44, 45, 47, 48, 49, 50, 51, 53, 56, 58, 60, 62, 63, 64, 67, 68, 70, 71, 72, 73, 74, 78, 79, 81, 83, 84, 86, 92, 93, 94, 95, 96, 97, 98, 99, 101, 103, 106, 111, 112, 114, 115, 116, 118, 125, 129, 136, 137, 138, 145, 146, 147, 148, 156, 157, 158, 166, 167, 168, 169, 171, 179, 180, 189, 190]"
agent_c,L0,short,92,44,48,7,0.5208,192,"[1, 3, 4, 6, 7, 9, 12, 13, 14, 16, 18, 20, 21, 22, 23, 24, 25, 27, 28, 29, 30, 31, 32, 33, 34, 35, 36, 37, 39, 41, 43, 44, 45, 46, 47, 52, 59, 61, 62, 64, 65, 68, 69, 71, 72, 75, 76, 77, 78, 79, 81, 82, 83, 86, 87, 88, 89, 91, 94, 96, 101, 104, 105, 107, 108, 109, 111, 114, 115, 119, 122, 123, 124, 127, 128, 137, 139, 145, 146, 149, 150, 157, 158, 159, 161, 168, 169, 171, 179, 180, 187, 190]"
agent_c,L0,short,95,46,49,6,0.5128,195,"[0, 3, 6, 7, 9, 10, 11, 14, 15, 17, 18, 19, 21, 22, 23, 24, 26, 27, 28, 29, 30, 31, 32, 33, 35, 36, 37, 38, 39, 41, 42, 43, 45, 46, 47, 48, 50, 51, 53, 56, 59, 61, 62, 64, 65, 67, 68, 71, 72, 73, 77, 78, 79, 80, 81, 83, 84, 85, 86, 88, 89, 90, 92, 94, 101, 102, 103, 113, 118, 119, 122, 123, 124, 131, 132, 133, 134, 143, 144, 146, 154, 155, 159, 165, 166, 167, 173, 175, 177, 178, 184, 186, 187, 189, 193]"
agent_c,L0,short,90,50,40,13,0.5263,190,"[3, 7, 8, 12, 13, 14, 17, 19, 24, 26, 32, 33, 35, 36, 37, 39, 41, 42, 43, 44, 45, 46, 47, 48, 49, 50, 51, 52, 56, 57, 58, 60, 61, 62, 64, 65, 68, 69, 70, 73, 74, 75, 77, 78, 79, 80, 81, 82, 83, 85, 88, 89, 94, 95, 96, 98, 99, 102, 104, 105, 106, 108, 109, 110, 111, 113, 115, 119, 121, 123, 125, 131, 132, 133, 135, 140, 141, 142, 143, 144, 145, 153, 155, 163, 168, 176, 178, 184, 186, 187]"
agent_c,L0,short,97,49,48,4,0.5076,197,"[3, 5, 6, 7, 8, 9, 10, 12, 14, 19, 20, 21, 23, 24, 26, 29, 30, 31, 32, 35, 36, 39, 40, 41, 42, 43, 45, 46, 47, 49, 50, 51, 52, 54, 56, 59, 60, 61, 62, 63, 65, 66, 67, 68, 70, 72, 74, 75, 78, 79, 80, 81, 83, 85, 86, 87, 88, 92, 95, 96, 99, 100, 104, 105, 108, 109, 110, 111, 113, 117, 120, 121, 122, 123, 129, 132, 133, 141, 142, 143, 149, 151, 153, 160, 161, 162, 163, 170, 171, 172, 174, 181, 182, 183, 185, 193, 194]"
agent_c,L0,short,97,61,36,10,0.5076,197,"[0, 1, 4, 5, 6, 7, 8, 9, 10, 14, 16, 17, 18, 19, 20, 21, 22, 23, 24, 26, 27, 28, 35, 36, 37, 41, 49, 50, 51, 52, 53, 54, 55, 57, 58, 59, 60, 61, 62, 63, 64, 65, 66, 67, 68, 69, 70, 71, 72, 75, 77, 79, 80, 81, 82, 83, 87, 88, 89, 90, 91, 93, 94, 95, 97, 98, 99, 100, 101, 102, 103, 104, 105, 106, 107, 117, 124, 125, 128, 129, 137, 138, 139, 140, 148, 149, 150, 151, 153, 161, 163, 171, 173, 181, 182, 184, 193]"
agent_c,L0,short,99,48,51,7,0.5025,199,"[1, 2, 4, 5, 6, 7, 8, 9, 11, 12, 13, 14, 16, 18, 21, 26, 27, 28, 29, 31, 32, 33, 34, 35, 36, 38, 41, 42, 43, 48, 49, 50, 52, 55, 56, 58, 59, 61, 63, 64, 65, 67, 69, 71, 73, 77, 78, 79, 81, 82, 83, 84, 85, 87, 88, 89, 92, 95, 97, 98, 99, 100, 102, 103, 104, 105, 106, 108, 111, 112, 113, 118, 119, 122, 123, 130, 132, 133, 139, 140, 141, 144, 151, 153, 154, 155, 162, 163, 164, 166, 174, 175, 183, 184, 187, 193, 194, 195, 196]"
agent_c,L0,short,94,46,48,7,0.5155,194,"[0, 1, 2, 5, 6, 7, 10, 11, 12, 13, 14, 17, 18, 19, 22, 23, 25, 26, 27, 29, 30, 31, 32, 34, 35, 38, 40, 41, 42, 44, 45, 46, 49, 50, 51, 52, 53, 54, 55, 56, 61, 63, 65, 66, 68, 70, 72, 73, 74, 75, 76, 77, 80, 81, 83, 88, 89, 90, 92, 94, 95, 96, 97, 98, 99, 100, 101, 103, 110, 112, 113, 118, 120, 122, 123, 128, 136, 142, 144, 145, 147, 154, 155, 156, 164, 165, 166, 174, 176, 177, 184, 185, 187, 188]"
agent_c,L0,short,101,40,61,8,0.495,200,"[2, 4, 5, 6, 7, 8, 9, 11, 12, 13, 15, 16, 17, 19, 20, 21, 22, 25, 26, 29, 30, 33, 36, 38, 39, 40, 41, 47, 48, 49, 51, 52, 53, 54, 55, 57, 59, 60, 63, 65, 66, 67, 70, 71, 74, 75, 77, 78, 80, 83, 87, 89, 90, 92, 93, 95, 98, 99, 101, 102, 105, 107, 108, 110, 111, 113, 115, 121, 122, 125, 131, 133, 134, 135, 141, 143, 144, 145, 151, 152, 153, 154, 155, 156, 163, 164, 165, 166, 173, 174, 175, 177, 178, 180, 189, 193, 194, 196, 197, 198, 199]"
agent_c,L0,short,99,48,51,3,0.5025,199,"[2, 3, 4, 5, 6, 7, 9, 10, 12, 13, 14, 15, 16, 17, 20, 23, 28, 29, 32, 33, 34, 35, 36, 37, 38, 39, 40, 41, 42, 44, 45, 47, 49, 50, 51, 52, 53, 55, 56, 58, 59, 60, 61, 62, 65, 66, 68, 71, 74, 75, 76, 78, 79, 80, 81, 82, 83, 84, 85, 86, 88, 91, 92, 100, 101, 102, 103, 107, 109, 110, 111, 112, 113, 120, 121, 122, 123, 130, 131, 132, 133, 134, 143, 145, 153, 154, 155, 163, 165, 173, 174, 175, 177, 185, 186, 187, 188, 195, 196]"
agent_c,L0,short,95,55,40,4,0.5128,195,"[0, 1, 2, 3, 5, 6, 7, 8, 9, 10, 13, 14, 15, 16, 17, 18, 19, 20, 24, 25, 27, 28, 29, 30, 31, 32, 33, 35, 36, 37, 38, 39, 40, 41, 42, 43, 45, 46, 47, 48, 49, 51, 57, 59, 60, 63, 64, 65, 66, 67, 68, 69, 71, 76, 79, 80, 81, 83, 86, 87, 88, 89, 91, 93, 98, 99, 101, 102, 105, 106, 108, 111, 112, 113, 114, 121, 122, 124, 126, 128, 129, 138, 139, 140, 149, 150, 159, 160, 168, 170, 180, 187, 188, 190, 193]"
agent_c,L0,short,94,49,45,13,0.5155,194,"[0, 4, 5, 6, 7, 8, 10, 11, 12, 14, 15, 17, 19, 20, 21, 26, 27, 28, 29, 31, 35, 36, 38, 42, 43, 44, 45, 47, 48, 49, 50, 51, 54, 56, 58, 59, 60, 61, 62, 63, 67, 68, 69, 70, 72, 75, 76, 77, 78, 79, 80, 82, 84, 85, 86, 87, 88, 93, 94, 95, 96, 97, 98, 101, 106, 107, 108, 109, 110, 114, 115, 117, 118, 123, 130, 132, 133, 135, 142, 143, 144, 150, 153, 154, 161, 162, 163, 168, 175, 182, 183, 184, 185, 189]"
agent_c,L0,short,93,43,50,12,0.5181,193,"[0, 1, 2, 3, 4, 5, 7, 9, 13, 16, 17, 20, 22, 24, 25, 26, 30, 32, 35, 37, 38, 40, 41, 44, 46, 47, 48, 49, 51, 52, 53, 54, 55, 57, 58, 59, 60, 63, 64, 65, 66, 67, 68, 69, 70, 71, 72, 74, 75, 79, 80, 81, 86, 89, 91, 93, 96, 99, 100, 101, 104, 105, 107, 108, 111, 113, 115, 119, 120, 121, 122, 123, 127, 133, 134, 135, 140, 141, 142, 144, 148, 155, 161, 164, 165, 166, 172, 173, 177, 183, 185, 187, 188]"
agent_c,L0,short,97,42,55,11,0.5076,197,"[0, 3, 4, 5, 6, 10, 11, 13, 14, 15, 16, 17, 18, 19, 20, 21, 22, 23, 24, 25, 27, 28, 30, 32, 33, 35, 36, 37, 39, 43, 44, 45, 47, 50, 51, 52, 53, 54, 55, 56, 59, 60, 61, 62, 63, 67, 69, 70, 73, 77, 79, 82, 85, 87, 89, 90, 91, 93, 94, 95, 96, 97, 98, 99, 102, 103, 108, 113, 115, 117, 122, 123, 124, 126, 127, 128, 129, 130, 138, 139, 142, 150, 157, 158, 159, 160, 161, 162, 170, 174, 181, 183, 184, 190, 191, 192, 194]"
agent_c,L0,short,100,38,62,8,0.5,200,"[0, 2, 4, 5, 6, 7, 8, 9, 10, 11, 12, 15, 17, 19, 20, 21, 22, 23, 24, 29, 31, 33, 34, 35, 37, 38, 39, 40, 41, 42, 43, 44, 45, 48, 49, 50, 51, 52, 55, 57, 61, 62, 63, 64, 66, 67, 68, 69, 70, 71, 72, 73, 78, 79, 81, 82, 83, 86, 87, 88, 90, 93, 97, 101, 106, 111, 112, 114, 118, 119, 120, 121, 122, 123, 129, 130, 131, 132, 133, 140, 141, 142, 143, 151, 152, 154, 163, 164, 171, 172, 173, 174, 182, 183, 184, 185, 192, 193, 194, 195]"
agent_c,L0,short,97,60,37,8,0.5076,197,"[1, 2, 3, 4, 5, 6, 7, 8, 10, 12, 13, 15, 17, 18, 19, 20, 21, 22, 23, 24, 25, 26, 27, 30, 32, 34, 35, 36, 38, 41, 42, 43, 44, 51, 52, 54, 55, 56, 57, 59, 60, 61, 62, 63, 65, 67, 68, 70, 72, 74, 77, 79, 80, 81, 82, 84, 85, 86, 88, 89, 90, 91, 92, 93, 95, 97, 98, 99, 100, 101, 108, 109, 110, 114, 121, 129, 130, 131, 138, 139, 141, 148, 149, 150, 152, 162, 170, 172, 178, 179, 180, 181, 183, 190, 191, 192, 193]"
agent_c,L0,short,95,48,47,5,0.5128,195,"[0, 1, 2, 3, 4, 7, 9, 11, 14, 15, 16, 19, 21, 22, 23, 25, 28, 29, 30, 32, 33, 34, 36, 37, 40, 41, 43, 44, 47, 48, 49, 50, 51, 52, 53, 54, 56, 57, 59, 60, 61, 65, 66, 67, 68, 70, 71, 72, 73, 74, 75, 77, 79, 80, 81, 82, 83, 84, 85, 90, 92, 93, 94, 95, 98, 99, 101, 102, 105, 111, 112, 113, 114, 115, 122, 123, 124, 125, 132, 133, 134, 137, 145, 153, 154, 155, 156, 157, 166, 167, 168, 176, 178, 186, 191]"
agent_c,L0,short,95,50,45,11,0.5128,195,"[1, 2, 5, 7, 9, 11, 12, 14, 16, 17, 18, 19, 20, 22, 24, 26, 27, 28, 29, 30, 32, 33, 34, 38, 40, 42, 43, 46, 47, 50, 55, 56, 57, 59, 61, 62, 67, 68, 71, 74, 75, 76, 79, 81, 82, 83, 84, 85, 88, 89, 90, 91, 92, 93, 94, 96, 98, 99, 100, 103, 104, 105, 106, 107, 112, 113, 114, 116, 117, 122, 124, 126, 127, 128, 135, 136, 138, 140, 146, 147, 148, 150, 157, 161, 167, 168, 170, 171, 178, 180, 181, 183, 190, 192, 193]"
agent_c,L0,short,99,45,54,16,0.5025,199,"[0, 1, 2, 3, 4, 5, 6, 7, 8, 9, 10, 12, 13, 17, 24, 25, 26, 27, 28, 30, 34, 35, 36, 37, 40, 42, 43, 45, 46, 47, 48, 52, 53, 54, 55, 56, 58, 59, 60, 61, 62, 63, 65, 66, 67, 69, 70, 75, 76, 78, 79, 81, 82, 83, 84, 88, 90, 92, 93, 94, 95, 96, 99, 100, 101, 102, 103, 107, 109, 110, 112, 113, 114, 120, 121, 123, 126, 133, 134, 136, 138, 139, 140, 148, 150, 152, 160, 161, 163, 166, 174, 175, 182, 183, 184, 185, 187, 195, 196]"
agent_c,L0,short,95,63,32,11,0.5128,195,"[0, 1, 2, 3, 4, 5, 6, 7, 10, 11, 13, 14, 15, 18, 19, 20, 21, 22, 26, 28, 30, 31, 34, 35, 36, 37, 38, 40, 42, 44, 46, 47, 49, 50, 51, 52, 55, 56, 58, 59, 60, 62, 63, 64, 65, 66, 68, 70, 71, 72, 75, 76, 77, 78, 79, 81, 82, 84, 86, 87, 89, 95, 96, 97, 98, 100, 101, 107, 108, 109, 116, 119, 124, 126, 127, 128, 129, 130, 137, 138, 141, 150, 151, 159, 160, 161, 162, 170, 171, 173, 174, 181, 183, 186, 192]"
agent_c,L0,short,95,50,45,9,0.5128,195,"[0, 1, 3, 5, 6, 7, 8, 10, 11, 13, 15, 16, 17, 18, 19, 20, 21, 22, 23, 26, 28, 29, 31, 32, 33, 37, 39, 40, 45, 46, 48, 49, 52, 53, 54, 55, 56, 57, 58, 59, 60, 63, 68, 70, 72, 73, 75, 76, 77, 78, 80, 82, 86, 89, 90, 93, 94, 95, 96, 97, 98, 99, 100, 101, 102, 103, 108, 109, 111, 112, 114, 119, 121, 122, 124, 125, 131, 132, 133, 134, 135, 143, 144, 145, 146, 153, 154, 156, 164, 165, 170, 178, 186, 187, 188]"
agent_c,L0,short,89,59,30,11,0.5291,189,"[0, 1, 3, 6, 7, 9, 10, 11, 12, 13, 14, 15, 16, 17, 18, 19, 20, 22, 23, 24, 25, 26, 27, 30, 32, 33, 35, 36, 38, 39, 40, 41, 42, 45, 47, 48, 49, 52, 53, 54, 55, 57, 59, 60, 63, 64, 66, 68, 77, 81, 83, 85, 86, 88, 89, 92, 93, 95, 98, 101, 105, 106, 108, 110, 111, 115, 116, 117, 121, 122, 123, 124, 125, 128, 134, 135, 136, 139, 146, 150, 153, 161, 166, 168, 169, 170, 171, 177, 181]"
agent_c,L0,short,92,46,46,12,0.5208,192,"[0, 1, 2, 3, 4, 6, 7, 11, 15, 16, 17, 18, 20, 21, 24, 26, 27, 28, 30, 31, 32, 33, 36, 37, 38, 41, 42, 43, 44, 48, 49, 50, 53, 55, 56, 57, 60, 64, 65, 67, 69, 71, 72, 74, 75, 76, 77, 79, 81, 82, 84, 85, 88, 89, 90, 91, 92, 93, 94, 95, 96, 98, 99, 100, 102, 103, 108, 110, 111, 112, 114, 119, 120, 121, 122, 123, 130, 132, 134, 142, 143, 144, 152, 154, 158, 168, 175, 177, 179, 184, 185, 188]"
agent_c,L0,short,98,62,36,11,0.5051,198,"[0, 1, 2, 3, 5, 6, 7, 11, 12, 13, 14, 15, 16, 17, 18, 19, 20, 21, 22, 23, 24, 25, 26, 27, 28, 30, 31, 32, 33, 34, 36, 37, 38, 41, 44, 45, 47, 48, 49, 53, 54, 55, 62, 66, 67, 68, 70, 71, 72, 73, 75, 76, 77, 78, 79, 80, 82, 90, 92, 94, 96, 97, 98, 99, 101, 107, 109, 110, 111, 116, 117, 118, 120, 121, 127, 128, 130, 132, 139, 141, 142, 143, 144, 151, 152, 154, 157, 165, 173, 174, 175, 176, 183, 185, 187, 194, 195, 196]"
agent_c,L0,short,97,50,47,8,0.5076,197,"[0, 1, 2, 5, 7, 8, 12, 14, 16, 20, 21, 24, 25, 27, 28, 29, 31, 32, 33, 34, 35, 37, 38, 40, 41, 42, 44, 46, 48, 49, 50, 51, 52, 55, 57, 59, 60, 61, 63, 64, 65, 66, 67, 68, 69, 71, 72, 73, 75, 76, 77, 78, 80, 82, 85, 86, 87, 88, 89, 91, 92, 93, 94, 95, 96, 98, 99, 100, 101, 102, 109, 110, 114, 120, 122, 129, 130, 131, 132, 134, 141, 142, 144, 151, 152, 154, 162, 163, 165, 172, 173, 174, 175, 177, 184, 186, 189]"
agent_c,L0,short,97,49,48,2,0.5076,197,"[3, 4, 5, 6, 7, 8, 9, 11, 12, 14, 15, 16, 18, 19, 22, 23, 24, 26, 27, 28, 29, 31, 33, 34, 35, 36, 37, 39, 41, 42, 43, 45, 46, 47, 49, 50, 52, 55, 56, 57, 60, 61, 62, 67, 68, 69, 72, 73, 74, 77, 78, 79, 80, 81, 82, 85, 86, 87, 88, 90, 91, 92, 99, 100, 102, 105, 107, 108, 109, 110, 112, 114, 122, 123, 129, 130, 132, 133, 139, 140, 141, 143, 150, 153, 161, 162, 163, 170, 172, 174, 181, 182, 183, 184, 191, 192, 194]"
agent_c,L0,short,100,46,54,9,0.5,200,"[1, 2, 5, 6, 7, 11, 12, 13, 14, 15, 16, 17, 18, 20, 21, 22, 23, 24, 25, 27, 28, 29, 30, 34, 37, 38, 39, 40, 41, 42, 43, 44, 45, 46, 47, 48, 50, 52, 54, 55, 56, 57, 59, 60, 61, 62, 65, 66, 68, 69, 70, 71, 72, 73, 75, 77, 78, 79, 80, 82, 90, 91, 92, 95, 97, 99, 100, 101, 102, 104, 112, 113, 119, 120, 122, 124, 132, 133, 139, 141, 142, 143, 144, 152, 154, 162, 163, 164, 165, 172, 173, 174, 175, 179, 187, 194, 195, 196, 197, 198]"
agent_c,L0,short,94,58,36,14,0.5155,194,"[0, 1, 2, 3, 7, 8, 9, 10, 11, 12, 14, 15, 16, 19, 23, 24, 28, 32, 33, 36, 39, 40, 41, 42, 44, 46, 47, 48, 50, 55, 56, 59, 60, 62, 63, 64, 68, 70, 71, 72, 73, 74, 76, 77, 78, 82, 83, 84, 86, 87, 88, 90, 92, 95, 97, 100, 101, 102, 103, 105, 106, 110, 111, 112, 114, 119, 120, 121, 124, 129, 130, 131, 132, 133, 138, 139, 140, 141, 143, 144, 153, 154, 155, 156, 157, 158, 165, 166, 167, 169, 176, 179, 186, 190]"
agent_c,L0,short,98,54,44,10,0.5051,198,"[0, 2, 5, 6, 7, 9, 12, 13, 14, 15, 16, 19, 20, 21, 22, 23, 26, 27, 30, 31, 32, 33, 34, 35, 36, 38, 39, 40, 41, 42, 43, 44, 46, 48, 49, 51, 53, 54, 55, 56, 59, 60, 64, 65, 66, 67, 68, 69, 71, 73, 74, 76, 78, 79, 84, 85, 87, 90, 91, 92, 95, 96, 97, 98, 100, 104, 105, 106, 109, 113, 115, 117, 119, 121, 127, 128, 129, 130, 132, 140, 141, 142, 143, 151, 153, 157, 165, 172, 173, 174, 181, 183, 184, 191, 192, 193, 194, 195]"
agent_c,L0,short,101,38,63,10,0.495,200,"[0, 1, 3, 4, 7, 8, 10, 11, 12, 13, 16, 17, 18, 19, 20, 21, 22, 24, 26, 27, 28, 30, 32, 33, 34, 35, 36, 37, 38, 39, 40, 41, 42, 43, 44, 45, 46, 47, 49, 50, 51, 54, 57, 58, 60, 61, 63, 64, 65, 67, 69, 70, 72, 74, 80, 82, 85, 87, 88, 89, 90, 91, 94, 95, 102, 103, 104, 105, 106, 110, 113, 115, 117, 123, 124, 125, 126, 128, 135, 136, 137, 138, 147, 148, 156, 158, 159, 167, 168, 170, 177, 178, 179, 180, 181, 189, 190, 192, 197, 198, 199]"
agent_c,L0,short,95,38,57,9,0.5128,195,"[1, 2, 4, 6, 7, 9, 10, 11, 12, 14, 15, 16, 17, 19, 21, 22, 23, 26, 28, 29, 30, 32, 33, 38, 39, 40, 41, 43, 47, 48, 49, 51, 52, 53, 54, 57, 58, 59, 61, 62, 63, 64, 65, 66, 67, 68, 69, 71, 75, 79, 80, 82, 84, 85, 86, 87, 88, 90, 91, 94, 99, 100, 101, 102, 103, 107, 108, 109, 111, 112, 114, 123, 128, 129, 130, 131, 133, 141, 144, 151, 152, 155, 163, 170, 171, 172, 173, 179, 180, 181, 184, 189, 191, 192, 193]"
agent_c,L0,short,93,39,54,11,0.5181,193,"[2, 4, 5, 6, 7, 9, 11, 12, 14, 16, 17, 20, 22, 23, 25, 26, 30, 31, 32, 33, 34, 36, 37, 39, 41, 42, 44, 46, 47, 49, 51, 53, 54, 55, 56, 58, 59, 60, 61, 62, 63, 64, 66, 67, 69, 70, 71, 74, 76, 77, 78, 79, 80, 81, 83, 86, 87, 89, 90, 91, 94, 99, 100, 102, 103, 108, 111, 112, 113, 115, 118, 120, 127, 131, 138, 139, 141, 146, 148, 149, 151, 158, 159, 160, 166, 168, 169, 170, 178, 180, 187, 188, 189]"
agent_c,L0,short,100,51,49,12,0.5,200,"[0, 1, 2, 4, 5, 6, 7, 8, 10, 11, 12, 13, 14, 19, 20, 21, 22, 24, 25, 27, 28, 29, 30, 31, 32, 33, 34, 37, 38, 43, 44, 45, 46, 47, 48, 49, 51, 52, 54, 56, 57, 59, 63, 64, 66, 67, 70, 72, 73, 74, 75, 76, 78, 83, 85, 87, 94, 95, 96, 97, 102, 103, 104, 105, 111, 113, 114, 115, 116, 117, 118, 124, 125, 126, 127, 128, 135, 136, 137, 138, 144, 146, 147, 148, 156, 157, 162, 170, 172, 179, 180, 181, 188, 189, 190, 191, 195, 196, 197, 198]"
agent_c,L0,short,91,46,45,12,0.5236,191,"[0, 1, 2, 3, 4, 5, 6, 7, 8, 9, 10, 11, 12, 13, 14, 15, 16, 18, 20, 21, 23, 24, 25, 27, 28, 30, 31, 32, 33, 34, 36, 37, 38, 39, 41, 42, 43, 44, 45, 49, 50, 52, 53, 54, 56, 57, 63, 65, 66, 67, 68, 69, 70, 72, 73, 74, 75, 77, 84, 86, 87, 88, 91, 92, 93, 94, 95, 96, 98, 107, 111, 115, 118, 124, 125, 126, 129, 139, 146, 147, 148, 152, 160, 167, 168, 169, 170, 177, 181, 188, 189]"
agent_c,L0,short,91,46,45,10,0.5236,191,"[2, 3, 4, 5, 7, 8, 10, 11, 13, 14, 19, 20, 21, 24, 25, 26, 28, 30, 34, 36, 37, 39, 41, 42, 44, 45, 46, 47, 48, 49, 50, 51, 52, 54, 57, 58, 60, 61, 62, 63, 64, 65, 66, 69, 70, 71, 72, 75, 79, 82, 83, 85, 86, 87, 88, 89, 91, 92, 93, 94, 96, 100, 104, 105, 106, 109, 110, 117, 118, 120, 125, 126, 128, 129, 133, 141, 152, 157, 158, 161, 167, 168, 170, 171, 177, 178, 179, 180, 182, 188, 189]"
agent_c,L0,short,97,42,55,6,0.5076,197,"[0, 2, 3, 4, 5, 7, 9, 10, 11, 13, 14, 15, 18, 21, 22, 23, 24, 26, 27, 31, 32, 33, 34, 35, 40, 41, 43, 44, 47, 48, 49, 51, 53, 54, 56, 57, 58, 59, 60, 62, 63, 66, 68, 71, 74, 75, 78, 80, 82, 83, 84, 86, 89, 93, 94, 95, 97, 98, 100, 101, 103, 104, 105, 106, 110, 111, 112, 113, 114, 115, 116, 117, 123, 124, 125, 126, 127, 136, 137, 147, 154, 155, 157, 164, 165, 166, 167, 169, 176, 179, 184, 185, 186, 187, 188, 189, 190]"
agent_c,L0,short,91,52,39,21,0.5236,191,"[0, 1, 3, 4, 5, 6, 8, 9, 11, 13, 14, 16, 17, 18, 19, 20, 22, 23, 25, 26, 28, 29, 30, 34, 35, 36, 37, 39, 43, 44, 46, 47, 48, 49, 50, 54, 55, 56, 58, 60, 61, 64, 65, 69, 70, 73, 76, 77, 79, 80, 81, 83, 86, 88, 89, 91, 92, 94, 95, 99, 100, 104, 105, 106, 108, 109, 110, 111, 112, 113, 115, 119, 125, 126, 127, 130, 136, 138, 146, 147, 151, 158, 164, 169, 176, 177, 179, 185, 186, 187, 188]"
agent_c,L0,short,96,56,40,12,0.5102,196,"[0, 1, 3, 4, 5, 6, 7, 8, 11, 13, 15, 16, 20, 22, 23, 25, 27, 28, 30, 31, 32, 33, 34, 37, 38, 39, 40, 43, 45, 47, 48, 49, 53, 55, 56, 57, 58, 60, 63, 64, 65, 66, 68, 69, 72, 73, 74, 75, 76, 77, 78, 79, 80, 81, 82, 84, 87, 88, 91, 92, 93, 94, 95, 97, 99, 100, 101, 102, 103, 105, 107, 109, 115, 116, 117, 118, 120, 128, 129, 137, 139, 146, 147, 148, 150, 157, 161, 168, 169, 170, 178, 179, 181, 187, 189, 190]"
agent_c,L0,short,97,50,47,8,0.5076,197,"[0, 2, 3, 4, 6, 7, 9, 10, 11, 15, 17, 18, 19, 22, 23, 24, 25, 26, 27, 29, 31, 33, 36, 38, 39, 41, 42, 44, 45, 47, 48, 49, 51, 52, 53, 54, 56, 57, 58, 61, 62, 63, 64, 65, 67, 68, 69, 70, 71, 73, 74, 75, 76, 77, 78, 79, 84, 85, 92, 93, 94, 95, 97, 98, 100, 101, 102, 103, 104, 105, 106, 107, 109, 116, 119, 126, 127, 128, 131, 141, 143, 150, 151, 152, 153, 160, 161, 162, 164, 172, 174, 183, 189, 190, 191, 192, 193]"
agent_c,L0,short,99,46,53,9,0.5025,199,"[0, 1, 2, 4, 5, 6, 7, 8, 10, 11, 12, 13, 14, 15, 16, 18, 19, 20, 21, 22, 23, 24, 25, 30, 31, 32, 33, 35, 36, 44, 46, 47, 49, 50, 51, 52, 54, 57, 60, 61, 62, 63, 64, 65, 66, 71, 73, 74, 75, 76, 79, 80, 86, 88, 90, 94, 95, 98, 99, 101, 104, 105, 106, 108, 109, 110, 114, 118, 119, 120, 121, 122, 123, 129, 130, 131, 133, 140, 142, 143, 144, 152, 153, 155, 161, 162, 163, 164, 165, 167, 176, 184, 185, 186, 187, 190, 195, 196, 197]"
agent_c,L0,short,94,37,57,11,0.5155,194,"[0, 1, 2, 3, 4, 5, 6, 8, 9, 11, 13, 15, 16, 17, 19, 20, 22, 23, 25, 26, 27, 28, 29, 30, 31, 32, 33, 35, 36, 38, 40, 42, 43, 44, 45, 46, 47, 48, 49, 50, 52, 54, 56, 57, 59, 60, 62, 63, 65, 71, 73, 74, 75, 76, 81, 82, 84, 85, 89, 90, 91, 92, 93, 95, 98, 99, 100, 101, 104, 105, 106, 107, 114, 115, 116, 120, 127, 136, 137, 144, 145, 146, 147, 155, 156, 157, 165, 166, 170, 180, 185, 186, 187, 188]"
agent_c,L0,short,96,24,72,2,0.5102,196,"[3, 5, 6, 8, 9, 12, 13, 14, 15, 16, 17, 18, 19, 20, 21, 22, 23, 24, 25, 26, 27, 28, 29, 30, 31, 32, 36, 37, 39, 40, 41, 42, 43, 44, 45, 47, 49, 51, 52, 53, 56, 57, 58, 59, 62, 67, 68, 69, 70, 71, 72, 74, 75, 76, 79, 80, 81, 82, 83, 84, 90, 91, 92, 94, 96, 99, 100, 101, 102, 104, 105, 106, 114, 116, 117, 125, 126, 127, 135, 137, 138, 145, 147, 149, 156, 159, 160, 161, 162, 173, 180, 181, 183, 190, 191, 193]"
agent_c,L0,short,101,40,61,6,0.495,200,"[0, 1, 2, 3, 5, 7, 8, 10, 11, 13, 14, 15, 16, 17, 20, 22, 23, 24, 25, 27, 29, 31, 32, 33, 35, 36, 39, 40, 41, 43, 44, 46, 47, 48, 49, 51, 55, 58, 59, 60, 61, 62, 63, 64, 68, 69, 70, 72, 73, 74, 75, 78, 82, 83, 84, 85, 86, 87, 88, 89, 91, 93, 94, 96, 102, 105, 107, 109, 110, 111, 112, 113, 114, 115, 121, 122, 123, 124, 125, 133, 134, 136, 143, 145, 146, 154, 155, 156, 166, 167, 178, 185, 186, 188, 189, 194, 195, 196, 197, 198, 199]"
agent_c,L0,short,94,41,53,10,0.5155,194,"[1, 2, 3, 4, 5, 6, 9, 10, 11, 13, 14, 15, 19, 20, 21, 22, 23, 26, 28, 30, 31, 34, 35, 36, 38, 40, 41, 44, 45, 46, 51, 52, 53, 54, 55, 56, 57, 58, 59, 61, 62, 65, 66, 67, 68, 69, 70, 71, 72, 73, 77, 81, 82, 83, 84, 85, 87, 91, 93, 96, 101, 104, 105, 106, 107, 108, 109, 110, 114, 120, 121, 122, 123, 126, 133, 134, 137, 143, 144, 146, 153, 155, 156, 162, 163, 164, 165, 166, 167, 177, 184, 186, 188, 192]"
agent_c,L0,short,93,45,48,12,0.5181,193,"[0, 1, 2, 3, 5, 6, 7, 10, 11, 13, 14, 17, 18, 19, 20, 21, 22, 23, 24, 25, 27, 29, 30, 35, 36, 37, 38, 42, 44, 45, 46, 48, 50, 52, 55, 56, 57, 58, 59, 60, 61, 62, 64, 65, 66, 69, 70, 71, 72, 73, 76, 81, 83, 86, 88, 89, 90, 91, 92, 93, 94, 96, 100, 101, 102, 105, 108, 109, 112, 114, 115, 118, 124, 125, 126, 128, 136, 137, 138, 146, 147, 148, 149, 150, 151, 160, 161, 162, 164, 172, 173, 174, 186]"
agent_c,L0,short,98,54,44,7,0.5051,198,"[2, 3, 6, 8, 9, 13, 14, 15, 16, 17, 18, 19, 20, 21, 22, 23, 26, 27, 30, 32, 33, 35, 36, 37, 38, 39, 40, 41, 43, 44, 46, 47, 49, 50, 51, 52, 53, 54, 56, 58, 59, 61, 62, 63, 64, 65, 66, 67, 68, 69, 70, 71, 72, 75, 80, 82, 84, 87, 88, 89, 93, 99, 100, 102, 105, 106, 110, 112, 113, 114, 115, 117, 123, 124, 126, 132, 134, 135, 137, 143, 144, 146, 154, 156, 163, 164, 166, 173, 174, 175, 176, 177, 178, 187, 189, 194, 195, 196]"
agent_c,L0,short,95,48,47,7,0.5128,195,"[0, 1, 2, 3, 4, 5, 6, 7, 8, 12, 13, 16, 17, 19, 20, 21, 23, 24, 25, 27, 28, 29, 30, 34, 35, 36, 37, 38, 40, 43, 44, 46, 47, 48, 50, 52, 53, 54, 55, 56, 57, 58, 60, 61, 63, 64, 67, 68, 69, 70, 71, 72, 73, 74, 81, 82, 83, 84, 85, 86, 87, 89, 91, 93, 94, 102, 103, 104, 108, 109, 110, 112, 113, 115, 116, 125, 126, 135, 136, 143, 144, 148, 157, 165, 167, 169, 175, 177, 178, 184, 185, 187, 189, 192, 193]"
agent_c,L0,short,92,37,55,8,0.5208,192,"[0, 2, 3, 4, 6, 9, 12, 13, 15, 16, 17, 23, 24, 26, 27, 28, 29, 31, 33, 35, 36, 37, 39, 40, 43, 44, 45, 47, 49, 51, 52, 53, 54, 55, 57, 60, 62, 63, 64, 66, 67, 69, 70, 71, 72, 75, 77, 78, 79, 80, 81, 82, 84, 90, 93, 97, 98, 99, 100, 101, 103, 104, 105, 106, 107, 108, 109, 110, 111, 112, 119, 120, 122, 125, 127, 138, 139, 145, 146, 147, 148, 150, 158, 160, 166, 167, 170, 178, 179, 180, 189, 190]"
agent_c,L0,short,95,32,63,9,0.5128,195,"[1, 2, 3, 4, 7, 8, 10, 12, 13, 14, 15, 18, 19, 21, 23, 24, 25, 27, 28, 29, 30, 31, 32, 33, 34, 35, 37, 39, 42, 43, 45, 46, 49, 50, 51, 52, 54, 55, 56, 57, 59, 60, 61, 66, 67, 68, 70, 72, 73, 75, 76, 77, 78, 79, 81, 85, 86, 87, 88, 90, 94, 95, 100, 101, 102, 103, 109, 110, 111, 112, 114, 119, 120, 122, 124, 130, 132, 133, 134, 142, 143, 144, 145, 152, 154, 155, 164, 165, 167, 174, 176, 183, 184, 187, 188]"
agent_c,L0,short,94,52,42,10,0.5155,194,"[0, 2, 6, 7, 9, 10, 13, 14, 15, 18, 19, 20, 24, 25, 26, 27, 28, 29, 31, 33, 36, 39, 40, 41, 44, 49, 50, 51, 52, 53, 55, 56, 57, 58, 59, 61, 62, 63, 64, 70, 71, 72, 73, 75, 76, 80, 81, 82, 83, 84, 85, 86, 87, 88, 89, 90, 91, 92, 94, 96, 97, 98, 99, 100, 107, 108, 109, 112, 116, 117, 118, 119, 121, 127, 129, 130, 138, 139, 140, 147, 148, 149, 150, 159, 162, 168, 169, 170, 177, 178, 179, 181, 189, 190]"
agent_c,L0,short,100,52,48,7,0.5,200,"[0, 2, 3, 4, 5, 6, 8, 9, 10, 12, 13, 14, 15, 17, 18, 20, 21, 22, 23, 25, 26, 27, 28, 30, 31, 33, 34, 35, 36, 38, 39, 40, 41, 42, 43, 44, 45, 46, 48, 49, 51, 56, 58, 59, 60, 62, 63, 64, 65, 67, 68, 71, 78, 80, 81, 82, 83, 84, 85, 86, 87, 89, 90, 92, 98, 100, 102, 107, 109, 110, 111, 112, 118, 119, 120, 123, 125, 132, 133, 134, 135, 142, 144, 145, 153, 154, 155, 158, 166, 174, 175, 176, 185, 187, 192, 193, 194, 195, 196, 198]"
agent_c,L0,short,96,55,41,8,0.5102,196,"[0, 1, 3, 4, 5, 6, 7, 8, 9, 10, 11, 13, 15, 16, 17, 18, 19, 21, 22, 25, 27, 28, 29, 31, 32, 33, 34, 35, 37, 38, 40, 41, 43, 44, 45, 47, 48, 49, 50, 51, 52, 55, 56, 57, 58, 60, 61, 65, 66, 67, 68, 69, 72, 73, 80, 81, 82, 83, 84, 85, 88, 89, 90, 93, 99, 100, 102, 105, 109, 110, 111, 113, 114, 115, 116, 124, 125, 126, 134, 135, 137, 145, 147, 148, 149, 150, 151, 152, 161, 162, 170, 176, 183, 190, 191, 192]"
agent_c,L0,short,94,43,51,8,0.5155,194,"[0, 1, 3, 4, 5, 6, 9, 10, 11, 12, 14, 16, 18, 19, 22, 24, 26, 28, 29, 31, 32, 33, 34, 36, 40, 41, 43, 46, 47, 48, 49, 50, 51, 53, 54, 56, 57, 60, 61, 62, 63, 64, 66, 67, 71, 72, 73, 74, 75, 78, 79, 80, 82, 85, 89, 90, 93, 94, 95, 97, 98, 99, 100, 102, 103, 104, 105, 108, 110, 111, 112, 113, 114, 115, 116, 125, 126, 133, 137, 144, 145, 147, 154, 155, 156, 157, 165, 166, 172, 179, 185, 187, 188, 189]"
agent_c,L0,short,96,57,39,10,0.5102,196,"[0, 1, 2, 3, 4, 5, 6, 7, 8, 9, 11, 12, 13, 14, 16, 17, 18, 21, 22, 23, 24, 27, 30, 31, 32, 35, 37, 38, 39, 40, 41, 42, 44, 45, 46, 49, 50, 51, 52, 53, 54, 55, 57, 59, 60, 62, 63, 64, 65, 66, 72, 73, 74, 76, 78, 80, 81, 82, 84, 85, 86, 88, 96, 99, 100, 102, 103, 104, 105, 106, 107, 109, 110, 119, 121, 127, 128, 129, 130, 132, 140, 141, 149, 150, 151, 159, 161, 168, 169, 170, 171, 176, 183, 190, 191, 193]"
agent_c,L0,short,94,51,43,16,0.5155,194,"[0, 1, 2, 3, 4, 6, 8, 9, 14, 16, 17, 18, 19, 21, 24, 25, 27, 28, 31, 35, 38, 39, 40, 43, 45, 47, 54, 55, 56, 57, 59, 60, 64, 68, 69, 70, 71, 73, 76, 77, 79, 80, 82, 83, 84, 85, 92, 95, 97, 98, 99, 100, 101, 103, 104, 106, 107, 108, 110, 111, 112, 113, 116, 118, 121, 124, 125, 127, 132, 133, 135, 136, 138, 140, 145, 146, 147, 149, 150, 151, 157, 158, 159, 160, 164, 170, 171, 172, 173, 180, 181, 182, 183, 191]"
agent_c,L0,short,97,56,41,11,0.5076,197,"[0, 2, 3, 4, 5, 8, 10, 11, 12, 13, 14, 15, 16, 17, 18, 19, 20, 21, 22, 23, 25, 27, 28, 29, 30, 31, 32, 33, 34, 35, 36, 39, 40, 44, 45, 46, 49, 50, 52, 53, 56, 58, 59, 60, 61, 62, 63, 64, 66, 67, 68, 69, 70, 72, 80, 81, 84, 87, 88, 91, 97, 98, 99, 100, 101, 103, 104, 107, 108, 109, 110, 111, 113, 119, 122, 128, 129, 130, 131, 132, 141, 145, 154, 161, 163, 164, 172, 173, 175, 182, 183, 185, 190, 191, 192, 193, 195]"
agent_c,L0,short,96,49,47,8,0.5102,196,"[0, 1, 2, 5, 6, 7, 11, 13, 15, 18, 19, 21, 23, 25, 26, 27, 28, 30, 31, 33, 34, 35, 36, 37, 38, 39, 41, 42, 43, 44, 45, 46, 48, 49, 50, 51, 52, 54, 55, 57, 58, 59, 60, 63, 65, 67, 69, 71, 72, 73, 74, 77, 78, 82, 83, 85, 86, 94, 96, 97, 98, 99, 101, 103, 104, 105, 107, 113, 115, 116, 117, 119, 124, 126, 127, 128, 129, 136, 137, 139, 150, 152, 158, 159, 160, 161, 162, 164, 172, 174, 176, 183, 188, 192, 193, 194]"
agent_c,L0,short,97,40,57,7,0.5076,197,"[0, 1, 3, 5, 7, 8, 9, 10, 11, 12, 14, 15, 16, 17, 20, 22, 23, 24, 25, 28, 29, 30, 31, 32, 34, 35, 36, 37, 39, 40, 42, 44, 46, 47, 48, 49, 50, 54, 55, 56, 58, 60, 63, 64, 66, 68, 69, 72, 73, 74, 76, 78, 81, 82, 84, 86, 87, 92, 94, 95, 96, 100, 101, 102, 103, 106, 108, 111, 118, 119, 120, 121, 127, 128, 129, 131, 137, 139, 141, 149, 150, 152, 155, 164, 170, 173, 174, 180, 181, 182, 183, 184, 190, 191, 192, 193, 194]"
agent_c,L0,short,93,52,41,10,0.5181,193,"[0, 2, 3, 4, 5, 6, 9, 10, 11, 13, 14, 17, 20, 21, 23, 25, 26, 27, 29, 30, 31, 33, 37, 38, 39, 40, 42, 43, 44, 45, 46, 47, 49, 50, 52, 53, 54, 56, 57, 58, 59, 60, 62, 63, 65, 66, 67, 68, 69, 70, 72, 78, 79, 80, 81, 83, 84, 85, 88, 89, 90, 91, 92, 93, 98, 99, 100, 102, 105, 110, 111, 112, 113, 122, 123, 124, 131, 133, 134, 135, 144, 146, 155, 157, 164, 165, 166, 167, 176, 180, 187, 188, 190]"
agent_c,L50,short,98,43,55,7,0.5051,198,"[0, 2, 4, 5, 6, 7, 9, 10, 12, 14, 15, 16, 18, 19, 20, 21, 22, 23, 25, 27, 29, 30, 31, 32, 34, 35, 36, 38, 40, 42, 43, 44, 45, 46, 47, 48, 49, 50, 52, 55, 59, 60, 61, 62, 63, 64, 65, 66, 67, 68, 70, 71, 73, 74, 76, 78, 79, 87, 88, 90, 91, 92, 93, 94, 95, 96, 97, 99, 100, 108, 109, 110, 114, 115, 121, 129, 130, 131, 132, 139, 140, 141, 143, 151, 152, 154, 163, 165, 172, 173, 174, 180, 181, 182, 184, 185, 188, 196]"
agent_c,L50,short,95,39,56,4,0.5128,195,"[5, 6, 10, 11, 12, 14, 15, 17, 20, 21, 23, 25, 26, 27, 28, 30, 31, 32, 35, 36, 37, 39, 43, 44, 45, 49, 50, 51, 54, 55, 56, 57, 58, 60, 61, 62, 63, 64, 66, 68, 70, 72, 73, 74, 75, 76, 78, 79, 80, 81, 82, 85, 86, 88, 89, 90, 91, 96, 97, 99, 100, 101, 105, 106, 108, 112, 114, 115, 116, 117, 121, 125, 126, 127, 133, 134, 135, 137, 143, 146, 147, 155, 156, 158, 167, 168, 169, 170, 177, 180, 181, 186, 188, 190, 192]"
agent_c,L50,short,94,51,43,8,0.5155,194,"[3, 4, 5, 6, 7, 8, 9, 10, 11, 13, 15, 16, 17, 18, 19, 20, 24, 25, 26, 27, 28, 29, 32, 34, 35, 38, 39, 40, 41, 42, 45, 46, 49, 50, 52, 54, 57, 59, 61, 62, 63, 64, 65, 66, 67, 68, 69, 70, 72, 73, 75, 76, 77, 78, 80, 81, 83, 84, 91, 92, 93, 94, 95, 100, 101, 103, 106, 112, 113, 114, 116, 121, 122, 124, 126, 133, 135, 136, 143, 144, 145, 147, 154, 155, 157, 165, 168, 175, 177, 183, 187, 188, 189, 192]"
agent_c,L50,short,101,49,52,4,0.495,200,"[0, 1, 3, 4, 6, 7, 9, 10, 12, 15, 16, 17, 20, 21, 22, 23, 25, 26, 27, 29, 30, 31, 32, 33, 34, 35, 38, 39, 40, 42, 43, 44, 47, 48, 49, 51, 52, 54, 55, 56, 57, 59, 60, 62, 64, 65, 68, 70, 71, 72, 73, 74, 75, 76, 77, 79, 80, 83, 84, 86, 95, 97, 99, 100, 101, 102, 103, 104, 105, 106, 107, 108, 117, 118, 124, 125, 126, 127, 128, 130, 138, 140, 147, 149, 157, 158, 159, 167, 168, 169, 177, 178, 179, 180, 181, 188, 190, 191, 196, 197, 198]"
agent_c,L50,short,99,61,38,12,0.5025,199,"[0, 1, 2, 3, 4, 6, 9, 11, 12, 13, 14, 15, 16, 17, 18, 19, 20, 21, 22, 23, 24, 25, 26, 29, 31, 33, 34, 35, 36, 38, 39, 42, 43, 44, 47, 49, 50, 51, 52, 54, 55, 56, 61, 64, 65, 68, 72, 74, 76, 77, 78, 79, 80, 81, 89, 92, 94, 95, 97, 98, 99, 100, 102, 104, 107, 108, 111, 113, 120, 121, 122, 123, 129, 130, 131, 132, 133, 141, 142, 144, 151, 152, 153, 159, 160, 162, 163, 164, 167, 174, 177, 183, 184, 187, 192, 193, 194, 195, 197]"
agent_c,L50,short,99,48,51,10,0.5025,199,"[0, 1, 4, 6, 7, 8, 10, 12, 14, 18, 19, 21, 23, 24, 26, 28, 30, 32, 33, 34, 36, 37, 40, 43, 45, 46, 47, 48, 49, 50, 52, 56, 57, 58, 59, 60, 61, 62, 63, 64, 66, 67, 69, 70, 73, 74, 76, 77, 82, 85, 86, 87, 89, 91, 92, 93, 94, 95, 96, 97, 98, 100, 101, 104, 105, 111, 112, 113, 116, 117, 122, 123, 124, 125, 126, 128, 135, 136, 139, 146, 147, 148, 150, 157, 158, 159, 162, 169, 173, 179, 181, 185, 186, 188, 189, 190, 192, 193, 197]"
agent_c,L50,short,97,48,49,12,0.5076,197,"[0, 1, 2, 3, 4, 6, 8, 9, 11, 12, 13, 15, 17, 18, 19, 21, 22, 23, 25, 26, 29, 30, 31, 32, 34, 36, 37, 38, 39, 40, 41, 43, 46, 48, 50, 51, 52, 55, 58, 59, 60, 65, 66, 67, 68, 70, 74, 76, 78, 79, 80, 83, 84, 85, 86, 87, 89, 90, 91, 96, 97, 99, 100, 102, 104, 105, 109, 110, 111, 113, 120, 121, 124, 129, 132, 133, 134, 141, 144, 145, 153, 154, 155, 162, 163, 164, 166, 173, 174, 176, 184, 185, 186, 191, 192, 193, 194]"
agent_c,L50,short,98,55,43,1,0.5051,198,"[0, 1, 3, 4, 6, 9, 10, 12, 13, 14, 15, 16, 18, 19, 20, 21, 22, 23, 24, 26, 28, 29, 30, 32, 34, 37, 38, 40, 41, 42, 43, 45, 47, 48, 49, 51, 53, 54, 55, 57, 59, 60, 61, 62, 64, 65, 66, 67, 68, 70, 71, 78, 80, 81, 83, 84, 85, 86, 87, 88, 90, 91, 93, 102, 104, 105, 106, 107, 111, 112, 115, 117, 125, 126, 127, 129, 135, 136, 137, 139, 146, 148, 149, 156, 159, 166, 168, 169, 170, 177, 178, 179, 180, 187, 188, 189, 191, 192]"
agent_c,L50,short,97,33,64,10,0.5076,197,"[0, 3, 4, 5, 6, 7, 9, 10, 11, 12, 13, 14, 16, 17, 18, 19, 20, 21, 22, 24, 27, 30, 31, 33, 34, 36, 37, 39, 43, 44, 46, 47, 50, 52, 53, 54, 56, 57, 58, 59, 62, 63, 64, 67, 68, 70, 71, 72, 73, 75, 77, 78, 79, 80, 81, 85, 86, 87, 89, 90, 91, 92, 93, 97, 98, 99, 100, 101, 102, 111, 112, 117, 119, 120, 121, 122, 130, 131, 133, 140, 142, 143, 146, 154, 156, 162, 163, 164, 166, 174, 175, 181, 183, 184, 186, 194, 195]"
agent_c,L50,short,98,47,51,16,0.5051,198,"[1, 2, 4, 6, 7, 8, 9, 10, 13, 15, 16, 17, 18, 20, 21, 22, 23, 24, 25, 27, 28, 29, 32, 33, 34, 35, 36, 37, 42, 43, 46, 47, 49, 50, 51, 54, 56, 57, 59, 60, 61, 62, 63, 65, 66, 67, 68, 69, 73, 76, 77, 78, 80, 82, 83, 86, 87, 88, 89, 91, 92, 96, 100, 101, 102, 103, 105, 106, 107, 110, 111, 112, 114, 123, 125, 131, 132, 133, 135, 143, 144, 145, 146, 147, 148, 150, 158, 159, 161, 162, 173, 179, 180, 181, 182, 185, 191, 194]"
agent_c,L50,short,97,43,54,15,0.5076,197,"[1, 2, 3, 4, 5, 6, 7, 9, 10, 11, 14, 17, 18, 19, 20, 21, 25, 26, 31, 33, 35, 37, 38, 39, 42, 43, 45, 47, 48, 49, 50, 51, 53, 55, 56, 57, 59, 60, 63, 65, 67, 68, 69, 72, 73, 74, 75, 77, 79, 82, 83, 85, 86, 91, 93, 95, 100, 102, 103, 104, 105, 107, 109, 110, 111, 115, 116, 117, 118, 119, 120, 121, 126, 128, 129, 131, 133, 140, 143, 145, 153, 155, 162, 163, 164, 170, 171, 172, 174, 175, 181, 182, 183, 184, 185, 189, 195]"
agent_c,L50,short,93,41,52,13,0.5181,193,"[0, 1, 2, 3, 5, 7, 9, 10, 11, 13, 16, 20, 21, 22, 23, 24, 25, 26, 27, 28, 29, 30, 32, 34, 35, 36, 39, 43, 45, 47, 48, 51, 53, 57, 58, 59, 61, 62, 64, 65, 66, 67, 69, 70, 71, 76, 78, 79, 80, 81, 82, 84, 86, 87, 88, 90, 91, 92, 96, 97, 98, 99, 101, 102, 103, 105, 108, 110, 111, 112, 119, 122, 127, 128, 129, 130, 131, 133, 140, 142, 143, 146, 153, 154, 155, 163, 164, 165, 172, 173, 174, 177, 185]"
agent_c,L50,short,97,48,49,6,0.5076,197,"[1, 2, 3, 4, 7, 11, 12, 13, 15, 16, 17, 18, 19, 20, 21, 22, 23, 27, 28, 30, 32, 33, 35, 36, 37, 38, 39, 40, 41, 42, 43, 44, 45, 47, 49, 50, 51, 53, 56, 57, 58, 59, 60, 64, 65, 66, 69, 71, 78, 80, 82, 84, 85, 86, 87, 88, 89, 91, 92, 93, 95, 99, 101, 102, 103, 104, 105, 108, 109, 110, 111, 112, 113, 114, 115, 124, 125, 133, 135, 136, 144, 146, 153, 155, 156, 164, 166, 173, 174, 176, 180, 185, 186, 189, 193, 194, 195]"
agent_c,L50,short,94,47,47,17,0.5155,194,"[0, 1, 3, 4, 6, 7, 9, 10, 11, 12, 14, 15, 16, 18, 20, 21, 22, 23, 24, 29, 30, 36, 38, 40, 41, 42, 43, 44, 45, 47, 48, 49, 50, 52, 53, 56, 60, 62, 64, 65, 66, 67, 68, 75, 78, 79, 80, 82, 84, 85, 87, 88, 89, 91, 92, 93, 100, 101, 102, 103, 104, 106, 108, 109, 112, 115, 116, 120, 121, 123, 125, 126, 133, 135, 138, 143, 144, 145, 146, 147, 148, 155, 157, 158, 160, 166, 168, 170, 177, 178, 180, 187, 189, 191]"
agent_c,L50,short,99,56,43,14,0.5025,199,"[0, 1, 2, 3, 4, 6, 7, 8, 10, 12, 13, 15, 16, 18, 19, 20, 22, 23, 24, 26, 27, 28, 29, 30, 32, 34, 36, 37, 39, 41, 42, 43, 44, 45, 47, 48, 49, 50, 54, 56, 58, 59, 62, 63, 65, 69, 70, 73, 75, 76, 77, 78, 79, 80, 81, 84, 85, 91, 92, 94, 95, 101, 102, 103, 104, 106, 113, 115, 116, 119, 123, 124, 125, 126, 133, 135, 136, 142, 146, 147, 148, 150, 157, 158, 159, 161, 162, 166, 173, 174, 181, 182, 183, 184, 185, 190, 191, 192, 194]"
agent_c,L50,short,95,45,50,14,0.5128,195,"[1, 2, 5, 8, 9, 10, 11, 12, 13, 14, 16, 17, 18, 19, 20, 22, 23, 25, 26, 27, 28, 29, 33, 37, 38, 42, 43, 44, 45, 46, 47, 50, 51, 52, 53, 54, 56, 57, 58, 59, 60, 62, 64, 65, 69, 70, 71, 72, 74, 75, 76, 82, 83, 84, 85, 86, 87, 88, 90, 92, 93, 94, 97, 99, 100, 107, 108, 109, 112, 115, 116, 117, 118, 122, 129, 131, 137, 139, 140, 147, 149, 150, 157, 158, 159, 163, 171, 177, 178, 180, 185, 186, 187, 188, 191]"
agent_c,L50,short,96,30,66,6,0.5102,196,"[0, 1, 4, 5, 7, 9, 11, 12, 14, 15, 17, 18, 19, 21, 22, 23, 26, 27, 28, 29, 30, 33, 35, 37, 38, 40, 41, 42, 43, 44, 45, 47, 48, 50, 52, 53, 54, 56, 58, 59, 61, 62, 64, 65, 66, 67, 68, 69, 70, 71, 76, 77, 78, 79, 81, 82, 83, 84, 85, 86, 87, 91, 93, 94, 95, 97, 104, 105, 106, 111, 117, 119, 126, 127, 128, 129, 136, 137, 139, 147, 148, 149, 150, 152, 162, 163, 170, 171, 173, 176, 181, 185, 187, 188, 193, 194]"
agent_c,L50,short,100,46,54,3,0.5,200,"[0, 1, 2, 4, 6, 7, 8, 9, 10, 11, 13, 14, 15, 16, 19, 20, 25, 28, 29, 30, 31, 33, 34, 37, 39, 40, 41, 42, 43, 48, 49, 50, 52, 53, 54, 55, 56, 60, 61, 62, 64, 65, 66, 67, 68, 69, 70, 71, 73, 75, 79, 80, 81, 82, 83, 84, 85, 86, 87, 88, 89, 90, 92, 93, 94, 95, 96, 97, 98, 99, 108, 109, 110, 115, 117, 118, 119, 121, 129, 130, 132, 142, 150, 151, 159, 160, 161, 168, 169, 170, 171, 178, 180, 181, 188, 189, 190, 191, 193, 194]"
agent_c,L50,short,88,37,51,12,0.5319,188,"[0, 1, 4, 6, 7, 9, 11, 13, 16, 17, 18, 19, 20, 22, 24, 25, 26, 27, 29, 30, 31, 32, 33, 34, 36, 39, 41, 42, 45, 46, 47, 49, 52, 53, 54, 57, 58, 61, 62, 63, 65, 66, 67, 68, 69, 71, 72, 73, 75, 79, 80, 82, 83, 85, 86, 90, 91, 93, 95, 97, 104, 105, 107, 109, 110, 112, 113, 114, 115, 116, 117, 118, 123, 131, 136, 141, 148, 149, 150, 155, 159, 161, 168, 169, 170, 175, 181, 185]"
agent_c,L50,short,98,33,65,16,0.5051,198,"[0, 7, 9, 10, 13, 14, 15, 16, 19, 20, 21, 22, 23, 26, 27, 28, 30, 31, 32, 33, 35, 36, 37, 38, 41, 42, 43, 44, 45, 46, 60, 61, 62, 63, 64, 65, 66, 67, 69, 72, 73, 75, 76, 77, 83, 84, 86, 87, 88, 90, 92, 93, 95, 96, 97, 98, 99, 100, 101, 102, 103, 104, 106, 108, 109, 111, 112, 113, 114, 115, 121, 123, 124, 125, 131, 134, 136, 143, 144, 145, 152, 154, 155, 162, 163, 164, 165, 172, 173, 175, 176, 177, 183, 184, 185, 186, 191, 195]"
agent_c,L50,short,99,53,46,6,0.5025,199,"[0, 2, 5, 6, 7, 11, 13, 16, 17, 18, 20, 23, 27, 28, 29, 30, 32, 33, 34, 36, 37, 38, 39, 40, 41, 42, 43, 44, 45, 46, 48, 49, 50, 51, 52, 53, 54, 55, 58, 59, 60, 63, 64, 65, 69, 75, 76, 77, 79, 81, 82, 83, 84, 87, 88, 90, 92, 93, 95, 96, 99, 102, 104, 105, 106, 107, 110, 111, 112, 113, 114, 115, 116, 123, 124, 125, 127, 134, 135, 136, 137, 139, 149, 150, 157, 158, 159, 160, 168, 170, 178, 179, 181, 187, 188, 189, 190, 195, 197]"
agent_c,L50,short,97,27,70,11,0.5076,197,"[0, 2, 3, 4, 5, 6, 7, 8, 10, 12, 13, 14, 16, 17, 19, 21, 22, 23, 24, 25, 26, 27, 28, 30, 31, 32, 33, 34, 36, 37, 39, 41, 42, 43, 44, 45, 46, 47, 48, 49, 50, 51, 52, 57, 58, 59, 61, 64, 65, 67, 69, 70, 71, 72, 73, 74, 75, 77, 84, 85, 87, 88, 89, 90, 91, 92, 94, 97, 99, 108, 109, 113, 115, 117, 119, 126, 128, 130, 137, 138, 140, 148, 149, 151, 160, 167, 169, 172, 178, 179, 180, 181, 187, 188, 189, 190, 193]"
agent_c,L50,short,93,38,55,17,0.5181,193,"[0, 1, 2, 4, 5, 6, 7, 9, 10, 12, 13, 15, 16, 18, 20, 21, 22, 23, 26, 28, 29, 30, 31, 33, 34, 35, 36, 37, 39, 40, 41, 42, 44, 45, 46, 47, 50, 52, 53, 54, 55, 59, 60, 61, 62, 63, 64, 65, 66, 68, 69, 72, 79, 80, 81, 82, 84, 85, 86, 87, 90, 91, 96, 101, 106, 108, 109, 110, 113, 120, 121, 122, 124, 129, 132, 135, 142, 143, 144, 146, 152, 154, 156, 163, 165, 166, 170, 176, 177, 183, 186, 188, 190]"
agent_c,L50,short,97,45,52,10,0.5076,197,"[0, 1, 3, 4, 6, 7, 9, 11, 13, 14, 15, 17, 18, 19, 20, 21, 23, 24, 25, 26, 30, 32, 33, 36, 39, 41, 44, 45, 46, 47, 48, 50, 52, 53, 54, 56, 57, 59, 62, 63, 64, 65, 67, 68, 70, 71, 72, 75, 77, 80, 81, 85, 88, 89, 90, 91, 93, 94, 95, 96, 97, 99, 100, 101, 106, 107, 108, 109, 110, 111, 118, 120, 121, 122, 129, 130, 131, 132, 133, 143, 150, 151, 152, 153, 160, 161, 162, 163, 164, 165, 173, 176, 182, 184, 186, 193, 194]"
agent_c,L50,short,97,28,69,18,0.5076,197,"[2, 4, 5, 6, 7, 8, 12, 13, 14, 15, 16, 18, 21, 22, 23, 24, 27, 31, 32, 33, 38, 39, 40, 41, 42, 43, 44, 45, 46, 47, 48, 49, 50, 52, 53, 57, 58, 59, 60, 61, 62, 63, 66, 67, 68, 71, 72, 73, 74, 75, 77, 81, 83, 84, 85, 86, 87, 89, 94, 95, 97, 102, 103, 105, 107, 108, 110, 111, 118, 119, 120, 121, 126, 127, 130, 131, 138, 146, 151, 159, 160, 161, 162, 167, 170, 171, 172, 174, 181, 182, 183, 184, 190, 191, 193, 194, 195]"
agent_c,L50,short,96,41,55,11,0.5102,196,"[0, 2, 3, 6, 7, 9, 10, 11, 13, 15, 16, 17, 18, 19, 20, 23, 24, 26, 28, 29, 30, 31, 33, 34, 35, 38, 39, 41, 42, 45, 46, 47, 49, 50, 52, 53, 54, 55, 58, 59, 60, 61, 62, 66, 67, 68, 69, 70, 71, 72, 73, 76, 77, 79, 80, 81, 86, 91, 92, 93, 95, 96, 97, 98, 99, 100, 101, 102, 110, 113, 114, 120, 121, 122, 123, 124, 132, 133, 135, 142, 143, 145, 153, 154, 155, 161, 162, 163, 167, 174, 175, 183, 186, 191, 193, 194]"
agent_c,L50,short,100,55,45,3,0.5,200,"[1, 2, 3, 5, 6, 7, 9, 10, 11, 12, 14, 16, 17, 18, 20, 21, 22, 23, 26, 27, 28, 30, 31, 32, 33, 34, 36, 37, 38, 39, 40, 41, 42, 43, 44, 45, 47, 49, 50, 51, 52, 53, 54, 55, 57, 59, 61, 67, 69, 71, 73, 74, 76, 78, 79, 80, 81, 82, 88, 91, 92, 94, 95, 96, 97, 98, 99, 101, 103, 111, 113, 118, 119, 121, 122, 124, 132, 133, 134, 137, 139, 147, 148, 149, 152, 161, 162, 168, 169, 170, 171, 172, 174, 182, 183, 190, 191, 192, 193, 198]"
agent_c,L50,short,89,30,59,19,0.5291,189,"[0, 1, 2, 3, 6, 7, 8, 10, 11, 12, 14, 15, 16, 17, 19, 21, 22, 24, 25, 26, 27, 28, 30, 31, 32, 33, 34, 36, 37, 43, 44, 45, 47, 48, 49, 55, 57, 58, 59, 60, 61, 62, 63, 64, 66, 67, 69, 70, 71, 72, 73, 74, 75, 76, 77, 84, 85, 89, 90, 94, 95, 96, 97, 98, 99, 107, 108, 109, 110, 111, 121, 126, 127, 128, 129, 137, 144, 151, 157, 162, 170, 171, 176, 177, 178, 179, 180, 181, 186]"
agent_c,L50,short,98,47,51,3,0.5051,198,"[1, 2, 3, 4, 6, 7, 8, 9, 10, 11, 14, 15, 16, 17, 19, 20, 23, 25, 28, 29, 30, 32, 34, 36, 37, 38, 39, 40, 41, 42, 43, 46, 47, 49, 52, 55, 59, 64, 65, 66, 68, 71, 73, 74, 75, 76, 79, 80, 83, 85, 86, 87, 88, 89, 91, 92, 94, 96, 100, 101, 102, 103, 104, 105, 107, 108, 110, 111, 112, 113, 114, 115, 117, 119, 127, 128, 129, 138, 139, 146, 147, 148, 149, 157, 159, 160, 167, 169, 170, 178, 179, 181, 186, 187, 189, 190, 194, 195]"
agent_c,L50,short,102,46,56,12,0.49,200,"[0, 3, 4, 5, 7, 9, 12, 14, 15, 16, 18, 20, 21, 24, 28, 29, 30, 31, 35, 36, 37, 38, 40, 42, 43, 46, 49, 50, 51, 54, 56, 57, 58, 60, 62, 63, 65, 66, 67, 70, 71, 72, 73, 74, 76, 78, 79, 81, 82, 83, 84, 87, 88, 89, 90, 94, 95, 97, 98, 101, 102, 103, 106, 108, 109, 110, 111, 117, 119, 120, 123, 128, 132, 134, 135, 141, 142, 143, 144, 145, 146, 153, 154, 155, 156, 164, 165, 166, 167, 174, 175, 176, 178, 184, 185, 186, 187, 192, 194, 195, 196, 198]"
agent_c,L50,short,93,28,65,6,0.5181,193,"[0, 2, 4, 6, 7, 9, 10, 14, 15, 16, 17, 19, 20, 21, 22, 23, 25, 27, 28, 29, 30, 32, 33, 34, 35, 37, 38, 39, 42, 43, 44, 45, 46, 47, 48, 50, 52, 53, 54, 55, 58, 59, 61, 62, 63, 65, 66, 67, 70, 71, 72, 74, 76, 78, 80, 81, 86, 88, 91, 93, 94, 95, 96, 97, 99, 100, 101, 102, 103, 104, 106, 113, 114, 116, 118, 125, 126, 127, 136, 138, 148, 155, 157, 158, 165, 168, 177, 178, 182, 183, 184, 186, 189]"
agent_c,L50,short,94,47,47,8,0.5155,194,"[0, 1, 3, 5, 6, 7, 8, 10, 11, 12, 14, 16, 17, 18, 19, 21, 23, 24, 25, 26, 27, 28, 30, 31, 32, 35, 36, 37, 39, 40, 41, 43, 44, 45, 46, 47, 49, 51, 52, 56, 57, 58, 59, 60, 63, 64, 65, 66, 67, 71, 73, 78, 80, 81, 82, 85, 86, 87, 88, 91, 92, 95, 102, 104, 105, 109, 110, 111, 114, 116, 121, 122, 123, 125, 126, 128, 135, 136, 138, 147, 148, 154, 155, 156, 159, 166, 167, 168, 175, 177, 178, 185, 187, 188]"
agent_c,L50,short,98,45,53,5,0.5051,198,"[0, 1, 2, 6, 7, 9, 11, 13, 14, 17, 19, 23, 24, 25, 26, 28, 29, 30, 31, 32, 33, 34, 35, 37, 39, 40, 41, 42, 43, 44, 47, 48, 49, 50, 52, 53, 57, 58, 60, 61, 62, 63, 64, 67, 68, 71, 74, 76, 78, 79, 80, 81, 82, 84, 85, 86, 88, 90, 92, 93, 95, 99, 101, 102, 103, 104, 105, 107, 110, 111, 112, 113, 118, 127, 128, 134, 136, 137, 138, 145, 146, 148, 150, 156, 157, 158, 160, 161, 163, 171, 172, 179, 181, 182, 188, 191, 193, 194]"
agent_c,L50,short,98,51,47,6,0.5051,198,"[0, 4, 5, 10, 11, 12, 15, 16, 18, 19, 21, 22, 23, 24, 27, 32, 33, 36, 37, 39, 41, 42, 43, 44, 45, 47, 48, 49, 50, 51, 53, 54, 56, 57, 58, 59, 61, 62, 64, 65, 66, 68, 69, 70, 71, 73, 74, 75, 76, 77, 78, 79, 80, 82, 83, 84, 85, 86, 87, 88, 91, 96, 98, 99, 100, 101, 104, 106, 107, 108, 109, 110, 111, 112, 113, 121, 122, 123, 130, 131, 133, 134, 142, 145, 152, 154, 156, 164, 165, 172, 174, 175, 176, 183, 186, 192, 195, 196]"
agent_c,L50,short,98,45,53,13,0.5051,198,"[0, 1, 2, 3, 4, 7, 8, 9, 10, 11, 14, 15, 16, 17, 19, 21, 22, 23, 24, 25, 26, 27, 30, 34, 35, 36, 37, 38, 40, 41, 42, 45, 46, 47, 52, 53, 56, 57, 58, 59, 61, 62, 63, 64, 66, 68, 69, 72, 74, 75, 76, 77, 78, 79, 84, 85, 86, 88, 89, 90, 91, 92, 94, 95, 96, 97, 98, 100, 107, 108, 109, 110, 116, 119, 120, 121, 129, 133, 139, 140, 143, 150, 151, 152, 154, 161, 162, 164, 173, 180, 181, 184, 185, 186, 187, 193, 195, 196]"
agent_c,L50,short,93,36,57,9,0.5181,193,"[2, 3, 5, 7, 9, 11, 12, 13, 14, 16, 17, 18, 20, 23, 24, 25, 27, 32, 33, 34, 37, 38, 39, 40, 42, 43, 44, 45, 47, 49, 50, 55, 60, 61, 63, 64, 65, 67, 68, 69, 70, 72, 73, 74, 75, 77, 78, 79, 82, 83, 84, 87, 88, 90, 91, 93, 94, 95, 97, 98, 100, 101, 103, 105, 106, 108, 111, 113, 114, 115, 116, 117, 118, 121, 128, 130, 132, 138, 140, 142, 149, 150, 154, 160, 162, 172, 177, 178, 180, 181, 182, 190, 191]"
agent_c,L50,short,93,53,40,8,0.5181,193,"[3, 5, 6, 7, 8, 9, 11, 12, 15, 16, 17, 18, 19, 21, 22, 24, 28, 29, 32, 33, 34, 35, 36, 41, 42, 43, 44, 45, 47, 50, 51, 52, 56, 57, 59, 61, 63, 65, 66, 67, 69, 70, 71, 74, 77, 78, 79, 80, 81, 82, 83, 84, 85, 86, 87, 88, 90, 91, 93, 94, 95, 96, 97, 106, 107, 108, 110, 111, 112, 113, 114, 116, 118, 125, 126, 128, 134, 136, 138, 145, 147, 153, 159, 160, 162, 163, 171, 172, 173, 180, 181, 182, 184]"
agent_c,L50,short,102,56,46,4,0.49,200,"[1, 2, 4, 5, 8, 9, 10, 13, 14, 17, 18, 19, 21, 22, 23, 24, 25, 26, 29, 30, 32, 34, 35, 36, 37, 38, 39, 40, 42, 43, 44, 45, 48, 49, 51, 52, 54, 55, 58, 61, 62, 63, 64, 65, 67, 68, 69, 70, 71, 73, 74, 78, 81, 82, 85, 86, 88, 89, 90, 91, 92, 93, 94, 101, 102, 103, 104, 106, 109, 110, 111, 112, 115, 123, 124, 125, 132, 133, 134, 135, 136, 144, 146, 147, 155, 156, 157, 159, 167, 168, 169, 176, 177, 178, 179, 188, 189, 195, 196, 197, 198, 199]"
agent_c,L50,short,98,42,56,11,0.5051,198,"[0, 2, 3, 4, 5, 7, 8, 9, 10, 11, 12, 13, 14, 15, 16, 17, 18, 20, 22, 24, 26, 27, 28, 31, 33, 34, 35, 36, 37, 38, 39, 41, 42, 43, 44, 45, 46, 48, 49, 51, 52, 54, 57, 58, 59, 60, 62, 63, 64, 65, 69, 74, 77, 78, 80, 81, 82, 83, 84, 85, 86, 94, 97, 98, 99, 100, 103, 104, 105, 106, 108, 117, 124, 125, 126, 129, 136, 138, 148, 149, 158, 159, 160, 162, 168, 169, 170, 171, 179, 180, 181, 182, 183, 188, 190, 191, 192, 193]"
agent_c,L50,short,101,51,50,4,0.495,200,"[1, 2, 4, 5, 7, 8, 9, 11, 13, 14, 17, 19, 22, 23, 24, 25, 26, 27, 30, 31, 33, 34, 38, 39, 42, 45, 46, 47, 49, 50, 51, 53, 54, 55, 56, 57, 59, 60, 61, 62, 63, 64, 65, 68, 70, 72, 74, 75, 76, 77, 78, 79, 80, 81, 82, 83, 84, 85, 86, 88, 90, 91, 92, 94, 102, 104, 105, 106, 107, 109, 111, 112, 113, 114, 124, 130, 132, 133, 135, 143, 144, 145, 152, 154, 155, 163, 164, 165, 167, 174, 176, 177, 184, 185, 186, 187, 188, 189, 196, 198, 199]"
agent_c,L50,short,94,49,45,17,0.5155,194,"[0, 1, 2, 3, 4, 5, 6, 7, 12, 13, 14, 15, 16, 17, 19, 20, 21, 22, 23, 25, 27, 28, 29, 31, 34, 35, 36, 39, 40, 42, 43, 45, 46, 47, 48, 49, 50, 52, 53, 54, 55, 58, 59, 61, 62, 64, 65, 67, 68, 69, 70, 71, 72, 73, 74, 75, 76, 83, 87, 89, 90, 92, 93, 94, 95, 99, 105, 106, 107, 111, 112, 113, 117, 124, 125, 128, 134, 139, 147, 152, 153, 154, 155, 156, 157, 158, 167, 169, 175, 176, 177, 179, 187, 192]"
agent_c,L50,short,97,42,55,12,0.5076,197,"[1, 3, 6, 7, 8, 9, 10, 11, 13, 14, 16, 18, 19, 20, 23, 24, 26, 29, 31, 33, 36, 38, 40, 41, 43, 44, 45, 47, 48, 49, 53, 54, 55, 56, 57, 60, 63, 64, 65, 66, 67, 68, 73, 75, 76, 77, 79, 80, 81, 84, 88, 89, 90, 92, 95, 97, 98, 99, 100, 102, 108, 111, 112, 113, 114, 117, 120, 122, 123, 127, 134, 135, 136, 141, 142, 143, 144, 145, 146, 147, 149, 156, 157, 160, 168, 169, 176, 177, 178, 179, 180, 185, 186, 188, 189, 190, 195]"
agent_c,L50,short,93,41,52,6,0.5181,193,"[0, 1, 2, 3, 4, 6, 7, 8, 11, 12, 14, 15, 16, 18, 20, 21, 22, 23, 24, 25, 26, 27, 30, 32, 35, 39, 40, 41, 42, 43, 45, 47, 48, 49, 51, 52, 53, 55, 56, 57, 58, 60, 61, 65, 66, 67, 68, 69, 73, 75, 76, 77, 79, 80, 81, 86, 91, 93, 95, 96, 97, 98, 99, 100, 102, 107, 108, 109, 110, 111, 116, 118, 120, 121, 122, 123, 130, 131, 133, 140, 141, 142, 143, 153, 160, 163, 165, 172, 173, 174, 180, 182, 184]"
agent_c,L50,short,99,39,60,16,0.5025,199,"[0, 2, 4, 5, 6, 8, 10, 14, 15, 16, 18, 19, 22, 23, 24, 25, 26, 27, 28, 29, 31, 32, 33, 36, 37, 38, 39, 42, 43, 44, 45, 47, 48, 52, 55, 60, 62, 64, 65, 67, 68, 69, 71, 72, 73, 77, 79, 81, 82, 83, 85, 86, 88, 89, 91, 92, 93, 96, 97, 101, 103, 104, 108, 109, 110, 111, 112, 115, 118, 119, 120, 121, 122, 123, 124, 126, 133, 134, 135, 137, 145, 146, 153, 155, 156, 162, 163, 166, 167, 168, 169, 177, 178, 179, 180, 187, 188, 190, 196]"
agent_c,L50,short,101,42,59,8,0.495,200,"[0, 1, 2, 5, 7, 12, 13, 16, 17, 19, 20, 21, 22, 23, 25, 26, 29, 31, 32, 33, 34, 35, 36, 37, 38, 39, 40, 41, 42, 43, 44, 46, 47, 48, 49, 51, 52, 53, 54, 55, 56, 58, 59, 60, 61, 62, 68, 69, 72, 73, 74, 75, 76, 77, 78, 79, 84, 88, 89, 90, 91, 92, 95, 96, 97, 98, 99, 101, 102, 103, 112, 113, 118, 120, 121, 124, 129, 136, 137, 138, 139, 146, 147, 148, 149, 159, 167, 169, 176, 177, 178, 180, 186, 187, 188, 189, 190, 191, 196, 197, 198]"
agent_c,L50,short,93,32,61,16,0.5181,193,"[0, 3, 4, 5, 7, 9, 10, 12, 15, 17, 18, 20, 21, 22, 25, 28, 30, 31, 32, 33, 34, 35, 36, 40, 42, 43, 44, 45, 46, 47, 49, 54, 58, 59, 61, 64, 66, 67, 70, 71, 76, 79, 80, 81, 82, 83, 84, 86, 87, 88, 89, 92, 95, 97, 98, 100, 101, 103, 107, 109, 110, 111, 112, 113, 116, 117, 119, 123, 127, 128, 129, 131, 136, 138, 143, 149, 150, 151, 152, 153, 160, 163, 168, 169, 170, 171, 172, 173, 179, 180, 182, 187, 191]"
agent_c,L50,short,92,48,44,12,0.5208,192,"[0, 1, 2, 3, 5, 7, 8, 9, 11, 13, 15, 17, 18, 19, 20, 22, 23, 24, 29, 31, 33, 36, 38, 40, 42, 45, 46, 49, 51, 52, 53, 55, 56, 57, 58, 60, 62, 63, 64, 65, 66, 67, 69, 70, 73, 74, 75, 79, 81, 85, 86, 88, 89, 90, 91, 92, 93, 94, 95, 96, 98, 99, 100, 101, 102, 103, 104, 107, 118, 122, 123, 124, 126, 134, 137, 143, 144, 145, 146, 152, 154, 155, 158, 164, 168, 176, 177, 178, 182, 183, 186, 189]"
agent_c,L50,short,99,44,55,3,0.5025,199,"[2, 3, 4, 6, 7, 8, 9, 11, 12, 13, 14, 15, 17, 18, 20, 21, 23, 24, 25, 26, 27, 28, 29, 30, 31, 32, 34, 36, 37, 38, 39, 40, 41, 42, 44, 46, 48, 49, 50, 53, 54, 55, 57, 58, 59, 60, 61, 62, 67, 68, 69, 70, 72, 73, 74, 76, 77, 78, 79, 80, 81, 82, 83, 84, 85, 96, 97, 98, 99, 101, 102, 103, 105, 108, 109, 110, 119, 120, 128, 129, 131, 139, 141, 148, 150, 151, 160, 161, 168, 169, 171, 179, 180, 181, 183, 190, 191, 192, 194]"
agent_c,L50,short,99,47,52,5,0.5025,199,"[0, 1, 2, 5, 6, 8, 9, 10, 11, 12, 14, 15, 17, 18, 19, 20, 23, 24, 25, 26, 28, 29, 30, 31, 33, 34, 35, 36, 37, 38, 40, 41, 43, 45, 46, 47, 48, 51, 52, 54, 55, 56, 57, 59, 60, 61, 64, 65, 67, 69, 70, 71, 72, 73, 74, 81, 83, 86, 87, 88, 90, 91, 94, 95, 97, 103, 104, 106, 107, 111, 112, 113, 115, 116, 117, 125, 127, 134, 137, 144, 145, 146, 147, 155, 156, 157, 165, 166, 167, 174, 180, 185, 187, 188, 189, 194, 195, 196, 197]"
agent_c,L50,short,98,51,47,11,0.5051,198,"[0, 1, 2, 3, 4, 6, 7, 11, 13, 14, 16, 20, 21, 22, 24, 25, 26, 28, 30, 31, 32, 33, 35, 36, 37, 38, 40, 41, 42, 43, 45, 46, 47, 50, 52, 53, 54, 55, 56, 58, 59, 61, 64, 66, 67, 69, 70, 71, 74, 76, 77, 79, 80, 81, 82, 86, 88, 89, 91, 93, 94, 95, 96, 98, 100, 101, 102, 103, 104, 105, 106, 113, 114, 115, 116, 117, 123, 124, 126, 127, 135, 139, 146, 147, 155, 158, 165, 168, 176, 177, 178, 184, 186, 189, 193, 194, 195, 196]"
agent_c,L50,short,93,51,42,5,0.5181,193,"[1, 3, 4, 5, 7, 8, 10, 11, 12, 13, 15, 18, 19, 20, 22, 23, 24, 25, 27, 28, 31, 32, 33, 34, 36, 37, 38, 39, 41, 42, 43, 44, 45, 46, 47, 48, 49, 50, 51, 55, 56, 60, 61, 63, 64, 66, 68, 69, 70, 71, 76, 77, 78, 79, 80, 81, 82, 85, 87, 88, 89, 90, 91, 92, 99, 101, 102, 104, 106, 107, 109, 114, 123, 128, 129, 130, 134, 135, 136, 143, 144, 146, 160, 167, 168, 173, 177, 178, 182, 183, 187, 188, 189]"
agent_c,L50,short,94,42,52,15,0.5155,194,"[0, 1, 3, 5, 6, 7, 8, 9, 10, 12, 13, 16, 18, 23, 24, 25, 27, 29, 30, 31, 32, 33, 35, 36, 37, 38, 42, 43, 44, 46, 47, 48, 50, 52, 53, 54, 55, 57, 58, 59, 60, 62, 64, 65, 66, 67, 68, 70, 71, 73, 76, 77, 78, 79, 80, 81, 82, 83, 84, 85, 91, 92, 93, 94, 95, 96, 98, 99, 100, 101, 102, 103, 104, 106, 116, 122, 124, 125, 134, 135, 142, 145, 152, 153, 154, 158, 165, 172, 173, 175, 184, 187, 191, 192]"
agent_c,L50,short,91,47,44,9,0.5236,191,"[0, 1, 2, 3, 5, 6, 9, 10, 12, 14, 15, 16, 17, 18, 19, 20, 21, 24, 26, 28, 30, 31, 33, 34, 35, 36, 37, 38, 39, 40, 44, 45, 46, 47, 49, 50, 52, 53, 54, 55, 56, 57, 58, 60, 63, 66, 68, 70, 71, 75, 76, 77, 78, 79, 81, 88, 89, 90, 91, 92, 93, 94, 95, 96, 97, 99, 101, 110, 111, 115, 116, 117, 119, 123, 131, 132, 140, 141, 142, 145, 152, 154, 161, 162, 164, 172, 174, 180, 181, 183, 188]"
agent_c,L50,short,100,62,38,5,0.5,200,"[0, 1, 2, 3, 4, 5, 6, 7, 8, 9, 10, 11, 13, 14, 15, 16, 17, 18, 19, 20, 22, 24, 25, 26, 27, 29, 30, 31, 32, 33, 34, 39, 41, 43, 44, 47, 49, 51, 53, 54, 55, 57, 58, 59, 60, 61, 62, 63, 64, 65, 66, 67, 68, 70, 72, 80, 86, 89, 91, 92, 93, 95, 100, 101, 103, 104, 105, 106, 111, 113, 114, 116, 124, 126, 127, 133, 134, 135, 137, 144, 147, 153, 154, 156, 157, 166, 167, 168, 175, 176, 177, 178, 179, 187, 188, 189, 194, 195, 196, 197]"
agent_c,L50,short,99,52,47,8,0.5025,199,"[0, 2, 3, 4, 5, 6, 7, 8, 9, 10, 11, 12, 14, 15, 17, 18, 19, 22, 24, 26, 27, 28, 30, 31, 32, 33, 34, 35, 36, 37, 40, 42, 43, 44, 45, 48, 49, 51, 52, 53, 54, 55, 58, 60, 64, 65, 68, 70, 71, 73, 77, 79, 80, 82, 83, 85, 86, 87, 93, 94, 95, 97, 98, 101, 103, 105, 107, 114, 115, 116, 117, 121, 123, 124, 125, 126, 127, 128, 133, 141, 148, 149, 150, 151, 153, 161, 162, 163, 170, 171, 173, 180, 181, 182, 186, 192, 193, 194, 195]"
agent_c,L50,short,99,37,62,10,0.5025,199,"[0, 1, 2, 3, 6, 9, 12, 14, 15, 16, 17, 19, 22, 23, 24, 29, 31, 32, 33, 34, 35, 39, 40, 42, 43, 44, 46, 47, 49, 51, 54, 55, 57, 59, 61, 62, 63, 64, 67, 68, 70, 71, 73, 74, 75, 76, 77, 78, 80, 83, 84, 85, 86, 88, 89, 90, 91, 92, 96, 100, 101, 102, 108, 109, 110, 111, 112, 115, 116, 119, 120, 121, 122, 128, 129, 131, 132, 133, 139, 142, 143, 150, 151, 153, 160, 161, 162, 163, 172, 174, 180, 181, 182, 183, 190, 191, 192, 193, 194]"
agent_c,L50,short,97,45,52,5,0.5076,197,"[2, 3, 6, 8, 9, 10, 12, 13, 14, 17, 18, 19, 21, 23, 24, 25, 26, 27, 28, 29, 30, 31, 32, 33, 34, 35, 36, 37, 38, 39, 40, 42, 43, 44, 45, 46, 47, 49, 51, 52, 55, 56, 57, 59, 60, 61, 62, 64, 65, 66, 72, 73, 74, 75, 77, 79, 80, 82, 84, 87, 95, 96, 97, 98, 99, 101, 102, 103, 106, 107, 115, 116, 117, 125, 127, 135, 136, 137, 143, 144, 145, 147, 154, 155, 156, 158, 165, 167, 174, 175, 176, 180, 187, 189, 190, 191, 194]"
agent_c,L50,short,98,50,48,13,0.5051,198,"[0, 2, 4, 5, 6, 7, 9, 10, 13, 14, 15, 16, 17, 18, 21, 22, 26, 29, 30, 31, 32, 33, 34, 35, 36, 37, 38, 39, 40, 42, 43, 44, 45, 46, 47, 50, 51, 53, 54, 55, 56, 58, 60, 64, 67, 70, 71, 72, 73, 74, 77, 78, 79, 80, 81, 82, 84, 85, 89, 93, 94, 95, 96, 97, 98, 99, 100, 101, 102, 103, 104, 107, 115, 116, 122, 130, 137, 138, 139, 146, 147, 148, 149, 157, 159, 167, 169, 170, 177, 178, 179, 180, 186, 187, 190, 191, 195, 196]"
agent_c,L50,short,94,41,53,3,0.5155,194,"[0, 1, 3, 5, 8, 9, 10, 11, 13, 14, 15, 16, 18, 20, 21, 22, 24, 25, 27, 28, 29, 30, 31, 32, 36, 38, 39, 40, 41, 43, 44, 45, 46, 47, 49, 50, 51, 52, 53, 54, 58, 59, 60, 61, 62, 63, 64, 65, 66, 67, 68, 70, 71, 72, 73, 74, 82, 83, 85, 86, 87, 88, 90, 91, 92, 93, 94, 102, 103, 104, 111, 113, 114, 115, 116, 126, 132, 133, 137, 140, 148, 149, 150, 151, 159, 160, 161, 162, 163, 174, 182, 183, 185, 191]"
agent_c,L50,short,94,42,52,10,0.5155,194,"[1, 2, 3, 4, 6, 8, 11, 13, 14, 15, 16, 19, 20, 23, 24, 25, 26, 27, 28, 29, 30, 32, 33, 34, 36, 37, 38, 40, 41, 43, 45, 46, 47, 50, 53, 56, 57, 58, 59, 60, 62, 63, 64, 66, 68, 69, 70, 73, 74, 75, 76, 77, 81, 82, 85, 87, 89, 91, 93, 94, 95, 97, 98, 100, 101, 102, 108, 113, 118, 119, 120, 121, 125, 134, 139, 141, 143, 149, 150, 153, 160, 164, 171, 172, 173, 174, 180, 183, 184, 187, 189, 190, 191, 192]"
agent_c,L50,short,95,36,59,10,0.5128,195,"[1, 2, 3, 4, 5, 6, 9, 10, 11, 12, 13, 14, 15, 16, 17, 18, 19, 20, 21, 24, 25, 28, 30, 31, 33, 34, 36, 39, 40, 42, 43, 44, 45, 46, 47, 48, 49, 51, 54, 56, 58, 61, 64, 66, 67, 71, 72, 73, 74, 75, 76, 77, 78, 79, 80, 82, 83, 84, 87, 89, 90, 95, 96, 97, 98, 99, 100, 101, 103, 105, 106, 107, 112, 122, 128, 130, 138, 140, 141, 148, 149, 152, 159, 160, 162, 171, 177, 178, 180, 183, 188, 189, 190, 192, 193]"
agent_c,L50,short,100,56,44,9,0.5,200,"[0, 2, 4, 7, 8, 10, 11, 12, 13, 14, 15, 16, 18, 21, 22, 23, 24, 25, 26, 27, 29, 31, 32, 34, 35, 36, 37, 38, 39, 40, 41, 42, 43, 46, 47, 48, 50, 51, 52, 55, 57, 58, 59, 60, 61, 62, 65, 66, 69, 70, 75, 77, 79, 81, 82, 85, 86, 87, 88, 90, 91, 93, 96, 101, 103, 105, 106, 107, 113, 114, 116, 117, 124, 125, 129, 135, 136, 137, 145, 146, 147, 148, 154, 156, 158, 165, 166, 167, 168, 174, 175, 176, 177, 178, 185, 186, 187, 188, 189, 190]"
agent_c,L50,short,99,43,56,8,0.5025,199,"[1, 2, 3, 4, 7, 8, 9, 10, 11, 13, 14, 15, 16, 17, 18, 20, 22, 23, 24, 25, 26, 28, 30, 31, 32, 33, 34, 35, 36, 37, 40, 42, 43, 46, 47, 48, 49, 51, 52, 53, 54, 55, 56, 57, 58, 59, 61, 62, 63, 64, 66, 67, 74, 75, 78, 79, 80, 82, 84, 86, 88, 89, 90, 91, 99, 105, 108, 109, 110, 112, 119, 121, 122, 127, 129, 132, 141, 142, 144, 150, 153, 154, 161, 163, 166, 172, 175, 176, 182, 183, 184, 186, 190, 191, 192, 193, 194, 195, 197]"
agent_c,L50,short,94,40,54,20,0.5155,194,"[1, 2, 3, 4, 5, 6, 8, 10, 11, 12, 13, 15, 16, 18, 19, 20, 21, 23, 24, 25, 26, 29, 32, 33, 34, 35, 36, 37, 38, 39, 41, 43, 44, 46, 47, 48, 49, 50, 52, 53, 54, 55, 56, 57, 58, 59, 60, 61, 62, 63, 64, 67, 68, 71, 77, 78, 79, 81, 84, 85, 87, 89, 90, 91, 99, 101, 109, 113, 114, 115, 121, 124, 125, 130, 131, 132, 133, 134, 135, 144, 146, 155, 161, 169, 174, 176, 177, 182, 184, 185, 186, 188, 191, 192]"
agent_c,L50,short,95,47,48,16,0.5128,195,"[1, 2, 3, 4, 5, 7, 9, 10, 11, 12, 13, 14, 15, 18, 19, 25, 27, 28, 29, 30, 31, 32, 33, 34, 35, 37, 38, 39, 40, 42, 43, 45, 49, 50, 51, 52, 53, 54, 55, 56, 58, 59, 60, 61, 62, 66, 68, 70, 71, 72, 73, 74, 75, 76, 77, 79, 81, 82, 85, 93, 94, 95, 96, 98, 99, 100, 101, 102, 104, 112, 114, 115, 116, 122, 123, 124, 125, 126, 134, 135, 138, 146, 147, 148, 149, 157, 158, 160, 168, 169, 176, 183, 187, 188, 191]"
agent_c,L50,short,101,43,58,21,0.495,200,"[0, 1, 2, 3, 4, 5, 6, 7, 8, 9, 10, 11, 12, 13, 14, 19, 23, 25, 27, 28, 30, 31, 33, 35, 37, 38, 39, 41, 42, 43, 44, 45, 48, 51, 53, 54, 57, 59, 60, 61, 63, 64, 65, 66, 67, 69, 71, 72, 73, 75, 77, 78, 79, 80, 85, 86, 87, 88, 96, 99, 101, 105, 108, 109, 110, 111, 113, 119, 120, 121, 122, 124, 130, 132, 133, 140, 143, 149, 150, 151, 152, 160, 166, 173, 174, 175, 176, 181, 182, 183, 184, 185, 186, 191, 193, 194, 195, 196, 197, 198, 199]"
agent_c,L50,short,97,61,36,8,0.5076,197,"[0, 1, 2, 4, 7, 9, 10, 11, 13, 16, 17, 21, 22, 23, 24, 26, 27, 29, 30, 31, 33, 34, 35, 36, 37, 38, 39, 40, 41, 42, 43, 44, 46, 47, 48, 50, 51, 54, 55, 56, 57, 58, 59, 60, 61, 66, 68, 71, 72, 73, 74, 75, 77, 78, 79, 80, 81, 84, 85, 94, 95, 96, 100, 102, 104, 105, 106, 112, 114, 116, 122, 123, 124, 125, 126, 134, 136, 138, 139, 146, 147, 148, 149, 156, 158, 159, 163, 170, 171, 178, 179, 180, 181, 187, 188, 191, 195]"
agent_c,L50,short,99,53,46,6,0.5025,199,"[0, 1, 2, 3, 5, 7, 9, 11, 12, 14, 15, 17, 19, 20, 22, 23, 24, 26, 27, 29, 32, 34, 35, 36, 37, 38, 39, 40, 41, 42, 44, 45, 46, 47, 48, 50, 51, 53, 54, 55, 57, 58, 62, 66, 67, 70, 72, 74, 76, 77, 78, 79, 80, 81, 85, 86, 87, 88, 89, 90, 92, 93, 95, 96, 97, 98, 100, 101, 102, 111, 112, 114, 119, 121, 124, 133, 139, 143, 144, 150, 151, 152, 153, 154, 155, 162, 163, 164, 165, 166, 167, 176, 177, 184, 185, 187, 194, 196, 197]"
agent_c,L50,short,96,46,50,5,0.5102,196,"[0, 1, 2, 4, 5, 7, 9, 11, 12, 13, 15, 18, 21, 22, 23, 24, 25, 26, 27, 28, 29, 30, 31, 33, 34, 35, 37, 41, 42, 44, 47, 48, 49, 51, 52, 54, 55, 57, 58, 59, 60, 61, 63, 65, 66, 67, 68, 69, 70, 71, 72, 73, 74, 76, 79, 82, 86, 87, 88, 89, 90, 93, 95, 96, 97, 98, 101, 102, 103, 104, 113, 114, 115, 120, 123, 127, 134, 135, 136, 137, 144, 145, 147, 154, 155, 157, 165, 168, 176, 177, 183, 185, 186, 189, 193, 194]"
agent_c,L50,short,93,48,45,11,0.5181,193,"[0, 2, 4, 6, 8, 12, 14, 15, 16, 17, 19, 21, 23, 26, 27, 30, 32, 33, 35, 38, 41, 42, 43, 44, 45, 46, 47, 48, 50, 51, 52, 53, 55, 56, 57, 58, 59, 61, 62, 63, 67, 69, 70, 72, 73, 74, 75, 77, 78, 79, 81, 84, 85, 87, 89, 91, 92, 93, 94, 96, 98, 100, 101, 105, 107, 108, 110, 111, 114, 115, 117, 118, 120, 121, 128, 129, 130, 131, 132, 134, 141, 144, 153, 154, 160, 161, 163, 167, 177, 183, 185, 187, 191]"
agent_c,L50,short,96,52,44,6,0.5102,196,"[0, 1, 3, 4, 6, 7, 10, 12, 13, 17, 18, 20, 21, 23, 25, 26, 27, 28, 32, 33, 35, 37, 40, 41, 42, 43, 44, 45, 47, 48, 49, 50, 52, 53, 54, 55, 56, 57, 58, 59, 60, 61, 62, 66, 67, 68, 69, 70, 72, 74, 75, 76, 77, 78, 79, 81, 82, 84, 86, 95, 96, 97, 99, 100, 101, 102, 103, 105, 111, 112, 116, 121, 122, 123, 124, 125, 126, 127, 135, 137, 144, 145, 146, 147, 158, 165, 166, 167, 174, 176, 177, 183, 184, 185, 186, 187]"
agent_c,L50,short,95,46,49,7,0.5128,195,"[0, 2, 3, 6, 7, 8, 9, 10, 15, 16, 18, 19, 20, 21, 23, 25, 26, 28, 29, 30, 31, 32, 33, 34, 35, 36, 37, 39, 40, 41, 42, 43, 46, 47, 48, 50, 52, 53, 54, 55, 58, 59, 61, 63, 64, 65, 66, 67, 68, 69, 70, 71, 76, 80, 81, 82, 83, 85, 88, 90, 91, 93, 94, 95, 96, 104, 105, 106, 110, 111, 112, 113, 116, 123, 125, 126, 133, 134, 135, 136, 144, 147, 154, 155, 156, 164, 165, 166, 172, 173, 175, 176, 182, 184, 190]"
agent_c,L50,short,95,50,45,10,0.5128,195,"[3, 4, 7, 8, 10, 13, 16, 20, 22, 23, 24, 25, 28, 30, 31, 32, 34, 35, 36, 38, 39, 41, 43, 44, 45, 47, 48, 50, 51, 53, 54, 55, 56, 57, 58, 59, 60, 62, 63, 64, 65, 66, 67, 69, 70, 71, 72, 74, 78, 82, 85, 86, 87, 89, 90, 91, 92, 93, 94, 97, 99, 100, 101, 102, 103, 104, 105, 106, 107, 108, 109, 112, 113, 114, 126, 132, 133, 134, 135, 143, 145, 146, 149, 157, 165, 166, 167, 176, 177, 183, 185, 186, 187, 190, 193]"
agent_c,L50,short,102,56,46,18,0.49,200,"[0, 1, 2, 3, 4, 6, 7, 8, 10, 12, 13, 15, 17, 18, 21, 22, 25, 27, 28, 29, 31, 33, 34, 35, 36, 37, 38, 40, 45, 47, 48, 49, 50, 51, 52, 53, 55, 58, 59, 60, 61, 62, 63, 64, 65, 67, 68, 70, 72, 73, 74, 76, 77, 78, 79, 80, 81, 83, 84, 85, 91, 92, 93, 94, 95, 97, 98, 99, 100, 102, 103, 104, 109, 123, 130, 136, 138, 144, 145, 148, 149, 156, 158, 159, 165, 166, 168, 170, 177, 178, 179, 185, 186, 188, 189, 193, 194, 195, 196, 197, 198, 199]"
agent_c,L50,short,95,39,56,13,0.5128,195,"[0, 2, 3, 5, 6, 7, 8, 9, 10, 11, 12, 13, 14, 16, 17, 18, 19, 20, 21, 22, 24, 27, 28, 30, 31, 33, 34, 37, 39, 40, 41, 43, 44, 45, 46, 47, 50, 52, 53, 55, 56, 57, 58, 59, 60, 61, 64, 69, 70, 72, 73, 75, 76, 78, 79, 80, 82, 86, 92, 95, 96, 98, 99, 104, 106, 112, 113, 114, 115, 119, 123, 124, 126, 127, 133, 134, 135, 137, 143, 145, 146, 147, 155, 156, 158, 166, 170, 177, 179, 181, 183, 190, 191, 192, 193]"
agent_c,L50,short,96,50,46,11,0.5102,196,"[0, 1, 2, 3, 8, 9, 10, 11, 12, 14, 15, 17, 18, 19, 21, 22, 24, 25, 26, 27, 29, 30, 31, 32, 33, 34, 35, 36, 41, 42, 43, 44, 47, 48, 52, 53, 54, 55, 56, 58, 59, 60, 61, 62, 63, 65, 66, 67, 69, 73, 74, 78, 79, 80, 83, 85, 87, 88, 89, 92, 94, 95, 100, 104, 105, 107, 108, 109, 110, 112, 113, 114, 116, 124, 125, 131, 132, 133, 134, 135, 137, 145, 146, 147, 148, 156, 157, 159, 167, 169, 176, 181, 186, 187, 188, 193]"
agent_c,L50,short,97,46,51,6,0.5076,197,"[1, 2, 3, 4, 6, 7, 8, 9, 11, 12, 13, 16, 18, 19, 20, 21, 23, 24, 26, 27, 28, 30, 31, 32, 33, 34, 35, 36, 37, 38, 39, 40, 41, 42, 43, 44, 45, 47, 52, 53, 54, 56, 57, 58, 59, 60, 62, 65, 68, 69, 70, 71, 78, 79, 80, 81, 82, 84, 85, 86, 87, 88, 89, 90, 91, 93, 95, 96, 97, 107, 112, 116, 118, 125, 126, 127, 133, 135, 136, 137, 138, 146, 148, 155, 156, 161, 168, 169, 171, 177, 178, 180, 186, 187, 191, 194, 195]"
agent_c,L50,short,94,45,49,10,0.5155,194,"[0, 2, 5, 7, 9, 13, 15, 18, 19, 20, 22, 24, 26, 27, 28, 29, 30, 32, 33, 34, 36, 37, 38, 39, 40, 42, 43, 44, 45, 46, 47, 49, 50, 51, 52, 55, 56, 57, 60, 61, 62, 63, 64, 65, 66, 67, 68, 70, 71, 74, 75, 78, 81, 84, 85, 87, 88, 90, 94, 95, 96, 98, 99, 102, 106, 107, 108, 109, 110, 111, 117, 118, 119, 123, 131, 133, 141, 142, 144, 152, 153, 156, 162, 165, 172, 173, 174, 175, 181, 185, 188, 190, 191, 192]"
agent_c,L50,short,102,48,54,6,0.49,200,"[0, 2, 5, 6, 7, 9, 10, 14, 15, 17, 18, 19, 21, 22, 23, 24, 25, 26, 27, 28, 29, 30, 31, 33, 34, 35, 36, 38, 40, 41, 43, 44, 45, 46, 47, 49, 50, 52, 53, 54, 55, 56, 57, 59, 63, 64, 66, 67, 72, 73, 74, 75, 77, 78, 81, 82, 83, 84, 85, 86, 91, 99, 100, 101, 103, 104, 105, 106, 107, 108, 109, 117, 118, 119, 126, 127, 128, 130, 131, 139, 142, 149, 150, 151, 152, 160, 161, 163, 170, 171, 172, 173, 181, 182, 183, 189, 190, 191, 192, 193, 194, 196]"
agent_c,L50,short,99,62,37,3,0.5025,199,"[0, 1, 2, 3, 4, 5, 6, 7, 8, 10, 11, 12, 14, 15, 16, 17, 18, 19, 21, 22, 25, 26, 27, 29, 30, 32, 34, 35, 36, 37, 39, 40, 41, 43, 44, 45, 46, 48, 50, 54, 56, 57, 58, 59, 60, 61, 62, 63, 64, 66, 67, 68, 69, 70, 72, 74, 84, 87, 88, 89, 90, 91, 92, 93, 94, 103, 104, 107, 108, 109, 110, 111, 112, 113, 115, 124, 125, 133, 134, 135, 144, 146, 153, 154, 155, 162, 164, 165, 172, 173, 174, 176, 177, 185, 186, 187, 194, 196, 197]"
agent_c,L50,short,95,32,63,14,0.5128,195,"[0, 1, 3, 4, 5, 6, 7, 10, 11, 12, 13, 16, 18, 19, 20, 21, 22, 23, 24, 26, 27, 28, 29, 30, 31, 32, 33, 34, 35, 39, 43, 45, 46, 47, 49, 50, 52, 53, 55, 56, 57, 58, 61, 62, 64, 65, 66, 67, 68, 71, 72, 78, 81, 83, 84, 86, 87, 88, 89, 90, 91, 94, 102, 105, 107, 109, 111, 112, 113, 116, 121, 125, 131, 132, 137, 148, 155, 156, 157, 163, 164, 165, 166, 169, 174, 175, 176, 177, 178, 179, 180, 185, 186, 188, 193]"
agent_c,L50,short,97,56,41,8,0.5076,197,"[0, 1, 2, 3, 4, 5, 6, 7, 10, 12, 13, 15, 16, 17, 18, 19, 20, 21, 22, 23, 24, 25, 27, 28, 29, 30, 31, 32, 33, 36, 37, 39, 40, 41, 43, 45, 48, 49, 51, 52, 53, 55, 56, 57, 58, 60, 62, 63, 64, 72, 75, 76, 77, 78, 79, 80, 81, 82, 83, 84, 90, 92, 93, 94, 95, 96, 98, 100, 101, 102, 104, 105, 114, 116, 124, 125, 132, 134, 135, 142, 143, 148, 160, 167, 174, 175, 177, 181, 182, 183, 184, 185, 186, 188, 192, 193, 195]"
agent_c,L50,short,100,40,60,10,0.5,200,"[0, 1, 5, 6, 7, 8, 9, 12, 13, 14, 17, 18, 19, 20, 21, 22, 25, 28, 30, 31, 32, 33, 34, 36, 38, 39, 40, 41, 43, 44, 46, 47, 48, 53, 56, 59, 62, 63, 64, 66, 67, 68, 69, 70, 71, 73, 74, 75, 77, 78, 79, 82, 83, 87, 88, 91, 92, 94, 95, 97, 98, 100, 101, 102, 104, 108, 109, 110, 111, 112, 113, 115, 117, 124, 125, 127, 135, 136, 142, 143, 144, 146, 147, 154, 155, 157, 165, 166, 167, 168, 170, 177, 178, 179, 182, 189, 190, 191, 192, 195]"
agent_c,L50,short,99,43,56,6,0.5025,199,"[0, 2, 4, 5, 6, 7, 8, 10, 11, 13, 14, 15, 16, 17, 19, 20, 21, 22, 23, 25, 26, 27, 28, 29, 30, 31, 32, 34, 35, 36, 39, 40, 41, 42, 43, 45, 46, 47, 48, 49, 53, 56, 58, 60, 62, 64, 67, 68, 70, 77, 78, 81, 83, 85, 86, 87, 88, 90, 93, 94, 97, 99, 103, 104, 106, 108, 109, 110, 115, 117, 119, 121, 126, 127, 128, 129, 131, 138, 140, 142, 150, 151, 153, 154, 161, 163, 165, 172, 173, 174, 180, 181, 183, 184, 185, 192, 193, 194, 195]"
agent_c,L50,short,98,46,52,7,0.5051,198,"[1, 2, 3, 4, 7, 8, 9, 10, 13, 14, 15, 16, 18, 19, 21, 22, 23, 24, 25, 26, 27, 28, 30, 31, 32, 34, 36, 39, 40, 41, 43, 45, 46, 47, 53, 54, 55, 56, 58, 59, 60, 61, 62, 63, 64, 67, 69, 70, 71, 72, 73, 76, 78, 79, 81, 83, 84, 85, 86, 93, 94, 95, 96, 97, 99, 102, 103, 105, 106, 114, 116, 121, 123, 125, 129, 135, 136, 142, 143, 144, 145, 146, 147, 154, 156, 157, 165, 166, 167, 174, 175, 177, 178, 179, 186, 187, 190, 196]"
agent_c,L50,short,96,43,53,11,0.5102,196,"[1, 3, 4, 11, 12, 13, 15, 17, 18, 19, 20, 21, 22, 23, 25, 26, 27, 29, 30, 32, 33, 34, 35, 36, 38, 39, 40, 42, 44, 45, 46, 48, 49, 51, 54, 56, 57, 59, 60, 63, 65, 67, 68, 69, 71, 72, 74, 75, 76, 77, 78, 81, 82, 83, 84, 89, 91, 92, 95, 96, 97, 100, 101, 103, 104, 108, 109, 110, 111, 112, 113, 116, 117, 123, 124, 125, 126, 128, 138, 144, 146, 147, 148, 155, 158, 165, 166, 167, 168, 169, 173, 180, 186, 188, 189, 190]"
agent_c,L50,short,97,51,46,5,0.5076,197,"[0, 1, 3, 4, 5, 6, 7, 8, 9, 10, 13, 15, 17, 18, 20, 21, 22, 23, 27, 29, 31, 32, 34, 35, 36, 37, 38, 39, 40, 41, 42, 46, 47, 48, 49, 50, 51, 52, 55, 56, 57, 58, 60, 61, 62, 64, 65, 66, 68, 69, 70, 72, 79, 81, 82, 83, 84, 87, 88, 89, 90, 92, 93, 100, 103, 104, 105, 107, 110, 111, 114, 123, 126, 132, 133, 134, 135, 142, 143, 145, 152, 157, 165, 166, 172, 173, 174, 175, 176, 178, 179, 180, 186, 187, 189, 190, 195]"
agent_c,L50,short,94,60,34,13,0.5155,194,"[2, 3, 4, 5, 6, 7, 8, 9, 10, 13, 14, 15, 22, 23, 24, 25, 26, 27, 28, 32, 33, 34, 35, 37, 39, 40, 41, 42, 44, 45, 46, 47, 48, 49, 50, 51, 52, 53, 54, 56, 57, 58, 59, 61, 65, 66, 67, 69, 70, 71, 72, 75, 76, 77, 79, 80, 81, 90, 91, 92, 93, 94, 95, 96, 97, 98, 99, 100, 105, 111, 118, 119, 124, 131, 132, 139, 140, 143, 150, 151, 153, 158, 159, 160, 162, 169, 172, 177, 180, 181, 182, 183, 185, 192]"
agent_c,L50,short,95,35,60,13,0.5128,195,"[0, 1, 2, 4, 6, 7, 8, 11, 12, 13, 14, 16, 18, 20, 21, 22, 23, 26, 28, 29, 31, 32, 34, 35, 37, 38, 39, 41, 42, 43, 44, 45, 46, 47, 48, 49, 50, 51, 54, 56, 58, 59, 60, 61, 62, 63, 64, 66, 67, 68, 70, 71, 75, 81, 82, 84, 85, 88, 90, 91, 94, 100, 101, 103, 105, 106, 107, 108, 110, 111, 112, 113, 115, 123, 124, 125, 133, 134, 136, 143, 144, 145, 152, 153, 154, 155, 164, 165, 174, 175, 177, 185, 186, 188, 193]"
agent_c,L50,short,98,55,43,10,0.5051,198,"[1, 3, 6, 7, 8, 9, 10, 11, 14, 15, 16, 20, 22, 23, 25, 26, 27, 29, 30, 34, 37, 41, 43, 44, 45, 47, 50, 52, 57, 59, 60, 61, 62, 64, 65, 66, 68, 69, 70, 72, 73, 74, 75, 76, 78, 79, 83, 84, 85, 86, 89, 90, 92, 94, 95, 98, 100, 101, 102, 104, 105, 106, 107, 108, 109, 111, 112, 113, 114, 115, 117, 118, 119, 127, 128, 131, 137, 138, 141, 148, 149, 150, 157, 158, 159, 160, 168, 169, 171, 177, 178, 179, 180, 181, 183, 190, 191, 193]"
agent_c,L50,short,97,46,51,11,0.5076,197,"[0, 1, 3, 4, 5, 6, 7, 8, 9, 10, 11, 12, 13, 15, 18, 21, 22, 23, 24, 25, 26, 27, 28, 31, 32, 33, 34, 35, 36, 38, 40, 41, 42, 43, 46, 47, 50, 51, 53, 54, 57, 60, 61, 63, 64, 65, 66, 67, 70, 71, 72, 73, 74, 75, 77, 84, 85, 86, 89, 91, 92, 93, 96, 97, 102, 104, 105, 106, 107, 111, 112, 113, 114, 117, 124, 125, 127, 134, 135, 136, 137, 139, 147, 149, 156, 157, 162, 170, 177, 179, 184, 185, 186, 190, 193, 194, 195]"
agent_c,L50,short,97,38,59,3,0.5076,197,"[0, 1, 2, 5, 7, 9, 10, 11, 12, 13, 17, 18, 20, 21, 22, 24, 26, 27, 29, 31, 32, 34, 36, 37, 38, 40, 41, 42, 43, 44, 45, 46, 47, 48, 49, 50, 51, 52, 55, 56, 57, 60, 61, 63, 64, 67, 68, 69, 71, 72, 73, 74, 75, 76, 77, 78, 79, 82, 84, 85, 93, 94, 96, 97, 98, 99, 102, 103, 105, 106, 113, 114, 117, 124, 126, 127, 128, 135, 137, 138, 139, 140, 148, 150, 157, 158, 161, 169, 171, 178, 179, 180, 182, 187, 189, 191, 192]"
agent_c,L50,short,97,58,39,2,0.5076,197,"[1, 2, 3, 4, 5, 7, 8, 9, 10, 12, 14, 17, 18, 19, 20, 21, 22, 23, 24, 28, 29, 30, 31, 32, 33, 34, 35, 36, 37, 38, 39, 41, 42, 43, 44, 45, 47, 50, 52, 53, 55, 56, 57, 59, 60, 62, 63, 64, 67, 69, 70, 78, 79, 80, 83, 84, 85, 86, 87, 88, 89, 90, 91, 97, 98, 101, 103, 105, 107, 108, 110, 111, 112, 113, 114, 115, 116, 126, 135, 137, 144, 145, 146, 147, 156, 157, 166, 167, 173, 174, 175, 177, 178, 179, 187, 189, 195]"
agent_c,L50,short,97,51,46,7,0.5076,197,"[0, 1, 2, 4, 6, 7, 8, 9, 10, 11, 12, 13, 15, 16, 18, 20, 21, 23, 25, 27, 28, 29, 30, 31, 32, 33, 34, 36, 37, 38, 39, 40, 41, 42, 44, 45, 46, 48, 53, 55, 56, 57, 58, 59, 60, 62, 65, 67, 69, 71, 72, 74, 75, 77, 79, 80, 81, 84, 89, 90, 92, 93, 95, 96, 97, 99, 101, 102, 103, 105, 112, 113, 115, 116, 117, 124, 125, 126, 127, 128, 130, 139, 149, 156, 157, 160, 161, 168, 169, 173, 180, 181, 182, 191, 192, 193, 194]"
agent_c,L50,short,95,41,54,10,0.5128,195,"[0, 3, 5, 7, 8, 9, 10, 11, 12, 13, 15, 16, 18, 19, 20, 21, 22, 23, 24, 26, 27, 31, 33, 35, 36, 37, 38, 39, 40, 43, 45, 46, 47, 48, 49, 50, 51, 54, 55, 58, 59, 60, 61, 64, 65, 67, 68, 69, 71, 72, 73, 74, 75, 76, 77, 82, 83, 85, 91, 92, 98, 103, 104, 105, 106, 107, 109, 115, 116, 118, 119, 126, 127, 129, 134, 135, 139, 143, 149, 151, 156, 157, 158, 160, 161, 162, 166, 173, 178, 181, 182, 183, 191, 192, 193]"
agent_c,L50,short,97,29,68,10,0.5076,197,"[1, 3, 4, 5, 6, 7, 9, 10, 11, 12, 13, 14, 15, 16, 17, 18, 20, 21, 23, 24, 25, 27, 29, 30, 31, 32, 35, 36, 37, 38, 40, 42, 43, 44, 45, 46, 47, 48, 49, 50, 51, 52, 53, 54, 55, 56, 57, 58, 59, 60, 68, 71, 72, 73, 74, 75, 77, 79, 81, 92, 95, 96, 97, 98, 99, 100, 108, 109, 111, 115, 120, 125, 130, 135, 137, 138, 139, 140, 147, 148, 149, 151, 158, 160, 161, 162, 163, 166, 173, 174, 180, 181, 182, 183, 185, 192, 193]"
agent_c,L50,short,91,46,45,9,0.5236,191,"[2, 6, 7, 8, 9, 10, 11, 12, 13, 14, 16, 17, 18, 19, 20, 22, 23, 24, 26, 28, 30, 33, 34, 35, 37, 38, 39, 40, 41, 45, 48, 49, 51, 52, 54, 55, 56, 57, 59, 61, 63, 64, 65, 66, 67, 68, 69, 72, 73, 74, 75, 76, 77, 78, 79, 80, 83, 84, 89, 90, 91, 93, 95, 97, 98, 100, 101, 103, 104, 111, 113, 114, 119, 120, 123, 125, 134, 135, 142, 145, 147, 158, 163, 165, 166, 174, 175, 176, 177, 183, 189]"
agent_c,L50,short,101,39,62,3,0.495,200,"[0, 1, 4, 5, 6, 7, 8, 9, 10, 12, 14, 16, 17, 18, 19, 20, 21, 22, 23, 24, 25, 27, 28, 29, 30, 31, 32, 33, 35, 40, 41, 42, 43, 44, 45, 49, 50, 51, 52, 53, 54, 55, 56, 57, 59, 60, 61, 62, 64, 65, 66, 67, 68, 69, 70, 72, 73, 82, 84, 85, 86, 88, 89, 90, 91, 92, 93, 94, 105, 108, 110, 112, 114, 115, 123, 126, 132, 133, 136, 143, 144, 145, 147, 155, 157, 165, 166, 167, 173, 175, 176, 178, 186, 187, 188, 193, 194, 195, 196, 198, 199]"
agent_c,L50,short,97,46,51,9,0.5076,197,"[0, 1, 2, 3, 4, 6, 7, 8, 9, 10, 14, 17, 19, 20, 21, 22, 23, 27, 28, 29, 30, 31, 32, 33, 34, 35, 36, 37, 39, 40, 43, 44, 46, 47, 48, 49, 51, 52, 53, 54, 56, 57, 58, 59, 60, 61, 62, 63, 66, 68, 73, 74, 75, 78, 80, 82, 83, 85, 86, 87, 88, 89, 96, 97, 98, 99, 102, 103, 105, 106, 107, 108, 110, 119, 125, 128, 129, 136, 138, 139, 146, 148, 149, 150, 157, 160, 161, 168, 169, 170, 171, 179, 180, 181, 188, 190, 193]"
agent_c,L50,short,102,43,59,7,0.49,200,"[0, 1, 3, 4, 5, 8, 10, 11, 12, 13, 14, 15, 16, 17, 19, 21, 22, 23, 24, 25, 26, 27, 28, 29, 31, 32, 33, 34, 36, 38, 39, 41, 46, 47, 48, 49, 51, 52, 53, 55, 56, 60, 61, 62, 63, 64, 67, 69, 70, 72, 73, 74, 77, 84, 87, 88, 89, 90, 91, 92, 93, 95, 96, 98, 103, 104, 105, 106, 107, 109, 114, 115, 116, 117, 118, 127, 128, 130, 137, 138, 139, 147, 148, 149, 150, 151, 158, 159, 161, 169, 170, 171, 179, 184, 189, 190, 191, 195, 196, 197, 198, 199]"
agent_c,L100,short,102,56,46,6,0.49,200,"[0, 1, 3, 4, 6, 7, 8, 10, 12, 14, 15, 17, 19, 20, 23, 24, 28, 30, 32, 33, 37, 38, 40, 41, 46, 47, 49, 51, 52, 53, 54, 55, 56, 57, 58, 59, 60, 61, 62, 64, 65, 68, 69, 70, 72, 75, 76, 78, 79, 80, 81, 83, 85, 86, 87, 88, 89, 90, 91, 92, 93, 94, 95, 96, 97, 100, 105, 106, 107, 108, 109, 110, 111, 112, 113, 116, 117, 123, 127, 132, 133, 135, 136, 137, 145, 146, 148, 157, 158, 165, 166, 168, 175, 178, 181, 187, 189, 190, 196, 197, 198, 199]"
agent_c,L100,short,94,52,42,10,0.5155,194,"[0, 1, 2, 3, 8, 14, 19, 20, 22, 23, 25, 28, 29, 32, 35, 36, 37, 38, 40, 42, 43, 44, 45, 47, 48, 53, 54, 55, 56, 57, 58, 59, 61, 62, 65, 66, 67, 68, 69, 70, 71, 73, 74, 75, 76, 78, 80, 81, 82, 84, 85, 86, 89, 93, 97, 99, 100, 101, 103, 104, 105, 106, 108, 110, 111, 112, 113, 115, 116, 117, 119, 122, 123, 124, 125, 126, 131, 136, 142, 144, 145, 147, 155, 156, 157, 158, 164, 165, 167, 169, 177, 178, 186, 189]"
agent_c,L100,short,99,65,34,7,0.5025,199,"[0, 2, 3, 5, 6, 7, 8, 10, 11, 13, 14, 16, 19, 22, 23, 26, 27, 29, 30, 31, 32, 33, 34, 35, 36, 37, 39, 40, 41, 42, 43, 44, 46, 48, 49, 51, 52, 54, 55, 56, 58, 61, 62, 63, 65, 66, 68, 69, 70, 71, 74, 75, 76, 79, 80, 82, 85, 88, 89, 91, 92, 93, 94, 95, 97, 99, 101, 102, 104, 106, 107, 108, 109, 111, 113, 114, 115, 116, 118, 126, 127, 133, 135, 137, 145, 146, 147, 148, 156, 157, 158, 166, 168, 178, 179, 188, 189, 190, 194]"
agent_c,L100,short,104,48,56,9,0.48,200,"[1, 2, 3, 8, 9, 10, 12, 13, 14, 15, 16, 17, 19, 20, 21, 22, 23, 24, 25, 26, 28, 30, 31, 32, 34, 35, 38, 39, 40, 45, 46, 47, 48, 49, 50, 53, 54, 56, 57, 58, 59, 61, 63, 64, 66, 67, 71, 72, 74, 75, 76, 77, 79, 80, 83, 85, 87, 88, 90, 91, 92, 93, 96, 97, 98, 100, 103, 105, 107, 108, 110, 111, 112, 113, 115, 116, 117, 119, 124, 125, 127, 128, 129, 131, 140, 148, 149, 150, 159, 160, 167, 168, 169, 170, 178, 179, 180, 188, 189, 190, 191, 192, 194, 195]"
agent_c,L100,short,99,41,58,15,0.5025,199,"[1, 3, 4, 6, 7, 8, 10, 12, 13, 14, 15, 16, 18, 20, 21, 22, 23, 25, 26, 28, 30, 31, 32, 33, 35, 36, 37, 38, 39, 40, 41, 42, 43, 44, 45, 46, 47, 48, 49, 50, 51, 52, 53, 54, 56, 57, 58, 59, 60, 62, 65, 66, 68, 69, 71, 78, 79, 80, 81, 83, 84, 85, 86, 87, 88, 89, 90, 93, 98, 99, 102, 103, 105, 107, 110, 111, 112, 113, 120, 121, 123, 130, 132, 133, 137, 145, 152, 153, 155, 165, 172, 173, 174, 176, 177, 183, 184, 186, 189]"
agent_c,L100,short,99,43,56,5,0.5025,199,"[1, 2, 3, 5, 6, 8, 9, 10, 13, 14, 15, 16, 18, 20, 21, 22, 23, 24, 26, 27, 28, 29, 30, 33, 34, 35, 36, 38, 39, 40, 41, 42, 44, 45, 47, 48, 50, 51, 55, 56, 57, 58, 59, 60, 61, 63, 64, 70, 71, 72, 73, 74, 75, 79, 82, 83, 85, 87, 88, 90, 94, 97, 98, 99, 100, 101, 102, 103, 105, 107, 108, 109, 111, 112, 113, 114, 115, 120, 121, 123, 124, 125, 132, 133, 134, 136, 137, 138, 145, 148, 158, 159, 167, 168, 169, 178, 180, 190, 191]"
agent_c,L100,short,100,59,41,4,0.5,200,"[0, 1, 2, 3, 4, 7, 8, 9, 10, 13, 15, 16, 18, 19, 20, 21, 22, 23, 24, 25, 26, 27, 29, 30, 31, 33, 35, 36, 42, 43, 45, 47, 48, 49, 50, 51, 52, 53, 54, 55, 56, 57, 59, 60, 61, 62, 63, 65, 66, 67, 71, 72, 73, 74, 75, 78, 80, 81, 83, 84, 87, 90, 91, 92, 93, 94, 95, 96, 97, 98, 103, 105, 110, 111, 112, 115, 120, 121, 124, 126, 134, 137, 143, 144, 145, 152, 153, 154, 155, 156, 165, 166, 173, 174, 175, 176, 186, 194, 195, 198]"
agent_c,L100,short,101,58,43,5,0.495,200,"[1, 4, 6, 7, 8, 9, 10, 11, 12, 13, 14, 15, 21, 22, 23, 24, 25, 29, 31, 33, 34, 35, 38, 39, 41, 43, 44, 46, 47, 50, 51, 52, 53, 56, 57, 58, 60, 61, 62, 65, 67, 68, 69, 70, 72, 74, 75, 77, 78, 79, 80, 82, 85, 86, 87, 90, 93, 94, 95, 96, 98, 99, 100, 102, 103, 104, 105, 106, 108, 109, 110, 112, 113, 114, 116, 121, 123, 124, 125, 127, 132, 134, 136, 144, 145, 146, 147, 155, 158, 159, 161, 168, 170, 178, 179, 180, 188, 190, 196, 198, 199]"
agent_c,L100,short,99,52,47,6,0.5025,199,"[0, 2, 4, 5, 9, 10, 12, 13, 16, 18, 19, 21, 22, 23, 24, 25, 26, 30, 31, 34, 35, 36, 37, 40, 41, 42, 43, 47, 48, 49, 50, 51, 52, 53, 54, 55, 56, 59, 61, 63, 64, 66, 67, 68, 69, 70, 73, 74, 75, 76, 77, 79, 80, 82, 83, 85, 86, 91, 94, 96, 97, 99, 100, 101, 102, 103, 104, 105, 108, 109, 110, 111, 114, 119, 120, 121, 122, 123, 125, 131, 132, 134, 136, 145, 153, 154, 156, 163, 165, 172, 173, 174, 175, 177, 186, 192, 193, 195, 196]"
agent_c,L100,short,98,67,31,10,0.5051,198,"[0, 1, 2, 3, 4, 7, 9, 11, 12, 13, 16, 21, 22, 23, 25, 26, 29, 30, 31, 32, 33, 36, 37, 38, 39, 44, 46, 47, 48, 49, 52, 53, 56, 57, 58, 61, 62, 65, 66, 67, 69, 72, 76, 77, 78, 79, 82, 83, 84, 85, 86, 87, 88, 89, 90, 91, 93, 94, 97, 98, 100, 101, 102, 103, 104, 107, 108, 109, 113, 114, 115, 116, 118, 122, 129, 132, 136, 137, 138, 143, 149, 150, 151, 152, 158, 162, 170, 171, 172, 174, 182, 183, 184, 190, 191, 192, 193, 195]"
agent_c,L100,short,102,60,42,8,0.49,200,"[0, 1, 4, 6, 8, 9, 10, 11, 12, 14, 15, 16, 17, 18, 19, 20, 21, 22, 23, 25, 26, 27, 28, 30, 33, 35, 36, 37, 38, 39, 40, 42, 43, 44, 46, 47, 48, 49, 53, 54, 55, 56, 57, 58, 62, 64, 65, 67, 68, 69, 70, 76, 77, 78, 79, 82, 83, 84, 86, 88, 89, 90, 91, 98, 99, 101, 102, 103, 104, 105, 106, 110, 111, 116, 123, 130, 131, 133, 134, 135, 137, 144, 146, 153, 154, 156, 163, 164, 165, 166, 168, 177, 184, 185, 186, 187, 188, 194, 195, 196, 197, 199]"
agent_c,L100,short,100,41,59,8,0.5,200,"[0, 3, 4, 5, 6, 7, 8, 9, 10, 13, 14, 16, 17, 19, 20, 24, 26, 27, 28, 31, 32, 34, 35, 36, 37, 38, 40, 41, 42, 43, 44, 45, 47, 48, 49, 50, 52, 54, 55, 56, 57, 59, 60, 61, 62, 63, 66, 67, 68, 69, 70, 73, 75, 78, 80, 81, 82, 83, 84, 85, 86, 87, 89, 90, 91, 95, 96, 97, 100, 101, 103, 104, 105, 106, 108, 109, 110, 111, 121, 123, 128, 129, 130, 131, 132, 140, 142, 150, 151, 154, 163, 170, 171, 172, 173, 180, 182, 184, 188, 195]"
agent_c,L100,short,100,24,76,4,0.5,200,"[2, 3, 4, 5, 6, 7, 9, 10, 11, 14, 16, 18, 19, 20, 21, 22, 23, 24, 25, 26, 27, 28, 31, 32, 35, 36, 39, 40, 41, 43, 44, 45, 46, 47, 48, 49, 50, 51, 52, 53, 54, 55, 56, 59, 60, 62, 63, 65, 66, 67, 68, 69, 70, 71, 72, 77, 78, 79, 80, 81, 82, 83, 87, 89, 90, 93, 100, 101, 102, 103, 104, 106, 109, 110, 112, 113, 114, 119, 122, 123, 129, 134, 136, 137, 148, 156, 157, 165, 166, 167, 175, 176, 177, 186, 187, 193, 194, 195, 196, 198]"
agent_c,L100,short,97,38,59,12,0.5076,197,"[0, 2, 3, 4, 6, 7, 8, 9, 10, 11, 12, 13, 14, 16, 18, 19, 21, 22, 23, 24, 27, 28, 30, 31, 32, 33, 35, 36, 37, 39, 40, 43, 45, 47, 48, 49, 51, 52, 53, 56, 58, 59, 60, 61, 62, 63, 64, 65, 66, 67, 68, 69, 70, 71, 72, 73, 75, 79, 81, 82, 85, 87, 89, 90, 92, 94, 100, 103, 104, 106, 107, 108, 109, 112, 114, 118, 122, 123, 126, 131, 133, 134, 135, 142, 143, 147, 154, 158, 166, 172, 173, 176, 183, 184, 187, 193, 195]"
agent_c,L100,short,103,69,34,9,0.485,200,"[1, 2, 5, 6, 8, 9, 11, 12, 13, 14, 16, 18, 21, 22, 23, 24, 25, 26, 28, 32, 33, 34, 35, 36, 37, 38, 39, 40, 41, 42, 45, 46, 47, 50, 51, 52, 53, 54, 55, 56, 57, 58, 59, 60, 61, 62, 63, 65, 66, 67, 68, 69, 70, 71, 72, 73, 77, 78, 79, 80, 83, 85, 86, 93, 95, 97, 98, 99, 100, 102, 103, 105, 106, 107, 112, 113, 114, 116, 118, 123, 124, 126, 127, 136, 139, 146, 147, 155, 157, 164, 165, 166, 167, 168, 175, 176, 177, 178, 187, 189, 196, 197, 199]"
agent_c,L100,short,103,58,45,14,0.485,200,"[0, 1, 3, 4, 5, 7, 8, 9, 11, 12, 13, 15, 16, 18, 19, 20, 24, 25, 26, 27, 28, 30, 31, 32, 33, 34, 37, 38, 40, 42, 44, 45, 46, 51, 53, 54, 55, 56, 57, 58, 61, 62, 63, 64, 65, 66, 67, 68, 70, 73, 78, 80, 81, 82, 83, 84, 86, 88, 90, 93, 94, 101, 103, 106, 107, 108, 110, 113, 114, 115, 117, 118, 119, 120, 121, 122, 124, 125, 130, 131, 132, 133, 135, 142, 143, 144, 147, 154, 159, 166, 167, 174, 175, 176, 177, 183, 185, 186, 187, 189, 196, 197, 198]"
agent_c,L100,short,101,54,47,7,0.495,200,"[4, 5, 10, 11, 12, 13, 14, 15, 19, 20, 22, 23, 24, 28, 29, 30, 32, 34, 36, 37, 39, 41, 43, 44, 45, 46, 47, 48, 50, 52, 53, 54, 56, 57, 58, 59, 60, 61, 63, 65, 66, 67, 70, 71, 74, 75, 77, 78, 79, 80, 82, 83, 85, 87, 88, 90, 91, 92, 93, 94, 95, 96, 98, 99, 100, 102, 103, 106, 109, 111, 113, 114, 117, 118, 120, 123, 124, 125, 126, 127, 128, 129, 137, 138, 140, 148, 149, 150, 158, 159, 160, 169, 171, 172, 174, 175, 184, 187, 194, 195, 197]"
agent_c,L100,short,102,51,51,7,0.49,200,"[0, 2, 3, 4, 6, 7, 9, 10, 11, 15, 16, 17, 18, 19, 21, 22, 24, 28, 29, 32, 34, 36, 37, 39, 40, 41, 42, 43, 44, 45, 46, 49, 50, 54, 56, 57, 58, 59, 60, 62, 63, 65, 66, 67, 68, 69, 71, 73, 74, 76, 77, 79, 80, 81, 82, 83, 86, 88, 89, 90, 91, 92, 93, 94, 95, 96, 98, 99, 100, 101, 102, 104, 110, 112, 113, 116, 119, 121, 122, 124, 130, 131, 133, 139, 141, 143, 151, 152, 153, 154, 162, 163, 165, 166, 168, 176, 177, 178, 189, 190, 196, 198]"
agent_c,L100,short,101,67,34,8,0.495,200,"[0, 2, 3, 6, 8, 10, 14, 15, 16, 17, 18, 19, 20, 22, 23, 24, 25, 26, 28, 29, 31, 33, 34, 35, 36, 37, 40, 41, 43, 44, 45, 46, 48, 50, 51, 52, 53, 54, 56, 57, 58, 59, 61, 62, 65, 67, 68, 69, 70, 73, 74, 75, 77, 78, 82, 83, 84, 85, 90, 91, 93, 94, 95, 96, 97, 98, 100, 101, 106, 108, 109, 112, 113, 114, 116, 119, 120, 121, 123, 125, 126, 132, 134, 135, 137, 139, 146, 147, 149, 159, 168, 169, 170, 177, 178, 179, 180, 189, 190, 196, 197]"
agent_c,L100,short,95,41,54,10,0.5128,195,"[0, 1, 4, 5, 9, 14, 16, 17, 18, 19, 21, 22, 23, 24, 25, 26, 27, 29, 30, 33, 34, 36, 38, 39, 42, 45, 51, 56, 57, 58, 59, 60, 61, 62, 64, 65, 67, 69, 71, 73, 75, 76, 78, 83, 84, 85, 87, 89, 90, 92, 93, 95, 96, 97, 101, 102, 103, 104, 107, 109, 110, 111, 112, 113, 114, 118, 120, 121, 123, 124, 125, 126, 128, 134, 135, 136, 137, 139, 144, 145, 146, 147, 149, 156, 157, 158, 164, 166, 168, 177, 180, 185, 186, 189, 191]"
agent_c,L100,short,101,51,50,9,0.495,200,"[1, 2, 3, 4, 8, 9, 10, 11, 13, 14, 15, 17, 19, 20, 22, 23, 24, 25, 26, 28, 30, 32, 33, 34, 35, 38, 39, 40, 44, 47, 48, 50, 52, 54, 56, 57, 58, 59, 60, 64, 65, 67, 68, 69, 70, 74, 76, 77, 78, 79, 80, 81, 82, 83, 86, 87, 88, 90, 91, 92, 93, 94, 95, 96, 97, 99, 101, 102, 103, 104, 105, 106, 108, 109, 111, 117, 118, 119, 124, 125, 127, 128, 131, 139, 141, 150, 152, 159, 161, 164, 172, 179, 180, 181, 182, 188, 190, 191, 192, 198, 199]"
agent_c,L100,short,101,45,56,3,0.495,200,"[1, 4, 6, 7, 9, 11, 13, 14, 15, 16, 17, 18, 19, 20, 21, 22, 23, 24, 25, 27, 28, 30, 31, 33, 34, 35, 36, 37, 38, 41, 43, 44, 45, 46, 47, 48, 51, 52, 53, 54, 55, 57, 58, 59, 61, 64, 65, 68, 69, 70, 71, 72, 73, 74, 75, 76, 77, 80, 84, 89, 90, 91, 92, 94, 95, 96, 99, 107, 108, 112, 113, 114, 115, 116, 117, 119, 125, 126, 127, 130, 138, 139, 140, 147, 149, 150, 158, 159, 161, 170, 171, 178, 179, 180, 182, 189, 191, 196, 197, 198, 199]"
agent_c,L100,short,103,57,46,4,0.485,200,"[0, 1, 3, 4, 5, 7, 8, 9, 10, 12, 13, 14, 15, 16, 17, 18, 19, 21, 22, 26, 27, 28, 30, 31, 32, 33, 35, 36, 37, 38, 41, 43, 44, 46, 48, 51, 52, 53, 54, 55, 56, 58, 59, 60, 61, 63, 64, 67, 68, 69, 72, 73, 74, 75, 77, 79, 80, 83, 88, 89, 90, 91, 93, 96, 100, 101, 102, 103, 106, 107, 108, 109, 112, 115, 118, 122, 123, 128, 129, 130, 131, 132, 133, 134, 140, 141, 142, 143, 144, 153, 155, 163, 164, 165, 174, 175, 176, 178, 188, 189, 197, 198, 199]"
agent_c,L100,short,100,46,54,9,0.5,200,"[1, 3, 4, 5, 6, 7, 8, 12, 15, 17, 18, 19, 20, 22, 24, 27, 28, 29, 32, 34, 35, 37, 38, 39, 40, 41, 43, 44, 45, 47, 48, 49, 50, 51, 52, 53, 54, 55, 56, 61, 64, 65, 66, 67, 68, 69, 70, 72, 75, 76, 77, 78, 81, 82, 83, 88, 89, 90, 91, 93, 94, 95, 98, 99, 102, 103, 104, 105, 106, 107, 109, 112, 114, 117, 118, 120, 126, 127, 129, 130, 138, 140, 142, 149, 150, 153, 160, 163, 170, 171, 172, 179, 180, 182, 187, 189, 190, 191, 192, 198]"
agent_c,L100,short,101,50,51,9,0.495,200,"[0, 1, 3, 4, 5, 9, 11, 12, 15, 16, 17, 19, 21, 23, 24, 25, 27, 28, 30, 32, 34, 35, 38, 39, 41, 42, 43, 45, 46, 47, 49, 51, 52, 54, 55, 56, 57, 58, 62, 63, 65, 67, 68, 70, 71, 72, 73, 74, 75, 76, 77, 78, 82, 83, 86, 88, 89, 90, 93, 94, 95, 96, 97, 98, 99, 100, 101, 102, 106, 107, 110, 111, 114, 120, 121, 122, 124, 129, 130, 131, 132, 135, 143, 144, 145, 153, 154, 155, 164, 165, 166, 170, 178, 185, 186, 188, 194, 195, 196, 198, 199]"
agent_c,L100,short,101,66,35,4,0.495,200,"[1, 2, 3, 4, 5, 6, 7, 8, 9, 10, 11, 12, 13, 14, 17, 18, 21, 23, 27, 28, 29, 32, 33, 34, 35, 36, 37, 41, 42, 43, 44, 45, 46, 49, 51, 52, 53, 54, 55, 56, 61, 62, 63, 64, 65, 66, 67, 70, 71, 72, 74, 76, 79, 80, 81, 83, 84, 85, 87, 88, 90, 91, 92, 93, 95, 96, 98, 99, 100, 101, 102, 103, 104, 105, 106, 108, 109, 110, 117, 119, 121, 128, 130, 131, 140, 141, 150, 151, 152, 163, 165, 168, 175, 176, 177, 183, 184, 185, 186, 188, 199]"
agent_c,L100,short,102,56,46,4,0.49,200,"[1, 3, 4, 5, 7, 8, 10, 11, 12, 13, 15, 17, 18, 19, 22, 23, 26, 27, 29, 30, 31, 32, 34, 35, 36, 39, 40, 41, 42, 43, 47, 48, 49, 50, 51, 52, 53, 54, 57, 59, 60, 61, 62, 63, 66, 67, 69, 70, 71, 72, 74, 76, 77, 78, 79, 80, 81, 82, 83, 85, 87, 88, 92, 93, 95, 96, 97, 98, 100, 101, 104, 105, 106, 108, 115, 118, 121, 122, 124, 125, 126, 127, 136, 137, 144, 145, 146, 147, 148, 149, 150, 159, 160, 170, 171, 180, 181, 189, 190, 191, 192, 193]"
agent_c,L100,short,99,34,65,11,0.5025,199,"[0, 1, 2, 3, 4, 7, 8, 9, 10, 11, 12, 16, 17, 18, 19, 23, 24, 25, 26, 29, 30, 31, 34, 36, 39, 40, 41, 42, 44, 45, 46, 49, 53, 54, 55, 57, 59, 60, 61, 62, 63, 64, 65, 66, 67, 70, 74, 76, 79, 80, 81, 84, 85, 87, 88, 89, 90, 91, 92, 93, 95, 96, 97, 98, 99, 100, 102, 105, 106, 107, 108, 109, 110, 111, 112, 113, 114, 119, 121, 122, 123, 125, 134, 141, 142, 146, 154, 161, 162, 165, 172, 173, 178, 185, 186, 193, 194, 195, 197]"
agent_c,L100,short,103,49,54,7,0.485,200,"[1, 2, 3, 4, 5, 6, 7, 8, 10, 13, 14, 15, 16, 17, 21, 25, 27, 28, 31, 32, 33, 34, 36, 37, 38, 39, 41, 42, 44, 45, 47, 48, 49, 51, 52, 54, 55, 56, 57, 58, 59, 60, 62, 63, 64, 66, 69, 73, 74, 77, 80, 82, 83, 84, 87, 88, 91, 94, 95, 96, 99, 100, 102, 103, 104, 105, 107, 108, 110, 112, 116, 117, 121, 122, 127, 128, 129, 130, 131, 132, 138, 140, 141, 142, 143, 144, 145, 154, 155, 163, 164, 165, 166, 175, 176, 178, 185, 186, 187, 194, 195, 196, 197]"
agent_c,L100,short,104,49,55,4,0.48,200,"[3, 4, 5, 7, 9, 10, 12, 13, 14, 16, 17, 18, 19, 20, 23, 24, 25, 26, 28, 29, 30, 31, 34, 36, 38, 40, 41, 42, 43, 45, 46, 49, 50, 52, 53, 54, 56, 57, 58, 59, 60, 61, 63, 64, 66, 68, 71, 72, 74, 75, 77, 78, 80, 81, 82, 83, 84, 85, 88, 89, 90, 91, 92, 93, 95, 103, 104, 105, 106, 107, 111, 112, 113, 114, 115, 116, 117, 118, 124, 125, 126, 129, 134, 135, 137, 139, 148, 149, 151, 160, 161, 163, 172, 180, 181, 182, 188, 189, 190, 191, 192, 193, 194, 195]"
agent_c,L100,short,101,43,58,6,0.495,200,"[0, 1, 2, 4, 5, 6, 7, 10, 11, 12, 13, 14, 15, 16, 17, 19, 21, 23, 24, 25, 27, 28, 30, 31, 32, 33, 35, 36, 38, 39, 40, 41, 42, 43, 46, 47, 48, 50, 51, 53, 54, 56, 57, 58, 60, 61, 64, 65, 68, 71, 73, 76, 77, 78, 79, 80, 81, 82, 84, 85, 90, 91, 92, 93, 94, 96, 97, 98, 99, 100, 101, 103, 104, 105, 109, 114, 115, 117, 118, 121, 128, 129, 136, 137, 138, 140, 141, 149, 151, 152, 153, 162, 164, 172, 173, 180, 181, 182, 184, 192, 193]"
agent_c,L100,short,101,37,64,9,0.495,200,"[0, 1, 3, 4, 5, 6, 11, 12, 14, 15, 16, 17, 19, 20, 22, 24, 25, 29, 30, 31, 32, 34, 35, 36, 37, 38, 39, 42, 43, 44, 45, 48, 49, 50, 51, 53, 54, 55, 56, 58, 59, 60, 62, 64, 65, 67, 69, 70, 74, 75, 76, 77, 78, 80, 82, 84, 86, 87, 89, 90, 91, 92, 95, 97, 102, 103, 104, 105, 106, 108, 109, 110, 111, 112, 113, 114, 115, 120, 123, 124, 125, 127, 128, 138, 146, 150, 157, 158, 159, 168, 169, 171, 178, 179, 180, 187, 191, 196, 197, 198, 199]"
agent_c,L100,short,94,48,46,9,0.5155,194,"[2, 3, 4, 7, 8, 9, 13, 14, 17, 18, 20, 22, 23, 24, 25, 26, 27, 28, 31, 36, 37, 38, 39, 40, 41, 42, 43, 44, 45, 47, 48, 50, 54, 55, 56, 57, 59, 60, 62, 63, 64, 66, 67, 70, 71, 74, 76, 77, 78, 81, 82, 83, 84, 85, 86, 87, 88, 90, 91, 92, 94, 95, 96, 97, 98, 99, 100, 101, 106, 110, 111, 112, 117, 120, 121, 122, 129, 130, 133, 139, 141, 142, 143, 154, 162, 164, 170, 171, 172, 174, 182, 186, 190, 192]"
agent_c,L100,short,99,61,38,15,0.5025,199,"[0, 1, 2, 5, 6, 7, 10, 11, 12, 13, 14, 15, 16, 17, 18, 19, 20, 21, 23, 26, 27, 28, 29, 30, 31, 33, 34, 35, 36, 37, 38, 39, 40, 41, 43, 44, 47, 48, 50, 51, 56, 58, 59, 60, 61, 62, 67, 69, 70, 71, 72, 73, 74, 75, 77, 78, 79, 81, 82, 83, 84, 85, 89, 92, 93, 94, 95, 96, 97, 98, 99, 100, 102, 103, 105, 107, 115, 116, 118, 123, 124, 126, 129, 138, 141, 148, 149, 150, 152, 160, 161, 162, 173, 182, 185, 191, 192, 195, 197]"
agent_c,L100,short,97,54,43,8,0.5076,197,"[0, 1, 2, 4, 5, 6, 7, 10, 11, 14, 15, 16, 18, 19, 21, 22, 24, 28, 29, 30, 32, 33, 38, 39, 42, 43, 44, 45, 46, 47, 53, 54, 55, 58, 60, 61, 63, 65, 66, 67, 68, 69, 70, 72, 76, 80, 82, 83, 84, 85, 86, 87, 89, 90, 91, 95, 97, 98, 100, 103, 104, 106, 107, 109, 110, 112, 114, 117, 119, 120, 121, 122, 123, 124, 126, 127, 132, 133, 134, 135, 136, 138, 145, 147, 154, 156, 157, 164, 167, 175, 176, 177, 178, 185, 186, 188, 194]"
agent_c,L100,short,101,48,53,6,0.495,200,"[1, 2, 4, 5, 6, 7, 8, 9, 17, 19, 21, 24, 25, 28, 30, 31, 32, 33, 34, 36, 37, 38, 39, 41, 42, 47, 48, 49, 50, 51, 57, 58, 59, 60, 63, 64, 65, 66, 67, 68, 69, 71, 72, 73, 74, 75, 76, 78, 79, 81, 82, 85, 86, 87, 91, 92, 93, 95, 96, 97, 98, 101, 102, 104, 105, 106, 107, 112, 113, 114, 115, 117, 119, 120, 121, 123, 127, 128, 129, 130, 131, 132, 138, 139, 140, 142, 144, 152, 155, 163, 164, 166, 173, 174, 175, 182, 183, 185, 193, 195, 196]"
agent_c,L100,short,99,48,51,15,0.5025,199,"[0, 1, 2, 4, 5, 6, 7, 8, 9, 10, 11, 12, 14, 15, 17, 20, 21, 22, 23, 24, 25, 27, 29, 30, 31, 33, 36, 38, 40, 44, 45, 46, 47, 48, 49, 50, 51, 52, 53, 54, 57, 58, 59, 60, 61, 62, 64, 67, 68, 69, 70, 71, 73, 74, 75, 76, 77, 80, 81, 82, 86, 87, 88, 90, 91, 94, 96, 97, 98, 101, 108, 116, 119, 120, 121, 125, 126, 127, 128, 129, 130, 131, 139, 140, 144, 152, 159, 162, 169, 171, 177, 181, 182, 184, 190, 191, 193, 194, 197]"
agent_c,L100,short,101,48,53,10,0.495,200,"[0, 1, 3, 4, 5, 7, 8, 11, 12, 14, 15, 16, 17, 19, 21, 23, 24, 25, 26, 30, 31, 32, 33, 34, 35, 36, 37, 38, 40, 43, 44, 45, 46, 47, 48, 50, 52, 54, 56, 58, 59, 61, 63, 66, 67, 68, 70, 71, 72, 74, 77, 78, 82, 83, 84, 85, 86, 87, 89, 90, 91, 92, 94, 95, 96, 98, 99, 100, 101, 102, 103, 109, 111, 112, 113, 116, 121, 122, 123, 124, 127, 136, 146, 153, 154, 156, 163, 164, 165, 166, 167, 168, 177, 178, 187, 189, 191, 196, 197, 198, 199]"
agent_c,L100,short,101,54,47,16,0.495,200,"[0, 1, 3, 4, 5, 6, 7, 8, 9, 10, 11, 12, 16, 17, 19, 20, 21, 22, 25, 26, 27, 29, 30, 32, 35, 36, 39, 40, 41, 42, 44, 45, 46, 48, 52, 53, 54, 55, 56, 58, 59, 60, 61, 67, 68, 69, 70, 71, 72, 74, 76, 77, 79, 80, 81, 83, 85, 86, 87, 90, 91, 93, 94, 97, 98, 99, 100, 101, 102, 103, 105, 108, 111, 113, 114, 119, 123, 128, 134, 136, 137, 139, 147, 150, 157, 158, 165, 166, 167, 169, 176, 178, 180, 185, 187, 188, 189, 191, 197, 198, 199]"
agent_c,L100,short,105,65,40,1,0.475,200,"[0, 1, 2, 3, 4, 5, 6, 7, 8, 9, 10, 11, 12, 14, 15, 18, 19, 20, 21, 22, 23, 25, 26, 27, 30, 32, 34, 35, 36, 37, 38, 39, 40, 41, 42, 43, 44, 45, 46, 47, 48, 50, 51, 52, 53, 54, 55, 57, 58, 59, 60, 61, 66, 67, 68, 70, 71, 72, 75, 77, 78, 79, 80, 81, 82, 83, 85, 86, 94, 97, 99, 100, 101, 102, 103, 104, 105, 108, 116, 120, 128, 131, 139, 140, 141, 148, 150, 151, 160, 161, 162, 169, 170, 172, 173, 181, 182, 183, 191, 192, 193, 194, 195, 196, 197]"
agent_c,L100,short,100,53,47,7,0.5,200,"[1, 2, 3, 6, 8, 10, 11, 13, 15, 16, 18, 19, 20, 23, 24, 26, 27, 28, 29, 30, 31, 32, 35, 36, 37, 38, 40, 41, 42, 43, 47, 48, 49, 50, 51, 52, 53, 55, 57, 58, 59, 60, 61, 62, 65, 68, 69, 72, 73, 75, 76, 78, 79, 82, 83, 87, 88, 89, 90, 91, 93, 94, 95, 98, 99, 100, 105, 107, 108, 111, 114, 115, 118, 120, 124, 125, 127, 128, 129, 130, 136, 137, 138, 141, 149, 151, 158, 159, 160, 161, 169, 173, 180, 182, 187, 188, 189, 190, 191, 192]"
agent_c,L100,short,99,45,54,8,0.5025,199,"[0, 2, 3, 4, 5, 7, 9, 10, 16, 17, 19, 20, 21, 22, 23, 24, 26, 27, 28, 30, 31, 33, 34, 35, 36, 37, 38, 40, 41, 42, 43, 45, 46, 48, 49, 50, 51, 52, 53, 57, 59, 60, 62, 64, 66, 67, 68, 69, 72, 73, 74, 75, 76, 77, 80, 81, 82, 83, 84, 85, 86, 87, 91, 92, 94, 96, 99, 100, 102, 110, 112, 115, 118, 119, 121, 125, 126, 127, 130, 132, 138, 139, 140, 141, 149, 150, 151, 158, 159, 160, 161, 165, 172, 173, 181, 184, 191, 192, 193]"
agent_c,L100,short,99,62,37,7,0.5025,199,"[0, 1, 2, 4, 5, 10, 12, 14, 15, 16, 19, 20, 23, 24, 26, 28, 29, 30, 31, 34, 36, 39, 42, 43, 44, 45, 46, 50, 51, 52, 53, 54, 55, 57, 58, 59, 60, 62, 64, 67, 68, 69, 70, 71, 72, 73, 74, 76, 78, 79, 80, 81, 83, 84, 85, 87, 89, 90, 91, 92, 95, 97, 98, 99, 100, 101, 103, 105, 108, 111, 112, 113, 114, 117, 118, 123, 124, 125, 126, 128, 134, 135, 136, 138, 144, 145, 146, 147, 148, 157, 158, 160, 169, 171, 184, 190, 191, 192, 194]"
agent_c,L100,short,97,49,48,11,0.5076,197,"[1, 2, 3, 4, 5, 9, 10, 13, 14, 15, 16, 18, 20, 21, 22, 23, 25, 26, 28, 31, 32, 33, 34, 35, 36, 37, 39, 42, 44, 45, 48, 50, 51, 53, 54, 55, 57, 59, 60, 62, 63, 64, 65, 66, 67, 68, 71, 73, 74, 75, 77, 78, 79, 80, 81, 82, 84, 85, 86, 91, 92, 93, 95, 98, 99, 100, 101, 102, 103, 104, 105, 106, 108, 109, 111, 112, 113, 115, 116, 117, 119, 127, 133, 140, 148, 149, 156, 157, 158, 159, 167, 168, 169, 177, 178, 180, 190]"
agent_c,L100,short,101,58,43,18,0.495,200,"[0, 1, 2, 5, 6, 7, 8, 12, 14, 16, 17, 20, 25, 26, 28, 29, 30, 32, 33, 34, 36, 38, 39, 42, 44, 45, 46, 47, 48, 49, 50, 52, 53, 54, 55, 58, 59, 60, 61, 62, 63, 65, 66, 68, 70, 72, 73, 76, 77, 78, 82, 85, 86, 87, 90, 92, 95, 96, 98, 99, 100, 101, 107, 110, 111, 112, 115, 116, 117, 118, 119, 120, 121, 123, 124, 125, 126, 131, 132, 133, 134, 135, 138, 144, 145, 148, 157, 164, 165, 167, 174, 175, 176, 177, 186, 188, 193, 194, 195, 196, 197]"
agent_c,L100,short,99,40,59,12,0.5025,199,"[0, 3, 4, 5, 6, 9, 11, 13, 15, 16, 17, 18, 19, 20, 21, 23, 25, 26, 27, 29, 30, 31, 34, 35, 37, 39, 40, 41, 42, 43, 47, 49, 51, 52, 53, 54, 57, 59, 60, 65, 66, 67, 69, 70, 71, 73, 74, 75, 81, 82, 84, 85, 86, 87, 89, 90, 91, 92, 94, 97, 98, 99, 101, 103, 105, 110, 111, 112, 113, 114, 115, 116, 119, 120, 122, 124, 126, 127, 131, 132, 134, 137, 138, 145, 146, 147, 150, 157, 159, 166, 168, 176, 177, 178, 181, 187, 188, 191, 197]"
agent_c,L100,short,101,58,43,15,0.495,200,"[0, 1, 2, 3, 4, 5, 6, 7, 9, 10, 11, 12, 13, 14, 15, 17, 18, 19, 20, 21, 23, 26, 27, 28, 29, 31, 33, 34, 36, 37, 38, 40, 42, 43, 45, 46, 50, 51, 55, 56, 57, 59, 60, 61, 63, 64, 67, 68, 69, 70, 72, 73, 75, 77, 78, 80, 86, 87, 88, 89, 92, 95, 96, 99, 100, 101, 102, 103, 104, 106, 110, 112, 113, 115, 120, 121, 123, 124, 132, 133, 136, 143, 144, 151, 152, 154, 162, 163, 164, 171, 173, 174, 180, 181, 182, 183, 184, 185, 187, 194, 198]"
agent_c,L100,short,101,53,48,9,0.495,200,"[0, 1, 2, 4, 6, 7, 10, 11, 12, 14, 15, 16, 18, 19, 20, 22, 25, 26, 27, 29, 31, 33, 34, 35, 36, 37, 38, 39, 40, 42, 43, 44, 45, 46, 47, 48, 49, 50, 52, 54, 55, 57, 60, 61, 62, 63, 64, 65, 66, 67, 68, 69, 70, 71, 73, 74, 76, 77, 81, 84, 88, 91, 93, 99, 102, 105, 106, 107, 108, 109, 110, 113, 114, 115, 118, 124, 125, 126, 129, 135, 136, 138, 150, 156, 157, 160, 169, 170, 177, 179, 180, 185, 186, 187, 188, 189, 190, 196, 197, 198, 199]"
agent_c,L100,short,101,42,59,1,0.495,200,"[0, 2, 3, 4, 6, 7, 8, 9, 11, 12, 14, 16, 18, 21, 22, 23, 24, 26, 27, 30, 31, 32, 33, 34, 37, 38, 39, 41, 42, 43, 44, 47, 48, 50, 51, 52, 53, 54, 56, 57, 58, 59, 60, 61, 62, 63, 64, 65, 66, 68, 69, 71, 72, 74, 76, 77, 78, 79, 83, 84, 85, 88, 89, 93, 94, 95, 96, 98, 100, 101, 102, 104, 105, 111, 112, 114, 115, 120, 124, 126, 134, 135, 142, 145, 146, 156, 163, 164, 167, 168, 169, 175, 176, 177, 179, 186, 188, 189, 196, 198, 199]"
agent_c,L100,short,99,50,49,10,0.5025,199,"[1, 2, 5, 6, 7, 8, 9, 11, 12, 14, 15, 16, 17, 19, 20, 21, 22, 23, 24, 28, 29, 32, 33, 34, 36, 37, 40, 41, 43, 44, 45, 46, 47, 48, 50, 51, 54, 55, 58, 59, 61, 64, 66, 68, 69, 70, 71, 72, 73, 74, 75, 78, 79, 80, 83, 86, 87, 88, 91, 94, 95, 97, 99, 100, 101, 102, 103, 106, 107, 108, 109, 110, 111, 112, 113, 122, 123, 129, 130, 131, 133, 140, 141, 143, 144, 153, 154, 162, 165, 166, 167, 168, 170, 178, 180, 187, 189, 190, 193]"
agent_c,L100,short,99,43,56,6,0.5025,199,"[0, 3, 4, 5, 7, 8, 9, 10, 11, 12, 13, 14, 15, 16, 17, 18, 19, 20, 21, 22, 23, 24, 25, 26, 27, 28, 30, 31, 32, 33, 35, 36, 37, 38, 39, 40, 41, 44, 45, 46, 48, 49, 51, 52, 53, 54, 55, 57, 61, 64, 65, 66, 67, 68, 70, 71, 72, 73, 75, 77, 78, 79, 80, 81, 83, 91, 92, 93, 94, 97, 98, 100, 101, 102, 103, 104, 113, 115, 116, 122, 124, 125, 126, 135, 136, 144, 146, 147, 155, 156, 157, 159, 168, 176, 177, 180, 190, 196, 197]"
agent_c,L100,short,98,60,38,8,0.5051,198,"[0, 2, 4, 6, 7, 9, 11, 12, 13, 14, 15, 17, 18, 21, 22, 26, 27, 28, 29, 30, 31, 32, 33, 36, 37, 39, 40, 41, 42, 43, 45, 46, 48, 52, 53, 54, 55, 56, 57, 60, 61, 63, 64, 66, 67, 69, 70, 71, 72, 74, 75, 76, 77, 78, 79, 80, 81, 82, 83, 86, 90, 91, 93, 94, 96, 97, 98, 99, 100, 101, 102, 104, 105, 106, 107, 114, 116, 117, 123, 124, 125, 126, 127, 136, 137, 138, 139, 140, 148, 149, 150, 161, 169, 170, 179, 180, 182, 193]"
agent_c,L100,short,100,51,49,9,0.5,200,"[0, 1, 2, 4, 5, 6, 7, 8, 9, 11, 12, 14, 15, 16, 17, 18, 19, 20, 21, 22, 23, 24, 25, 29, 31, 32, 37, 38, 40, 42, 43, 44, 45, 46, 47, 48, 49, 51, 52, 53, 54, 56, 57, 60, 61, 62, 63, 64, 66, 67, 70, 71, 74, 75, 78, 81, 82, 83, 84, 89, 91, 92, 93, 95, 96, 97, 99, 100, 101, 102, 103, 105, 110, 111, 116, 119, 122, 123, 124, 125, 131, 133, 134, 136, 145, 152, 153, 155, 162, 165, 167, 175, 177, 185, 186, 191, 192, 193, 195, 196]"
agent_c,L100,short,96,53,43,13,0.5102,196,"[1, 2, 3, 5, 6, 9, 10, 11, 12, 13, 14, 15, 16, 17, 18, 20, 21, 22, 23, 25, 26, 27, 30, 32, 33, 34, 36, 38, 40, 41, 43, 44, 45, 47, 48, 52, 53, 54, 56, 57, 59, 62, 64, 65, 66, 68, 69, 70, 71, 72, 75, 76, 77, 78, 79, 80, 81, 82, 83, 85, 86, 87, 89, 95, 98, 99, 100, 102, 103, 104, 106, 108, 110, 111, 112, 113, 119, 121, 122, 125, 132, 133, 142, 144, 151, 155, 162, 164, 165, 167, 176, 182, 184, 186, 193, 194]"
agent_c,L100,short,100,48,52,5,0.5,200,"[1, 3, 4, 6, 7, 8, 9, 10, 11, 12, 13, 14, 15, 17, 18, 19, 21, 22, 25, 26, 28, 30, 31, 32, 33, 34, 36, 37, 38, 39, 40, 43, 44, 46, 47, 48, 50, 52, 54, 56, 57, 59, 63, 64, 68, 70, 72, 73, 74, 75, 76, 77, 78, 79, 80, 83, 85, 86, 87, 89, 90, 95, 96, 99, 100, 103, 105, 106, 107, 109, 113, 116, 117, 119, 120, 122, 127, 128, 129, 131, 132, 137, 138, 139, 143, 151, 152, 159, 160, 161, 162, 170, 173, 181, 182, 183, 184, 191, 192, 195]"
agent_c,L100,short,100,36,64,5,0.5,200,"[1, 3, 4, 6, 7, 9, 12, 13, 14, 15, 16, 20, 21, 22, 23, 24, 26, 27, 29, 30, 31, 32, 33, 34, 35, 37, 38, 40, 43, 44, 45, 46, 48, 49, 51, 52, 53, 55, 58, 59, 60, 61, 62, 64, 66, 67, 68, 69, 70, 71, 74, 77, 78, 81, 84, 85, 86, 87, 89, 90, 91, 92, 93, 94, 95, 96, 97, 98, 100, 101, 105, 106, 107, 108, 109, 110, 111, 116, 118, 120, 122, 124, 132, 134, 140, 141, 142, 144, 154, 163, 166, 174, 181, 182, 183, 184, 191, 192, 193, 194]"
agent_c,L100,short,102,49,53,13,0.49,200,"[2, 6, 7, 8, 11, 12, 13, 14, 17, 18, 19, 20, 22, 23, 24, 25, 26, 27, 29, 30, 32, 34, 35, 36, 37, 38, 39, 41, 42, 43, 44, 45, 46, 47, 49, 51, 52, 53, 54, 60, 63, 64, 67, 69, 71, 73, 74, 75, 78, 79, 80, 81, 83, 84, 87, 90, 91, 92, 94, 96, 97, 99, 100, 101, 102, 103, 108, 109, 110, 112, 116, 117, 118, 119, 120, 121, 122, 124, 130, 131, 134, 141, 142, 143, 145, 146, 154, 155, 156, 157, 166, 168, 169, 171, 179, 180, 188, 189, 190, 191, 192, 193]"
agent_c,L100,short,102,59,43,7,0.49,200,"[0, 3, 4, 5, 8, 12, 13, 15, 19, 20, 21, 23, 25, 26, 28, 29, 31, 34, 35, 36, 37, 38, 39, 40, 43, 44, 47, 48, 49, 52, 53, 54, 55, 57, 58, 59, 60, 61, 62, 63, 65, 66, 67, 68, 70, 71, 74, 75, 76, 77, 78, 79, 81, 82, 83, 84, 85, 86, 87, 88, 89, 90, 91, 92, 94, 95, 100, 101, 102, 103, 104, 105, 108, 109, 111, 112, 114, 115, 121, 123, 124, 125, 132, 134, 135, 143, 146, 153, 154, 155, 156, 164, 165, 166, 176, 177, 179, 186, 187, 189, 190, 198]"
agent_c,L100,short,105,43,62,3,0.475,200,"[2, 4, 6, 7, 8, 9, 10, 12, 13, 15, 16, 17, 19, 20, 21, 22, 23, 24, 25, 26, 30, 31, 32, 33, 35, 36, 37, 38, 39, 41, 43, 45, 46, 47, 48, 49, 50, 51, 52, 53, 54, 55, 56, 59, 61, 62, 64, 66, 67, 69, 71, 74, 76, 79, 81, 82, 83, 84, 85, 87, 88, 89, 90, 92, 93, 94, 95, 97, 102, 103, 105, 107, 109, 112, 114, 115, 116, 117, 125, 126, 127, 133, 134, 135, 136, 137, 145, 146, 147, 148, 156, 158, 168, 169, 178, 179, 185, 186, 187, 188, 189, 196, 197, 198, 199]"
agent_c,L100,short,100,45,55,8,0.5,200,"[0, 2, 3, 4, 6, 8, 11, 12, 14, 16, 19, 20, 22, 24, 25, 26, 27, 30, 31, 32, 33, 36, 37, 40, 41, 42, 43, 44, 46, 47, 48, 49, 50, 54, 56, 57, 59, 60, 61, 62, 63, 64, 65, 67, 69, 70, 72, 73, 74, 76, 79, 80, 81, 82, 84, 86, 87, 88, 89, 90, 91, 92, 94, 97, 98, 99, 100, 101, 102, 103, 105, 107, 108, 109, 110, 111, 112, 113, 114, 115, 122, 123, 125, 132, 133, 134, 136, 146, 158, 165, 173, 174, 176, 182, 183, 185, 186, 193, 194, 196]"
agent_c,L100,short,98,60,38,8,0.5051,198,"[0, 2, 4, 6, 8, 9, 10, 12, 15, 17, 19, 20, 22, 24, 25, 27, 29, 30, 31, 34, 36, 38, 41, 42, 44, 45, 46, 47, 48, 49, 51, 52, 54, 56, 57, 59, 62, 65, 66, 67, 68, 69, 70, 71, 73, 74, 75, 76, 79, 81, 82, 86, 87, 89, 90, 92, 93, 94, 95, 97, 99, 100, 102, 103, 104, 107, 109, 110, 111, 112, 114, 117, 118, 119, 120, 121, 123, 124, 125, 126, 134, 136, 142, 143, 144, 146, 155, 156, 163, 165, 167, 168, 177, 178, 179, 182, 189, 191]"
agent_c,L100,short,99,41,58,17,0.5025,199,"[0, 1, 2, 3, 6, 7, 8, 9, 10, 11, 12, 13, 14, 15, 16, 19, 20, 22, 25, 26, 27, 28, 29, 32, 34, 36, 39, 40, 42, 44, 45, 46, 48, 49, 51, 53, 56, 57, 59, 60, 61, 62, 64, 65, 66, 67, 68, 69, 70, 71, 73, 74, 75, 76, 77, 78, 85, 86, 87, 88, 89, 90, 93, 94, 95, 97, 101, 102, 103, 104, 106, 107, 108, 110, 111, 112, 113, 114, 117, 118, 126, 127, 136, 143, 150, 156, 157, 158, 159, 160, 167, 168, 169, 170, 181, 188, 189, 191, 193]"
agent_c,L100,short,98,54,44,7,0.5051,198,"[0, 1, 2, 3, 4, 6, 7, 8, 9, 10, 11, 12, 13, 14, 16, 17, 18, 19, 22, 23, 24, 25, 27, 32, 33, 35, 36, 38, 39, 40, 41, 43, 44, 45, 46, 47, 48, 49, 50, 52, 54, 55, 56, 60, 61, 63, 67, 68, 69, 72, 73, 74, 75, 76, 80, 82, 83, 86, 87, 88, 89, 91, 92, 93, 94, 95, 96, 97, 98, 99, 102, 105, 106, 108, 109, 116, 117, 122, 126, 128, 130, 136, 137, 140, 147, 150, 157, 158, 161, 169, 170, 172, 181, 182, 188, 190, 191, 193]"
agent_c,L100,short,102,53,49,10,0.49,200,"[0, 1, 2, 4, 6, 8, 9, 11, 12, 14, 15, 16, 17, 19, 20, 21, 22, 23, 24, 26, 27, 28, 29, 31, 33, 34, 35, 36, 39, 40, 41, 44, 45, 46, 47, 48, 52, 53, 54, 55, 57, 58, 59, 60, 62, 63, 64, 67, 68, 69, 71, 72, 74, 75, 78, 79, 80, 82, 84, 90, 93, 94, 95, 96, 100, 101, 103, 105, 106, 111, 112, 114, 115, 116, 117, 118, 121, 122, 124, 125, 126, 127, 130, 137, 138, 146, 147, 148, 151, 159, 160, 163, 170, 172, 179, 181, 190, 191, 192, 193, 194, 198]"
agent_c,L100,short,95,65,30,16,0.5128,195,"[0, 1, 2, 3, 5, 6, 8, 10, 12, 13, 14, 18, 20, 21, 22, 23, 24, 25, 26, 27, 28, 34, 35, 36, 37, 38, 41, 42, 45, 47, 49, 50, 52, 53, 58, 59, 60, 61, 63, 64, 65, 66, 68, 70, 71, 72, 73, 74, 75, 78, 79, 80, 81, 82, 83, 85, 87, 88, 91, 93, 94, 95, 97, 100, 101, 102, 103, 104, 106, 107, 114, 115, 117, 121, 122, 123, 124, 125, 128, 134, 136, 138, 147, 148, 155, 157, 158, 163, 170, 177, 179, 180, 183, 190, 192]"
agent_c,L100,short,97,50,47,10,0.5076,197,"[0, 1, 2, 4, 5, 6, 7, 8, 9, 10, 13, 14, 15, 16, 17, 18, 19, 20, 21, 22, 23, 24, 25, 28, 31, 32, 34, 36, 42, 43, 45, 46, 47, 49, 50, 51, 52, 53, 54, 56, 59, 60, 65, 67, 68, 69, 70, 71, 72, 73, 74, 75, 77, 81, 82, 84, 85, 87, 88, 89, 90, 91, 92, 93, 96, 97, 99, 100, 101, 103, 104, 106, 110, 111, 112, 113, 115, 119, 126, 127, 134, 135, 136, 137, 145, 146, 147, 155, 156, 158, 166, 167, 177, 184, 185, 189, 195]"
agent_c,L100,short,96,39,57,14,0.5102,196,"[0, 1, 4, 6, 8, 11, 13, 15, 16, 18, 24, 25, 26, 31, 32, 33, 34, 35, 36, 37, 40, 41, 42, 43, 44, 45, 46, 47, 48, 51, 53, 54, 55, 56, 57, 60, 61, 63, 65, 66, 67, 71, 73, 74, 75, 76, 78, 79, 81, 83, 84, 88, 90, 93, 94, 98, 99, 100, 103, 104, 107, 108, 109, 111, 114, 115, 116, 117, 118, 120, 125, 126, 131, 134, 139, 140, 141, 142, 147, 149, 150, 154, 159, 162, 167, 168, 169, 170, 172, 175, 182, 183, 189, 190, 192, 193]"
agent_c,L100,short,102,48,54,7,0.49,200,"[0, 1, 3, 4, 5, 6, 7, 8, 9, 10, 12, 13, 14, 15, 16, 17, 18, 20, 22, 25, 27, 28, 30, 32, 34, 35, 36, 37, 38, 39, 40, 42, 43, 44, 48, 50, 51, 52, 53, 57, 58, 59, 60, 62, 64, 67, 68, 69, 71, 73, 74, 75, 76, 78, 79, 80, 81, 82, 84, 85, 86, 91, 92, 93, 94, 98, 99, 100, 101, 102, 103, 104, 107, 114, 116, 117, 120, 124, 126, 129, 135, 137, 138, 139, 148, 150, 157, 158, 160, 167, 168, 169, 171, 178, 179, 180, 181, 189, 190, 191, 192, 198]"
agent_c,L100,short,97,50,47,10,0.5076,197,"[0, 1, 2, 3, 4, 5, 6, 8, 9, 10, 12, 13, 22, 23, 25, 26, 27, 29, 31, 32, 33, 34, 36, 38, 39, 40, 41, 42, 43, 44, 46, 47, 48, 50, 51, 52, 53, 54, 55, 57, 58, 59, 60, 61, 63, 64, 65, 67, 68, 69, 70, 71, 73, 75, 76, 77, 78, 79, 80, 81, 87, 88, 90, 91, 93, 94, 95, 97, 98, 100, 104, 106, 112, 113, 115, 119, 120, 121, 123, 124, 125, 127, 128, 137, 138, 146, 147, 150, 159, 168, 169, 176, 177, 178, 179, 182, 190]"
agent_c,L100,short,97,51,46,8,0.5076,197,"[1, 2, 3, 5, 8, 11, 12, 13, 14, 16, 17, 22, 24, 26, 27, 28, 29, 30, 33, 34, 35, 36, 37, 38, 39, 40, 41, 43, 48, 51, 52, 54, 56, 57, 59, 60, 62, 63, 66, 67, 68, 69, 72, 73, 74, 75, 76, 78, 79, 80, 82, 83, 84, 85, 87, 91, 92, 93, 95, 96, 97, 98, 101, 102, 103, 108, 109, 110, 111, 112, 114, 115, 116, 118, 119, 127, 128, 129, 135, 136, 137, 138, 139, 147, 148, 149, 151, 158, 160, 167, 169, 170, 178, 179, 180, 188, 190]"
agent_c,L100,short,101,62,39,5,0.495,200,"[0, 1, 6, 8, 9, 11, 14, 15, 16, 17, 18, 20, 21, 22, 23, 24, 25, 27, 28, 29, 30, 32, 33, 35, 36, 37, 38, 39, 44, 45, 48, 49, 50, 53, 55, 56, 59, 61, 62, 63, 65, 66, 67, 68, 69, 70, 71, 72, 74, 75, 76, 80, 81, 82, 85, 86, 87, 88, 89, 90, 91, 93, 98, 99, 100, 101, 104, 105, 106, 107, 109, 110, 112, 113, 117, 120, 122, 123, 125, 130, 131, 135, 142, 143, 144, 145, 155, 156, 158, 166, 167, 175, 176, 178, 185, 186, 189, 194, 195, 198, 199]"
agent_c,L100,short,98,47,51,10,0.5051,198,"[0, 2, 6, 7, 8, 9, 11, 13, 14, 15, 17, 18, 19, 20, 24, 26, 29, 30, 32, 33, 35, 36, 38, 40, 41, 42, 43, 45, 47, 48, 50, 51, 52, 53, 54, 55, 57, 59, 60, 63, 64, 65, 68, 69, 70, 71, 72, 73, 75, 79, 80, 81, 82, 83, 86, 87, 88, 90, 92, 93, 95, 96, 97, 98, 100, 102, 104, 105, 109, 112, 114, 115, 116, 117, 120, 123, 124, 126, 127, 128, 129, 135, 136, 138, 139, 146, 150, 158, 160, 168, 169, 172, 180, 181, 188, 189, 190, 191]"
agent_c,L100,short,99,61,38,9,0.5025,199,"[2, 4, 5, 6, 8, 9, 11, 12, 13, 14, 15, 16, 18, 21, 23, 24, 25, 26, 27, 28, 29, 32, 33, 35, 37, 38, 39, 41, 42, 43, 44, 45, 49, 50, 51, 52, 57, 58, 59, 61, 62, 63, 65, 68, 69, 71, 72, 74, 76, 77, 78, 79, 80, 81, 84, 85, 87, 89, 91, 92, 96, 98, 101, 103, 104, 105, 106, 108, 109, 112, 114, 116, 117, 118, 119, 120, 121, 128, 130, 132, 138, 139, 140, 141, 149, 150, 151, 158, 159, 161, 169, 170, 172, 179, 180, 181, 188, 191, 196]"
agent_c,L100,short,101,48,53,8,0.495,200,"[1, 5, 6, 8, 9, 10, 11, 12, 14, 16, 17, 18, 19, 20, 21, 23, 24, 25, 26, 28, 30, 32, 33, 34, 36, 37, 39, 40, 41, 42, 45, 46, 47, 48, 50, 51, 52, 53, 55, 56, 57, 58, 59, 62, 63, 64, 67, 69, 70, 71, 76, 77, 78, 79, 81, 82, 83, 86, 88, 89, 92, 93, 94, 95, 97, 98, 99, 100, 101, 102, 103, 104, 106, 107, 113, 114, 115, 116, 117, 119, 125, 127, 129, 131, 138, 139, 141, 148, 149, 151, 160, 161, 162, 163, 172, 174, 175, 184, 185, 194, 196]"
agent_c,L100,short,95,48,47,9,0.5128,195,"[0, 1, 3, 6, 7, 9, 10, 11, 13, 14, 15, 17, 18, 19, 20, 22, 25, 27, 29, 31, 34, 35, 36, 37, 40, 44, 46, 47, 48, 49, 50, 52, 54, 55, 57, 60, 61, 62, 64, 65, 66, 67, 68, 69, 70, 71, 72, 73, 75, 76, 77, 80, 81, 82, 83, 84, 85, 86, 88, 89, 90, 94, 96, 97, 99, 101, 103, 104, 105, 107, 108, 109, 112, 113, 119, 120, 121, 123, 127, 129, 132, 133, 145, 153, 154, 161, 162, 163, 164, 166, 176, 183, 185, 192, 193]"
agent_c,L100,short,103,51,52,8,0.485,200,"[0, 1, 2, 3, 5, 6, 7, 9, 10, 11, 12, 14, 16, 17, 18, 19, 20, 22, 23, 26, 29, 30, 32, 33, 36, 37, 38, 39, 40, 42, 43, 45, 47, 48, 50, 52, 53, 55, 57, 58, 59, 61, 62, 63, 64, 65, 67, 68, 70, 71, 72, 73, 74, 75, 76, 78, 79, 80, 82, 83, 86, 88, 89, 90, 92, 99, 100, 103, 105, 107, 108, 109, 110, 111, 112, 114, 119, 120, 121, 122, 123, 129, 130, 133, 134, 143, 144, 145, 153, 155, 163, 165, 173, 175, 182, 183, 184, 188, 195, 196, 197, 198, 199]"
agent_c,L100,short,99,56,43,13,0.5025,199,"[0, 2, 3, 4, 6, 7, 9, 11, 12, 14, 19, 21, 22, 24, 25, 26, 28, 29, 30, 32, 33, 35, 37, 39, 40, 41, 42, 43, 44, 45, 47, 48, 49, 52, 55, 56, 57, 59, 61, 64, 65, 67, 68, 69, 70, 72, 74, 75, 77, 78, 80, 81, 83, 84, 90, 92, 93, 94, 98, 99, 100, 101, 102, 103, 107, 108, 109, 110, 113, 114, 115, 116, 117, 119, 126, 127, 130, 134, 135, 136, 139, 146, 147, 148, 154, 155, 156, 157, 158, 167, 169, 170, 171, 181, 188, 189, 190, 191, 192]"
agent_c,L100,short,100,54,46,9,0.5,200,"[0, 2, 5, 7, 9, 10, 12, 13, 14, 16, 17, 19, 21, 23, 25, 26, 27, 28, 30, 31, 32, 33, 35, 36, 37, 38, 40, 41, 42, 43, 44, 45, 49, 51, 53, 54, 56, 57, 58, 59, 61, 62, 63, 64, 65, 67, 69, 70, 71, 73, 77, 78, 79, 81, 82, 86, 87, 89, 90, 92, 93, 94, 97, 99, 100, 101, 102, 105, 107, 108, 109, 110, 114, 118, 120, 121, 122, 123, 128, 131, 132, 133, 134, 140, 142, 146, 155, 162, 163, 164, 171, 172, 173, 174, 182, 183, 184, 187, 194, 196]"
agent_c,L100,short,101,51,50,8,0.495,200,"[0, 1, 4, 6, 8, 9, 10, 11, 12, 13, 14, 15, 17, 18, 20, 21, 23, 24, 26, 30, 32, 34, 36, 38, 40, 42, 43, 45, 46, 48, 49, 50, 51, 52, 54, 56, 57, 58, 59, 62, 63, 64, 66, 67, 71, 72, 74, 78, 80, 81, 82, 84, 85, 87, 88, 89, 90, 91, 94, 95, 96, 97, 99, 101, 102, 105, 106, 107, 108, 109, 112, 114, 115, 116, 117, 118, 119, 121, 128, 129, 130, 131, 140, 142, 150, 151, 158, 161, 162, 165, 172, 173, 180, 181, 182, 183, 184, 190, 192, 193, 196]"
agent_c,L100,short,100,58,42,11,0.5,200,"[1, 4, 6, 7, 8, 9, 11, 12, 13, 15, 16, 18, 19, 20, 21, 23, 24, 25, 26, 28, 31, 33, 34, 35, 37, 38, 39, 40, 43, 44, 45, 46, 47, 48, 49, 51, 52, 53, 54, 56, 57, 58, 59, 60, 61, 67, 68, 72, 73, 75, 76, 78, 80, 81, 83, 86, 87, 89, 90, 91, 93, 94, 96, 97, 100, 101, 104, 108, 109, 110, 111, 114, 117, 118, 120, 125, 130, 131, 132, 134, 140, 141, 142, 143, 144, 153, 158, 165, 167, 175, 176, 183, 184, 186, 192, 193, 194, 195, 196, 197]"
agent_c,L100,short,102,60,42,10,0.49,200,"[0, 1, 2, 3, 5, 6, 8, 11, 13, 15, 16, 18, 20, 21, 23, 26, 27, 28, 29, 30, 31, 32, 33, 37, 38, 39, 40, 41, 42, 46, 47, 48, 49, 50, 51, 52, 54, 55, 58, 59, 60, 61, 62, 63, 64, 66, 67, 68, 72, 73, 74, 77, 78, 79, 80, 81, 85, 86, 89, 90, 91, 92, 95, 96, 100, 101, 102, 106, 108, 109, 111, 112, 113, 114, 115, 116, 119, 124, 125, 127, 132, 133, 135, 136, 137, 140, 148, 149, 157, 158, 161, 168, 169, 176, 178, 179, 180, 181, 189, 190, 191, 199]"
agent_c,L100,short,101,41,60,11,0.495,200,"[2, 3, 4, 6, 7, 8, 16, 17, 18, 19, 21, 25, 26, 28, 29, 30, 31, 32, 33, 34, 35, 38, 39, 40, 41, 43, 44, 45, 47, 48, 49, 50, 51, 53, 54, 56, 57, 58, 61, 62, 63, 64, 65, 66, 67, 68, 71, 72, 73, 74, 75, 77, 78, 79, 81, 82, 83, 86, 89, 92, 93, 94, 95, 96, 99, 102, 103, 104, 105, 106, 107, 108, 109, 112, 113, 114, 116, 124, 126, 131, 132, 133, 134, 135, 136, 145, 146, 147, 155, 156, 157, 166, 167, 175, 177, 178, 187, 190, 191, 197, 199]"
agent_c,L100,short,103,50,53,3,0.485,200,"[0, 1, 2, 3, 4, 5, 7, 8, 9, 11, 12, 15, 16, 18, 20, 22, 24, 26, 27, 29, 30, 31, 33, 34, 35, 39, 40, 41, 42, 45, 46, 48, 50, 52, 53, 54, 56, 57, 59, 60, 61, 62, 64, 65, 66, 68, 69, 70, 72, 73, 75, 77, 78, 79, 80, 81, 83, 84, 85, 86, 87, 88, 89, 90, 91, 92, 93, 96, 102, 104, 105, 107, 108, 110, 112, 113, 114, 115, 123, 125, 131, 132, 133, 135, 136, 137, 138, 147, 148, 156, 159, 168, 175, 177, 178, 179, 185, 186, 187, 188, 189, 190, 198]"
agent_c,L100,short,98,50,48,11,0.5051,198,"[0, 1, 2, 3, 4, 5, 6, 8, 9, 11, 12, 13, 14, 15, 17, 18, 19, 20, 22, 23, 24, 25, 26, 27, 29, 30, 32, 33, 37, 38, 39, 40, 43, 44, 46, 48, 49, 50, 53, 54, 56, 57, 62, 63, 64, 66, 67, 68, 69, 70, 71, 74, 76, 77, 78, 81, 82, 84, 85, 86, 87, 88, 89, 91, 94, 95, 96, 97, 98, 99, 100, 103, 106, 107, 110, 114, 122, 124, 130, 131, 133, 140, 142, 144, 151, 153, 160, 161, 162, 166, 173, 176, 183, 184, 185, 193, 194, 196]"
agent_c,L100,short,102,57,45,7,0.49,200,"[0, 1, 6, 7, 11, 15, 17, 18, 19, 20, 22, 23, 24, 27, 28, 29, 30, 31, 34, 35, 36, 37, 40, 41, 42, 43, 44, 46, 48, 50, 52, 53, 56, 57, 58, 59, 60, 61, 63, 64, 65, 66, 67, 68, 69, 70, 71, 72, 73, 74, 75, 76, 77, 78, 80, 81, 83, 84, 89, 90, 91, 92, 94, 95, 96, 97, 99, 100, 102, 106, 109, 110, 111, 112, 113, 116, 117, 118, 121, 122, 123, 126, 133, 135, 136, 137, 146, 147, 149, 159, 168, 175, 176, 177, 178, 186, 188, 195, 196, 197, 198, 199]"
agent_c,L100,short,97,50,47,11,0.5076,197,"[0, 3, 4, 5, 6, 7, 8, 10, 11, 14, 15, 16, 17, 18, 20, 21, 22, 24, 25, 26, 28, 29, 31, 32, 36, 37, 38, 39, 41, 42, 43, 45, 46, 47, 49, 50, 52, 53, 54, 55, 57, 58, 59, 60, 61, 64, 65, 66, 68, 69, 70, 72, 74, 75, 76, 77, 78, 79, 80, 81, 83, 84, 85, 92, 93, 97, 99, 100, 101, 102, 104, 105, 108, 112, 115, 116, 118, 122, 123, 125, 126, 128, 136, 137, 140, 147, 148, 159, 166, 172, 178, 179, 185, 186, 187, 188, 190]"
agent_c,L100,short,102,46,56,9,0.49,200,"[0, 1, 2, 4, 5, 6, 7, 12, 14, 16, 17, 18, 20, 21, 22, 24, 27, 28, 29, 30, 32, 33, 34, 35, 36, 37, 40, 41, 42, 43, 44, 45, 46, 47, 48, 49, 50, 52, 53, 57, 58, 59, 60, 63, 64, 66, 67, 69, 70, 71, 72, 75, 76, 77, 78, 79, 80, 81, 84, 85, 87, 89, 92, 94, 96, 98, 99, 100, 102, 107, 109, 110, 111, 112, 115, 116, 117, 119, 120, 121, 123, 124, 125, 134, 135, 136, 144, 145, 148, 157, 158, 165, 166, 168, 175, 176, 177, 178, 188, 189, 196, 197]"
agent_c,L100,short,103,45,58,5,0.485,200,"[1, 4, 5, 8, 10, 11, 13, 14, 17, 18, 20, 21, 23, 24, 27, 28, 29, 30, 31, 32, 34, 35, 36, 37, 41, 43, 44, 46, 47, 48, 49, 50, 52, 53, 55, 57, 58, 59, 60, 61, 63, 64, 66, 67, 69, 71, 73, 74, 75, 76, 77, 78, 79, 83, 84, 85, 87, 89, 90, 91, 92, 93, 95, 96, 99, 101, 102, 103, 106, 107, 108, 109, 111, 112, 113, 115, 120, 121, 123, 124, 126, 132, 133, 134, 136, 144, 146, 156, 157, 158, 165, 166, 167, 168, 175, 176, 177, 178, 179, 190, 197, 198, 199]"
agent_c,L100,short,98,42,56,10,0.5051,198,"[0, 2, 4, 5, 7, 8, 9, 10, 11, 12, 14, 17, 19, 20, 22, 26, 28, 29, 30, 31, 33, 34, 35, 36, 37, 39, 40, 41, 42, 45, 46, 47, 48, 49, 51, 52, 54, 55, 56, 57, 58, 59, 60, 61, 62, 63, 64, 68, 69, 71, 73, 76, 78, 79, 81, 83, 86, 87, 88, 89, 90, 91, 93, 95, 100, 102, 103, 105, 108, 109, 112, 113, 116, 117, 118, 121, 122, 124, 129, 130, 133, 140, 141, 142, 143, 146, 155, 162, 164, 172, 173, 174, 181, 182, 183, 185, 192, 193]"
agent_c,L100,short,100,39,61,6,0.5,200,"[3, 7, 8, 9, 10, 12, 13, 16, 17, 18, 22, 25, 26, 28, 29, 30, 31, 34, 36, 37, 38, 39, 40, 42, 43, 44, 45, 46, 47, 48, 49, 52, 54, 55, 57, 58, 59, 60, 61, 62, 63, 66, 67, 68, 71, 73, 74, 75, 76, 77, 80, 82, 84, 85, 86, 88, 90, 91, 93, 94, 96, 98, 99, 100, 101, 105, 106, 107, 109, 112, 113, 114, 115, 116, 118, 122, 123, 124, 125, 127, 128, 129, 131, 138, 139, 140, 141, 149, 150, 151, 159, 161, 163, 173, 181, 183, 189, 190, 191, 192]"
agent_c,L100,short,101,42,59,6,0.495,200,"[0, 3, 5, 6, 7, 8, 10, 12, 13, 14, 15, 16, 18, 20, 21, 22, 23, 24, 27, 28, 29, 31, 34, 38, 39, 40, 42, 45, 46, 47, 48, 49, 51, 52, 53, 54, 55, 56, 58, 59, 60, 61, 62, 65, 66, 67, 68, 72, 74, 75, 79, 80, 83, 84, 85, 86, 87, 88, 89, 91, 94, 96, 97, 99, 101, 102, 103, 104, 105, 107, 109, 112, 113, 114, 115, 116, 117, 124, 125, 126, 127, 128, 130, 137, 139, 140, 148, 150, 151, 161, 168, 170, 171, 178, 179, 180, 182, 190, 191, 192, 193]"
agent_c,L100,short,99,63,36,11,0.5025,199,"[0, 4, 5, 6, 7, 8, 11, 12, 13, 14, 15, 17, 19, 20, 24, 27, 28, 30, 32, 33, 34, 35, 37, 38, 41, 42, 43, 44, 45, 46, 47, 48, 49, 53, 55, 56, 57, 58, 59, 61, 64, 65, 66, 69, 71, 72, 74, 75, 76, 78, 79, 80, 83, 84, 85, 86, 87, 90, 91, 92, 95, 96, 97, 98, 101, 102, 103, 104, 105, 107, 108, 109, 110, 111, 112, 115, 121, 122, 123, 127, 135, 136, 142, 143, 144, 145, 146, 156, 164, 165, 166, 167, 168, 169, 170, 179, 181, 189, 194]"
agent_c,L100,short,95,56,39,17,0.5128,195,"[0, 4, 6, 7, 8, 10, 11, 12, 13, 14, 15, 16, 17, 18, 21, 23, 24, 26, 27, 28, 29, 30, 31, 34, 36, 37, 40, 41, 42, 43, 45, 48, 49, 50, 52, 58, 59, 60, 61, 62, 63, 65, 66, 67, 68, 71, 72, 73, 75, 77, 78, 79, 81, 83, 86, 88, 89, 92, 93, 94, 96, 97, 98, 101, 102, 104, 106, 109, 110, 113, 115, 122, 123, 124, 127, 133, 134, 135, 137, 143, 145, 146, 147, 154, 159, 167, 170, 172, 180, 181, 186, 188, 189, 190, 192]"
agent_c,L100,short,100,32,68,5,0.5,200,"[2, 3, 4, 5, 6, 7, 8, 9, 11, 13, 14, 15, 16, 17, 18, 20, 21, 23, 24, 25, 27, 28, 29, 30, 31, 32, 33, 36, 37, 41, 44, 46, 47, 48, 51, 52, 54, 55, 56, 58, 59, 60, 61, 62, 63, 64, 65, 66, 67, 68, 70, 71, 74, 75, 76, 78, 79, 80, 82, 83, 85, 87, 92, 94, 95, 97, 99, 100, 102, 103, 104, 105, 106, 107, 111, 118, 121, 125, 126, 127, 130, 132, 140, 141, 142, 149, 152, 161, 162, 171, 172, 179, 180, 181, 183, 185, 187, 193, 196, 197]"
agent_c,L100,short,101,65,36,7,0.495,200,"[0, 1, 2, 3, 6, 9, 10, 11, 12, 13, 14, 15, 16, 17, 18, 19, 21, 22, 23, 24, 27, 30, 31, 32, 33, 34, 35, 36, 37, 38, 39, 41, 43, 44, 45, 47, 48, 49, 50, 52, 53, 54, 56, 58, 60, 61, 62, 65, 66, 67, 68, 69, 70, 72, 73, 76, 77, 83, 84, 89, 91, 92, 95, 96, 97, 99, 100, 101, 105, 106, 107, 108, 110, 113, 115, 116, 117, 123, 126, 127, 130, 137, 138, 145, 146, 147, 148, 158, 159, 166, 167, 168, 169, 171, 179, 180, 188, 189, 191, 198, 199]"
agent_c,L100,short,96,50,46,17,0.5102,196,"[2, 4, 5, 6, 10, 11, 13, 15, 16, 17, 18, 19, 20, 22, 23, 24, 26, 27, 28, 29, 30, 31, 32, 33, 34, 36, 37, 38, 39, 41, 42, 43, 46, 47, 48, 50, 51, 52, 53, 54, 55, 58, 59, 60, 62, 63, 66, 67, 70, 74, 75, 76, 77, 78, 81, 82, 84, 85, 86, 88, 89, 94, 95, 97, 98, 100, 101, 103, 104, 106, 109, 111, 116, 118, 121, 126, 129, 130, 136, 138, 139, 140, 146, 147, 148, 153, 166, 174, 180, 181, 186, 187, 189, 190, 191, 192]"
agent_c,L100,short,100,64,36,10,0.5,200,"[0, 1, 2, 3, 4, 5, 6, 11, 13, 14, 15, 18, 20, 22, 27, 28, 29, 30, 32, 33, 34, 35, 36, 37, 39, 40, 41, 42, 44, 46, 48, 49, 53, 54, 55, 56, 57, 58, 59, 64, 68, 69, 71, 76, 77, 78, 80, 81, 82, 84, 86, 87, 88, 93, 94, 95, 96, 97, 98, 100, 101, 103, 105, 106, 108, 109, 110, 114, 117, 120, 121, 122, 123, 125, 130, 131, 132, 133, 134, 136, 143, 144, 145, 152, 153, 154, 155, 162, 163, 164, 165, 173, 174, 176, 182, 184, 185, 192, 195, 196]"
agent_c,L100,short,100,49,51,18,0.5,200,"[0, 3, 6, 7, 10, 11, 12, 14, 17, 18, 21, 22, 23, 24, 25, 27, 29, 33, 34, 35, 36, 38, 39, 40, 42, 44, 47, 48, 49, 52, 53, 54, 56, 59, 60, 62, 64, 65, 66, 67, 69, 70, 71, 73, 74, 76, 77, 78, 79, 81, 82, 83, 85, 87, 95, 96, 97, 98, 99, 102, 103, 104, 106, 108, 109, 111, 112, 113, 114, 115, 118, 119, 121, 122, 124, 126, 142, 147, 148, 153, 155, 156, 157, 158, 163, 164, 166, 167, 169, 176, 177, 178, 185, 186, 187, 188, 193, 196, 197, 198]"
agent_c,L100,short,101,46,55,9,0.495,200,"[0, 2, 5, 6, 7, 8, 9, 10, 11, 12, 13, 16, 20, 21, 22, 23, 24, 25, 26, 28, 29, 30, 31, 34, 35, 36, 37, 38, 40, 41, 42, 46, 50, 51, 52, 54, 55, 57, 58, 61, 62, 63, 64, 65, 66, 67, 68, 72, 75, 77, 78, 79, 81, 82, 84, 85, 86, 88, 90, 91, 92, 93, 94, 97, 98, 99, 102, 104, 107, 108, 109, 111, 112, 113, 115, 116, 119, 124, 125, 126, 127, 129, 130, 138, 139, 142, 150, 157, 158, 159, 160, 161, 163, 165, 176, 184, 191, 192, 194, 196, 197]"
agent_c,L100,short,101,57,44,10,0.495,200,"[1, 4, 5, 7, 8, 9, 10, 11, 12, 13, 15, 17, 18, 19, 20, 23, 24, 25, 27, 29, 30, 32, 34, 35, 36, 40, 41, 42, 44, 45, 46, 48, 49, 50, 52, 55, 58, 59, 60, 61, 62, 63, 64, 65, 67, 69, 71, 72, 73, 74, 75, 76, 78, 79, 80, 81, 82, 83, 84, 85, 87, 89, 90, 91, 92, 96, 99, 100, 101, 104, 105, 106, 107, 110, 111, 115, 125, 129, 130, 131, 132, 133, 134, 135, 137, 138, 139, 150, 158, 159, 160, 168, 171, 172, 181, 182, 188, 189, 190, 191, 193]"
agent_c,L0,middle,55,28,27,3,0.6452,155,"[11, 13, 14, 15, 17, 20, 22, 23, 25, 26, 27, 28, 29, 30, 31, 32, 34, 35, 36, 37, 38, 39, 40, 57, 58, 59, 60, 63, 71, 72, 73, 76, 77, 80, 82, 84, 101, 103, 104, 105, 106, 108, 124, 125, 127, 129, 141, 142, 144, 145, 146, 147, 148, 149, 150]"
agent_c,L0,middle,46,20,26,3,0.6849,146,"[11, 15, 16, 17, 19, 20, 21, 22, 23, 25, 26, 31, 34, 35, 36, 37, 38, 39, 42, 56, 58, 61, 68, 69, 75, 76, 78, 80, 92, 93, 97, 98, 99, 100, 101, 116, 117, 119, 122, 132, 133, 134, 138, 139, 140, 142]"
agent_c,L0,middle,51,31,20,1,0.6623,151,"[11, 12, 14, 15, 18, 19, 20, 21, 22, 23, 24, 25, 27, 28, 29, 31, 32, 33, 34, 35, 36, 37, 38, 39, 42, 61, 69, 70, 71, 72, 74, 76, 77, 78, 79, 80, 81, 96, 98, 101, 117, 118, 119, 120, 121, 122, 138, 139, 140, 142, 143]"
agent_c,L0,middle,48,21,27,6,0.6757,148,"[0, 1, 2, 3, 4, 6, 7, 8, 9, 11, 16, 17, 18, 19, 35, 36, 40, 43, 44, 45, 46, 47, 49, 50, 52, 54, 55, 60, 75, 76, 77, 81, 96, 98, 101, 116, 117, 119, 120, 121, 123, 135, 136, 137, 138, 139, 141, 143]"
agent_c,L0,middle,48,21,27,3,0.6757,148,"[12, 13, 15, 17, 19, 20, 22, 24, 26, 27, 28, 30, 31, 33, 34, 36, 38, 39, 41, 56, 58, 59, 60, 66, 68, 73, 74, 76, 79, 80, 92, 94, 95, 96, 97, 99, 100, 101, 117, 118, 120, 121, 123, 136, 139, 140, 141, 143]"
agent_c,L0,middle,50,20,30,7,0.6667,150,"[0, 1, 3, 6, 7, 8, 9, 10, 12, 14, 15, 18, 19, 35, 36, 37, 38, 40, 41, 47, 49, 50, 52, 53, 55, 56, 57, 63, 78, 79, 81, 98, 99, 100, 101, 102, 107, 121, 123, 124, 126, 128, 137, 140, 141, 142, 143, 144, 145, 146]"
agent_c,L0,middle,51,26,25,5,0.6623,151,"[12, 13, 14, 17, 21, 22, 23, 24, 27, 28, 29, 30, 32, 33, 35, 37, 38, 41, 54, 55, 56, 59, 61, 68, 69, 70, 71, 72, 74, 76, 77, 78, 79, 80, 81, 96, 97, 98, 100, 101, 102, 103, 104, 122, 123, 124, 138, 139, 140, 143, 146]"
agent_c,L0,middle,48,36,12,5,0.6757,148,"[0, 1, 2, 3, 5, 6, 7, 8, 9, 12, 14, 15, 16, 17, 19, 20, 22, 39, 40, 41, 44, 45, 47, 48, 49, 50, 51, 52, 56, 57, 58, 59, 60, 61, 80, 82, 99, 100, 101, 103, 120, 121, 122, 134, 136, 138, 139, 145]"
agent_c,L0,middle,49,16,33,5,0.6711,149,"[0, 2, 3, 5, 6, 8, 9, 11, 14, 15, 16, 17, 18, 19, 20, 38, 39, 41, 43, 44, 45, 46, 49, 52, 53, 55, 56, 57, 58, 61, 76, 77, 78, 79, 81, 97, 98, 99, 101, 103, 121, 123, 135, 137, 138, 140, 141, 142, 144]"
agent_c,L0,middle,50,27,23,2,0.6667,150,"[11, 12, 13, 14, 16, 19, 20, 21, 22, 24, 25, 26, 28, 29, 30, 33, 35, 37, 38, 39, 40, 41, 58, 59, 60, 61, 70, 71, 74, 75, 77, 79, 80, 81, 82, 83, 98, 99, 100, 101, 104, 121, 122, 123, 136, 137, 139, 141, 142, 144]"
agent_c,L0,middle,50,21,29,2,0.6667,150,"[0, 1, 2, 4, 6, 7, 10, 11, 13, 15, 16, 17, 18, 19, 20, 22, 42, 45, 49, 50, 51, 52, 53, 54, 55, 56, 58, 59, 63, 66, 81, 82, 85, 101, 104, 105, 118, 120, 122, 123, 124, 125, 126, 127, 140, 142, 144, 145, 146, 147]"
agent_c,L0,middle,50,20,30,1,0.6667,150,"[11, 12, 13, 15, 16, 17, 19, 21, 25, 27, 29, 30, 31, 32, 33, 34, 35, 36, 37, 38, 40, 57, 58, 59, 60, 67, 68, 69, 71, 72, 73, 74, 75, 77, 78, 80, 81, 96, 97, 99, 101, 102, 119, 120, 122, 136, 138, 141, 142, 143]"
agent_c,L0,middle,49,20,29,1,0.6711,149,"[13, 15, 16, 19, 20, 21, 23, 24, 27, 28, 29, 30, 33, 34, 35, 36, 37, 38, 39, 54, 55, 58, 59, 60, 66, 68, 69, 70, 71, 72, 73, 74, 77, 78, 79, 80, 94, 95, 96, 97, 98, 99, 100, 101, 122, 136, 140, 141, 143]"
agent_c,L0,middle,47,24,23,5,0.6803,147,"[0, 1, 2, 3, 6, 7, 8, 9, 11, 14, 15, 16, 17, 18, 19, 20, 37, 39, 42, 44, 45, 46, 48, 49, 50, 52, 53, 57, 58, 59, 60, 77, 78, 79, 81, 97, 101, 104, 118, 120, 123, 136, 138, 139, 140, 141, 143]"
agent_c,L0,middle,55,27,28,4,0.6452,155,"[11, 12, 13, 14, 15, 17, 18, 19, 21, 22, 23, 26, 28, 31, 32, 33, 35, 36, 37, 38, 42, 57, 58, 59, 60, 61, 63, 74, 75, 77, 78, 79, 81, 83, 84, 98, 99, 100, 101, 103, 104, 106, 107, 123, 124, 125, 126, 127, 143, 144, 145, 146, 147, 148, 150]"
agent_c,L0,middle,48,10,38,5,0.6757,148,"[11, 12, 13, 17, 19, 20, 21, 25, 26, 27, 28, 30, 31, 32, 33, 34, 35, 37, 38, 40, 55, 56, 58, 60, 66, 68, 70, 71, 75, 76, 77, 78, 79, 83, 96, 97, 98, 100, 106, 121, 122, 123, 124, 125, 138, 142, 143, 145]"
agent_c,L0,middle,47,27,20,4,0.6803,147,"[0, 1, 2, 3, 5, 6, 11, 15, 16, 17, 19, 20, 35, 39, 41, 42, 43, 44, 45, 46, 47, 48, 49, 50, 51, 53, 54, 55, 56, 57, 59, 60, 61, 62, 84, 100, 101, 102, 117, 118, 122, 134, 137, 138, 140, 141, 144]"
agent_c,L0,middle,51,18,33,1,0.6623,151,"[0, 2, 3, 4, 5, 8, 9, 10, 11, 12, 13, 15, 16, 17, 18, 20, 37, 39, 40, 41, 43, 44, 45, 48, 49, 55, 56, 57, 60, 75, 76, 78, 79, 80, 97, 98, 99, 100, 101, 116, 119, 122, 133, 134, 135, 136, 137, 138, 139, 141, 142]"
agent_c,L0,middle,51,31,20,1,0.6623,151,"[0, 1, 2, 3, 5, 7, 8, 10, 11, 12, 13, 15, 16, 18, 20, 38, 39, 40, 41, 42, 43, 49, 51, 52, 54, 55, 56, 59, 74, 77, 78, 79, 80, 98, 99, 100, 115, 116, 119, 120, 131, 134, 135, 136, 137, 138, 139, 140, 141, 142, 143]"
agent_c,L0,middle,54,34,20,0,0.6494,154,"[1, 2, 3, 5, 6, 7, 9, 11, 12, 13, 14, 15, 16, 17, 18, 19, 21, 22, 23, 41, 42, 43, 44, 46, 47, 50, 51, 53, 55, 56, 58, 59, 60, 62, 63, 64, 82, 85, 86, 107, 108, 125, 126, 127, 128, 139, 140, 141, 142, 143, 145, 147, 148, 149]"
agent_c,L0,middle,49,24,25,1,0.6711,149,"[1, 2, 3, 6, 7, 8, 10, 12, 14, 16, 17, 18, 19, 35, 38, 39, 40, 43, 44, 47, 48, 49, 50, 51, 53, 54, 55, 56, 57, 58, 60, 77, 78, 79, 80, 96, 97, 98, 99, 101, 118, 119, 120, 134, 135, 136, 137, 138, 140]"
agent_c,L0,middle,47,28,19,4,0.6803,147,"[11, 13, 14, 15, 16, 17, 22, 23, 24, 26, 27, 31, 33, 34, 35, 37, 38, 39, 53, 54, 56, 57, 58, 59, 66, 67, 69, 72, 73, 75, 76, 78, 79, 80, 93, 95, 98, 99, 100, 116, 117, 122, 135, 136, 137, 139, 143]"
agent_c,L0,middle,50,32,18,3,0.6667,150,"[0, 1, 2, 3, 4, 5, 7, 8, 9, 10, 11, 12, 13, 14, 15, 16, 17, 20, 39, 40, 41, 43, 46, 47, 49, 51, 53, 54, 55, 57, 58, 59, 61, 79, 80, 81, 83, 84, 85, 103, 107, 122, 123, 124, 126, 140, 143, 145, 146, 147]"
agent_c,L0,middle,49,25,24,3,0.6711,149,"[11, 12, 13, 14, 15, 17, 18, 20, 21, 22, 23, 25, 26, 27, 30, 31, 32, 33, 34, 35, 36, 37, 38, 40, 57, 58, 59, 60, 61, 71, 72, 73, 74, 76, 77, 78, 79, 80, 81, 97, 99, 100, 101, 119, 120, 121, 123, 138, 143]"
agent_c,L0,middle,47,26,21,8,0.6803,147,"[1, 2, 4, 6, 8, 9, 10, 11, 12, 15, 16, 18, 22, 39, 43, 44, 46, 48, 53, 54, 56, 58, 59, 60, 61, 72, 73, 74, 75, 76, 78, 79, 81, 97, 98, 99, 102, 116, 119, 120, 121, 122, 124, 138, 140, 141, 144]"
agent_c,L0,middle,55,26,29,5,0.6452,155,"[11, 14, 16, 17, 18, 20, 21, 22, 23, 25, 26, 27, 28, 33, 34, 36, 37, 38, 42, 56, 58, 59, 64, 66, 67, 69, 70, 71, 72, 73, 74, 75, 76, 77, 78, 79, 94, 95, 96, 97, 98, 100, 118, 119, 120, 135, 136, 137, 138, 139, 140, 149, 150, 151, 152]"
agent_c,L0,middle,48,24,24,2,0.6757,148,"[13, 14, 16, 17, 19, 20, 23, 24, 25, 26, 27, 28, 31, 32, 33, 34, 35, 37, 38, 39, 54, 56, 58, 59, 66, 67, 69, 72, 75, 77, 78, 79, 80, 81, 82, 83, 99, 100, 101, 102, 103, 105, 124, 138, 139, 142, 143, 145]"
agent_c,L0,middle,52,25,27,3,0.6579,152,"[1, 2, 4, 5, 6, 7, 8, 9, 10, 11, 13, 14, 15, 16, 18, 19, 37, 38, 39, 41, 43, 44, 45, 47, 48, 49, 52, 57, 60, 75, 76, 78, 79, 82, 100, 101, 102, 116, 117, 119, 120, 121, 122, 135, 136, 137, 138, 139, 140, 141, 142, 144]"
agent_c,L0,middle,49,20,29,4,0.6711,149,"[2, 3, 4, 5, 6, 7, 10, 11, 13, 14, 15, 16, 17, 19, 36, 37, 38, 39, 41, 42, 43, 48, 49, 51, 53, 54, 55, 56, 57, 60, 76, 77, 78, 81, 97, 98, 100, 114, 115, 117, 119, 120, 133, 134, 135, 136, 138, 139, 141]"
agent_c,L0,middle,47,22,25,5,0.6803,147,"[11, 12, 13, 15, 16, 20, 22, 23, 24, 25, 27, 30, 31, 34, 36, 37, 38, 41, 55, 57, 58, 59, 61, 66, 67, 69, 70, 71, 74, 76, 78, 79, 80, 81, 95, 98, 99, 100, 103, 120, 121, 134, 136, 138, 139, 140, 141]"
agent_c,L0,middle,47,24,23,7,0.6803,147,"[11, 12, 13, 14, 15, 16, 17, 18, 19, 20, 21, 22, 24, 25, 27, 28, 29, 30, 31, 33, 35, 37, 38, 39, 40, 41, 42, 67, 79, 81, 82, 94, 95, 96, 98, 99, 100, 104, 119, 120, 124, 135, 136, 137, 138, 142, 143]"
agent_c,L0,middle,44,18,26,2,0.6944,144,"[0, 1, 7, 10, 12, 13, 15, 16, 18, 19, 33, 35, 36, 40, 41, 42, 44, 48, 50, 51, 52, 53, 54, 57, 58, 59, 72, 73, 75, 76, 77, 79, 80, 96, 97, 98, 99, 100, 120, 132, 134, 135, 136, 141]"
agent_c,L0,middle,51,26,25,4,0.6623,151,"[13, 15, 16, 19, 20, 25, 34, 36, 37, 40, 48, 50, 51, 52, 54, 55, 56, 58, 59, 62, 66, 69, 71, 72, 73, 75, 76, 77, 81, 93, 94, 96, 97, 98, 99, 100, 101, 103, 121, 122, 124, 135, 136, 137, 138, 139, 140, 141, 142, 143, 145]"
agent_c,L0,middle,47,22,25,5,0.6803,147,"[0, 1, 2, 3, 4, 5, 6, 11, 14, 15, 16, 17, 18, 21, 36, 37, 39, 40, 41, 42, 43, 45, 47, 48, 49, 50, 51, 54, 55, 56, 57, 60, 80, 96, 97, 98, 99, 113, 116, 117, 119, 121, 134, 135, 136, 139, 140]"
agent_c,L0,middle,51,31,20,2,0.6623,151,"[12, 13, 14, 15, 16, 17, 18, 19, 20, 21, 22, 23, 25, 26, 27, 28, 29, 30, 31, 32, 33, 34, 35, 37, 38, 39, 40, 42, 61, 71, 72, 74, 75, 76, 77, 78, 79, 80, 81, 98, 100, 101, 118, 120, 122, 136, 137, 138, 140, 141, 142]"
agent_c,L0,middle,49,27,22,2,0.6711,149,"[0, 1, 2, 3, 5, 6, 7, 10, 12, 13, 14, 15, 18, 19, 36, 38, 39, 40, 41, 42, 44, 45, 46, 47, 50, 53, 54, 56, 59, 60, 61, 77, 79, 81, 97, 98, 99, 100, 102, 118, 119, 120, 122, 135, 136, 137, 138, 140, 141]"
agent_c,L0,middle,48,25,23,5,0.6757,148,"[1, 2, 4, 5, 6, 7, 9, 10, 12, 13, 14, 16, 17, 18, 19, 36, 37, 39, 40, 42, 43, 44, 45, 46, 47, 49, 50, 51, 54, 59, 60, 62, 78, 79, 80, 83, 84, 101, 103, 104, 120, 121, 122, 123, 126, 139, 142, 143]"
agent_c,L0,middle,44,17,27,8,0.6944,144,"[11, 12, 13, 14, 16, 19, 20, 21, 25, 26, 27, 29, 30, 31, 32, 35, 37, 38, 41, 54, 55, 57, 58, 61, 67, 68, 70, 71, 73, 74, 76, 77, 78, 79, 93, 95, 98, 102, 120, 132, 135, 136, 137, 139]"
agent_c,L0,middle,52,26,26,3,0.6579,152,"[0, 1, 3, 4, 5, 6, 7, 9, 10, 12, 14, 15, 16, 18, 19, 20, 38, 40, 41, 42, 43, 45, 51, 52, 53, 54, 56, 57, 58, 59, 60, 77, 78, 79, 81, 97, 98, 99, 100, 116, 118, 119, 121, 123, 135, 137, 138, 139, 140, 141, 143, 145]"
agent_c,L0,middle,48,23,25,3,0.6757,148,"[12, 14, 15, 16, 17, 18, 19, 21, 22, 24, 27, 28, 29, 31, 32, 33, 34, 35, 36, 37, 39, 55, 60, 66, 67, 68, 70, 71, 72, 73, 74, 75, 76, 77, 79, 81, 95, 96, 99, 100, 102, 118, 121, 122, 137, 139, 140, 142]"
agent_c,L0,middle,47,22,25,2,0.6803,147,"[1, 3, 4, 7, 8, 9, 10, 12, 13, 14, 15, 16, 17, 18, 21, 38, 39, 40, 41, 45, 46, 47, 48, 49, 51, 53, 54, 55, 56, 57, 58, 60, 78, 79, 80, 81, 98, 101, 116, 117, 120, 121, 133, 137, 138, 139, 141]"
agent_c,L0,middle,50,25,25,5,0.6667,150,"[0, 3, 5, 6, 7, 9, 11, 14, 15, 17, 20, 35, 37, 38, 39, 40, 41, 43, 44, 45, 47, 49, 50, 51, 52, 53, 54, 55, 57, 58, 59, 62, 78, 79, 80, 96, 97, 98, 99, 101, 119, 120, 132, 133, 134, 136, 137, 138, 139, 142]"
agent_c,L0,middle,53,23,30,3,0.6536,153,"[11, 13, 14, 15, 16, 18, 21, 22, 23, 24, 25, 26, 27, 28, 30, 31, 32, 33, 35, 36, 37, 38, 39, 40, 42, 59, 60, 61, 62, 63, 72, 73, 74, 75, 76, 77, 78, 79, 80, 83, 84, 85, 86, 87, 106, 107, 126, 127, 129, 143, 145, 146, 150]"
agent_c,L0,middle,51,13,38,5,0.6623,151,"[1, 2, 3, 4, 5, 6, 8, 9, 14, 15, 16, 17, 20, 21, 36, 37, 38, 40, 41, 42, 43, 44, 45, 46, 50, 51, 52, 54, 55, 56, 57, 59, 60, 61, 80, 81, 83, 100, 101, 102, 103, 119, 120, 121, 122, 123, 124, 128, 143, 144, 147]"
agent_c,L0,middle,50,24,26,2,0.6667,150,"[11, 12, 13, 14, 16, 17, 18, 21, 22, 23, 24, 25, 26, 27, 28, 29, 30, 34, 36, 37, 38, 40, 42, 43, 44, 45, 63, 66, 75, 76, 79, 80, 81, 82, 83, 84, 87, 90, 106, 107, 108, 124, 126, 128, 129, 142, 143, 145, 146, 148]"
agent_c,L0,middle,43,15,28,4,0.6993,143,"[13, 17, 19, 20, 21, 22, 23, 24, 26, 27, 28, 29, 30, 31, 32, 38, 40, 42, 57, 58, 59, 60, 61, 62, 63, 72, 73, 77, 79, 80, 81, 82, 84, 98, 99, 101, 103, 107, 125, 128, 137, 140, 141]"
agent_c,L0,middle,43,22,21,3,0.6993,143,"[11, 12, 13, 14, 15, 16, 17, 18, 20, 21, 23, 25, 26, 28, 31, 32, 34, 35, 38, 39, 56, 57, 59, 60, 67, 68, 69, 70, 74, 77, 79, 80, 94, 98, 99, 100, 101, 118, 119, 120, 123, 136, 139]"
agent_c,L0,middle,44,17,27,4,0.6944,144,"[0, 2, 3, 5, 7, 8, 9, 10, 11, 13, 16, 17, 20, 21, 23, 39, 41, 42, 43, 45, 48, 50, 52, 53, 54, 56, 57, 61, 63, 65, 80, 81, 84, 87, 88, 104, 106, 107, 110, 125, 126, 127, 128, 130]"
agent_c,L0,middle,48,25,23,1,0.6757,148,"[12, 13, 14, 17, 18, 19, 20, 21, 22, 23, 24, 26, 27, 29, 30, 31, 32, 33, 35, 36, 39, 56, 57, 58, 59, 60, 69, 70, 71, 74, 75, 78, 80, 94, 95, 96, 97, 98, 99, 100, 116, 117, 118, 120, 121, 139, 140, 142]"
agent_c,L0,middle,48,25,23,6,0.6757,148,"[12, 13, 14, 15, 16, 22, 23, 25, 26, 29, 30, 32, 36, 37, 38, 39, 51, 53, 55, 58, 61, 62, 63, 69, 70, 71, 72, 74, 75, 76, 77, 78, 79, 80, 81, 82, 84, 99, 100, 101, 102, 105, 122, 123, 136, 140, 141, 143]"
agent_c,L0,middle,49,20,29,2,0.6711,149,"[11, 12, 13, 14, 15, 16, 17, 18, 19, 22, 23, 26, 28, 29, 31, 32, 33, 36, 37, 38, 39, 40, 57, 60, 66, 67, 69, 71, 72, 73, 75, 77, 78, 80, 93, 95, 97, 98, 100, 118, 120, 121, 134, 135, 138, 139, 140, 141, 145]"
agent_c,L0,middle,45,20,25,2,0.6897,145,"[3, 4, 6, 7, 8, 9, 10, 11, 12, 13, 14, 17, 18, 19, 20, 37, 39, 40, 41, 45, 49, 50, 54, 57, 58, 59, 60, 74, 75, 76, 78, 79, 80, 81, 97, 101, 115, 117, 123, 136, 137, 140, 141, 142, 143]"
agent_c,L0,middle,51,17,34,7,0.6623,151,"[12, 14, 15, 17, 19, 20, 23, 24, 26, 27, 28, 29, 30, 33, 34, 36, 37, 39, 40, 41, 46, 59, 60, 62, 63, 71, 73, 75, 78, 80, 81, 82, 83, 84, 85, 86, 88, 103, 104, 105, 106, 109, 125, 126, 127, 140, 143, 144, 145, 146, 147]"
agent_c,L0,middle,50,23,27,3,0.6667,150,"[12, 13, 14, 15, 16, 17, 20, 21, 22, 24, 25, 26, 27, 28, 29, 30, 32, 33, 34, 36, 37, 39, 40, 57, 59, 61, 69, 71, 72, 73, 74, 75, 78, 80, 81, 98, 101, 103, 118, 121, 122, 123, 135, 136, 137, 138, 140, 141, 142, 143]"
agent_c,L0,middle,49,20,29,5,0.6711,149,"[0, 1, 2, 4, 5, 6, 9, 11, 12, 14, 18, 21, 35, 36, 37, 38, 39, 40, 43, 45, 47, 50, 51, 53, 54, 55, 56, 58, 63, 79, 80, 81, 82, 99, 102, 103, 105, 106, 119, 120, 122, 123, 127, 137, 139, 140, 141, 142, 147]"
agent_c,L0,middle,46,19,27,2,0.6849,146,"[11, 13, 14, 15, 17, 19, 20, 22, 23, 24, 25, 26, 30, 31, 32, 33, 36, 39, 40, 54, 55, 58, 59, 60, 68, 70, 71, 73, 74, 78, 79, 81, 94, 95, 96, 97, 98, 99, 100, 118, 120, 133, 134, 135, 137, 141]"
agent_c,L0,middle,50,35,15,4,0.6667,150,"[11, 12, 14, 16, 17, 18, 19, 22, 23, 26, 27, 28, 29, 30, 31, 33, 35, 36, 40, 43, 57, 58, 59, 60, 61, 62, 63, 73, 74, 76, 78, 79, 82, 85, 99, 100, 101, 106, 122, 125, 126, 137, 138, 139, 140, 141, 143, 144, 145, 147]"
agent_c,L0,middle,52,18,34,1,0.6579,152,"[2, 3, 7, 9, 10, 11, 12, 14, 15, 16, 18, 19, 34, 35, 37, 38, 41, 43, 47, 48, 50, 51, 52, 56, 57, 58, 59, 60, 62, 79, 81, 96, 97, 98, 99, 101, 102, 116, 117, 120, 121, 122, 133, 134, 135, 136, 137, 138, 139, 140, 141, 142]"
agent_c,L0,middle,46,24,22,0,0.6849,146,"[0, 1, 2, 3, 4, 7, 8, 9, 10, 11, 12, 13, 18, 19, 35, 36, 37, 39, 40, 41, 44, 45, 46, 47, 48, 51, 52, 53, 54, 56, 57, 59, 60, 79, 80, 96, 97, 98, 99, 100, 120, 121, 133, 137, 140, 141]"
agent_c,L0,middle,48,26,22,2,0.6757,148,"[1, 2, 5, 7, 8, 9, 10, 11, 12, 13, 16, 17, 18, 20, 36, 37, 38, 41, 42, 44, 45, 46, 47, 48, 49, 51, 52, 53, 55, 56, 58, 59, 60, 61, 64, 81, 82, 83, 84, 103, 104, 105, 122, 125, 138, 139, 143, 145]"
agent_c,L0,middle,46,21,25,2,0.6849,146,"[11, 12, 13, 14, 15, 16, 17, 19, 22, 23, 26, 27, 28, 29, 30, 32, 33, 35, 36, 39, 40, 55, 56, 57, 58, 59, 60, 71, 72, 73, 74, 77, 79, 80, 94, 96, 97, 98, 100, 122, 133, 134, 135, 137, 138, 140]"
agent_c,L0,middle,49,17,32,4,0.6711,149,"[1, 2, 4, 6, 7, 9, 10, 12, 14, 16, 18, 20, 34, 36, 37, 38, 39, 42, 45, 46, 47, 48, 49, 50, 51, 52, 53, 55, 56, 57, 59, 60, 78, 79, 80, 82, 99, 101, 116, 117, 118, 119, 121, 133, 134, 136, 138, 140, 141]"
agent_c,L0,middle,51,23,28,2,0.6623,151,"[13, 17, 19, 20, 21, 22, 26, 27, 29, 33, 35, 38, 40, 51, 53, 54, 55, 56, 58, 59, 63, 64, 68, 69, 70, 71, 72, 73, 74, 76, 77, 78, 80, 94, 95, 97, 100, 116, 117, 118, 122, 134, 135, 136, 137, 139, 141, 142, 143, 144, 146]"
agent_c,L0,middle,46,25,21,7,0.6849,146,"[11, 12, 13, 14, 15, 16, 17, 20, 21, 22, 23, 24, 25, 26, 27, 29, 30, 32, 33, 34, 35, 38, 39, 57, 58, 59, 65, 66, 68, 74, 75, 76, 77, 81, 95, 96, 97, 98, 99, 101, 117, 121, 135, 137, 138, 142]"
agent_c,L0,middle,48,24,24,3,0.6757,148,"[12, 13, 14, 15, 16, 19, 21, 22, 23, 27, 28, 30, 32, 33, 34, 35, 37, 38, 40, 54, 55, 58, 59, 60, 67, 68, 69, 71, 73, 74, 76, 81, 95, 96, 97, 98, 99, 100, 102, 103, 120, 121, 122, 125, 139, 140, 142, 143]"
agent_c,L0,middle,46,24,22,1,0.6849,146,"[12, 14, 15, 17, 18, 19, 21, 23, 24, 26, 28, 30, 32, 33, 34, 35, 36, 42, 55, 56, 58, 59, 62, 69, 70, 71, 73, 76, 77, 78, 79, 81, 82, 84, 99, 101, 102, 103, 118, 119, 120, 123, 135, 137, 138, 143]"
agent_c,L0,middle,52,35,17,3,0.6579,152,"[1, 4, 5, 7, 9, 10, 12, 13, 16, 18, 23, 39, 40, 41, 42, 43, 44, 46, 47, 48, 49, 50, 51, 52, 54, 56, 57, 58, 59, 60, 61, 62, 64, 80, 82, 83, 101, 102, 103, 104, 120, 121, 122, 123, 124, 136, 137, 139, 141, 142, 144, 145]"
agent_c,L0,middle,52,37,15,7,0.6579,152,"[12, 14, 15, 16, 19, 22, 23, 24, 27, 28, 29, 31, 33, 34, 36, 39, 40, 41, 54, 55, 56, 58, 59, 60, 62, 68, 70, 71, 72, 73, 74, 75, 77, 79, 83, 97, 98, 99, 100, 101, 103, 121, 122, 123, 136, 137, 138, 139, 140, 141, 142, 146]"
agent_c,L0,middle,51,33,18,1,0.6623,151,"[4, 5, 6, 7, 8, 9, 10, 11, 13, 14, 15, 16, 17, 19, 35, 36, 37, 40, 41, 42, 43, 45, 50, 53, 55, 56, 57, 59, 61, 62, 76, 77, 78, 81, 82, 100, 101, 103, 118, 119, 121, 122, 133, 134, 135, 136, 137, 139, 141, 142, 143]"
agent_c,L0,middle,48,10,38,1,0.6757,148,"[11, 12, 13, 15, 18, 19, 20, 21, 22, 24, 28, 33, 35, 36, 37, 39, 41, 55, 56, 57, 61, 67, 68, 69, 70, 71, 72, 73, 74, 75, 77, 78, 79, 80, 82, 97, 98, 100, 101, 103, 119, 121, 122, 136, 137, 140, 141, 142]"
agent_c,L0,middle,47,26,21,4,0.6803,147,"[0, 1, 3, 4, 7, 9, 11, 12, 13, 15, 16, 18, 21, 37, 38, 39, 40, 41, 43, 47, 49, 50, 52, 53, 54, 55, 56, 58, 59, 75, 76, 77, 78, 81, 99, 113, 117, 118, 120, 130, 131, 132, 134, 135, 136, 137, 140]"
agent_c,L0,middle,52,27,25,1,0.6579,152,"[0, 1, 3, 4, 6, 7, 8, 11, 12, 13, 14, 16, 17, 18, 20, 37, 38, 39, 40, 41, 43, 44, 45, 46, 49, 50, 52, 53, 54, 56, 58, 59, 60, 61, 81, 82, 99, 100, 101, 103, 105, 121, 122, 123, 124, 136, 137, 138, 140, 141, 142, 144]"
agent_c,L0,middle,50,31,19,2,0.6667,150,"[0, 2, 3, 4, 5, 7, 8, 10, 11, 13, 15, 16, 17, 19, 35, 36, 37, 38, 39, 41, 43, 44, 45, 47, 50, 52, 55, 56, 59, 62, 76, 77, 79, 81, 82, 99, 100, 102, 117, 118, 120, 121, 122, 123, 135, 137, 139, 140, 141, 144]"
agent_c,L0,middle,51,24,27,4,0.6623,151,"[0, 1, 2, 3, 5, 6, 7, 8, 9, 10, 11, 12, 13, 14, 16, 17, 19, 20, 21, 40, 41, 44, 45, 46, 47, 48, 49, 50, 51, 52, 54, 56, 57, 59, 60, 61, 82, 99, 103, 118, 120, 121, 122, 123, 126, 139, 140, 141, 142, 143, 145]"
agent_c,L0,middle,52,19,33,2,0.6579,152,"[11, 13, 14, 15, 16, 17, 18, 19, 24, 26, 28, 29, 30, 31, 32, 33, 34, 35, 36, 37, 38, 39, 58, 59, 66, 68, 69, 71, 73, 74, 75, 76, 79, 94, 95, 97, 98, 100, 115, 117, 118, 120, 133, 134, 135, 136, 137, 138, 139, 148, 149, 150]"
agent_c,L0,middle,49,18,31,4,0.6711,149,"[13, 14, 15, 17, 18, 19, 20, 21, 22, 23, 27, 28, 29, 30, 32, 34, 35, 36, 37, 38, 39, 40, 41, 57, 58, 59, 61, 69, 70, 73, 74, 75, 76, 78, 80, 82, 97, 99, 100, 101, 102, 105, 122, 123, 138, 139, 141, 143, 145]"
agent_c,L0,middle,47,17,30,4,0.6803,147,"[12, 13, 14, 16, 17, 18, 20, 21, 23, 24, 25, 26, 27, 28, 29, 30, 31, 32, 33, 34, 37, 38, 39, 56, 59, 64, 65, 67, 71, 73, 76, 77, 79, 92, 93, 94, 95, 96, 100, 116, 118, 121, 134, 136, 138, 139, 142]"
agent_c,L0,middle,52,25,27,5,0.6579,152,"[0, 1, 4, 5, 6, 7, 8, 10, 12, 13, 14, 15, 16, 18, 19, 24, 42, 43, 44, 45, 46, 48, 49, 50, 51, 52, 55, 56, 57, 58, 60, 61, 62, 79, 80, 81, 82, 83, 84, 102, 104, 105, 107, 124, 125, 126, 141, 143, 144, 145, 146, 148]"
agent_c,L0,middle,48,23,25,3,0.6757,148,"[1, 4, 5, 7, 13, 14, 18, 22, 34, 36, 37, 38, 39, 40, 42, 46, 47, 48, 49, 50, 51, 53, 54, 56, 59, 73, 74, 75, 77, 78, 79, 94, 95, 96, 97, 100, 101, 115, 116, 117, 118, 121, 134, 135, 136, 138, 139, 141]"
agent_c,L0,middle,50,30,20,2,0.6667,150,"[12, 14, 15, 16, 17, 18, 19, 20, 21, 22, 23, 24, 27, 28, 29, 30, 31, 33, 35, 36, 38, 40, 41, 57, 58, 60, 61, 70, 71, 73, 74, 75, 76, 78, 79, 80, 81, 98, 99, 100, 102, 118, 119, 121, 122, 136, 137, 140, 141, 143]"
agent_c,L0,middle,47,19,28,2,0.6803,147,"[1, 3, 4, 6, 7, 8, 9, 10, 12, 13, 14, 15, 17, 20, 36, 37, 38, 39, 40, 41, 42, 43, 45, 48, 49, 50, 51, 52, 53, 55, 56, 57, 59, 78, 79, 96, 100, 114, 115, 118, 119, 120, 132, 133, 136, 139, 141]"
agent_c,L0,middle,50,24,26,2,0.6667,150,"[12, 13, 14, 16, 17, 18, 19, 21, 22, 23, 24, 25, 26, 27, 30, 31, 32, 33, 35, 36, 38, 39, 40, 41, 58, 59, 61, 70, 73, 74, 75, 77, 78, 80, 81, 96, 97, 98, 100, 101, 117, 118, 119, 121, 135, 136, 137, 139, 141, 144]"
agent_c,L0,middle,46,19,27,6,0.6849,146,"[0, 5, 6, 8, 9, 11, 12, 13, 14, 15, 17, 19, 35, 36, 38, 39, 40, 41, 42, 43, 44, 47, 48, 49, 50, 51, 52, 55, 57, 59, 77, 79, 95, 96, 101, 114, 115, 116, 117, 120, 124, 135, 136, 137, 138, 142]"
agent_c,L0,middle,50,25,25,1,0.6667,150,"[11, 14, 16, 18, 19, 20, 21, 23, 27, 28, 30, 33, 34, 36, 37, 38, 39, 53, 55, 56, 57, 60, 61, 68, 69, 70, 71, 72, 73, 74, 75, 77, 78, 80, 81, 96, 99, 100, 101, 118, 121, 122, 134, 135, 137, 138, 141, 143, 144, 146]"
agent_c,L0,middle,52,29,23,3,0.6579,152,"[12, 14, 15, 17, 18, 21, 22, 23, 24, 25, 29, 31, 32, 33, 34, 35, 36, 37, 38, 39, 55, 57, 58, 60, 66, 71, 73, 75, 78, 79, 91, 92, 94, 95, 96, 97, 98, 99, 101, 102, 103, 122, 124, 125, 126, 139, 140, 143, 144, 145, 146, 147]"
agent_c,L0,middle,45,20,25,11,0.6897,145,"[13, 15, 16, 18, 21, 23, 25, 26, 27, 29, 30, 32, 34, 35, 38, 42, 54, 55, 56, 57, 60, 64, 65, 69, 70, 71, 74, 77, 79, 81, 94, 95, 97, 98, 104, 117, 118, 119, 123, 135, 137, 138, 139, 140, 141]"
agent_c,L0,middle,47,28,19,0,0.6803,147,"[1, 2, 4, 7, 8, 11, 14, 15, 16, 17, 18, 19, 34, 35, 36, 37, 38, 40, 43, 44, 45, 46, 48, 49, 52, 53, 54, 57, 58, 59, 60, 77, 81, 98, 99, 100, 101, 119, 120, 121, 133, 134, 136, 139, 141, 142, 143]"
agent_c,L0,middle,50,14,36,0,0.6667,150,"[11, 13, 15, 17, 18, 19, 21, 22, 24, 25, 28, 29, 31, 36, 37, 38, 39, 51, 52, 53, 54, 55, 57, 58, 59, 67, 69, 70, 71, 73, 74, 75, 77, 79, 93, 94, 95, 99, 116, 117, 118, 119, 120, 134, 136, 137, 138, 139, 140, 141]"
agent_c,L0,middle,51,25,26,6,0.6623,151,"[0, 1, 3, 4, 6, 7, 8, 9, 10, 14, 15, 19, 20, 25, 41, 42, 45, 48, 50, 51, 52, 53, 54, 58, 59, 60, 61, 64, 78, 79, 80, 81, 83, 84, 85, 102, 103, 104, 106, 120, 122, 126, 128, 138, 140, 141, 142, 143, 144, 145, 149]"
agent_c,L0,middle,48,23,25,5,0.6757,148,"[12, 14, 15, 16, 17, 18, 19, 21, 22, 23, 24, 25, 26, 27, 28, 29, 32, 33, 36, 38, 39, 43, 59, 60, 61, 62, 69, 70, 71, 73, 74, 76, 77, 78, 79, 80, 83, 99, 100, 102, 103, 120, 122, 125, 138, 139, 142, 143]"
agent_c,L0,middle,48,28,20,7,0.6757,148,"[3, 4, 7, 8, 9, 10, 11, 12, 13, 16, 19, 34, 36, 37, 38, 39, 42, 43, 44, 45, 46, 48, 49, 50, 52, 54, 55, 59, 61, 75, 76, 78, 79, 82, 100, 101, 115, 117, 118, 120, 121, 123, 135, 136, 137, 138, 139, 143]"
agent_c,L0,middle,48,24,24,3,0.6757,148,"[1, 3, 4, 6, 7, 8, 9, 10, 12, 13, 15, 16, 17, 18, 20, 39, 40, 41, 43, 44, 45, 47, 48, 49, 50, 51, 52, 53, 57, 58, 59, 60, 61, 62, 80, 82, 83, 84, 103, 105, 120, 121, 124, 137, 138, 141, 142, 145]"
agent_c,L0,middle,47,20,27,1,0.6803,147,"[12, 13, 14, 15, 16, 17, 19, 20, 21, 22, 25, 28, 29, 31, 32, 33, 34, 36, 37, 38, 39, 57, 58, 59, 67, 68, 70, 71, 72, 75, 76, 77, 78, 79, 93, 94, 95, 96, 97, 98, 99, 117, 120, 134, 135, 136, 139]"
agent_c,L0,middle,47,20,27,7,0.6803,147,"[12, 15, 18, 20, 21, 22, 24, 25, 27, 33, 34, 35, 38, 39, 49, 50, 51, 52, 53, 54, 56, 57, 59, 65, 66, 67, 68, 69, 70, 71, 73, 74, 75, 76, 77, 78, 82, 98, 99, 100, 116, 117, 118, 119, 124, 138, 140]"
agent_c,L0,middle,50,17,33,2,0.6667,150,"[11, 12, 15, 17, 19, 20, 21, 22, 24, 26, 27, 28, 30, 31, 33, 34, 35, 36, 37, 38, 39, 40, 41, 57, 58, 59, 60, 61, 70, 71, 72, 74, 76, 77, 78, 80, 81, 96, 97, 98, 99, 100, 102, 119, 120, 122, 138, 140, 141, 143]"
agent_c,L0,middle,52,17,35,4,0.6579,152,"[11, 12, 13, 14, 18, 20, 21, 22, 23, 24, 26, 29, 30, 31, 32, 33, 34, 35, 37, 40, 54, 55, 57, 58, 59, 61, 69, 71, 73, 75, 79, 80, 93, 94, 95, 96, 98, 99, 100, 102, 119, 120, 122, 123, 125, 138, 139, 141, 142, 143, 144, 147]"
agent_c,L0,middle,53,18,35,0,0.6536,153,"[0, 2, 4, 5, 8, 9, 13, 14, 15, 16, 17, 18, 20, 35, 36, 37, 38, 39, 40, 42, 43, 45, 47, 48, 50, 51, 52, 53, 55, 56, 57, 58, 60, 79, 80, 96, 97, 100, 101, 116, 117, 118, 119, 120, 121, 122, 136, 138, 139, 140, 141, 142, 143]"
agent_c,L0,middle,49,20,29,4,0.6711,149,"[11, 15, 16, 17, 18, 19, 20, 22, 25, 26, 27, 29, 30, 31, 32, 35, 37, 38, 39, 40, 54, 55, 56, 57, 58, 59, 61, 70, 71, 72, 74, 76, 77, 79, 80, 94, 95, 96, 97, 99, 100, 117, 118, 123, 136, 137, 138, 140, 142]"
agent_c,L0,middle,47,20,27,1,0.6803,147,"[1, 2, 4, 6, 8, 10, 11, 12, 14, 15, 18, 19, 35, 36, 37, 39, 40, 41, 43, 44, 45, 46, 47, 49, 51, 52, 53, 55, 56, 58, 59, 61, 78, 79, 80, 97, 98, 100, 101, 102, 123, 135, 136, 137, 139, 140, 144]"
agent_c,L0,middle,49,19,30,3,0.6711,149,"[11, 13, 14, 15, 16, 18, 19, 21, 22, 23, 27, 28, 30, 32, 33, 34, 35, 36, 37, 40, 54, 55, 56, 59, 60, 67, 68, 69, 72, 73, 74, 75, 78, 79, 82, 97, 98, 99, 100, 101, 117, 118, 120, 121, 135, 136, 137, 140, 142]"
agent_c,L50,middle,48,33,15,4,0.6757,148,"[10, 11, 12, 13, 15, 16, 19, 20, 21, 22, 23, 24, 27, 29, 31, 32, 33, 34, 35, 36, 38, 39, 55, 56, 57, 58, 59, 67, 69, 70, 71, 72, 73, 74, 75, 76, 77, 78, 81, 97, 98, 99, 101, 118, 121, 138, 139, 140]"
agent_c,L50,middle,56,20,36,2,0.641,156,"[0, 1, 2, 3, 6, 8, 11, 12, 13, 15, 16, 17, 18, 19, 37, 38, 39, 42, 44, 45, 46, 47, 48, 50, 51, 52, 54, 55, 56, 59, 61, 63, 64, 65, 81, 84, 85, 86, 105, 106, 122, 123, 124, 125, 126, 127, 140, 142, 143, 144, 145, 146, 147, 149, 150, 151]"
agent_c,L50,middle,49,27,22,2,0.6711,149,"[0, 1, 2, 3, 4, 5, 6, 7, 8, 10, 12, 14, 15, 16, 18, 19, 36, 37, 38, 39, 42, 44, 45, 46, 47, 49, 51, 53, 54, 55, 56, 57, 58, 59, 60, 80, 81, 96, 97, 99, 101, 102, 104, 122, 123, 125, 142, 144, 145]"
agent_c,L50,middle,52,27,25,0,0.6579,152,"[1, 4, 5, 6, 8, 10, 13, 14, 18, 19, 33, 34, 35, 37, 38, 39, 42, 43, 44, 45, 47, 48, 49, 51, 54, 55, 56, 57, 58, 59, 75, 76, 77, 78, 79, 80, 96, 97, 99, 100, 101, 102, 119, 120, 121, 123, 137, 139, 140, 141, 142, 143]"
agent_c,L50,middle,49,19,30,2,0.6711,149,"[1, 2, 3, 5, 7, 8, 11, 12, 13, 14, 15, 18, 20, 35, 37, 38, 39, 40, 42, 46, 47, 48, 49, 53, 54, 55, 57, 58, 59, 60, 76, 77, 78, 79, 82, 99, 100, 101, 102, 103, 121, 122, 123, 138, 139, 140, 141, 142, 143]"
agent_c,L50,middle,49,17,32,6,0.6711,149,"[10, 11, 12, 13, 14, 15, 17, 18, 22, 26, 27, 29, 31, 32, 34, 36, 37, 38, 39, 40, 54, 56, 57, 59, 60, 66, 67, 69, 71, 72, 73, 74, 75, 76, 77, 81, 96, 97, 98, 99, 101, 104, 120, 121, 122, 139, 140, 141, 142]"
agent_c,L50,middle,49,26,23,4,0.6711,149,"[0, 1, 2, 3, 4, 5, 7, 8, 10, 13, 16, 18, 20, 35, 36, 37, 38, 39, 41, 42, 43, 44, 46, 47, 48, 50, 51, 52, 53, 54, 56, 58, 59, 60, 79, 80, 96, 97, 98, 99, 103, 120, 133, 134, 136, 137, 140, 141, 142]"
agent_c,L50,middle,47,34,13,6,0.6803,147,"[10, 12, 13, 15, 17, 18, 19, 21, 24, 26, 27, 28, 32, 33, 34, 35, 36, 37, 41, 54, 56, 59, 60, 61, 67, 68, 70, 71, 72, 74, 75, 76, 77, 81, 94, 95, 96, 97, 98, 99, 100, 102, 119, 120, 122, 139, 143]"
agent_c,L50,middle,50,28,22,6,0.6667,150,"[1, 2, 3, 4, 5, 6, 7, 9, 10, 11, 13, 14, 15, 16, 17, 18, 20, 43, 45, 46, 47, 50, 51, 52, 55, 56, 57, 58, 59, 60, 76, 79, 80, 81, 82, 85, 100, 101, 103, 104, 120, 121, 122, 123, 124, 140, 142, 143, 144, 146]"
agent_c,L50,middle,54,32,22,1,0.6494,154,"[12, 13, 14, 15, 16, 17, 18, 19, 20, 21, 22, 24, 25, 27, 28, 33, 34, 37, 38, 39, 55, 57, 58, 59, 64, 65, 73, 74, 75, 76, 77, 80, 92, 93, 94, 95, 96, 97, 99, 100, 102, 104, 105, 122, 123, 125, 126, 141, 142, 143, 144, 145, 146, 147]"
agent_c,L50,middle,47,25,22,2,0.6803,147,"[0, 3, 4, 5, 6, 7, 8, 10, 13, 16, 17, 18, 19, 35, 37, 38, 39, 41, 42, 43, 44, 45, 46, 47, 54, 55, 58, 59, 62, 76, 78, 79, 80, 81, 84, 99, 101, 102, 119, 120, 121, 122, 123, 137, 138, 141, 143]"
agent_c,L50,middle,50,17,33,3,0.6667,150,"[10, 13, 14, 16, 17, 18, 20, 21, 22, 24, 25, 26, 27, 30, 32, 33, 34, 36, 37, 38, 39, 40, 42, 58, 59, 60, 61, 70, 71, 72, 73, 74, 75, 77, 78, 79, 80, 81, 83, 99, 101, 102, 119, 122, 138, 139, 141, 142, 143, 144]"
agent_c,L50,middle,48,26,22,5,0.6757,148,"[0, 2, 5, 6, 7, 8, 9, 13, 16, 18, 19, 21, 35, 38, 41, 43, 44, 46, 47, 48, 49, 50, 51, 52, 53, 55, 57, 58, 59, 61, 75, 76, 77, 79, 80, 95, 99, 102, 118, 119, 121, 123, 136, 137, 138, 139, 140, 143]"
agent_c,L50,middle,52,30,22,3,0.6579,152,"[2, 3, 5, 6, 8, 9, 11, 12, 13, 14, 15, 16, 17, 18, 20, 36, 37, 40, 41, 42, 44, 45, 46, 48, 49, 50, 51, 52, 53, 54, 55, 57, 58, 59, 61, 66, 83, 98, 99, 102, 103, 104, 105, 106, 124, 126, 140, 141, 143, 145, 146, 147]"
agent_c,L50,middle,49,26,23,2,0.6711,149,"[0, 1, 3, 5, 6, 8, 10, 12, 13, 17, 18, 19, 22, 25, 39, 40, 41, 43, 45, 47, 48, 50, 51, 52, 55, 56, 57, 60, 63, 65, 66, 68, 82, 83, 85, 86, 87, 103, 104, 106, 108, 110, 127, 128, 130, 143, 144, 146, 147]"
agent_c,L50,middle,47,17,30,2,0.6803,147,"[10, 12, 14, 15, 16, 19, 20, 21, 23, 26, 27, 29, 30, 31, 32, 33, 34, 35, 36, 38, 39, 54, 55, 56, 58, 59, 66, 67, 70, 72, 73, 74, 75, 77, 78, 80, 93, 95, 96, 97, 99, 115, 116, 118, 120, 138, 139]"
agent_c,L50,middle,51,22,29,5,0.6623,151,"[0, 2, 4, 5, 7, 8, 9, 10, 11, 13, 17, 18, 19, 20, 21, 37, 38, 39, 40, 41, 42, 45, 46, 47, 48, 49, 50, 51, 52, 53, 55, 56, 57, 59, 60, 61, 63, 64, 83, 85, 102, 103, 106, 123, 124, 127, 140, 142, 144, 145, 147]"
agent_c,L50,middle,52,25,27,0,0.6579,152,"[11, 12, 16, 18, 19, 21, 25, 26, 27, 30, 31, 32, 33, 35, 36, 37, 38, 39, 53, 54, 55, 56, 57, 59, 64, 65, 66, 67, 68, 69, 70, 71, 73, 74, 75, 76, 77, 79, 95, 96, 97, 98, 99, 100, 118, 119, 121, 122, 139, 140, 141, 142]"
agent_c,L50,middle,48,21,27,6,0.6757,148,"[1, 2, 4, 6, 7, 10, 12, 14, 16, 18, 19, 20, 34, 35, 37, 39, 40, 42, 45, 46, 47, 49, 50, 51, 52, 53, 55, 56, 57, 59, 60, 76, 78, 82, 96, 97, 98, 99, 101, 117, 118, 119, 120, 121, 123, 139, 142, 145]"
agent_c,L50,middle,51,34,17,3,0.6623,151,"[10, 12, 13, 14, 16, 17, 19, 20, 21, 23, 26, 27, 29, 31, 32, 34, 36, 37, 38, 39, 40, 42, 59, 60, 62, 69, 70, 71, 72, 73, 75, 76, 79, 81, 82, 83, 85, 101, 102, 103, 104, 120, 122, 124, 138, 139, 140, 141, 142, 144, 146]"
agent_c,L50,middle,49,15,34,4,0.6711,149,"[10, 11, 12, 13, 14, 15, 20, 21, 22, 23, 27, 28, 29, 30, 31, 34, 37, 40, 53, 54, 57, 60, 63, 69, 70, 71, 72, 75, 77, 78, 79, 80, 81, 95, 96, 98, 99, 100, 103, 118, 119, 120, 121, 137, 139, 140, 141, 142, 143]"
agent_c,L50,middle,46,17,29,1,0.6849,146,"[10, 11, 12, 13, 14, 15, 17, 18, 19, 20, 21, 23, 27, 28, 29, 30, 32, 33, 34, 35, 36, 39, 55, 56, 60, 66, 70, 71, 72, 73, 75, 76, 78, 80, 96, 97, 98, 99, 100, 117, 120, 135, 137, 138, 139, 140]"
agent_c,L50,middle,47,20,27,2,0.6803,147,"[10, 11, 14, 17, 18, 21, 22, 25, 27, 28, 29, 32, 33, 34, 36, 37, 39, 41, 42, 54, 55, 56, 57, 58, 60, 61, 63, 70, 71, 72, 76, 77, 79, 80, 81, 82, 96, 97, 98, 99, 100, 101, 102, 121, 122, 141, 142]"
agent_c,L50,middle,48,29,19,4,0.6757,148,"[10, 12, 13, 15, 16, 17, 19, 22, 25, 27, 28, 29, 30, 32, 34, 35, 37, 41, 55, 56, 57, 58, 59, 64, 65, 66, 69, 70, 72, 73, 75, 76, 77, 79, 82, 95, 96, 97, 99, 101, 119, 120, 121, 138, 139, 140, 142, 143]"
agent_c,L50,middle,46,16,30,3,0.6849,146,"[10, 11, 13, 15, 16, 17, 19, 20, 24, 25, 28, 29, 31, 34, 35, 37, 39, 40, 52, 53, 54, 56, 57, 58, 59, 60, 68, 71, 74, 75, 76, 78, 79, 80, 94, 95, 98, 100, 103, 118, 120, 123, 137, 139, 141, 143]"
agent_c,L50,middle,49,29,20,0,0.6711,149,"[10, 11, 13, 14, 15, 16, 17, 18, 19, 21, 22, 23, 24, 25, 26, 28, 29, 30, 31, 32, 33, 35, 36, 37, 39, 40, 58, 59, 60, 68, 69, 70, 72, 73, 74, 75, 76, 78, 79, 80, 96, 97, 98, 100, 118, 119, 120, 139, 141]"
agent_c,L50,middle,48,22,26,6,0.6757,148,"[10, 11, 12, 13, 14, 15, 16, 17, 20, 21, 22, 23, 26, 27, 29, 31, 32, 33, 35, 37, 38, 39, 40, 56, 57, 59, 61, 68, 72, 74, 76, 78, 80, 94, 95, 96, 97, 98, 101, 116, 118, 120, 123, 137, 138, 139, 140, 143]"
agent_c,L50,middle,49,34,15,3,0.6711,149,"[0, 1, 2, 3, 4, 7, 8, 9, 11, 12, 13, 15, 17, 18, 19, 36, 37, 38, 39, 40, 41, 43, 46, 48, 49, 50, 51, 53, 56, 59, 60, 62, 65, 81, 82, 83, 84, 101, 103, 104, 120, 121, 122, 125, 138, 139, 141, 143, 144]"
agent_c,L50,middle,49,20,29,2,0.6711,149,"[5, 7, 8, 9, 10, 11, 12, 13, 14, 15, 16, 18, 19, 34, 35, 36, 37, 38, 39, 40, 42, 46, 48, 49, 50, 51, 52, 53, 57, 58, 59, 62, 78, 81, 82, 83, 98, 99, 101, 102, 104, 121, 122, 123, 139, 140, 141, 142, 144]"
agent_c,L50,middle,49,15,34,2,0.6711,149,"[11, 13, 14, 16, 17, 19, 20, 21, 22, 23, 24, 25, 28, 29, 30, 32, 33, 35, 36, 37, 40, 55, 56, 57, 58, 59, 62, 69, 71, 72, 73, 74, 75, 76, 77, 78, 79, 81, 82, 99, 102, 118, 121, 122, 138, 139, 140, 141, 142]"
agent_c,L50,middle,51,26,25,3,0.6623,151,"[0, 1, 3, 4, 5, 7, 8, 12, 13, 15, 16, 18, 19, 34, 36, 37, 40, 41, 42, 43, 44, 45, 46, 48, 49, 51, 53, 54, 55, 57, 61, 76, 77, 78, 79, 93, 94, 95, 96, 97, 100, 118, 119, 120, 134, 135, 136, 137, 138, 139, 141]"
agent_c,L50,middle,48,17,31,3,0.6757,148,"[10, 12, 13, 15, 16, 18, 20, 21, 22, 23, 25, 27, 30, 31, 33, 34, 36, 37, 38, 39, 42, 56, 57, 58, 59, 60, 66, 68, 69, 70, 72, 73, 75, 76, 77, 79, 80, 81, 82, 98, 99, 100, 103, 121, 122, 140, 141, 142]"
agent_c,L50,middle,51,16,35,2,0.6623,151,"[12, 16, 17, 18, 20, 21, 24, 25, 27, 28, 29, 30, 31, 33, 35, 36, 37, 38, 39, 41, 54, 55, 56, 57, 59, 61, 68, 69, 70, 71, 72, 73, 74, 75, 76, 77, 78, 79, 80, 81, 82, 98, 99, 100, 101, 102, 121, 122, 125, 143, 144]"
agent_c,L50,middle,41,13,28,5,0.7092,141,"[2, 3, 4, 10, 11, 12, 13, 14, 15, 18, 19, 20, 21, 35, 36, 37, 38, 39, 40, 43, 46, 47, 49, 50, 53, 55, 56, 59, 61, 64, 78, 83, 85, 99, 100, 101, 102, 104, 107, 124, 127]"
agent_c,L50,middle,48,27,21,3,0.6757,148,"[12, 13, 15, 17, 18, 19, 20, 21, 23, 24, 26, 27, 28, 29, 30, 32, 34, 35, 36, 39, 53, 55, 56, 57, 59, 65, 66, 67, 71, 72, 74, 75, 77, 78, 79, 80, 81, 83, 98, 99, 100, 103, 105, 123, 125, 127, 141, 144]"
agent_c,L50,middle,49,22,27,3,0.6711,149,"[1, 2, 4, 6, 7, 8, 13, 15, 17, 18, 19, 33, 34, 35, 37, 39, 41, 42, 43, 44, 45, 46, 47, 48, 50, 51, 52, 53, 54, 55, 57, 58, 59, 76, 77, 78, 81, 83, 99, 100, 103, 104, 105, 123, 124, 125, 127, 142, 146]"
agent_c,L50,middle,49,23,26,3,0.6711,149,"[10, 11, 13, 14, 15, 16, 17, 20, 21, 22, 23, 24, 25, 27, 28, 29, 33, 36, 37, 38, 40, 56, 57, 58, 59, 65, 66, 67, 70, 71, 72, 73, 76, 77, 79, 92, 93, 94, 95, 96, 97, 98, 99, 118, 120, 136, 137, 138, 139]"
agent_c,L50,middle,51,22,29,4,0.6623,151,"[0, 2, 5, 6, 7, 8, 9, 10, 11, 14, 15, 17, 18, 20, 22, 38, 39, 40, 42, 43, 44, 46, 47, 48, 49, 52, 55, 56, 57, 58, 59, 60, 61, 63, 68, 84, 99, 100, 101, 102, 103, 104, 121, 122, 123, 124, 126, 141, 142, 143, 146]"
agent_c,L50,middle,49,22,27,2,0.6711,149,"[10, 11, 12, 13, 14, 15, 16, 17, 18, 19, 20, 21, 22, 23, 25, 26, 27, 28, 30, 31, 32, 33, 34, 35, 36, 38, 39, 40, 60, 69, 70, 71, 72, 73, 74, 75, 77, 79, 81, 96, 98, 99, 100, 117, 119, 121, 137, 140, 142]"
agent_c,L50,middle,48,25,23,4,0.6757,148,"[0, 1, 4, 5, 6, 9, 10, 11, 13, 15, 17, 18, 19, 35, 37, 38, 40, 41, 42, 43, 44, 45, 49, 50, 51, 52, 53, 54, 57, 58, 59, 60, 62, 78, 79, 81, 82, 97, 101, 102, 103, 121, 122, 125, 140, 141, 142, 144]"
agent_c,L50,middle,49,19,30,7,0.6711,149,"[0, 1, 4, 5, 6, 7, 9, 10, 11, 12, 14, 15, 16, 17, 18, 21, 38, 39, 41, 43, 44, 46, 47, 48, 50, 52, 54, 55, 56, 59, 60, 76, 78, 79, 81, 95, 99, 102, 118, 121, 134, 135, 136, 137, 138, 139, 140, 141, 143]"
agent_c,L50,middle,48,20,28,1,0.6757,148,"[11, 12, 13, 16, 18, 19, 21, 22, 23, 25, 27, 28, 29, 30, 31, 32, 33, 34, 35, 38, 39, 40, 41, 42, 59, 60, 61, 62, 71, 72, 75, 79, 80, 81, 82, 96, 98, 100, 101, 102, 103, 120, 121, 124, 139, 140, 142, 143]"
agent_c,L50,middle,44,28,16,15,0.6944,144,"[10, 12, 13, 15, 16, 17, 18, 20, 21, 22, 23, 24, 28, 30, 31, 32, 33, 34, 35, 36, 41, 55, 56, 57, 59, 60, 61, 69, 71, 73, 74, 75, 76, 80, 87, 100, 101, 115, 117, 118, 120, 124, 139, 140]"
agent_c,L50,middle,54,31,23,2,0.6494,154,"[0, 2, 3, 5, 7, 8, 9, 10, 11, 13, 15, 16, 17, 18, 19, 36, 37, 39, 40, 42, 45, 46, 48, 49, 52, 53, 54, 56, 57, 58, 59, 61, 78, 79, 81, 95, 96, 97, 98, 100, 101, 102, 119, 120, 121, 123, 137, 138, 139, 140, 141, 142, 143, 145]"
agent_c,L50,middle,49,26,23,1,0.6711,149,"[10, 12, 13, 14, 15, 16, 18, 19, 20, 22, 23, 25, 26, 29, 31, 32, 33, 34, 35, 36, 38, 39, 55, 57, 60, 66, 69, 70, 72, 73, 76, 78, 79, 92, 94, 95, 96, 97, 98, 99, 115, 117, 118, 119, 135, 136, 137, 138, 139]"
agent_c,L50,middle,53,24,29,0,0.6536,153,"[0, 1, 2, 3, 5, 6, 7, 10, 11, 12, 13, 14, 15, 16, 17, 18, 19, 20, 40, 41, 43, 46, 48, 49, 50, 52, 56, 57, 59, 60, 63, 78, 82, 84, 98, 99, 100, 101, 102, 103, 104, 125, 126, 127, 138, 140, 142, 144, 145, 146, 147, 149, 150]"
agent_c,L50,middle,49,28,21,0,0.6711,149,"[1, 2, 3, 7, 9, 11, 13, 14, 15, 16, 17, 18, 19, 34, 35, 36, 37, 39, 40, 41, 42, 43, 44, 45, 47, 48, 50, 52, 54, 57, 59, 60, 76, 77, 78, 79, 80, 95, 98, 99, 100, 117, 118, 119, 120, 135, 136, 139, 140]"
agent_c,L50,middle,49,33,16,1,0.6711,149,"[0, 1, 2, 3, 4, 6, 7, 8, 12, 13, 15, 16, 18, 19, 35, 36, 37, 38, 39, 40, 41, 44, 46, 47, 48, 50, 51, 52, 53, 55, 56, 57, 58, 60, 78, 79, 94, 95, 96, 97, 98, 99, 100, 119, 120, 121, 137, 139, 141]"
agent_c,L50,middle,49,15,34,8,0.6711,149,"[10, 11, 12, 13, 14, 15, 16, 17, 18, 19, 22, 23, 25, 27, 28, 29, 32, 34, 37, 38, 47, 59, 63, 66, 67, 68, 69, 70, 71, 72, 73, 74, 76, 77, 78, 79, 92, 93, 94, 95, 99, 115, 116, 117, 119, 135, 137, 138, 140]"
agent_c,L50,middle,46,30,16,2,0.6849,146,"[0, 1, 2, 3, 5, 6, 7, 8, 9, 10, 12, 14, 15, 16, 17, 20, 21, 38, 39, 42, 44, 45, 46, 47, 51, 52, 53, 55, 56, 58, 59, 61, 81, 96, 97, 99, 101, 119, 120, 121, 134, 137, 138, 139, 140, 142]"
agent_c,L50,middle,48,25,23,1,0.6757,148,"[1, 4, 5, 7, 8, 9, 10, 11, 12, 13, 14, 15, 17, 19, 35, 36, 37, 38, 40, 41, 42, 43, 46, 49, 50, 51, 52, 54, 56, 58, 59, 61, 77, 78, 79, 81, 96, 98, 100, 101, 118, 119, 120, 121, 122, 139, 140, 143]"
agent_c,L50,middle,47,32,15,1,0.6803,147,"[10, 12, 14, 15, 16, 17, 18, 19, 22, 28, 32, 34, 37, 40, 41, 51, 52, 53, 54, 55, 56, 58, 59, 60, 61, 62, 71, 72, 73, 75, 76, 77, 78, 80, 81, 82, 96, 98, 99, 100, 101, 102, 119, 120, 121, 122, 142]"
agent_c,L50,middle,49,14,35,2,0.6711,149,"[11, 12, 13, 14, 15, 16, 18, 21, 23, 24, 25, 26, 28, 29, 30, 34, 35, 36, 39, 53, 54, 55, 56, 57, 59, 65, 66, 69, 70, 71, 72, 74, 75, 76, 79, 92, 93, 94, 95, 98, 99, 117, 119, 134, 135, 136, 137, 138, 139]"
agent_c,L50,middle,49,18,31,2,0.6711,149,"[11, 12, 13, 14, 15, 16, 17, 19, 21, 22, 24, 25, 27, 28, 29, 31, 32, 33, 34, 36, 37, 38, 40, 41, 58, 59, 60, 64, 65, 66, 76, 77, 79, 80, 81, 82, 83, 84, 85, 87, 105, 106, 107, 125, 128, 143, 144, 145, 147]"
agent_c,L50,middle,47,20,27,2,0.6803,147,"[5, 7, 8, 9, 10, 11, 13, 16, 17, 18, 19, 20, 34, 35, 36, 37, 38, 39, 40, 41, 43, 45, 46, 47, 49, 50, 52, 54, 56, 59, 60, 62, 78, 79, 81, 95, 96, 97, 99, 100, 101, 120, 122, 137, 138, 139, 142]"
agent_c,L50,middle,50,26,24,2,0.6667,150,"[10, 11, 12, 13, 14, 18, 19, 20, 21, 22, 23, 24, 25, 26, 27, 28, 29, 30, 31, 33, 34, 36, 38, 39, 40, 58, 59, 60, 68, 69, 72, 73, 74, 75, 76, 77, 78, 79, 80, 81, 97, 98, 99, 101, 119, 121, 137, 138, 139, 143]"
agent_c,L50,middle,45,14,31,3,0.6897,145,"[11, 15, 16, 17, 18, 19, 20, 22, 23, 25, 27, 29, 31, 32, 33, 34, 35, 38, 39, 53, 54, 55, 56, 58, 61, 68, 71, 72, 73, 75, 76, 77, 79, 81, 96, 97, 98, 99, 100, 116, 117, 118, 121, 139, 140]"
agent_c,L50,middle,48,30,18,3,0.6757,148,"[0, 1, 2, 3, 4, 7, 10, 12, 13, 14, 16, 17, 18, 20, 36, 38, 40, 42, 43, 44, 45, 47, 48, 51, 52, 53, 54, 55, 59, 60, 61, 64, 79, 80, 82, 83, 98, 100, 102, 103, 120, 122, 125, 138, 140, 141, 142, 143]"
agent_c,L50,middle,46,21,25,4,0.6849,146,"[11, 12, 13, 14, 15, 18, 19, 21, 22, 23, 24, 26, 27, 28, 29, 31, 32, 33, 34, 35, 37, 41, 57, 58, 60, 66, 67, 68, 70, 71, 72, 73, 74, 76, 78, 79, 80, 98, 99, 101, 117, 118, 119, 121, 138, 140]"
agent_c,L50,middle,49,24,25,4,0.6711,149,"[10, 11, 15, 16, 17, 18, 19, 20, 22, 24, 25, 26, 27, 30, 32, 33, 36, 39, 42, 43, 45, 58, 59, 60, 61, 62, 63, 64, 65, 74, 76, 79, 83, 84, 85, 101, 102, 104, 106, 122, 123, 125, 139, 141, 142, 143, 144, 145, 147]"
agent_c,L50,middle,50,18,32,0,0.6667,150,"[1, 2, 6, 9, 11, 12, 13, 15, 18, 19, 32, 34, 35, 36, 37, 38, 39, 40, 42, 43, 45, 46, 47, 48, 49, 50, 51, 52, 54, 55, 56, 57, 58, 59, 77, 79, 94, 95, 96, 97, 98, 100, 118, 119, 120, 135, 136, 137, 138, 140]"
agent_c,L50,middle,44,26,18,3,0.6944,144,"[1, 2, 3, 4, 7, 8, 9, 10, 13, 14, 16, 17, 18, 19, 20, 21, 39, 42, 43, 44, 45, 46, 47, 48, 49, 51, 53, 54, 56, 57, 58, 59, 60, 62, 79, 80, 81, 83, 100, 105, 123, 137, 138, 139]"
agent_c,L50,middle,48,19,29,3,0.6757,148,"[11, 12, 17, 18, 19, 20, 23, 24, 25, 28, 29, 31, 32, 33, 35, 36, 38, 40, 41, 42, 44, 47, 60, 61, 62, 63, 65, 73, 75, 76, 79, 81, 84, 85, 87, 103, 104, 106, 121, 123, 125, 126, 140, 141, 142, 143, 144, 146]"
agent_c,L50,middle,44,21,23,5,0.6944,144,"[11, 12, 13, 14, 16, 19, 20, 21, 24, 25, 26, 27, 28, 30, 34, 35, 36, 37, 39, 53, 55, 56, 57, 58, 59, 65, 68, 69, 72, 73, 76, 77, 78, 80, 94, 95, 96, 103, 118, 119, 135, 136, 137, 139]"
agent_c,L50,middle,47,28,19,7,0.6803,147,"[10, 14, 15, 17, 18, 20, 21, 23, 24, 25, 26, 28, 29, 33, 35, 36, 37, 40, 52, 53, 55, 56, 58, 59, 63, 71, 73, 75, 76, 77, 79, 82, 93, 94, 95, 96, 97, 98, 100, 116, 117, 119, 120, 122, 139, 141, 142]"
agent_c,L50,middle,50,20,30,8,0.6667,150,"[0, 2, 3, 4, 6, 7, 9, 10, 13, 14, 16, 17, 18, 19, 35, 36, 37, 38, 39, 40, 41, 42, 44, 45, 48, 51, 52, 53, 54, 56, 57, 58, 59, 60, 64, 81, 96, 97, 99, 100, 102, 119, 120, 122, 124, 139, 141, 142, 143, 147]"
agent_c,L50,middle,50,30,20,2,0.6667,150,"[1, 2, 3, 6, 7, 8, 9, 10, 12, 13, 14, 15, 17, 18, 19, 20, 21, 38, 39, 40, 42, 44, 45, 46, 48, 49, 52, 53, 54, 55, 57, 60, 61, 81, 83, 97, 99, 101, 103, 104, 120, 121, 122, 123, 124, 139, 140, 141, 142, 145]"
agent_c,L50,middle,49,38,11,3,0.6711,149,"[0, 2, 3, 4, 6, 7, 8, 11, 13, 14, 15, 16, 17, 21, 36, 38, 40, 42, 43, 44, 45, 46, 47, 48, 49, 50, 52, 53, 55, 56, 58, 59, 76, 77, 79, 93, 97, 98, 99, 100, 101, 118, 119, 120, 121, 136, 139, 140, 141]"
agent_c,L50,middle,51,22,29,6,0.6623,151,"[10, 12, 15, 16, 17, 25, 26, 27, 28, 29, 30, 31, 32, 33, 34, 35, 39, 41, 42, 54, 55, 56, 57, 58, 59, 60, 61, 62, 63, 64, 73, 74, 75, 76, 77, 79, 81, 82, 83, 84, 100, 104, 120, 121, 122, 123, 125, 141, 142, 143, 144]"
agent_c,L50,middle,52,19,33,1,0.6579,152,"[10, 11, 12, 13, 15, 16, 17, 18, 19, 21, 22, 23, 27, 30, 31, 32, 33, 34, 35, 38, 39, 40, 55, 58, 59, 60, 66, 70, 72, 73, 75, 76, 79, 80, 94, 97, 98, 100, 101, 102, 103, 119, 123, 124, 125, 139, 140, 141, 142, 143, 144, 145]"
agent_c,L50,middle,54,27,27,1,0.6494,154,"[0, 1, 2, 5, 6, 7, 8, 9, 11, 12, 15, 16, 17, 18, 19, 39, 40, 41, 42, 44, 46, 47, 49, 50, 52, 53, 55, 56, 57, 58, 60, 61, 63, 64, 81, 82, 83, 85, 101, 102, 104, 105, 122, 124, 125, 126, 127, 129, 142, 143, 145, 146, 147, 148]"
agent_c,L50,middle,49,26,23,4,0.6711,149,"[10, 13, 15, 16, 17, 20, 21, 22, 23, 24, 25, 26, 28, 29, 30, 34, 37, 39, 53, 56, 59, 62, 67, 68, 70, 71, 74, 75, 76, 78, 79, 81, 82, 83, 84, 100, 101, 103, 104, 105, 106, 122, 126, 140, 141, 142, 143, 144, 147]"
agent_c,L50,middle,48,17,31,3,0.6757,148,"[1, 3, 4, 5, 6, 7, 8, 12, 13, 14, 15, 16, 18, 20, 36, 38, 39, 40, 42, 43, 45, 46, 49, 50, 51, 52, 53, 54, 55, 57, 60, 61, 77, 78, 79, 80, 82, 99, 100, 103, 122, 135, 136, 137, 138, 139, 141, 143]"
agent_c,L50,middle,41,17,24,8,0.7092,141,"[10, 13, 14, 16, 17, 18, 21, 25, 26, 27, 28, 29, 30, 31, 32, 35, 36, 37, 39, 40, 55, 56, 59, 60, 65, 72, 73, 74, 75, 76, 77, 79, 82, 97, 99, 101, 102, 104, 121, 122, 125]"
agent_c,L50,middle,47,17,30,6,0.6803,147,"[0, 1, 2, 3, 4, 5, 6, 9, 12, 14, 15, 16, 19, 20, 36, 37, 39, 40, 44, 45, 46, 47, 49, 50, 51, 52, 53, 55, 59, 60, 61, 77, 78, 79, 80, 81, 96, 98, 100, 102, 120, 121, 136, 137, 139, 140, 143]"
agent_c,L50,middle,49,26,23,11,0.6711,149,"[0, 3, 4, 6, 7, 8, 10, 11, 12, 14, 15, 16, 17, 18, 21, 37, 39, 40, 41, 42, 43, 46, 47, 48, 49, 50, 51, 52, 53, 54, 56, 59, 60, 64, 81, 82, 97, 98, 99, 100, 101, 103, 104, 122, 123, 127, 140, 143, 147]"
agent_c,L50,middle,46,30,16,3,0.6849,146,"[0, 1, 2, 4, 6, 9, 12, 14, 15, 16, 17, 19, 36, 37, 38, 40, 43, 45, 46, 47, 48, 49, 50, 52, 53, 54, 55, 56, 58, 61, 76, 77, 78, 79, 94, 95, 97, 98, 99, 119, 131, 132, 134, 136, 138, 139]"
agent_c,L50,middle,48,22,26,4,0.6757,148,"[10, 11, 15, 16, 17, 19, 20, 21, 23, 24, 25, 26, 27, 28, 29, 31, 32, 34, 36, 37, 38, 39, 55, 57, 58, 59, 60, 63, 71, 72, 73, 76, 77, 80, 81, 95, 96, 97, 98, 99, 100, 101, 103, 104, 123, 126, 142, 144]"
agent_c,L50,middle,51,22,29,5,0.6623,151,"[10, 11, 12, 13, 14, 15, 16, 17, 18, 21, 22, 23, 24, 27, 28, 29, 31, 32, 33, 34, 35, 37, 38, 41, 58, 59, 66, 68, 69, 70, 71, 72, 74, 75, 79, 80, 81, 82, 98, 99, 101, 102, 119, 122, 124, 139, 140, 141, 142, 143, 144]"
agent_c,L50,middle,49,13,36,3,0.6711,149,"[1, 2, 3, 6, 11, 14, 17, 20, 31, 32, 33, 34, 35, 36, 38, 40, 42, 43, 45, 46, 47, 49, 50, 53, 54, 55, 56, 58, 59, 60, 64, 78, 79, 82, 96, 97, 98, 99, 100, 101, 102, 119, 120, 122, 135, 138, 139, 140, 142]"
agent_c,L50,middle,51,27,24,4,0.6623,151,"[10, 11, 12, 13, 14, 15, 16, 17, 18, 20, 21, 22, 23, 24, 26, 27, 28, 29, 30, 31, 33, 34, 35, 36, 39, 57, 58, 59, 60, 68, 70, 71, 72, 73, 75, 76, 78, 79, 80, 82, 97, 98, 99, 101, 104, 122, 123, 124, 142, 143, 145]"
agent_c,L50,middle,53,24,29,1,0.6536,153,"[0, 4, 5, 6, 9, 10, 11, 14, 15, 16, 17, 18, 19, 34, 36, 37, 38, 39, 41, 42, 43, 45, 49, 50, 51, 52, 53, 55, 57, 58, 59, 60, 61, 62, 63, 64, 84, 100, 101, 103, 104, 121, 122, 123, 125, 139, 140, 141, 144, 145, 148, 149, 150]"
agent_c,L50,middle,48,27,21,3,0.6757,148,"[10, 11, 13, 15, 16, 17, 18, 19, 20, 21, 24, 25, 28, 29, 30, 31, 35, 36, 39, 53, 54, 55, 56, 57, 59, 60, 66, 67, 68, 70, 72, 73, 74, 76, 78, 80, 83, 97, 98, 100, 101, 102, 105, 123, 124, 139, 142, 144]"
agent_c,L50,middle,43,24,19,4,0.6993,143,"[2, 3, 4, 5, 6, 7, 8, 9, 11, 14, 15, 16, 17, 18, 19, 36, 37, 38, 39, 40, 41, 42, 43, 44, 45, 46, 49, 50, 51, 53, 54, 55, 61, 80, 97, 98, 99, 115, 116, 117, 120, 137, 139]"
agent_c,L50,middle,48,21,27,1,0.6757,148,"[10, 11, 12, 13, 14, 15, 19, 21, 22, 23, 24, 25, 26, 27, 30, 32, 33, 34, 36, 38, 41, 55, 56, 60, 65, 66, 67, 68, 71, 72, 73, 74, 75, 77, 78, 79, 80, 94, 95, 96, 97, 100, 101, 102, 120, 122, 140, 142]"
agent_c,L50,middle,51,33,18,2,0.6623,151,"[10, 11, 12, 13, 17, 18, 19, 20, 21, 22, 24, 26, 27, 28, 29, 31, 33, 34, 36, 37, 38, 39, 40, 56, 57, 58, 59, 60, 62, 65, 74, 75, 76, 78, 82, 83, 84, 85, 99, 101, 102, 103, 106, 124, 125, 126, 142, 143, 144, 145, 146]"
agent_c,L50,middle,47,29,18,10,0.6803,147,"[0, 2, 4, 5, 6, 7, 9, 11, 13, 14, 15, 16, 17, 23, 38, 39, 40, 42, 44, 46, 48, 49, 51, 52, 53, 54, 55, 56, 57, 58, 60, 61, 77, 78, 79, 82, 97, 98, 100, 101, 119, 121, 125, 138, 139, 141, 145]"
agent_c,L50,middle,51,20,31,3,0.6623,151,"[10, 12, 13, 14, 15, 16, 18, 19, 20, 21, 23, 25, 26, 27, 28, 30, 33, 34, 36, 37, 39, 54, 57, 58, 59, 67, 68, 69, 72, 73, 75, 76, 77, 80, 94, 96, 97, 98, 99, 114, 115, 116, 117, 118, 120, 136, 137, 138, 139, 140, 142]"
agent_c,L50,middle,49,22,27,2,0.6711,149,"[11, 12, 15, 18, 19, 20, 22, 23, 24, 25, 26, 27, 28, 32, 33, 34, 35, 36, 38, 40, 54, 55, 56, 58, 59, 65, 67, 68, 69, 70, 71, 72, 74, 75, 76, 77, 79, 81, 95, 96, 98, 99, 100, 118, 119, 120, 121, 139, 141]"
agent_c,L50,middle,44,19,25,4,0.6944,144,"[0, 1, 2, 6, 7, 8, 9, 10, 11, 14, 15, 17, 18, 19, 35, 36, 37, 38, 39, 40, 43, 44, 45, 46, 47, 48, 52, 53, 54, 55, 57, 58, 60, 79, 94, 95, 101, 119, 132, 133, 136, 137, 138, 140]"
agent_c,L50,middle,46,29,17,2,0.6849,146,"[0, 2, 3, 4, 7, 8, 10, 13, 14, 15, 19, 33, 35, 37, 38, 40, 41, 42, 45, 46, 47, 49, 50, 51, 52, 54, 55, 57, 59, 62, 77, 78, 80, 81, 95, 96, 97, 100, 101, 116, 117, 119, 122, 139, 140, 141]"
agent_c,L50,middle,51,25,26,2,0.6623,151,"[0, 3, 4, 5, 7, 8, 11, 12, 14, 16, 17, 21, 35, 38, 39, 40, 41, 42, 43, 44, 45, 47, 48, 49, 50, 52, 54, 55, 59, 60, 75, 76, 77, 80, 81, 82, 97, 98, 99, 101, 102, 118, 119, 120, 121, 122, 136, 137, 139, 140, 143]"
agent_c,L50,middle,45,24,21,3,0.6897,145,"[10, 11, 13, 14, 17, 18, 19, 20, 21, 22, 23, 24, 26, 27, 28, 30, 31, 32, 34, 35, 36, 37, 38, 39, 41, 59, 62, 64, 72, 73, 76, 77, 78, 79, 80, 81, 83, 87, 102, 105, 121, 125, 139, 140, 143]"
agent_c,L50,middle,50,12,38,5,0.6667,150,"[10, 11, 12, 13, 14, 16, 17, 18, 19, 20, 21, 22, 23, 24, 25, 27, 30, 31, 33, 34, 35, 36, 38, 39, 42, 59, 60, 65, 74, 76, 77, 78, 79, 80, 83, 96, 98, 100, 101, 102, 104, 120, 122, 123, 125, 139, 140, 143, 144, 145]"
agent_c,L50,middle,41,21,20,16,0.7092,141,"[0, 1, 2, 3, 4, 6, 8, 10, 11, 12, 13, 16, 18, 21, 38, 39, 40, 41, 43, 44, 46, 47, 49, 50, 52, 53, 55, 56, 58, 60, 61, 63, 78, 79, 81, 82, 91, 110, 126, 137, 138]"
agent_c,L50,middle,51,25,26,7,0.6623,151,"[0, 1, 2, 3, 4, 5, 6, 7, 8, 10, 12, 13, 14, 15, 16, 17, 18, 19, 20, 39, 41, 42, 43, 44, 45, 46, 47, 50, 51, 52, 53, 54, 55, 58, 59, 60, 62, 81, 82, 83, 86, 103, 104, 106, 128, 140, 141, 142, 143, 144, 145]"
agent_c,L50,middle,47,27,20,5,0.6803,147,"[0, 3, 4, 5, 6, 7, 8, 9, 11, 13, 15, 16, 17, 19, 35, 37, 38, 41, 42, 44, 46, 49, 50, 51, 52, 54, 56, 58, 61, 77, 78, 79, 92, 93, 95, 97, 98, 100, 102, 119, 121, 123, 137, 138, 140, 141, 142]"
agent_c,L50,middle,46,32,14,2,0.6849,146,"[0, 1, 2, 3, 4, 5, 6, 8, 9, 10, 12, 16, 17, 18, 19, 38, 39, 40, 42, 43, 44, 46, 47, 48, 49, 50, 51, 53, 55, 57, 58, 59, 61, 79, 80, 81, 96, 97, 99, 100, 102, 122, 136, 138, 139, 143]"
agent_c,L50,middle,51,21,30,1,0.6623,151,"[10, 11, 16, 17, 19, 20, 21, 22, 23, 26, 27, 28, 30, 31, 32, 33, 36, 37, 38, 39, 54, 56, 57, 58, 60, 66, 67, 69, 70, 71, 72, 73, 75, 76, 78, 79, 93, 94, 95, 98, 100, 116, 117, 118, 120, 121, 137, 138, 140, 141, 142]"
agent_c,L50,middle,49,36,13,1,0.6711,149,"[10, 13, 14, 15, 16, 18, 19, 20, 21, 22, 23, 24, 25, 26, 30, 32, 33, 34, 35, 36, 37, 38, 41, 42, 58, 60, 61, 62, 64, 73, 75, 77, 78, 81, 82, 83, 85, 101, 102, 103, 104, 120, 121, 122, 123, 125, 143, 144, 145]"
agent_c,L100,middle,50,33,17,2,0.6667,150,"[0, 1, 2, 4, 5, 6, 8, 9, 11, 12, 13, 15, 17, 20, 38, 39, 40, 41, 43, 44, 45, 46, 49, 50, 51, 52, 56, 57, 58, 62, 76, 79, 80, 82, 95, 96, 97, 98, 99, 100, 101, 104, 122, 124, 125, 127, 143, 144, 145, 147]"
agent_c,L100,middle,53,36,17,7,0.6536,153,"[10, 14, 15, 16, 17, 20, 21, 22, 24, 25, 26, 27, 28, 29, 30, 32, 34, 35, 36, 37, 38, 39, 40, 41, 57, 58, 59, 62, 73, 74, 75, 76, 77, 79, 80, 81, 85, 101, 102, 107, 123, 133, 134, 135, 136, 137, 138, 139, 140, 141, 143, 144, 145]"
agent_c,L100,middle,48,31,17,2,0.6757,148,"[10, 12, 14, 15, 16, 17, 18, 19, 20, 23, 24, 26, 28, 30, 31, 32, 33, 35, 36, 38, 39, 54, 56, 57, 58, 59, 64, 65, 68, 69, 70, 71, 72, 73, 74, 75, 76, 78, 83, 100, 101, 102, 103, 104, 121, 123, 124, 144]"
agent_c,L100,middle,49,23,26,5,0.6711,149,"[2, 5, 6, 7, 10, 12, 13, 16, 18, 19, 20, 34, 35, 37, 38, 40, 41, 42, 43, 44, 45, 48, 50, 51, 54, 56, 57, 58, 59, 61, 76, 77, 79, 82, 95, 97, 99, 100, 101, 102, 116, 117, 118, 119, 120, 121, 124, 142, 143]"
agent_c,L100,middle,50,29,21,2,0.6667,150,"[11, 13, 14, 16, 17, 18, 20, 23, 24, 26, 30, 31, 33, 34, 36, 39, 50, 51, 52, 53, 55, 56, 59, 60, 67, 68, 69, 70, 71, 74, 75, 78, 79, 83, 95, 96, 98, 99, 100, 102, 117, 118, 119, 120, 121, 122, 138, 139, 141, 142]"
agent_c,L100,middle,51,35,16,0,0.6623,151,"[0, 1, 2, 4, 5, 6, 7, 8, 10, 11, 13, 14, 16, 17, 19, 36, 37, 38, 39, 40, 41, 42, 43, 44, 45, 48, 49, 50, 52, 55, 56, 57, 58, 59, 76, 78, 79, 94, 95, 96, 97, 98, 99, 115, 116, 117, 118, 119, 120, 138, 140]"
agent_c,L100,middle,47,18,29,1,0.6803,147,"[11, 14, 16, 17, 18, 20, 21, 22, 23, 25, 27, 28, 30, 31, 37, 39, 50, 51, 52, 55, 57, 59, 60, 65, 66, 67, 68, 69, 71, 72, 73, 75, 76, 77, 78, 79, 80, 97, 98, 100, 116, 117, 120, 134, 135, 139, 141]"
agent_c,L100,middle,49,27,22,3,0.6711,149,"[10, 12, 14, 15, 17, 18, 19, 20, 21, 22, 23, 24, 28, 29, 31, 33, 34, 35, 36, 38, 39, 55, 56, 57, 58, 60, 67, 69, 70, 72, 73, 74, 76, 77, 78, 80, 95, 97, 98, 99, 116, 117, 119, 132, 133, 136, 137, 138, 140]"
agent_c,L100,middle,51,29,22,1,0.6623,151,"[0, 1, 2, 3, 4, 6, 7, 8, 9, 10, 11, 13, 14, 20, 36, 37, 39, 40, 42, 43, 44, 45, 47, 49, 50, 52, 59, 60, 61, 75, 76, 79, 80, 81, 94, 95, 97, 98, 99, 100, 102, 104, 120, 121, 122, 123, 124, 125, 143, 144, 146]"
agent_c,L100,middle,49,26,23,5,0.6711,149,"[0, 2, 3, 4, 7, 8, 10, 11, 13, 14, 15, 16, 17, 18, 19, 38, 39, 40, 45, 46, 47, 48, 49, 51, 53, 54, 55, 57, 58, 61, 62, 77, 78, 80, 81, 82, 83, 97, 99, 100, 103, 105, 121, 122, 125, 140, 141, 143, 144]"
agent_c,L100,middle,49,25,24,3,0.6711,149,"[0, 1, 3, 4, 5, 7, 8, 10, 12, 13, 16, 17, 18, 19, 20, 21, 39, 40, 41, 43, 44, 45, 47, 48, 49, 52, 53, 54, 56, 60, 63, 77, 80, 81, 95, 96, 97, 99, 101, 102, 117, 121, 122, 123, 139, 140, 141, 142, 144]"
agent_c,L100,middle,53,35,18,4,0.6536,153,"[0, 1, 2, 3, 5, 6, 8, 10, 12, 14, 15, 16, 17, 18, 19, 36, 37, 38, 39, 41, 42, 43, 47, 51, 52, 54, 55, 57, 59, 60, 61, 62, 77, 78, 79, 81, 83, 97, 98, 99, 100, 101, 102, 103, 121, 122, 125, 126, 142, 143, 145, 148, 151]"
agent_c,L100,middle,49,18,31,5,0.6711,149,"[1, 2, 3, 4, 5, 6, 7, 8, 9, 12, 13, 14, 15, 16, 17, 19, 37, 39, 40, 42, 43, 44, 45, 46, 47, 48, 49, 50, 51, 52, 53, 54, 56, 57, 58, 59, 78, 79, 80, 98, 99, 104, 119, 120, 123, 138, 140, 141, 143]"
agent_c,L100,middle,48,20,28,2,0.6757,148,"[11, 12, 14, 15, 16, 18, 19, 20, 21, 22, 23, 24, 26, 27, 28, 29, 30, 31, 32, 33, 34, 35, 36, 37, 38, 40, 59, 60, 67, 68, 69, 70, 73, 74, 75, 77, 79, 80, 97, 98, 99, 100, 102, 119, 120, 121, 123, 142]"
agent_c,L100,middle,47,24,23,7,0.6803,147,"[10, 12, 14, 15, 23, 25, 26, 27, 28, 30, 33, 35, 36, 39, 40, 41, 50, 52, 53, 54, 55, 59, 61, 62, 67, 68, 69, 71, 72, 73, 76, 77, 81, 85, 98, 100, 103, 118, 119, 120, 121, 122, 136, 137, 140, 141, 142]"
agent_c,L100,middle,50,27,23,1,0.6667,150,"[0, 1, 5, 7, 9, 10, 12, 13, 14, 20, 32, 33, 35, 36, 38, 39, 40, 46, 48, 49, 51, 52, 54, 55, 57, 59, 60, 74, 75, 77, 78, 79, 80, 93, 94, 96, 97, 99, 101, 115, 117, 118, 119, 121, 122, 137, 139, 140, 142, 143]"
agent_c,L100,middle,51,20,31,3,0.6623,151,"[0, 1, 2, 4, 7, 8, 9, 10, 11, 12, 13, 14, 15, 16, 18, 21, 38, 39, 41, 42, 43, 44, 46, 47, 49, 50, 52, 53, 54, 56, 57, 58, 59, 62, 64, 80, 81, 83, 85, 100, 102, 105, 121, 122, 123, 125, 126, 144, 145, 146, 147]"
agent_c,L100,middle,51,28,23,2,0.6623,151,"[0, 2, 3, 4, 6, 7, 8, 9, 10, 11, 12, 13, 14, 15, 18, 19, 20, 22, 40, 43, 44, 45, 46, 49, 50, 51, 52, 54, 55, 56, 57, 60, 62, 78, 80, 81, 83, 97, 98, 99, 100, 101, 102, 103, 120, 122, 123, 139, 141, 142, 143]"
agent_c,L100,middle,49,17,32,13,0.6711,149,"[0, 1, 2, 4, 7, 10, 13, 14, 15, 17, 18, 25, 41, 43, 44, 45, 46, 47, 48, 49, 50, 51, 52, 54, 55, 56, 57, 60, 75, 76, 77, 78, 80, 83, 97, 98, 99, 101, 105, 119, 123, 135, 136, 138, 140, 141, 142, 143, 145]"
agent_c,L100,middle,52,29,23,3,0.6579,152,"[0, 1, 3, 4, 5, 6, 8, 9, 10, 11, 15, 16, 17, 18, 19, 37, 38, 39, 40, 41, 42, 45, 47, 49, 50, 51, 53, 54, 55, 57, 59, 60, 75, 77, 79, 80, 95, 96, 97, 98, 99, 103, 119, 120, 121, 122, 138, 139, 140, 141, 142, 143]"
agent_c,L100,middle,50,30,20,4,0.6667,150,"[11, 12, 14, 15, 17, 18, 19, 22, 25, 27, 29, 33, 34, 35, 38, 39, 40, 41, 52, 55, 56, 57, 58, 59, 60, 62, 68, 69, 70, 71, 72, 73, 76, 77, 79, 80, 81, 99, 100, 101, 116, 117, 118, 119, 121, 122, 123, 125, 140, 144]"
agent_c,L100,middle,52,33,19,6,0.6579,152,"[0, 1, 2, 6, 8, 10, 11, 12, 14, 15, 20, 33, 34, 36, 37, 38, 39, 40, 43, 44, 45, 46, 48, 50, 52, 53, 57, 58, 59, 60, 74, 75, 76, 77, 78, 82, 96, 97, 98, 99, 100, 101, 118, 119, 120, 124, 139, 140, 141, 142, 143, 147]"
agent_c,L100,middle,50,26,24,5,0.6667,150,"[0, 1, 4, 5, 6, 7, 9, 11, 13, 15, 16, 17, 18, 21, 39, 41, 44, 45, 46, 47, 48, 50, 51, 52, 53, 55, 57, 60, 62, 75, 76, 77, 78, 79, 80, 83, 98, 99, 100, 102, 116, 117, 118, 119, 120, 123, 139, 140, 141, 142]"
agent_c,L100,middle,49,20,29,7,0.6711,149,"[0, 4, 5, 6, 7, 8, 11, 12, 13, 14, 15, 16, 17, 19, 37, 38, 41, 42, 43, 45, 47, 50, 51, 52, 53, 55, 57, 58, 59, 64, 77, 78, 79, 80, 81, 82, 96, 98, 99, 100, 102, 105, 121, 122, 123, 139, 140, 142, 143]"
agent_c,L100,middle,53,29,24,3,0.6536,153,"[11, 14, 15, 16, 17, 20, 21, 23, 27, 28, 29, 31, 32, 34, 36, 37, 38, 40, 41, 54, 56, 57, 58, 59, 60, 61, 69, 70, 72, 74, 76, 78, 81, 93, 94, 95, 96, 97, 98, 100, 101, 102, 103, 105, 124, 126, 140, 141, 142, 143, 144, 145, 147]"
agent_c,L100,middle,49,29,20,2,0.6711,149,"[13, 14, 15, 16, 17, 20, 21, 22, 23, 25, 26, 27, 29, 30, 32, 33, 34, 35, 36, 37, 39, 54, 55, 56, 59, 64, 67, 68, 69, 70, 71, 72, 73, 74, 75, 77, 78, 79, 94, 95, 96, 97, 99, 116, 118, 120, 135, 138, 139]"
agent_c,L100,middle,51,35,16,0,0.6623,151,"[11, 13, 15, 17, 20, 21, 23, 24, 28, 30, 31, 32, 33, 34, 35, 40, 41, 52, 54, 55, 56, 58, 60, 61, 67, 68, 69, 70, 71, 73, 74, 75, 76, 77, 78, 79, 80, 81, 97, 98, 99, 101, 102, 119, 120, 123, 127, 140, 142, 144, 147]"
agent_c,L100,middle,49,33,16,2,0.6711,149,"[0, 1, 2, 3, 4, 5, 6, 8, 9, 10, 12, 15, 16, 17, 18, 20, 37, 39, 41, 43, 44, 45, 46, 48, 50, 52, 53, 54, 56, 57, 58, 60, 75, 76, 80, 94, 95, 96, 97, 99, 100, 116, 118, 120, 136, 137, 139, 140, 142]"
agent_c,L100,middle,53,26,27,4,0.6536,153,"[10, 11, 13, 15, 18, 21, 24, 25, 27, 28, 29, 33, 34, 35, 37, 38, 39, 41, 52, 54, 55, 57, 58, 59, 60, 67, 68, 69, 70, 71, 72, 74, 75, 77, 79, 80, 95, 97, 98, 99, 101, 117, 118, 119, 120, 134, 135, 136, 137, 138, 139, 140, 141]"
agent_c,L100,middle,49,31,18,1,0.6711,149,"[11, 12, 13, 14, 15, 17, 19, 20, 21, 22, 23, 24, 25, 29, 30, 32, 33, 35, 36, 37, 38, 39, 55, 56, 58, 59, 67, 68, 70, 73, 74, 75, 76, 77, 81, 95, 98, 101, 118, 119, 121, 122, 123, 135, 136, 139, 141, 142, 144]"
agent_c,L100,middle,50,29,21,4,0.6667,150,"[10, 12, 13, 15, 18, 21, 23, 24, 25, 26, 27, 28, 29, 30, 31, 32, 33, 34, 36, 37, 39, 40, 41, 59, 60, 62, 68, 69, 70, 71, 72, 73, 74, 78, 80, 81, 97, 98, 99, 101, 116, 117, 118, 119, 120, 121, 135, 137, 138, 142]"
agent_c,L100,middle,47,32,15,2,0.6803,147,"[10, 12, 14, 15, 17, 18, 19, 20, 21, 22, 23, 24, 25, 26, 27, 29, 33, 34, 35, 36, 38, 39, 55, 58, 60, 66, 67, 69, 70, 72, 74, 75, 77, 78, 79, 96, 97, 99, 114, 116, 117, 120, 135, 137, 138, 140, 141]"
agent_c,L100,middle,48,32,16,4,0.6757,148,"[0, 1, 2, 3, 4, 8, 10, 11, 17, 18, 19, 33, 34, 35, 36, 40, 41, 42, 43, 44, 45, 46, 47, 48, 49, 54, 55, 57, 59, 61, 75, 77, 78, 79, 80, 94, 95, 96, 97, 99, 101, 117, 118, 119, 121, 137, 138, 142]"
agent_c,L100,middle,52,29,23,4,0.6579,152,"[11, 15, 16, 17, 19, 20, 21, 22, 25, 26, 27, 31, 32, 33, 34, 35, 38, 39, 41, 53, 55, 56, 57, 58, 59, 60, 67, 68, 69, 70, 73, 75, 77, 79, 81, 95, 96, 97, 98, 99, 103, 106, 122, 123, 124, 137, 138, 140, 141, 142, 143, 145]"
agent_c,L100,middle,48,21,27,6,0.6757,148,"[0, 1, 2, 3, 4, 6, 9, 10, 11, 12, 13, 16, 17, 18, 19, 37, 38, 40, 41, 43, 46, 47, 48, 49, 50, 51, 52, 54, 55, 56, 58, 62, 78, 79, 81, 97, 98, 99, 101, 115, 116, 117, 118, 120, 136, 137, 138, 140]"
agent_c,L100,middle,52,29,23,5,0.6579,152,"[0, 1, 2, 3, 4, 5, 6, 8, 9, 10, 15, 16, 18, 19, 35, 36, 37, 38, 39, 41, 42, 44, 46, 47, 49, 50, 51, 52, 53, 54, 57, 58, 59, 61, 78, 79, 80, 83, 100, 101, 102, 103, 104, 105, 122, 123, 124, 126, 142, 143, 144, 146]"
agent_c,L100,middle,49,17,32,1,0.6711,149,"[10, 11, 14, 15, 18, 19, 20, 22, 24, 26, 27, 28, 29, 31, 32, 33, 34, 39, 52, 53, 55, 56, 58, 59, 60, 66, 68, 70, 71, 72, 73, 74, 75, 76, 80, 94, 95, 96, 97, 98, 99, 100, 118, 120, 133, 134, 135, 136, 142]"
agent_c,L100,middle,48,20,28,0,0.6757,148,"[11, 12, 13, 16, 17, 19, 20, 24, 25, 27, 28, 29, 30, 31, 32, 34, 35, 37, 39, 52, 53, 56, 58, 59, 63, 64, 66, 67, 69, 71, 72, 73, 75, 76, 77, 78, 80, 81, 98, 100, 101, 117, 120, 121, 135, 136, 138, 141]"
agent_c,L100,middle,51,28,23,1,0.6623,151,"[0, 1, 3, 5, 6, 7, 8, 9, 10, 11, 15, 19, 36, 38, 39, 40, 41, 42, 43, 46, 47, 50, 51, 52, 54, 57, 59, 61, 62, 76, 78, 79, 80, 81, 82, 95, 96, 100, 101, 103, 117, 119, 120, 121, 122, 137, 138, 141, 142, 143, 144]"
agent_c,L100,middle,50,22,28,1,0.6667,150,"[0, 2, 3, 4, 5, 6, 8, 9, 10, 12, 17, 18, 19, 34, 36, 37, 38, 39, 41, 42, 43, 44, 45, 46, 47, 50, 51, 53, 54, 55, 56, 57, 58, 61, 78, 79, 80, 81, 99, 101, 102, 117, 118, 121, 122, 138, 139, 140, 141, 142]"
agent_c,L100,middle,46,30,16,2,0.6849,146,"[3, 5, 6, 7, 8, 9, 10, 11, 12, 13, 16, 17, 19, 34, 36, 39, 40, 43, 47, 49, 50, 51, 52, 54, 56, 57, 58, 59, 73, 74, 76, 77, 79, 93, 94, 95, 96, 98, 99, 116, 117, 118, 119, 134, 135, 141]"
agent_c,L100,middle,47,30,17,4,0.6803,147,"[0, 1, 2, 3, 5, 6, 7, 8, 9, 10, 11, 12, 13, 14, 15, 17, 18, 19, 37, 41, 42, 43, 45, 48, 49, 51, 52, 53, 54, 56, 57, 58, 61, 62, 78, 79, 80, 81, 82, 86, 105, 121, 126, 139, 140, 141, 144]"
agent_c,L100,middle,47,34,13,4,0.6803,147,"[10, 12, 14, 15, 16, 17, 18, 20, 21, 25, 26, 27, 28, 29, 32, 33, 34, 37, 39, 52, 53, 55, 56, 57, 59, 65, 66, 67, 68, 69, 70, 71, 73, 74, 75, 76, 77, 78, 81, 99, 116, 118, 120, 134, 135, 138, 139]"
agent_c,L100,middle,48,17,31,3,0.6757,148,"[10, 11, 12, 14, 15, 16, 17, 18, 19, 20, 21, 22, 24, 25, 26, 27, 30, 32, 33, 35, 39, 40, 41, 57, 58, 59, 61, 68, 69, 70, 71, 72, 73, 75, 76, 78, 80, 81, 97, 98, 100, 102, 120, 121, 122, 138, 141, 144]"
agent_c,L100,middle,49,22,27,2,0.6711,149,"[10, 11, 12, 13, 17, 18, 19, 22, 23, 25, 26, 27, 29, 31, 33, 38, 39, 40, 52, 53, 54, 55, 56, 57, 59, 60, 68, 70, 71, 74, 75, 76, 77, 80, 94, 95, 96, 97, 98, 100, 116, 117, 118, 120, 135, 136, 137, 139, 143]"
agent_c,L100,middle,46,26,20,8,0.6849,146,"[10, 12, 13, 15, 16, 17, 18, 19, 20, 21, 23, 24, 25, 27, 32, 33, 34, 35, 36, 38, 39, 41, 59, 60, 62, 67, 70, 71, 72, 74, 75, 76, 77, 78, 80, 82, 97, 98, 100, 104, 120, 126, 137, 138, 142, 143]"
agent_c,L100,middle,53,22,31,2,0.6536,153,"[0, 3, 5, 6, 7, 10, 12, 13, 14, 15, 18, 19, 20, 36, 37, 38, 40, 41, 42, 44, 45, 50, 53, 54, 56, 57, 59, 60, 61, 62, 64, 77, 78, 79, 81, 83, 84, 98, 100, 101, 102, 103, 104, 105, 107, 125, 126, 141, 142, 143, 144, 145, 146]"
agent_c,L100,middle,53,25,28,1,0.6536,153,"[0, 1, 2, 3, 4, 5, 6, 7, 8, 9, 11, 12, 15, 16, 18, 19, 37, 39, 40, 41, 42, 43, 45, 46, 47, 48, 50, 52, 53, 54, 55, 56, 58, 59, 61, 62, 64, 66, 84, 85, 86, 102, 104, 105, 106, 126, 128, 142, 143, 144, 145, 146, 147]"
agent_c,L100,middle,55,33,22,0,0.6452,155,"[10, 11, 13, 14, 15, 18, 19, 20, 21, 22, 23, 24, 26, 30, 32, 33, 34, 35, 36, 39, 40, 41, 42, 43, 44, 61, 62, 63, 64, 65, 66, 67, 69, 81, 82, 84, 86, 89, 103, 104, 105, 106, 107, 108, 110, 130, 145, 146, 147, 148, 149, 150, 151, 152, 153]"
agent_c,L100,middle,50,28,22,6,0.6667,150,"[10, 11, 13, 16, 17, 18, 19, 20, 21, 22, 23, 24, 26, 28, 30, 31, 33, 34, 35, 36, 37, 39, 41, 44, 59, 60, 61, 62, 70, 72, 73, 74, 75, 77, 78, 81, 82, 97, 101, 102, 104, 122, 125, 136, 137, 138, 139, 140, 143, 146]"
agent_c,L100,middle,52,28,24,0,0.6579,152,"[10, 11, 15, 16, 17, 19, 20, 21, 23, 24, 26, 27, 28, 29, 31, 32, 34, 35, 36, 37, 38, 39, 40, 56, 57, 58, 59, 60, 61, 70, 72, 73, 75, 76, 77, 78, 80, 81, 82, 99, 100, 101, 102, 119, 121, 122, 137, 138, 139, 140, 142, 143]"
agent_c,L100,middle,48,17,31,5,0.6757,148,"[0, 1, 2, 5, 6, 8, 9, 10, 11, 12, 13, 14, 15, 16, 17, 18, 19, 20, 21, 25, 43, 46, 47, 48, 49, 50, 52, 53, 54, 55, 56, 58, 61, 62, 80, 81, 82, 83, 98, 100, 101, 104, 119, 120, 123, 124, 142, 144]"
agent_c,L100,middle,52,28,24,3,0.6579,152,"[10, 11, 13, 14, 15, 16, 17, 18, 21, 22, 23, 26, 28, 31, 33, 34, 35, 36, 39, 52, 53, 55, 56, 57, 58, 61, 69, 70, 72, 73, 74, 75, 76, 77, 78, 80, 96, 97, 98, 99, 100, 117, 118, 120, 133, 134, 135, 136, 138, 139, 140, 141]"
agent_c,L100,middle,48,33,15,12,0.6757,148,"[11, 12, 13, 15, 17, 18, 21, 22, 23, 24, 29, 32, 33, 34, 35, 36, 37, 38, 39, 43, 57, 59, 60, 61, 66, 69, 70, 71, 72, 73, 74, 76, 80, 81, 86, 99, 100, 101, 102, 105, 120, 122, 124, 127, 140, 142, 143, 145]"
agent_c,L100,middle,50,39,11,3,0.6667,150,"[0, 1, 2, 3, 4, 5, 7, 9, 11, 13, 14, 15, 17, 18, 19, 36, 37, 38, 39, 40, 41, 42, 44, 45, 46, 47, 49, 51, 52, 53, 59, 60, 61, 78, 80, 84, 100, 101, 102, 115, 119, 120, 121, 123, 137, 138, 139, 140, 141, 142]"
agent_c,L100,middle,52,41,11,0,0.6579,152,"[1, 2, 3, 4, 5, 6, 7, 9, 10, 13, 14, 16, 18, 19, 20, 37, 38, 40, 42, 43, 44, 45, 47, 48, 49, 50, 51, 52, 53, 56, 58, 59, 60, 61, 78, 80, 85, 100, 102, 103, 104, 107, 122, 123, 124, 126, 127, 143, 144, 145, 146, 147]"
agent_c,L100,middle,52,16,36,2,0.6579,152,"[2, 4, 7, 8, 9, 11, 12, 13, 14, 17, 18, 19, 33, 35, 36, 37, 40, 43, 44, 45, 46, 47, 49, 54, 56, 60, 61, 63, 75, 76, 77, 78, 80, 81, 82, 96, 98, 99, 100, 101, 103, 119, 120, 121, 122, 123, 139, 140, 142, 143, 144, 145]"
agent_c,L100,middle,49,21,28,4,0.6711,149,"[10, 12, 17, 19, 20, 22, 24, 25, 26, 27, 28, 29, 30, 31, 33, 34, 36, 42, 53, 54, 56, 57, 58, 59, 61, 67, 69, 70, 71, 72, 73, 74, 75, 76, 77, 81, 99, 100, 115, 116, 117, 118, 119, 120, 121, 137, 138, 139, 141]"
agent_c,L100,middle,50,26,24,7,0.6667,150,"[10, 11, 14, 15, 17, 18, 22, 23, 26, 27, 28, 29, 30, 31, 32, 34, 37, 39, 51, 52, 53, 54, 58, 59, 60, 66, 67, 69, 71, 72, 73, 74, 75, 76, 77, 78, 80, 82, 99, 100, 102, 120, 121, 124, 136, 137, 139, 140, 141, 143]"
agent_c,L100,middle,51,33,18,8,0.6623,151,"[10, 12, 14, 15, 16, 17, 18, 21, 23, 26, 29, 30, 31, 32, 34, 35, 36, 37, 41, 53, 55, 58, 66, 70, 72, 74, 75, 76, 77, 79, 80, 83, 86, 97, 98, 99, 100, 101, 106, 124, 125, 136, 137, 138, 140, 141, 142, 143, 144, 145, 146]"
agent_c,L100,middle,47,26,21,5,0.6803,147,"[1, 3, 4, 7, 8, 9, 13, 14, 18, 21, 32, 34, 36, 37, 38, 39, 41, 42, 44, 49, 50, 52, 53, 54, 55, 56, 57, 58, 59, 62, 79, 80, 93, 94, 95, 96, 97, 98, 100, 115, 117, 118, 119, 120, 135, 138, 140]"
agent_c,L100,middle,49,31,18,2,0.6711,149,"[0, 1, 4, 5, 6, 8, 9, 11, 13, 14, 15, 16, 19, 34, 35, 36, 39, 40, 42, 44, 45, 46, 47, 49, 50, 52, 53, 55, 56, 58, 59, 62, 77, 78, 79, 81, 82, 97, 98, 99, 100, 103, 118, 120, 121, 123, 139, 140, 142]"
agent_c,L100,middle,54,32,22,5,0.6494,154,"[10, 11, 14, 15, 17, 18, 19, 21, 22, 23, 25, 26, 27, 28, 29, 30, 37, 38, 42, 54, 56, 57, 58, 59, 60, 61, 68, 71, 73, 76, 77, 78, 79, 84, 99, 100, 101, 103, 104, 120, 121, 123, 124, 135, 136, 137, 138, 139, 140, 141, 142, 143, 144, 145]"
agent_c,L100,middle,50,12,38,0,0.6667,150,"[0, 1, 3, 4, 7, 8, 9, 13, 14, 15, 16, 17, 19, 35, 36, 38, 39, 40, 41, 42, 43, 47, 49, 52, 53, 54, 55, 56, 58, 59, 60, 62, 77, 78, 79, 81, 82, 99, 100, 102, 118, 120, 121, 122, 123, 124, 141, 142, 143, 144]"
agent_c,L100,middle,51,35,16,3,0.6623,151,"[10, 13, 14, 15, 16, 18, 19, 20, 22, 23, 24, 26, 27, 28, 29, 31, 32, 33, 34, 35, 36, 37, 38, 39, 40, 41, 42, 60, 61, 62, 63, 65, 67, 77, 78, 79, 81, 82, 85, 89, 105, 106, 109, 126, 128, 140, 142, 143, 145, 146, 148]"
agent_c,L100,middle,51,24,27,1,0.6623,151,"[11, 12, 13, 14, 15, 17, 18, 21, 23, 25, 26, 28, 30, 31, 32, 33, 35, 36, 40, 41, 54, 58, 59, 60, 61, 67, 68, 69, 71, 74, 75, 76, 77, 78, 80, 81, 82, 98, 99, 100, 101, 102, 122, 124, 137, 139, 140, 141, 143, 145, 146]"
agent_c,L100,middle,46,15,31,4,0.6849,146,"[10, 11, 12, 13, 14, 15, 16, 17, 19, 20, 21, 23, 24, 25, 28, 29, 31, 33, 35, 37, 38, 39, 55, 56, 58, 59, 67, 68, 69, 70, 72, 74, 75, 76, 77, 81, 98, 99, 115, 116, 118, 120, 135, 137, 139, 141]"
agent_c,L100,middle,52,31,21,4,0.6579,152,"[0, 2, 6, 7, 8, 9, 10, 13, 14, 15, 16, 17, 18, 19, 35, 36, 37, 40, 42, 43, 45, 46, 47, 48, 49, 52, 53, 54, 55, 56, 58, 60, 75, 76, 77, 78, 80, 94, 95, 96, 97, 98, 99, 116, 117, 119, 120, 121, 123, 141, 142, 143]"
agent_c,L100,middle,52,37,15,5,0.6579,152,"[12, 13, 14, 15, 16, 17, 18, 20, 21, 22, 23, 24, 25, 26, 27, 28, 29, 31, 34, 36, 38, 39, 40, 42, 46, 61, 63, 70, 71, 72, 73, 75, 76, 77, 79, 81, 82, 83, 84, 100, 101, 102, 103, 104, 121, 122, 123, 125, 140, 142, 143, 147]"
agent_c,L100,middle,51,32,19,1,0.6623,151,"[4, 5, 7, 8, 9, 10, 11, 12, 15, 16, 17, 19, 20, 21, 36, 37, 38, 39, 41, 42, 44, 45, 46, 47, 48, 49, 51, 52, 54, 55, 56, 57, 58, 60, 61, 62, 80, 81, 82, 99, 100, 102, 103, 119, 120, 122, 123, 124, 141, 143, 145]"
agent_c,L100,middle,50,18,32,2,0.6667,150,"[10, 11, 12, 14, 16, 17, 18, 19, 20, 23, 25, 26, 27, 30, 32, 33, 34, 35, 36, 37, 38, 39, 55, 56, 57, 58, 59, 65, 66, 67, 68, 69, 71, 72, 73, 74, 75, 76, 77, 78, 81, 98, 99, 118, 119, 133, 134, 135, 136, 139]"
agent_c,L100,middle,46,26,20,4,0.6849,146,"[10, 11, 12, 14, 15, 16, 17, 18, 19, 21, 22, 23, 24, 25, 26, 27, 28, 29, 30, 31, 34, 35, 36, 38, 39, 41, 59, 60, 61, 62, 71, 72, 73, 75, 76, 80, 81, 82, 99, 100, 103, 120, 121, 123, 136, 143]"
agent_c,L100,middle,50,24,26,2,0.6667,150,"[10, 12, 13, 15, 16, 17, 18, 19, 20, 23, 24, 25, 26, 27, 28, 29, 31, 32, 35, 36, 37, 39, 40, 41, 43, 59, 60, 62, 70, 73, 75, 76, 77, 78, 79, 81, 82, 97, 98, 101, 102, 119, 120, 123, 136, 137, 138, 140, 141, 142]"
agent_c,L100,middle,51,27,24,2,0.6623,151,"[2, 5, 6, 8, 9, 10, 12, 13, 14, 16, 17, 19, 21, 36, 37, 38, 39, 40, 42, 43, 44, 45, 46, 47, 49, 52, 53, 54, 56, 57, 59, 61, 62, 78, 80, 82, 96, 97, 98, 100, 101, 102, 103, 119, 121, 123, 124, 141, 142, 143, 145]"
agent_c,L100,middle,48,24,24,0,0.6757,148,"[0, 1, 2, 3, 4, 5, 6, 9, 11, 12, 14, 15, 17, 18, 20, 37, 38, 39, 40, 41, 43, 48, 49, 51, 52, 53, 56, 57, 58, 59, 60, 61, 76, 77, 79, 80, 81, 96, 97, 99, 100, 101, 121, 135, 136, 139, 140, 141]"
agent_c,L100,middle,50,20,30,2,0.6667,150,"[1, 2, 5, 6, 7, 8, 11, 12, 14, 15, 16, 17, 18, 19, 35, 36, 37, 40, 42, 43, 46, 47, 49, 51, 52, 54, 55, 57, 58, 59, 60, 61, 62, 78, 80, 81, 82, 97, 100, 101, 102, 117, 119, 120, 121, 122, 125, 141, 142, 143]"
agent_c,L100,middle,51,36,15,2,0.6623,151,"[12, 14, 19, 20, 21, 22, 23, 24, 27, 29, 30, 31, 32, 33, 35, 36, 39, 40, 42, 56, 57, 58, 60, 62, 67, 68, 69, 71, 72, 73, 74, 75, 78, 79, 80, 81, 97, 98, 99, 101, 103, 120, 122, 123, 136, 137, 138, 139, 141, 142, 143]"
agent_c,L100,middle,50,31,19,2,0.6667,150,"[0, 1, 2, 3, 4, 5, 6, 8, 9, 10, 11, 12, 16, 17, 18, 20, 37, 38, 42, 44, 45, 47, 48, 49, 50, 51, 53, 54, 55, 56, 57, 58, 59, 60, 77, 78, 79, 80, 94, 95, 96, 97, 99, 100, 117, 118, 119, 120, 139, 140]"
agent_c,L100,middle,51,22,29,4,0.6623,151,"[10, 11, 13, 16, 18, 19, 22, 24, 25, 26, 27, 28, 29, 30, 33, 35, 39, 41, 42, 44, 59, 63, 69, 70, 71, 72, 73, 74, 75, 76, 77, 78, 79, 82, 83, 102, 104, 118, 119, 121, 122, 123, 125, 127, 139, 140, 141, 142, 144, 145, 146]"
agent_c,L100,middle,48,21,27,5,0.6757,148,"[10, 13, 14, 16, 19, 22, 23, 24, 25, 26, 27, 28, 31, 32, 33, 34, 35, 36, 37, 39, 53, 54, 57, 58, 59, 64, 65, 66, 67, 68, 69, 70, 71, 73, 75, 76, 78, 79, 95, 96, 97, 98, 100, 118, 119, 123, 138, 141]"
agent_c,L100,middle,50,25,25,1,0.6667,150,"[0, 1, 2, 3, 8, 9, 11, 12, 13, 14, 15, 16, 17, 19, 35, 36, 38, 39, 40, 41, 42, 43, 44, 45, 46, 47, 48, 51, 54, 55, 56, 57, 58, 59, 60, 78, 79, 80, 81, 97, 101, 117, 119, 120, 122, 137, 138, 139, 140, 141]"
agent_c,L100,middle,50,22,28,3,0.6667,150,"[0, 1, 2, 4, 5, 6, 7, 9, 11, 13, 17, 18, 19, 21, 36, 37, 38, 39, 40, 41, 42, 43, 45, 46, 47, 48, 49, 50, 52, 53, 55, 57, 58, 59, 60, 61, 62, 80, 82, 99, 102, 117, 118, 120, 121, 122, 138, 140, 143, 146]"
agent_c,L100,middle,51,30,21,6,0.6623,151,"[10, 12, 13, 14, 15, 19, 20, 21, 23, 24, 26, 27, 28, 29, 31, 32, 33, 34, 35, 36, 37, 38, 39, 40, 57, 58, 59, 60, 62, 70, 71, 72, 73, 74, 75, 76, 77, 79, 81, 98, 99, 100, 101, 121, 122, 127, 139, 140, 141, 142, 144]"
agent_c,L100,middle,53,34,19,2,0.6536,153,"[0, 1, 2, 3, 4, 6, 7, 8, 9, 12, 15, 17, 19, 34, 36, 38, 39, 41, 43, 44, 45, 47, 48, 51, 52, 53, 54, 56, 57, 58, 59, 60, 61, 80, 81, 97, 98, 102, 104, 106, 121, 122, 123, 125, 138, 139, 140, 142, 144, 145, 146, 147, 148]"
agent_c,L100,middle,52,26,26,0,0.6579,152,"[10, 11, 15, 16, 17, 18, 19, 20, 23, 25, 26, 27, 30, 32, 33, 35, 36, 37, 38, 40, 41, 42, 57, 58, 59, 61, 62, 64, 71, 74, 76, 77, 79, 80, 82, 83, 84, 85, 102, 105, 122, 123, 124, 126, 137, 139, 140, 141, 142, 143, 144, 146]"
agent_c,L100,middle,51,24,27,5,0.6623,151,"[0, 1, 4, 5, 6, 7, 9, 10, 12, 15, 16, 18, 20, 36, 37, 38, 43, 44, 46, 47, 49, 50, 52, 53, 54, 55, 57, 58, 62, 75, 76, 77, 80, 81, 82, 95, 96, 97, 98, 100, 102, 117, 118, 119, 122, 123, 139, 140, 141, 142, 143]"
agent_c,L100,middle,50,21,29,2,0.6667,150,"[0, 2, 3, 4, 6, 7, 9, 10, 11, 12, 13, 15, 17, 18, 19, 38, 39, 40, 42, 43, 44, 45, 46, 47, 48, 49, 51, 52, 53, 54, 56, 57, 59, 60, 61, 78, 79, 80, 81, 97, 98, 99, 100, 101, 102, 121, 124, 141, 142, 144]"
agent_c,L100,middle,53,13,40,3,0.6536,153,"[10, 11, 12, 13, 14, 15, 16, 17, 18, 19, 20, 21, 22, 23, 27, 29, 30, 31, 32, 33, 35, 37, 39, 42, 58, 60, 67, 68, 69, 70, 71, 72, 73, 74, 76, 77, 78, 79, 80, 96, 98, 99, 101, 102, 103, 104, 124, 125, 126, 128, 143, 146, 147]"
agent_c,L100,middle,48,21,27,2,0.6757,148,"[0, 2, 3, 5, 6, 7, 9, 11, 14, 16, 17, 18, 21, 35, 36, 37, 38, 39, 40, 41, 43, 44, 46, 47, 48, 49, 51, 53, 54, 55, 58, 59, 75, 76, 78, 79, 98, 99, 100, 116, 117, 119, 120, 135, 136, 137, 138, 140]"
agent_c,L100,middle,49,31,18,4,0.6711,149,"[0, 3, 4, 5, 6, 10, 11, 12, 13, 15, 16, 17, 19, 34, 35, 36, 37, 39, 41, 42, 44, 45, 46, 48, 49, 50, 51, 52, 55, 56, 57, 60, 76, 78, 80, 82, 96, 97, 98, 99, 100, 102, 119, 122, 137, 138, 139, 140, 142]"
agent_c,L100,middle,51,28,23,2,0.6623,151,"[2, 4, 5, 7, 8, 9, 10, 11, 13, 15, 16, 19, 34, 36, 37, 38, 41, 43, 44, 45, 48, 49, 50, 51, 54, 56, 59, 72, 73, 74, 77, 78, 79, 94, 95, 97, 98, 99, 114, 115, 117, 118, 119, 120, 122, 137, 138, 139, 140, 143, 144]"
agent_c,L100,middle,48,21,27,10,0.6757,148,"[11, 12, 13, 15, 16, 17, 18, 21, 22, 23, 25, 27, 28, 29, 31, 34, 35, 36, 37, 39, 40, 54, 56, 57, 62, 67, 68, 69, 70, 73, 75, 76, 77, 78, 79, 83, 98, 99, 100, 104, 120, 121, 136, 137, 138, 139, 140, 142]"
agent_c,L100,middle,52,29,23,5,0.6579,152,"[0, 1, 2, 3, 4, 5, 6, 8, 9, 10, 14, 15, 19, 22, 37, 38, 39, 41, 44, 45, 47, 48, 50, 53, 54, 55, 57, 58, 59, 61, 62, 76, 77, 80, 81, 82, 96, 99, 100, 101, 103, 118, 119, 121, 122, 137, 138, 139, 140, 141, 142, 143]"
agent_c,L100,middle,47,26,21,0,0.6803,147,"[10, 11, 12, 13, 14, 17, 18, 19, 20, 21, 28, 29, 31, 32, 34, 35, 36, 39, 51, 52, 53, 54, 58, 61, 66, 67, 68, 71, 72, 73, 75, 76, 77, 79, 81, 96, 97, 99, 100, 101, 116, 118, 119, 120, 122, 140, 142]"
agent_c,L100,middle,53,41,12,5,0.6536,153,"[10, 11, 13, 14, 17, 18, 19, 20, 21, 22, 23, 24, 25, 26, 28, 30, 31, 33, 34, 35, 36, 38, 39, 55, 56, 57, 58, 59, 60, 61, 71, 73, 74, 75, 76, 79, 80, 81, 83, 99, 100, 104, 106, 123, 124, 125, 138, 140, 141, 142, 143, 144, 149]"
agent_c,L100,middle,48,21,27,2,0.6757,148,"[10, 13, 14, 16, 17, 18, 20, 21, 22, 23, 25, 26, 29, 30, 31, 32, 34, 36, 37, 39, 40, 41, 56, 57, 58, 60, 62, 69, 71, 72, 73, 74, 76, 78, 79, 81, 100, 101, 117, 118, 119, 121, 135, 136, 139, 140, 141, 142]"
agent_c,L100,middle,47,16,31,3,0.6803,147,"[10, 11, 12, 13, 14, 16, 18, 19, 20, 25, 26, 28, 30, 31, 33, 34, 36, 37, 41, 42, 43, 56, 57, 58, 59, 60, 61, 62, 63, 64, 65, 66, 76, 78, 82, 83, 86, 87, 103, 105, 107, 124, 127, 139, 141, 143, 145]"
agent_c,L100,middle,53,25,28,1,0.6536,153,"[0, 5, 6, 7, 8, 9, 11, 12, 13, 14, 15, 16, 19, 34, 35, 36, 38, 39, 41, 42, 43, 44, 45, 47, 49, 50, 51, 53, 54, 55, 56, 57, 58, 59, 60, 78, 79, 80, 81, 96, 98, 99, 100, 102, 103, 104, 122, 123, 124, 125, 143, 145, 146]"
agent_c,L100,middle,51,17,34,6,0.6623,151,"[1, 2, 5, 6, 7, 8, 9, 10, 11, 13, 14, 15, 16, 17, 21, 37, 39, 40, 44, 45, 47, 48, 49, 51, 53, 54, 56, 57, 58, 59, 73, 74, 76, 79, 80, 81, 83, 98, 100, 102, 103, 105, 107, 123, 124, 126, 140, 141, 142, 144, 148]"
agent_c,L100,middle,50,29,21,3,0.6667,150,"[10, 13, 14, 19, 20, 21, 23, 25, 26, 28, 30, 31, 34, 35, 36, 38, 40, 41, 52, 54, 55, 56, 59, 60, 61, 63, 69, 70, 72, 73, 74, 75, 77, 78, 79, 80, 81, 82, 85, 102, 104, 121, 122, 123, 125, 138, 141, 142, 143, 144]"
agent_c,L0,long,24,10,14,5,0.8065,124,"[27, 28, 31, 45, 46, 47, 48, 49, 51, 52, 54, 55, 56, 57, 59, 62, 89, 91, 112, 113, 114, 117, 119, 120]"
agent_c,L0,long,26,9,17,6,0.7937,126,"[28, 30, 44, 46, 47, 48, 50, 51, 52, 53, 56, 57, 58, 59, 83, 84, 85, 87, 92, 113, 114, 115, 116, 118, 119, 123]"
agent_c,L0,long,23,8,15,3,0.813,123,"[14, 23, 24, 28, 29, 50, 51, 52, 54, 55, 56, 57, 58, 59, 84, 87, 89, 111, 112, 114, 115, 116, 119]"
agent_c,L0,long,29,3,26,1,0.7752,129,"[27, 28, 29, 41, 42, 43, 44, 45, 46, 51, 52, 53, 55, 56, 57, 58, 59, 60, 86, 88, 90, 91, 92, 93, 95, 120, 121, 122, 124]"
agent_c,L0,long,26,17,9,0,0.7937,126,"[27, 28, 30, 45, 47, 48, 50, 51, 53, 54, 55, 56, 59, 62, 86, 87, 89, 90, 91, 92, 114, 115, 118, 119, 120, 124]"
agent_c,L0,long,22,7,15,2,0.8197,122,"[27, 31, 44, 47, 49, 54, 55, 57, 58, 59, 82, 83, 84, 87, 89, 109, 110, 112, 113, 114, 118, 119]"
agent_c,L0,long,28,11,17,1,0.7812,128,"[27, 28, 30, 45, 46, 47, 49, 50, 51, 53, 54, 55, 57, 58, 59, 60, 85, 87, 90, 91, 114, 115, 116, 117, 118, 120, 121, 122]"
agent_c,L0,long,26,7,19,0,0.7937,126,"[28, 29, 41, 42, 43, 44, 46, 47, 48, 50, 52, 53, 54, 55, 56, 57, 58, 59, 85, 86, 91, 115, 116, 118, 119, 121]"
agent_c,L0,long,25,16,9,2,0.8,125,"[14, 23, 27, 28, 30, 51, 52, 53, 55, 58, 59, 84, 85, 86, 87, 88, 90, 112, 114, 115, 116, 117, 118, 120, 121]"
agent_c,L0,long,19,1,18,1,0.8403,119,"[14, 23, 25, 26, 27, 28, 29, 30, 54, 56, 57, 58, 59, 60, 88, 90, 92, 116, 117]"
agent_c,L0,long,21,7,14,4,0.8264,121,"[15, 27, 31, 51, 52, 55, 56, 61, 83, 86, 88, 89, 90, 109, 110, 112, 114, 115, 116, 117, 119]"
agent_c,L0,long,23,10,13,1,0.813,123,"[29, 30, 45, 46, 50, 51, 52, 53, 54, 55, 56, 60, 83, 85, 87, 88, 89, 90, 113, 114, 116, 117, 121]"
agent_c,L0,long,15,6,9,0,0.8696,115,"[28, 29, 45, 46, 49, 50, 52, 53, 55, 58, 61, 87, 90, 92, 112]"
agent_c,L0,long,26,12,14,2,0.7937,126,"[27, 28, 29, 30, 31, 48, 49, 51, 52, 53, 55, 56, 58, 59, 60, 61, 85, 89, 90, 92, 114, 116, 118, 119, 120, 123]"
agent_c,L0,long,23,5,18,6,0.813,123,"[15, 24, 25, 26, 27, 28, 29, 34, 56, 58, 59, 62, 88, 89, 92, 93, 95, 115, 116, 117, 118, 119, 121]"
agent_c,L0,long,23,9,14,1,0.813,123,"[27, 28, 30, 31, 32, 33, 35, 53, 55, 59, 60, 61, 64, 65, 67, 92, 95, 96, 116, 117, 119, 120, 121]"
agent_c,L0,long,22,11,11,1,0.8197,122,"[14, 23, 25, 26, 28, 29, 30, 32, 54, 55, 57, 60, 61, 88, 89, 90, 92, 113, 114, 115, 117, 119]"
agent_c,L0,long,25,13,12,7,0.8,125,"[27, 30, 44, 45, 48, 49, 50, 52, 53, 54, 56, 57, 63, 87, 88, 91, 110, 111, 112, 115, 116, 117, 118, 119, 123]"
agent_c,L0,long,25,11,14,3,0.8,125,"[27, 28, 30, 46, 47, 48, 50, 51, 52, 53, 54, 55, 57, 59, 83, 85, 86, 87, 88, 90, 115, 116, 117, 119, 121]"
agent_c,L0,long,33,10,23,3,0.7519,133,"[28, 31, 44, 45, 46, 47, 49, 50, 51, 52, 53, 54, 55, 58, 60, 61, 63, 64, 90, 91, 94, 116, 117, 118, 119, 120, 122, 123, 124, 125, 127, 128, 131]"
agent_c,L0,long,24,6,18,3,0.8065,124,"[31, 43, 44, 46, 47, 48, 49, 54, 55, 56, 58, 60, 83, 84, 89, 91, 110, 112, 113, 114, 115, 117, 118, 120]"
agent_c,L0,long,25,9,16,2,0.8,125,"[27, 28, 30, 45, 46, 47, 48, 49, 50, 55, 57, 58, 59, 61, 84, 86, 87, 88, 90, 115, 116, 117, 118, 119, 120]"
agent_c,L0,long,24,7,17,2,0.8065,124,"[14, 24, 27, 29, 31, 52, 54, 55, 56, 59, 60, 61, 86, 87, 88, 90, 91, 94, 115, 116, 118, 119, 120, 122]"
agent_c,L0,long,29,14,15,4,0.7752,129,"[27, 31, 44, 45, 46, 49, 51, 52, 53, 54, 55, 56, 57, 58, 59, 85, 86, 87, 88, 89, 111, 112, 114, 115, 116, 119, 120, 121, 124]"
agent_c,L0,long,21,6,15,0,0.8264,121,"[14, 23, 24, 27, 28, 29, 57, 58, 59, 60, 61, 62, 89, 91, 92, 112, 113, 116, 117, 118, 119]"
agent_c,L0,long,23,9,14,2,0.813,123,"[15, 24, 25, 26, 27, 30, 53, 55, 57, 59, 84, 85, 86, 87, 88, 89, 112, 113, 114, 115, 116, 117, 120]"
agent_c,L0,long,30,12,18,4,0.7692,130,"[27, 28, 33, 49, 50, 51, 52, 54, 56, 58, 61, 84, 87, 88, 89, 90, 91, 92, 93, 114, 117, 118, 119, 120, 121, 122, 123, 124, 125, 127]"
agent_c,L0,long,23,11,12,6,0.813,123,"[27, 28, 30, 47, 48, 51, 52, 53, 54, 55, 56, 57, 64, 89, 91, 110, 111, 114, 115, 116, 117, 118, 121]"
agent_c,L0,long,22,12,10,2,0.8197,122,"[14, 23, 24, 26, 27, 29, 31, 55, 56, 57, 59, 60, 61, 88, 89, 90, 92, 114, 115, 116, 119, 120]"
agent_c,L0,long,16,8,8,6,0.8621,116,"[14, 27, 28, 30, 51, 53, 54, 55, 56, 57, 58, 60, 87, 88, 89, 96]"
agent_c,L0,long,26,14,12,1,0.7937,126,"[14, 24, 25, 26, 27, 28, 29, 30, 53, 54, 55, 56, 57, 58, 59, 61, 87, 88, 90, 113, 116, 117, 118, 119, 120, 121]"
agent_c,L0,long,19,9,10,1,0.8403,119,"[16, 27, 28, 30, 53, 54, 55, 56, 57, 58, 59, 86, 87, 88, 89, 110, 113, 115, 116]"
agent_c,L0,long,23,9,14,0,0.813,123,"[14, 23, 24, 26, 27, 28, 29, 52, 54, 56, 57, 58, 59, 85, 86, 88, 89, 111, 114, 115, 117, 118, 120]"
agent_c,L0,long,26,8,18,6,0.7937,126,"[14, 23, 24, 25, 26, 28, 30, 52, 53, 54, 55, 56, 60, 84, 85, 86, 87, 88, 89, 91, 115, 116, 117, 118, 119, 123]"
agent_c,L0,long,24,8,16,0,0.8065,124,"[14, 24, 27, 29, 50, 51, 52, 53, 54, 55, 56, 57, 58, 59, 86, 88, 89, 111, 112, 114, 116, 117, 118, 119]"
agent_c,L0,long,21,8,13,1,0.8264,121,"[15, 24, 25, 26, 27, 28, 29, 53, 54, 58, 59, 84, 85, 88, 90, 111, 112, 114, 116, 118, 119]"
agent_c,L0,long,24,16,8,2,0.8065,124,"[14, 27, 30, 31, 51, 53, 54, 55, 56, 57, 58, 59, 60, 62, 88, 92, 112, 114, 115, 116, 118, 119, 120, 121]"
agent_c,L0,long,23,8,15,1,0.813,123,"[14, 23, 24, 25, 26, 28, 29, 52, 54, 56, 57, 58, 59, 61, 88, 90, 112, 113, 114, 116, 117, 118, 120]"
agent_c,L0,long,21,6,15,4,0.8264,121,"[15, 27, 31, 54, 55, 56, 57, 59, 82, 83, 84, 85, 88, 91, 111, 112, 113, 115, 116, 117, 119]"
agent_c,L0,long,23,6,17,0,0.813,123,"[27, 28, 29, 30, 46, 47, 49, 50, 51, 52, 53, 54, 55, 56, 59, 60, 84, 85, 86, 87, 90, 115, 120]"
agent_c,L0,long,26,13,13,0,0.7937,126,"[28, 29, 44, 45, 47, 48, 50, 51, 52, 53, 55, 56, 57, 58, 59, 84, 85, 87, 88, 89, 111, 112, 113, 114, 118, 119]"
agent_c,L0,long,27,12,15,0,0.7874,127,"[14, 23, 24, 25, 27, 28, 29, 52, 53, 55, 56, 57, 59, 60, 85, 86, 88, 90, 91, 92, 93, 116, 118, 119, 121, 122, 123]"
agent_c,L0,long,20,7,13,0,0.8333,120,"[16, 29, 50, 51, 53, 55, 56, 57, 59, 85, 88, 91, 110, 111, 112, 114, 115, 116, 117, 118]"
agent_c,L0,long,27,15,12,2,0.7874,127,"[27, 30, 48, 49, 55, 57, 58, 59, 60, 81, 82, 85, 86, 88, 89, 91, 110, 111, 113, 114, 116, 117, 118, 119, 120, 121, 122]"
agent_c,L0,long,29,21,8,0,0.7752,129,"[15, 27, 29, 50, 51, 53, 55, 56, 57, 58, 61, 85, 86, 90, 91, 92, 112, 113, 114, 115, 116, 117, 118, 119, 120, 121, 122, 123, 124]"
agent_c,L0,long,26,6,20,0,0.7937,126,"[27, 28, 29, 41, 44, 45, 47, 48, 50, 52, 55, 57, 58, 59, 84, 85, 86, 89, 112, 113, 115, 116, 117, 118, 119, 120]"
agent_c,L0,long,26,14,12,2,0.7937,126,"[27, 29, 41, 42, 45, 46, 47, 48, 50, 52, 54, 55, 56, 57, 58, 61, 86, 87, 88, 91, 114, 115, 117, 119, 120, 121]"
agent_c,L0,long,20,4,16,0,0.8333,120,"[14, 24, 25, 26, 28, 30, 31, 53, 54, 55, 60, 61, 86, 87, 88, 90, 91, 114, 117, 118]"
agent_c,L0,long,24,11,13,2,0.8065,124,"[29, 43, 44, 47, 48, 49, 52, 53, 54, 55, 57, 58, 59, 60, 86, 87, 92, 111, 114, 115, 116, 118, 120, 121]"
agent_c,L0,long,26,9,17,5,0.7937,126,"[27, 28, 29, 31, 47, 48, 50, 51, 52, 54, 55, 56, 58, 59, 63, 89, 90, 111, 112, 113, 114, 116, 117, 118, 119, 121]"
agent_c,L0,long,29,6,23,2,0.7752,129,"[27, 28, 29, 41, 43, 44, 45, 46, 47, 48, 50, 51, 52, 53, 57, 59, 86, 87, 88, 89, 111, 112, 113, 114, 115, 116, 117, 118, 121]"
agent_c,L0,long,27,6,21,5,0.7874,127,"[29, 30, 44, 45, 46, 50, 52, 54, 55, 56, 57, 58, 59, 63, 86, 87, 88, 92, 112, 113, 114, 115, 116, 117, 118, 119, 120]"
agent_c,L0,long,28,14,14,1,0.7812,128,"[27, 28, 29, 41, 43, 45, 46, 47, 48, 49, 51, 52, 54, 55, 56, 57, 58, 59, 83, 84, 85, 87, 90, 113, 115, 117, 118, 119]"
agent_c,L0,long,26,12,14,3,0.7937,126,"[28, 29, 44, 45, 46, 47, 49, 50, 52, 53, 55, 56, 58, 59, 63, 87, 89, 90, 112, 113, 114, 115, 116, 118, 120, 121]"
agent_c,L0,long,27,16,11,0,0.7874,127,"[27, 28, 29, 41, 42, 45, 46, 47, 48, 49, 51, 55, 56, 58, 59, 60, 62, 86, 88, 89, 90, 92, 117, 119, 120, 121, 122]"
agent_c,L0,long,21,15,6,0,0.8264,121,"[16, 27, 29, 50, 51, 53, 54, 55, 56, 57, 58, 59, 85, 86, 87, 88, 89, 113, 115, 118, 119]"
agent_c,L0,long,22,4,18,4,0.8197,122,"[14, 23, 25, 26, 29, 51, 52, 53, 54, 56, 57, 58, 59, 83, 85, 88, 93, 113, 116, 118, 119, 120]"
agent_c,L0,long,28,8,20,1,0.7812,128,"[14, 23, 25, 26, 28, 30, 52, 53, 54, 55, 56, 57, 59, 83, 84, 85, 86, 87, 89, 113, 115, 116, 118, 119, 120, 121, 122, 123]"
agent_c,L0,long,17,3,14,4,0.8547,117,"[14, 24, 25, 26, 27, 28, 29, 55, 56, 57, 60, 85, 87, 88, 89, 93, 114]"
agent_c,L0,long,24,8,16,1,0.8065,124,"[14, 23, 24, 25, 28, 30, 52, 53, 54, 55, 56, 57, 58, 59, 60, 86, 88, 89, 90, 113, 116, 118, 119, 122]"
agent_c,L0,long,26,10,16,0,0.7937,126,"[27, 29, 41, 43, 45, 49, 50, 53, 54, 58, 59, 60, 83, 84, 85, 86, 88, 90, 112, 113, 115, 116, 117, 118, 119, 120]"
agent_c,L0,long,25,13,12,0,0.8,125,"[27, 28, 29, 44, 45, 46, 48, 50, 51, 52, 54, 55, 57, 58, 59, 60, 84, 85, 88, 90, 91, 115, 117, 120, 121]"
agent_c,L0,long,25,9,16,3,0.8,125,"[27, 28, 29, 41, 42, 44, 45, 46, 47, 48, 49, 50, 51, 55, 56, 59, 60, 85, 86, 87, 88, 89, 92, 119, 121]"
agent_c,L0,long,28,5,23,2,0.7812,128,"[28, 29, 41, 42, 43, 44, 48, 49, 50, 52, 53, 54, 55, 56, 57, 58, 59, 60, 86, 87, 89, 91, 113, 114, 115, 116, 117, 121]"
agent_c,L0,long,24,19,5,1,0.8065,124,"[28, 29, 30, 47, 48, 50, 51, 52, 53, 55, 56, 58, 61, 85, 87, 89, 90, 113, 114, 115, 116, 118, 119, 120]"
agent_c,L0,long,22,10,12,1,0.8197,122,"[14, 23, 25, 26, 28, 29, 51, 52, 53, 55, 58, 59, 85, 86, 87, 90, 114, 115, 116, 117, 119, 120]"
agent_c,L0,long,23,11,12,3,0.813,123,"[27, 29, 44, 45, 48, 50, 51, 54, 55, 56, 57, 58, 59, 62, 87, 88, 89, 91, 112, 115, 116, 118, 120]"
agent_c,L0,long,26,6,20,0,0.7937,126,"[14, 23, 24, 25, 26, 27, 29, 53, 54, 55, 56, 57, 59, 83, 86, 87, 88, 91, 113, 114, 115, 116, 117, 119, 120, 121]"
agent_c,L0,long,29,19,10,2,0.7752,129,"[27, 30, 44, 45, 46, 48, 49, 50, 52, 53, 54, 55, 56, 57, 58, 59, 60, 85, 86, 87, 88, 89, 90, 91, 115, 117, 120, 121, 125]"
agent_c,L0,long,29,15,14,3,0.7752,129,"[27, 28, 30, 45, 46, 47, 48, 49, 50, 51, 53, 55, 56, 57, 58, 60, 84, 85, 87, 88, 90, 112, 113, 114, 116, 117, 118, 119, 120]"
agent_c,L0,long,28,7,21,1,0.7812,128,"[28, 30, 31, 32, 46, 47, 48, 49, 50, 51, 52, 53, 54, 55, 56, 58, 60, 62, 89, 90, 91, 93, 116, 117, 118, 119, 120, 122]"
agent_c,L0,long,26,10,16,1,0.7937,126,"[14, 23, 24, 25, 26, 27, 28, 29, 52, 53, 54, 55, 56, 57, 58, 59, 87, 89, 112, 114, 115, 116, 117, 118, 119, 121]"
agent_c,L0,long,23,6,17,3,0.813,123,"[14, 23, 24, 30, 51, 52, 53, 54, 56, 58, 60, 85, 86, 88, 90, 91, 113, 114, 116, 117, 118, 119, 120]"
agent_c,L0,long,21,4,17,0,0.8264,121,"[14, 24, 25, 26, 27, 28, 29, 30, 53, 54, 57, 58, 59, 60, 62, 89, 90, 91, 92, 115, 118]"
agent_c,L0,long,26,11,15,5,0.7937,126,"[29, 30, 32, 45, 46, 48, 49, 50, 51, 52, 54, 56, 57, 59, 61, 84, 85, 86, 89, 90, 94, 116, 117, 119, 120, 122]"
agent_c,L0,long,26,14,12,1,0.7937,126,"[14, 24, 25, 28, 29, 50, 51, 52, 53, 55, 56, 57, 58, 59, 84, 85, 86, 87, 90, 92, 117, 118, 119, 120, 121, 122]"
agent_c,L0,long,25,16,9,3,0.8,125,"[27, 29, 44, 45, 47, 48, 50, 51, 52, 53, 54, 55, 56, 57, 58, 59, 62, 87, 90, 92, 115, 118, 119, 120, 122]"
agent_c,L0,long,26,16,10,1,0.7937,126,"[27, 30, 44, 46, 49, 50, 51, 54, 56, 57, 58, 59, 60, 84, 85, 86, 88, 89, 90, 114, 115, 116, 118, 119, 120, 121]"
agent_c,L0,long,23,10,13,6,0.813,123,"[28, 29, 41, 42, 43, 44, 45, 46, 47, 49, 52, 53, 54, 55, 58, 65, 89, 113, 114, 116, 117, 118, 120]"
agent_c,L0,long,24,9,15,1,0.8065,124,"[14, 23, 24, 25, 26, 27, 30, 53, 54, 55, 57, 60, 61, 63, 89, 91, 92, 93, 94, 95, 96, 120, 121, 122]"
agent_c,L0,long,28,6,22,3,0.7812,128,"[27, 28, 29, 31, 46, 49, 51, 53, 54, 55, 56, 57, 58, 59, 60, 62, 87, 88, 89, 90, 91, 92, 95, 117, 118, 120, 122, 123]"
agent_c,L0,long,26,8,18,3,0.7937,126,"[27, 28, 30, 49, 50, 53, 55, 56, 57, 58, 60, 82, 83, 84, 85, 86, 87, 88, 89, 91, 114, 115, 116, 117, 118, 121]"
agent_c,L0,long,27,9,18,0,0.7874,127,"[28, 29, 41, 42, 43, 44, 45, 46, 47, 51, 54, 55, 56, 57, 58, 59, 60, 87, 88, 90, 114, 115, 116, 118, 119, 120, 121]"
agent_c,L0,long,22,14,8,3,0.8197,122,"[14, 24, 25, 27, 32, 54, 56, 59, 82, 83, 86, 87, 88, 89, 110, 111, 112, 113, 115, 116, 118, 119]"
agent_c,L0,long,23,10,13,0,0.813,123,"[14, 27, 28, 29, 49, 50, 51, 52, 54, 56, 57, 58, 59, 83, 89, 90, 112, 113, 114, 115, 116, 117, 120]"
agent_c,L0,long,28,13,15,0,0.7812,128,"[14, 24, 27, 28, 29, 31, 53, 54, 55, 56, 57, 60, 61, 87, 88, 89, 90, 91, 115, 116, 117, 118, 119, 120, 121, 122, 124, 125]"
agent_c,L0,long,21,14,7,2,0.8264,121,"[27, 29, 41, 42, 45, 46, 47, 49, 50, 53, 54, 55, 59, 82, 86, 87, 88, 89, 112, 115, 116]"
agent_c,L0,long,31,10,21,0,0.7634,131,"[27, 28, 29, 42, 43, 46, 48, 50, 51, 52, 54, 55, 56, 57, 58, 59, 83, 84, 85, 86, 88, 90, 91, 114, 115, 116, 117, 118, 119, 120, 121]"
agent_c,L0,long,30,7,23,2,0.7692,130,"[27, 28, 29, 30, 43, 45, 47, 48, 49, 50, 52, 53, 54, 55, 56, 59, 60, 88, 92, 113, 114, 115, 116, 117, 119, 120, 121, 122, 123, 124]"
agent_c,L0,long,25,6,19,1,0.8,125,"[14, 23, 25, 27, 28, 29, 52, 53, 54, 55, 56, 57, 59, 83, 84, 87, 88, 90, 113, 114, 115, 116, 117, 118, 119]"
agent_c,L0,long,24,6,18,2,0.8065,124,"[27, 28, 29, 30, 43, 44, 45, 46, 50, 52, 53, 54, 55, 57, 58, 59, 63, 88, 91, 114, 116, 117, 120, 121]"
agent_c,L0,long,23,7,16,2,0.813,123,"[27, 31, 44, 45, 46, 48, 49, 50, 53, 54, 55, 57, 59, 81, 82, 85, 86, 88, 90, 113, 114, 118, 120]"
agent_c,L0,long,25,7,18,1,0.8,125,"[28, 29, 41, 42, 43, 44, 45, 48, 50, 51, 52, 58, 60, 84, 85, 86, 87, 88, 89, 110, 112, 113, 115, 118, 119]"
agent_c,L0,long,26,16,10,1,0.7937,126,"[27, 28, 29, 41, 43, 44, 45, 47, 48, 49, 50, 51, 52, 53, 54, 55, 56, 62, 87, 88, 90, 91, 92, 120, 121, 122]"
agent_c,L0,long,30,22,8,2,0.7692,130,"[27, 28, 29, 42, 44, 45, 47, 48, 49, 50, 51, 52, 53, 54, 55, 56, 57, 58, 59, 84, 85, 86, 87, 88, 89, 115, 117, 118, 120, 123]"
agent_c,L0,long,27,9,18,1,0.7874,127,"[27, 30, 32, 45, 46, 47, 48, 49, 50, 51, 52, 53, 54, 56, 57, 58, 60, 63, 89, 91, 93, 116, 118, 120, 121, 122, 123]"
agent_c,L0,long,24,10,14,3,0.8065,124,"[27, 28, 30, 45, 46, 47, 48, 51, 54, 55, 57, 58, 59, 62, 86, 87, 88, 89, 90, 113, 114, 116, 119, 120]"
agent_c,L0,long,20,9,11,3,0.8333,120,"[14, 23, 24, 25, 26, 27, 29, 30, 31, 33, 57, 59, 60, 62, 64, 91, 92, 93, 94, 96]"
agent_c,L0,long,28,14,14,6,0.7812,128,"[27, 28, 32, 46, 48, 50, 52, 55, 56, 57, 58, 59, 60, 61, 84, 85, 87, 88, 90, 92, 114, 116, 117, 118, 120, 121, 122, 125]"
agent_c,L0,long,23,7,16,2,0.813,123,"[27, 28, 31, 45, 46, 47, 48, 49, 50, 51, 52, 53, 57, 59, 60, 85, 88, 90, 91, 92, 114, 118, 120]"
agent_c,L50,long,18,8,10,2,0.8475,118,"[27, 28, 30, 48, 50, 52, 53, 56, 57, 58, 61, 87, 89, 90, 112, 113, 115, 116]"
agent_c,L50,long,25,14,11,1,0.8,125,"[26, 27, 28, 30, 45, 46, 48, 50, 52, 53, 55, 56, 60, 85, 86, 87, 89, 90, 91, 92, 118, 119, 120, 121, 122]"
agent_c,L50,long,13,5,8,5,0.885,113,"[15, 28, 30, 50, 52, 53, 54, 57, 59, 63, 89, 90, 93]"
agent_c,L50,long,17,7,10,3,0.8547,117,"[16, 26, 27, 29, 49, 50, 52, 53, 54, 55, 56, 57, 58, 59, 86, 91, 95]"
agent_c,L50,long,20,5,15,0,0.8333,120,"[26, 27, 28, 29, 30, 48, 49, 50, 51, 53, 54, 57, 58, 59, 60, 61, 88, 90, 91, 118]"
agent_c,L50,long,23,4,19,1,0.813,123,"[26, 27, 28, 29, 44, 47, 48, 50, 51, 52, 55, 56, 58, 60, 87, 89, 114, 115, 116, 117, 119, 120, 121]"
agent_c,L50,long,14,8,6,3,0.8772,114,"[16, 26, 28, 29, 50, 53, 54, 56, 57, 58, 61, 88, 90, 112]"
agent_c,L50,long,15,9,6,2,0.8696,115,"[15, 25, 26, 31, 53, 54, 57, 58, 59, 60, 86, 87, 88, 90, 112]"
agent_c,L50,long,25,14,11,0,0.8,125,"[26, 28, 29, 44, 45, 47, 49, 51, 52, 53, 54, 55, 57, 58, 59, 84, 85, 86, 87, 89, 114, 116, 117, 118, 119]"
agent_c,L50,long,19,4,15,0,0.8403,119,"[15, 25, 27, 28, 29, 31, 52, 53, 54, 55, 56, 57, 58, 59, 61, 62, 90, 91, 92]"
agent_c,L50,long,14,12,2,3,0.8772,114,"[16, 29, 50, 51, 52, 54, 55, 56, 57, 58, 61, 63, 90, 94]"
agent_c,L50,long,17,10,7,0,0.8547,117,"[15, 28, 29, 30, 52, 53, 54, 55, 56, 57, 58, 59, 60, 61, 92, 114, 115]"
agent_c,L50,long,15,11,4,0,0.8696,115,"[15, 25, 26, 27, 28, 29, 30, 52, 53, 56, 57, 58, 61, 89, 91]"
agent_c,L50,long,22,13,9,2,0.8197,122,"[26, 27, 28, 29, 44, 45, 46, 47, 48, 49, 50, 51, 53, 54, 55, 57, 58, 59, 61, 64, 92, 120]"
agent_c,L50,long,22,13,9,3,0.8197,122,"[15, 25, 26, 27, 28, 30, 51, 54, 56, 57, 58, 59, 61, 89, 91, 113, 115, 116, 117, 118, 119, 120]"
agent_c,L50,long,20,10,10,1,0.8333,120,"[15, 25, 27, 29, 49, 50, 51, 52, 55, 56, 58, 62, 89, 90, 91, 113, 114, 115, 117, 118]"
agent_c,L50,long,19,9,10,3,0.8403,119,"[26, 27, 31, 48, 49, 52, 54, 55, 56, 57, 59, 83, 86, 91, 112, 114, 115, 116, 117]"
agent_c,L50,long,19,8,11,0,0.8403,119,"[26, 27, 28, 29, 30, 33, 35, 54, 55, 56, 57, 58, 59, 61, 62, 63, 64, 65, 95]"
agent_c,L50,long,19,9,10,0,0.8403,119,"[15, 25, 27, 29, 49, 50, 51, 52, 53, 54, 57, 58, 59, 86, 88, 90, 115, 116, 117]"
agent_c,L50,long,19,8,11,0,0.8403,119,"[26, 27, 29, 46, 47, 48, 51, 54, 56, 57, 59, 83, 84, 85, 87, 89, 114, 116, 117]"
agent_c,L50,long,18,10,8,6,0.8475,118,"[26, 27, 30, 48, 49, 51, 52, 53, 56, 57, 58, 59, 64, 89, 91, 114, 115, 116]"
agent_c,L50,long,12,11,1,5,0.8929,112,"[16, 26, 27, 28, 32, 53, 54, 55, 57, 58, 62, 90]"
agent_c,L50,long,18,9,9,4,0.8475,118,"[27, 28, 32, 47, 48, 50, 51, 53, 54, 57, 58, 59, 60, 62, 89, 90, 91, 116]"
agent_c,L50,long,21,10,11,3,0.8264,121,"[26, 27, 28, 30, 45, 46, 48, 50, 51, 52, 53, 54, 56, 57, 62, 87, 88, 89, 90, 91, 118]"
agent_c,L50,long,18,10,8,1,0.8475,118,"[16, 26, 27, 28, 29, 50, 52, 53, 54, 55, 56, 58, 59, 61, 63, 91, 93, 116]"
agent_c,L50,long,20,14,6,0,0.8333,120,"[28, 29, 30, 47, 48, 49, 50, 51, 52, 54, 56, 59, 61, 85, 88, 91, 115, 116, 117, 118]"
agent_c,L50,long,24,12,12,1,0.8065,124,"[26, 27, 28, 29, 44, 45, 46, 48, 49, 50, 51, 53, 57, 58, 59, 60, 87, 88, 89, 92, 118, 119, 120, 121]"
agent_c,L50,long,20,10,10,2,0.8333,120,"[26, 27, 28, 30, 45, 50, 52, 54, 55, 57, 58, 59, 60, 85, 87, 88, 89, 91, 116, 117]"
agent_c,L50,long,17,6,11,2,0.8547,117,"[15, 25, 27, 28, 29, 50, 52, 54, 55, 56, 57, 58, 59, 60, 62, 90, 95]"
agent_c,L50,long,21,4,17,2,0.8264,121,"[15, 26, 27, 29, 50, 51, 52, 53, 55, 56, 57, 58, 59, 86, 87, 90, 114, 115, 117, 118, 119]"
agent_c,L50,long,17,9,8,2,0.8547,117,"[15, 25, 26, 27, 28, 31, 52, 53, 55, 56, 58, 59, 60, 62, 88, 91, 114]"
agent_c,L50,long,14,5,9,5,0.8772,114,"[15, 28, 29, 31, 52, 54, 55, 57, 61, 88, 89, 90, 91, 95]"
agent_c,L50,long,24,11,13,1,0.8065,124,"[26, 28, 29, 43, 44, 47, 48, 49, 50, 52, 54, 55, 56, 58, 60, 87, 88, 89, 90, 91, 118, 119, 120, 122]"
agent_c,L50,long,24,10,14,2,0.8065,124,"[27, 29, 43, 44, 45, 47, 48, 50, 51, 52, 54, 55, 56, 57, 58, 59, 62, 92, 93, 117, 118, 119, 121, 122]"
agent_c,L50,long,24,8,16,3,0.8065,124,"[15, 25, 26, 28, 30, 51, 52, 54, 55, 56, 57, 58, 60, 61, 62, 64, 91, 93, 116, 117, 118, 119, 120, 122]"
agent_c,L50,long,23,10,13,3,0.813,123,"[15, 28, 31, 51, 52, 53, 54, 55, 56, 57, 58, 59, 86, 87, 88, 89, 90, 91, 117, 118, 119, 120, 121]"
agent_c,L50,long,23,3,20,2,0.813,123,"[16, 26, 29, 49, 50, 51, 53, 54, 55, 58, 61, 90, 91, 112, 113, 114, 115, 116, 117, 118, 119, 120, 121]"
agent_c,L50,long,14,10,4,2,0.8772,114,"[15, 25, 27, 28, 29, 50, 52, 53, 57, 61, 87, 88, 89, 112]"
agent_c,L50,long,18,13,5,3,0.8475,118,"[29, 45, 46, 47, 48, 50, 53, 54, 56, 57, 58, 59, 60, 61, 65, 92, 114, 116]"
agent_c,L50,long,19,8,11,0,0.8403,119,"[15, 26, 27, 28, 29, 30, 31, 56, 58, 59, 60, 61, 87, 88, 89, 91, 114, 115, 116]"
agent_c,L50,long,25,14,11,1,0.8,125,"[16, 29, 49, 50, 52, 53, 54, 55, 57, 58, 60, 85, 88, 89, 90, 91, 92, 93, 116, 117, 118, 119, 120, 122, 123]"
agent_c,L50,long,22,5,17,1,0.8197,122,"[16, 26, 27, 28, 30, 52, 55, 57, 58, 60, 85, 86, 87, 88, 89, 90, 114, 115, 116, 118, 119, 120]"
agent_c,L50,long,18,15,3,1,0.8475,118,"[17, 30, 50, 51, 52, 53, 54, 55, 56, 57, 58, 59, 60, 89, 90, 113, 114, 116]"
agent_c,L50,long,19,13,6,2,0.8403,119,"[27, 28, 30, 47, 48, 49, 50, 51, 52, 53, 57, 58, 59, 60, 86, 87, 88, 89, 91]"
agent_c,L50,long,20,5,15,3,0.8333,120,"[26, 28, 30, 48, 51, 52, 53, 54, 55, 56, 57, 62, 88, 89, 90, 93, 115, 116, 117, 118]"
agent_c,L50,long,15,8,7,1,0.8696,115,"[15, 25, 27, 28, 29, 51, 52, 53, 56, 57, 59, 61, 62, 90, 93]"
agent_c,L50,long,28,10,18,0,0.7812,128,"[26, 27, 28, 29, 30, 45, 46, 48, 49, 50, 52, 53, 54, 56, 57, 58, 59, 60, 61, 87, 88, 89, 90, 91, 118, 119, 120, 121]"
agent_c,L50,long,21,5,16,4,0.8264,121,"[15, 26, 27, 28, 30, 51, 52, 53, 54, 56, 57, 58, 60, 88, 90, 113, 115, 116, 117, 118, 119]"
agent_c,L50,long,25,7,18,1,0.8,125,"[26, 27, 29, 43, 44, 45, 48, 49, 50, 55, 56, 57, 60, 85, 87, 90, 92, 115, 116, 117, 118, 119, 120, 121, 122]"
agent_c,L50,long,20,10,10,0,0.8333,120,"[17, 29, 49, 51, 52, 53, 54, 55, 56, 59, 85, 86, 87, 89, 90, 113, 114, 115, 116, 118]"
agent_c,L50,long,23,12,11,1,0.813,123,"[27, 28, 30, 47, 48, 52, 54, 56, 58, 59, 60, 83, 85, 86, 87, 88, 89, 90, 116, 117, 118, 119, 120]"
agent_c,L50,long,22,6,16,0,0.8197,122,"[16, 26, 29, 49, 51, 52, 53, 54, 56, 57, 58, 59, 86, 87, 88, 89, 90, 115, 116, 117, 118, 120]"
agent_c,L50,long,17,9,8,4,0.8547,117,"[15, 25, 26, 27, 29, 32, 54, 56, 57, 58, 60, 86, 87, 89, 92, 114, 115]"
agent_c,L50,long,20,10,10,3,0.8333,120,"[27, 29, 43, 47, 48, 51, 52, 53, 54, 56, 57, 60, 61, 65, 91, 92, 93, 115, 116, 118]"
agent_c,L50,long,27,13,14,0,0.7874,127,"[15, 25, 26, 27, 29, 51, 52, 53, 54, 55, 56, 57, 58, 60, 87, 88, 89, 90, 91, 92, 93, 94, 95, 121, 122, 123, 124]"
agent_c,L50,long,26,15,11,1,0.7937,126,"[26, 27, 28, 29, 44, 46, 49, 50, 51, 54, 55, 56, 58, 59, 82, 83, 84, 85, 86, 87, 88, 89, 91, 118, 119, 121]"
agent_c,L50,long,24,10,14,0,0.8065,124,"[15, 25, 26, 27, 29, 30, 52, 53, 54, 55, 56, 58, 60, 61, 90, 91, 92, 115, 116, 117, 118, 120, 121, 122]"
agent_c,L50,long,15,7,8,4,0.8696,115,"[15, 26, 27, 29, 31, 52, 55, 57, 59, 60, 62, 63, 65, 93, 97]"
agent_c,L50,long,15,2,13,0,0.8696,115,"[18, 29, 31, 53, 54, 55, 57, 58, 59, 60, 61, 62, 63, 91, 96]"
agent_c,L50,long,23,12,11,3,0.813,123,"[16, 26, 27, 28, 30, 31, 35, 56, 57, 58, 60, 61, 62, 88, 90, 91, 92, 93, 116, 117, 118, 119, 120]"
agent_c,L50,long,22,11,11,2,0.8197,122,"[26, 27, 29, 30, 48, 49, 52, 54, 55, 58, 60, 83, 84, 85, 86, 87, 88, 89, 91, 118, 119, 120]"
agent_c,L50,long,22,12,10,3,0.8197,122,"[26, 27, 28, 30, 45, 46, 48, 49, 50, 51, 54, 56, 57, 60, 86, 87, 89, 114, 115, 116, 117, 120]"
agent_c,L50,long,22,2,20,6,0.8197,122,"[26, 27, 33, 50, 51, 55, 56, 57, 58, 59, 62, 87, 90, 111, 113, 114, 115, 116, 117, 118, 119, 120]"
agent_c,L50,long,21,8,13,3,0.8264,121,"[15, 25, 26, 27, 28, 29, 51, 52, 54, 55, 56, 57, 58, 61, 88, 89, 114, 115, 116, 118, 119]"
agent_c,L50,long,22,8,14,0,0.8197,122,"[15, 25, 27, 29, 49, 50, 52, 53, 54, 56, 57, 58, 59, 86, 87, 88, 89, 115, 116, 117, 119, 120]"
agent_c,L50,long,19,8,11,2,0.8403,119,"[26, 28, 31, 33, 49, 51, 52, 53, 55, 57, 58, 59, 61, 63, 91, 92, 114, 115, 117]"
agent_c,L50,long,20,10,10,2,0.8333,120,"[26, 27, 30, 47, 48, 51, 53, 55, 56, 58, 59, 60, 84, 86, 88, 89, 91, 115, 116, 118]"
agent_c,L50,long,21,10,11,2,0.8264,121,"[26, 27, 29, 43, 44, 46, 48, 49, 51, 52, 53, 54, 56, 57, 58, 59, 85, 86, 91, 118, 119]"
agent_c,L50,long,14,7,7,2,0.8772,114,"[18, 30, 50, 51, 52, 54, 55, 57, 58, 60, 85, 86, 87, 90]"
agent_c,L50,long,18,6,12,3,0.8475,118,"[17, 31, 50, 51, 54, 55, 56, 57, 58, 59, 61, 88, 89, 90, 112, 114, 115, 116]"
agent_c,L50,long,25,10,15,3,0.8,125,"[26, 27, 28, 29, 44, 45, 47, 49, 51, 52, 53, 56, 57, 58, 60, 86, 87, 88, 90, 114, 115, 117, 118, 119, 122]"
agent_c,L50,long,25,13,12,2,0.8,125,"[26, 27, 28, 29, 32, 49, 50, 51, 52, 53, 54, 57, 59, 60, 86, 87, 88, 90, 91, 92, 118, 119, 120, 122, 123]"
agent_c,L50,long,22,10,12,1,0.8197,122,"[29, 45, 46, 47, 48, 49, 51, 53, 54, 55, 56, 58, 59, 82, 84, 87, 89, 115, 116, 117, 118, 120]"
agent_c,L50,long,18,5,13,0,0.8475,118,"[17, 29, 49, 50, 51, 52, 53, 55, 58, 59, 84, 88, 89, 111, 112, 113, 114, 116]"
agent_c,L50,long,19,9,10,0,0.8403,119,"[15, 25, 29, 50, 51, 53, 54, 55, 56, 57, 58, 59, 87, 88, 89, 92, 94, 95, 117]"
agent_c,L50,long,19,11,8,1,0.8403,119,"[15, 25, 26, 28, 29, 30, 51, 52, 53, 54, 55, 57, 58, 61, 88, 90, 91, 92, 117]"
agent_c,L50,long,21,9,12,1,0.8264,121,"[16, 26, 28, 29, 30, 53, 54, 55, 56, 57, 58, 60, 87, 88, 89, 90, 114, 115, 117, 118, 119]"
agent_c,L50,long,25,13,12,2,0.8,125,"[26, 27, 30, 47, 49, 50, 51, 53, 55, 59, 83, 84, 85, 86, 87, 88, 89, 90, 92, 117, 118, 119, 120, 121, 122]"
agent_c,L50,long,17,5,12,1,0.8547,117,"[16, 26, 27, 28, 29, 52, 53, 54, 55, 56, 57, 58, 59, 87, 88, 90, 115]"
agent_c,L50,long,23,13,10,1,0.813,123,"[26, 27, 29, 43, 44, 45, 46, 47, 50, 51, 52, 54, 56, 59, 82, 84, 85, 86, 87, 88, 90, 116, 119]"
agent_c,L50,long,19,9,10,1,0.8403,119,"[15, 25, 26, 29, 49, 50, 51, 52, 54, 55, 58, 59, 61, 87, 88, 89, 90, 115, 117]"
agent_c,L50,long,17,12,5,2,0.8547,117,"[28, 29, 30, 33, 51, 52, 53, 55, 56, 57, 58, 59, 62, 89, 90, 91, 93]"
agent_c,L50,long,23,9,14,3,0.813,123,"[26, 29, 43, 44, 46, 49, 51, 53, 54, 56, 60, 83, 84, 85, 88, 91, 114, 115, 116, 117, 118, 120, 121]"
agent_c,L50,long,21,4,17,3,0.8264,121,"[27, 28, 29, 43, 44, 46, 47, 49, 50, 55, 56, 57, 58, 60, 88, 89, 91, 115, 116, 117, 118]"
agent_c,L50,long,13,11,2,1,0.885,113,"[15, 25, 26, 27, 28, 29, 30, 55, 56, 57, 58, 61, 92]"
agent_c,L50,long,24,6,18,2,0.8065,124,"[15, 25, 27, 29, 51, 52, 53, 54, 55, 57, 59, 62, 89, 90, 112, 113, 114, 115, 116, 117, 118, 119, 120, 121]"
agent_c,L50,long,14,5,9,3,0.8772,114,"[16, 26, 29, 33, 55, 56, 57, 59, 60, 86, 89, 90, 91, 112]"
agent_c,L50,long,23,10,13,6,0.813,123,"[15, 26, 27, 28, 33, 53, 54, 56, 57, 61, 87, 89, 110, 111, 112, 113, 114, 115, 116, 117, 118, 119, 121]"
agent_c,L50,long,25,11,14,0,0.8,125,"[28, 29, 30, 31, 48, 49, 50, 52, 53, 54, 55, 57, 58, 60, 61, 89, 90, 91, 116, 117, 118, 119, 121, 122, 123]"
agent_c,L50,long,21,12,9,2,0.8264,121,"[26, 27, 28, 29, 44, 46, 48, 49, 52, 53, 54, 55, 56, 58, 59, 84, 85, 90, 117, 118, 119]"
agent_c,L50,long,18,2,16,0,0.8475,118,"[15, 26, 29, 30, 31, 52, 53, 54, 56, 59, 61, 62, 90, 91, 92, 114, 115, 116]"
agent_c,L50,long,26,12,14,1,0.7937,126,"[27, 28, 29, 44, 45, 46, 47, 48, 49, 50, 51, 53, 54, 55, 56, 57, 58, 59, 86, 87, 88, 90, 116, 118, 119, 120]"
agent_c,L50,long,22,9,13,0,0.8197,122,"[15, 25, 27, 29, 49, 53, 54, 55, 56, 58, 59, 85, 86, 88, 89, 90, 114, 115, 116, 118, 119, 120]"
agent_c,L50,long,18,7,11,3,0.8475,118,"[15, 26, 27, 28, 31, 52, 53, 54, 55, 57, 59, 60, 86, 87, 88, 91, 115, 116]"
agent_c,L50,long,21,6,15,2,0.8264,121,"[15, 25, 26, 27, 28, 30, 51, 54, 55, 56, 57, 58, 59, 87, 88, 90, 114, 115, 116, 117, 119]"
agent_c,L50,long,18,4,14,2,0.8475,118,"[29, 31, 46, 49, 50, 52, 53, 56, 58, 59, 61, 87, 90, 91, 112, 113, 115, 116]"
agent_c,L50,long,21,8,13,0,0.8264,121,"[15, 25, 26, 29, 49, 50, 51, 53, 54, 55, 58, 59, 60, 88, 89, 90, 91, 115, 116, 117, 118]"
agent_c,L50,long,22,9,13,7,0.8197,122,"[26, 27, 28, 34, 53, 54, 55, 56, 58, 59, 60, 83, 84, 85, 87, 89, 93, 115, 116, 117, 119, 120]"
agent_c,L50,long,23,12,11,3,0.813,123,"[28, 29, 30, 32, 48, 49, 51, 52, 53, 54, 56, 57, 58, 59, 62, 92, 114, 115, 116, 117, 118, 119, 120]"
agent_c,L50,long,18,8,10,1,0.8475,118,"[27, 28, 29, 30, 31, 51, 52, 54, 57, 60, 62, 87, 88, 89, 90, 91, 93, 115]"
agent_c,L100,long,24,9,15,2,0.8065,124,"[27, 28, 30, 48, 49, 50, 53, 54, 55, 56, 57, 59, 60, 85, 86, 87, 91, 115, 117, 118, 119, 120, 121, 122]"
agent_c,L100,long,17,13,4,0,0.8547,117,"[28, 29, 46, 47, 49, 50, 52, 53, 56, 57, 58, 59, 84, 86, 87, 90, 114]"
agent_c,L100,long,28,19,9,1,0.7812,128,"[27, 29, 30, 31, 49, 50, 51, 52, 53, 54, 55, 56, 57, 58, 59, 60, 61, 62, 63, 65, 66, 97, 121, 122, 123, 124, 125, 126]"
agent_c,L100,long,24,11,13,0,0.8065,124,"[28, 30, 31, 49, 50, 51, 56, 59, 61, 85, 87, 88, 89, 90, 91, 114, 115, 116, 117, 118, 119, 120, 121, 122]"
agent_c,L100,long,19,10,9,5,0.8403,119,"[14, 26, 27, 29, 31, 54, 57, 58, 59, 62, 85, 87, 89, 92, 111, 112, 113, 114, 116]"
agent_c,L100,long,24,21,3,0,0.8065,124,"[13, 24, 25, 26, 28, 29, 54, 55, 56, 57, 58, 59, 88, 89, 90, 111, 112, 114, 115, 116, 117, 118, 119, 120]"
agent_c,L100,long,18,7,11,3,0.8475,118,"[13, 24, 25, 26, 27, 29, 31, 55, 56, 57, 60, 86, 87, 88, 89, 92, 115, 116]"
agent_c,L100,long,23,10,13,0,0.813,123,"[27, 29, 45, 46, 47, 48, 50, 51, 52, 53, 54, 55, 59, 82, 85, 86, 87, 88, 90, 91, 118, 120, 121]"
agent_c,L100,long,21,6,15,1,0.8264,121,"[28, 31, 48, 49, 50, 51, 52, 53, 55, 56, 57, 58, 59, 60, 87, 88, 89, 90, 91, 117, 119]"
agent_c,L100,long,18,10,8,0,0.8475,118,"[13, 24, 25, 27, 28, 29, 54, 55, 56, 57, 59, 60, 63, 64, 65, 93, 94, 95]"
agent_c,L100,long,25,10,15,2,0.8,125,"[27, 29, 30, 49, 51, 52, 53, 54, 55, 58, 59, 60, 65, 89, 91, 92, 93, 115, 117, 118, 119, 120, 121, 122, 123]"
agent_c,L100,long,15,4,11,2,0.8696,115,"[27, 28, 29, 32, 50, 51, 55, 56, 57, 59, 60, 61, 63, 91, 93]"
agent_c,L100,long,20,12,8,6,0.8333,120,"[14, 26, 28, 34, 56, 57, 58, 59, 60, 61, 85, 86, 87, 88, 89, 91, 92, 94, 115, 116]"
agent_c,L100,long,22,9,13,1,0.8197,122,"[27, 29, 30, 31, 33, 34, 56, 58, 59, 62, 63, 66, 89, 90, 92, 93, 95, 116, 117, 118, 119, 120]"
agent_c,L100,long,26,13,13,2,0.7937,126,"[13, 24, 25, 26, 27, 28, 29, 30, 31, 58, 60, 61, 62, 87, 91, 92, 113, 114, 115, 116, 117, 118, 119, 120, 121, 124]"
agent_c,L100,long,15,6,9,2,0.8696,115,"[27, 28, 29, 30, 33, 52, 57, 60, 61, 88, 89, 91, 92, 93, 96]"
agent_c,L100,long,20,9,11,0,0.8333,120,"[15, 27, 28, 29, 52, 54, 55, 56, 58, 59, 84, 85, 86, 89, 90, 111, 113, 114, 116, 117]"
agent_c,L100,long,23,14,9,2,0.813,123,"[13, 24, 25, 26, 27, 28, 31, 55, 57, 58, 59, 85, 87, 88, 89, 111, 112, 113, 114, 116, 117, 118, 119]"
agent_c,L100,long,22,10,12,2,0.8197,122,"[27, 29, 31, 49, 51, 52, 53, 54, 55, 58, 59, 60, 85, 86, 87, 88, 89, 91, 117, 118, 119, 120]"
agent_c,L100,long,23,10,13,0,0.813,123,"[13, 25, 26, 28, 29, 57, 58, 60, 82, 84, 85, 86, 87, 88, 89, 90, 91, 113, 115, 117, 118, 120, 121]"
agent_c,L100,long,24,7,17,0,0.8065,124,"[27, 28, 29, 45, 46, 47, 48, 49, 50, 53, 55, 56, 57, 59, 86, 87, 89, 91, 116, 117, 118, 119, 120, 121]"
agent_c,L100,long,20,10,10,1,0.8333,120,"[27, 28, 30, 31, 51, 52, 53, 55, 57, 58, 59, 61, 84, 85, 86, 89, 91, 92, 94, 118]"
agent_c,L100,long,25,15,10,2,0.8,125,"[13, 24, 25, 26, 28, 29, 55, 56, 57, 60, 84, 85, 86, 87, 88, 89, 112, 113, 114, 115, 116, 117, 118, 119, 121]"
agent_c,L100,long,23,9,14,1,0.813,123,"[27, 29, 30, 49, 50, 52, 53, 54, 55, 57, 58, 59, 61, 86, 87, 88, 90, 115, 116, 117, 118, 119, 121]"
agent_c,L100,long,25,11,14,1,0.8,125,"[13, 24, 25, 27, 28, 29, 30, 32, 56, 57, 61, 85, 86, 90, 91, 92, 114, 115, 116, 117, 118, 119, 120, 121, 122]"
agent_c,L100,long,25,18,7,1,0.8,125,"[28, 29, 45, 47, 48, 49, 50, 51, 52, 54, 55, 57, 58, 59, 83, 84, 85, 86, 87, 88, 90, 91, 119, 120, 122]"
agent_c,L100,long,23,5,18,1,0.813,123,"[27, 28, 29, 45, 47, 49, 51, 53, 54, 55, 56, 57, 58, 59, 83, 84, 86, 87, 88, 89, 90, 118, 121]"
agent_c,L100,long,14,7,7,5,0.8772,114,"[27, 28, 30, 34, 53, 54, 57, 58, 60, 62, 87, 88, 90, 92]"
agent_c,L100,long,17,12,5,4,0.8547,117,"[13, 25, 26, 27, 29, 53, 54, 55, 56, 61, 85, 87, 91, 110, 113, 114, 115]"
agent_c,L100,long,19,7,12,1,0.8403,119,"[13, 24, 25, 26, 27, 29, 30, 31, 32, 34, 60, 62, 63, 91, 92, 93, 113, 115, 117]"
agent_c,L100,long,21,11,10,0,0.8264,121,"[27, 30, 31, 32, 50, 51, 52, 53, 54, 56, 59, 60, 61, 62, 86, 88, 89, 90, 93, 118, 119]"
agent_c,L100,long,24,8,16,2,0.8065,124,"[27, 28, 29, 45, 46, 47, 48, 49, 50, 51, 52, 53, 54, 55, 58, 59, 60, 85, 86, 88, 89, 92, 119, 121]"
agent_c,L100,long,19,5,14,1,0.8403,119,"[13, 24, 27, 29, 52, 54, 56, 57, 59, 83, 84, 85, 86, 88, 89, 90, 91, 93, 117]"
agent_c,L100,long,25,15,10,0,0.8,125,"[13, 27, 28, 29, 52, 53, 55, 56, 57, 58, 59, 61, 86, 87, 89, 90, 91, 113, 114, 115, 116, 117, 118, 120, 122]"
agent_c,L100,long,15,9,6,3,0.8696,115,"[27, 29, 31, 49, 51, 52, 53, 54, 60, 61, 62, 88, 89, 90, 94]"
agent_c,L100,long,25,19,6,0,0.8,125,"[13, 24, 25, 26, 28, 29, 30, 31, 56, 57, 58, 59, 60, 61, 89, 90, 91, 114, 115, 116, 117, 118, 119, 120, 121]"
agent_c,L100,long,23,11,12,1,0.813,123,"[27, 28, 29, 47, 48, 49, 51, 52, 54, 55, 57, 58, 60, 85, 86, 88, 89, 90, 116, 117, 118, 119, 121]"
agent_c,L100,long,19,13,6,1,0.8403,119,"[13, 25, 26, 27, 28, 29, 54, 55, 56, 57, 60, 85, 87, 88, 89, 90, 92, 114, 115]"
agent_c,L100,long,17,7,10,2,0.8547,117,"[28, 29, 31, 49, 50, 51, 52, 54, 55, 56, 59, 60, 62, 86, 87, 89, 91]"
agent_c,L100,long,28,9,19,1,0.7812,128,"[14, 27, 28, 30, 52, 53, 55, 59, 60, 83, 85, 86, 87, 88, 89, 90, 113, 114, 115, 116, 118, 119, 120, 121, 122, 123, 124, 126]"
agent_c,L100,long,20,6,14,4,0.8333,120,"[28, 29, 32, 49, 50, 51, 52, 53, 54, 56, 58, 59, 60, 87, 88, 89, 90, 93, 117, 118]"
agent_c,L100,long,23,15,8,2,0.813,123,"[15, 28, 31, 52, 55, 56, 57, 59, 82, 85, 86, 88, 89, 90, 110, 111, 112, 114, 115, 116, 117, 119, 120]"
agent_c,L100,long,17,7,10,0,0.8547,117,"[28, 29, 47, 48, 49, 51, 52, 53, 54, 56, 57, 59, 84, 87, 88, 89, 114]"
agent_c,L100,long,16,14,2,1,0.8621,116,"[28, 29, 46, 52, 53, 54, 55, 56, 60, 85, 86, 87, 88, 89, 112, 113]"
agent_c,L100,long,24,16,8,0,0.8065,124,"[13, 26, 27, 28, 29, 53, 54, 56, 57, 58, 59, 87, 90, 91, 111, 112, 113, 114, 116, 118, 119, 120, 121, 122]"
agent_c,L100,long,21,12,9,1,0.8264,121,"[28, 30, 47, 48, 49, 50, 53, 55, 57, 59, 60, 62, 85, 86, 88, 89, 90, 93, 94, 117, 119]"
agent_c,L100,long,19,11,8,2,0.8403,119,"[27, 28, 30, 47, 48, 49, 50, 51, 52, 53, 54, 56, 58, 59, 62, 90, 114, 115, 117]"
agent_c,L100,long,17,8,9,2,0.8547,117,"[27, 28, 30, 47, 48, 49, 50, 54, 55, 56, 57, 60, 85, 89, 113, 114, 115]"
agent_c,L100,long,16,10,6,0,0.8621,116,"[13, 24, 27, 28, 29, 53, 54, 55, 56, 58, 59, 85, 86, 88, 89, 113]"
agent_c,L100,long,22,7,15,1,0.8197,122,"[29, 44, 45, 46, 47, 48, 49, 52, 53, 56, 59, 83, 85, 86, 88, 90, 91, 115, 116, 118, 119, 120]"
agent_c,L100,long,20,11,9,1,0.8333,120,"[27, 30, 48, 49, 50, 52, 53, 56, 57, 58, 59, 83, 84, 85, 86, 87, 90, 91, 94, 118]"
agent_c,L100,long,20,4,16,0,0.8333,120,"[14, 27, 28, 29, 52, 54, 56, 57, 58, 60, 84, 85, 86, 87, 89, 90, 112, 113, 116, 118]"
agent_c,L100,long,21,9,12,2,0.8264,121,"[15, 27, 28, 29, 52, 53, 54, 55, 56, 58, 59, 60, 87, 91, 111, 113, 114, 115, 117, 118, 119]"
agent_c,L100,long,19,14,5,1,0.8403,119,"[28, 29, 30, 47, 48, 49, 50, 51, 52, 53, 54, 55, 57, 59, 61, 91, 114, 115, 117]"
agent_c,L100,long,15,6,9,0,0.8696,115,"[16, 28, 29, 34, 56, 57, 60, 63, 65, 66, 89, 90, 94, 95, 96]"
agent_c,L100,long,16,16,0,3,0.8621,116,"[29, 30, 47, 51, 52, 54, 55, 56, 57, 58, 59, 60, 64, 89, 90, 91]"
agent_c,L100,long,20,6,14,3,0.8333,120,"[28, 30, 48, 49, 50, 51, 55, 56, 58, 59, 87, 88, 90, 111, 112, 113, 114, 115, 116, 117]"
agent_c,L100,long,19,14,5,1,0.8403,119,"[13, 24, 27, 28, 29, 30, 55, 56, 57, 58, 59, 60, 86, 91, 111, 112, 113, 116, 117]"
agent_c,L100,long,15,7,8,2,0.8696,115,"[27, 28, 31, 50, 53, 54, 55, 57, 59, 82, 85, 86, 88, 89, 113]"
agent_c,L100,long,16,7,9,0,0.8621,116,"[13, 24, 25, 26, 28, 29, 30, 58, 59, 61, 62, 86, 87, 90, 92, 114]"
agent_c,L100,long,25,12,13,0,0.8,125,"[27, 28, 29, 45, 46, 47, 48, 50, 51, 52, 53, 54, 56, 57, 59, 83, 85, 86, 87, 88, 89, 91, 119, 120, 121]"
agent_c,L100,long,19,6,13,0,0.8403,119,"[13, 24, 25, 26, 27, 28, 29, 54, 55, 56, 58, 59, 89, 109, 111, 113, 114, 115, 116]"
agent_c,L100,long,22,9,13,0,0.8197,122,"[27, 28, 29, 45, 46, 47, 48, 53, 54, 56, 58, 59, 84, 85, 86, 87, 89, 114, 115, 117, 118, 119]"
agent_c,L100,long,22,16,6,0,0.8197,122,"[13, 25, 26, 27, 28, 29, 54, 56, 59, 84, 85, 86, 87, 89, 110, 111, 113, 114, 115, 116, 117, 119]"
agent_c,L100,long,25,16,9,2,0.8,125,"[27, 28, 30, 47, 48, 49, 50, 51, 52, 53, 54, 55, 58, 59, 83, 84, 85, 86, 87, 88, 90, 116, 117, 118, 119]"
agent_c,L100,long,24,11,13,3,0.8065,124,"[14, 28, 29, 30, 52, 53, 54, 56, 59, 60, 61, 86, 87, 88, 89, 90, 91, 113, 114, 116, 117, 118, 119, 120]"
agent_c,L100,long,16,14,2,1,0.8621,116,"[14, 26, 27, 28, 29, 30, 54, 55, 56, 57, 58, 59, 60, 89, 91, 113]"
agent_c,L100,long,22,5,17,2,0.8197,122,"[13, 27, 29, 30, 53, 55, 56, 57, 58, 59, 60, 61, 87, 88, 89, 90, 92, 114, 115, 117, 118, 119]"
agent_c,L100,long,16,7,9,0,0.8621,116,"[13, 24, 27, 29, 52, 53, 56, 59, 60, 83, 84, 86, 87, 90, 112, 113]"
agent_c,L100,long,18,12,6,0,0.8475,118,"[28, 29, 45, 46, 49, 50, 51, 54, 56, 58, 59, 83, 85, 86, 87, 89, 90, 116]"
agent_c,L100,long,19,10,9,0,0.8403,119,"[13, 24, 28, 29, 52, 53, 55, 56, 57, 58, 59, 61, 86, 87, 88, 90, 91, 114, 115]"
agent_c,L100,long,22,4,18,4,0.8197,122,"[27, 28, 29, 33, 51, 52, 54, 55, 57, 59, 60, 62, 85, 87, 88, 89, 90, 92, 116, 117, 118, 119]"
agent_c,L100,long,16,10,6,1,0.8621,116,"[28, 30, 47, 50, 51, 52, 53, 54, 56, 57, 58, 59, 60, 85, 91, 114]"
agent_c,L100,long,17,10,7,5,0.8547,117,"[14, 28, 31, 52, 53, 54, 55, 56, 57, 60, 63, 89, 90, 92, 111, 112, 115]"
agent_c,L100,long,18,13,5,2,0.8475,118,"[14, 26, 27, 28, 29, 30, 31, 56, 57, 60, 62, 86, 87, 88, 90, 92, 113, 114]"
agent_c,L100,long,21,8,13,1,0.8264,121,"[16, 29, 50, 51, 52, 54, 55, 56, 59, 83, 84, 85, 86, 88, 89, 90, 114, 115, 116, 117, 119]"
agent_c,L100,long,17,7,10,3,0.8547,117,"[13, 27, 28, 30, 52, 53, 54, 56, 58, 61, 63, 66, 90, 92, 93, 94, 95]"
agent_c,L100,long,17,11,6,1,0.8547,117,"[13, 24, 25, 27, 28, 29, 55, 57, 60, 83, 85, 87, 88, 89, 110, 111, 115]"
agent_c,L100,long,24,19,5,3,0.8065,124,"[13, 24, 25, 31, 52, 53, 54, 55, 57, 58, 60, 86, 87, 89, 110, 111, 112, 114, 115, 116, 117, 118, 119, 120]"
agent_c,L100,long,23,9,14,1,0.813,123,"[27, 28, 29, 45, 46, 47, 48, 49, 50, 52, 53, 55, 56, 57, 59, 83, 84, 85, 87, 88, 90, 119, 120]"
agent_c,L100,long,23,11,12,0,0.813,123,"[27, 28, 29, 45, 47, 48, 49, 51, 52, 53, 54, 55, 56, 58, 59, 60, 89, 90, 116, 117, 118, 119, 121]"
agent_c,L100,long,22,11,11,1,0.8197,122,"[28, 29, 46, 47, 49, 50, 51, 53, 54, 55, 56, 57, 58, 60, 86, 87, 89, 90, 116, 118, 119, 120]"
agent_c,L100,long,19,8,11,2,0.8403,119,"[13, 24, 26, 27, 28, 29, 55, 56, 59, 83, 85, 86, 87, 88, 91, 113, 114, 116, 117]"
agent_c,L100,long,18,8,10,1,0.8475,118,"[13, 25, 26, 28, 29, 53, 56, 57, 60, 83, 85, 86, 87, 88, 90, 114, 115, 116]"
agent_c,L100,long,22,6,16,2,0.8197,122,"[14, 26, 27, 29, 52, 53, 56, 61, 83, 89, 107, 109, 110, 111, 112, 113, 114, 115, 116, 117, 118, 119]"
agent_c,L100,long,14,8,6,5,0.8772,114,"[27, 31, 48, 49, 50, 54, 58, 60, 62, 85, 86, 88, 89, 93]"
agent_c,L100,long,19,13,6,1,0.8403,119,"[13, 24, 26, 27, 28, 30, 54, 55, 56, 58, 59, 86, 87, 88, 89, 111, 112, 113, 117]"
agent_c,L100,long,24,17,7,2,0.8065,124,"[13, 24, 25, 27, 28, 29, 30, 56, 57, 58, 59, 60, 62, 87, 89, 91, 112, 113, 114, 115, 117, 118, 120, 122]"
agent_c,L100,long,20,12,8,0,0.8333,120,"[28, 29, 45, 48, 49, 50, 57, 59, 60, 61, 62, 91, 92, 93, 113, 114, 115, 116, 117, 118]"
agent_c,L100,long,21,15,6,0,0.8264,121,"[13, 25, 26, 28, 29, 30, 54, 55, 56, 57, 58, 59, 60, 88, 89, 92, 93, 116, 117, 118, 119]"
agent_c,L100,long,27,19,8,0,0.7874,127,"[14, 27, 28, 29, 52, 54, 56, 57, 58, 59, 86, 87, 88, 89, 90, 91, 112, 113, 114, 115, 116, 117, 118, 119, 120, 121, 122]"
agent_c,L100,long,18,13,5,0,0.8475,118,"[27, 28, 29, 45, 48, 50, 51, 52, 53, 57, 59, 83, 84, 85, 86, 87, 89, 116]"
agent_c,L100,long,27,2,25,0,0.7874,127,"[27, 28, 29, 45, 46, 47, 48, 49, 50, 51, 52, 54, 55, 56, 57, 58, 60, 86, 88, 90, 91, 92, 93, 121, 122, 123, 125]"
agent_c,L100,long,23,8,15,1,0.813,123,"[28, 29, 30, 31, 49, 50, 51, 53, 55, 56, 57, 58, 59, 60, 61, 62, 89, 91, 92, 117, 118, 119, 121]"
agent_c,L100,long,28,10,18,0,0.7812,128,"[27, 28, 29, 30, 31, 49, 52, 53, 54, 55, 56, 58, 59, 60, 61, 88, 89, 90, 91, 92, 93, 94, 95, 96, 122, 123, 125, 126]"
agent_c,L100,long,13,7,6,7,0.885,113,"[13, 24, 25, 26, 28, 29, 54, 55, 58, 62, 85, 88, 94]"
agent_c,L100,long,12,4,8,5,0.8929,112,"[13, 24, 26, 29, 54, 55, 57, 58, 63, 87, 90, 92]"
agent_c,L100,long,21,15,6,1,0.8264,121,"[14, 26, 27, 29, 52, 54, 58, 60, 83, 85, 86, 87, 88, 90, 110, 111, 113, 114, 116, 117, 118]"
agent_c,L100,long,12,4,8,5,0.8929,112,"[13, 24, 25, 31, 53, 55, 56, 57, 58, 59, 84, 92]"
agent_c,L100,long,21,7,14,0,0.8264,121,"[27, 28, 29, 46, 47, 48, 49, 50, 51, 53, 54, 56, 58, 62, 64, 91, 92, 94, 116, 118, 119]"
