agent_name,layout,event_update_level,num_attention_switches,num_attention_switches_margins,num_attention_switches_middle,inform_loss,reading_speed,total_steps,attention_switches_time_steps_list
agent_c,L0,short,133,62,71,5,0.335,200,"[1, 3, 4, 5, 6, 7, 8, 9, 11, 12, 13, 14, 15, 16, 17, 18, 19, 20, 22, 23, 24, 25, 26, 27, 28, 32, 33, 34, 35, 37, 38, 39, 40, 45, 47, 48, 49, 50, 51, 52, 54, 55, 56, 57, 58, 59, 60, 65, 66, 67, 69, 70, 71, 73, 75, 76, 79, 82, 83, 84, 86, 87, 89, 90, 92, 95, 96, 97, 98, 99, 100, 101, 102, 103, 104, 105, 108, 109, 110, 111, 112, 113, 114, 115, 116, 117, 118, 119, 122, 124, 125, 126, 127, 129, 130, 131, 132, 134, 135, 136, 137, 138, 140, 141, 142, 145, 146, 148, 149, 152, 153, 154, 156, 157, 158, 159, 162, 166, 172, 173, 174, 176, 177, 179, 180, 182, 183, 185, 186, 187, 189, 191, 193]"
agent_c,L0,short,125,85,40,9,0.375,200,"[0, 2, 3, 4, 5, 9, 10, 11, 12, 14, 15, 16, 17, 18, 19, 20, 21, 22, 24, 25, 34, 35, 37, 40, 42, 43, 47, 48, 49, 50, 52, 53, 54, 55, 56, 57, 58, 62, 63, 64, 65, 69, 70, 71, 72, 73, 75, 76, 77, 78, 80, 82, 83, 84, 85, 88, 89, 90, 91, 92, 93, 94, 95, 96, 97, 98, 100, 103, 106, 107, 110, 111, 112, 113, 114, 116, 117, 119, 121, 122, 124, 125, 127, 128, 129, 130, 132, 135, 138, 140, 142, 143, 146, 149, 150, 151, 152, 157, 158, 159, 160, 161, 162, 164, 165, 166, 168, 171, 172, 173, 174, 176, 177, 179, 180, 182, 183, 184, 185, 186, 187, 188, 189, 191, 193]"
agent_c,L0,short,130,66,64,11,0.35,200,"[0, 2, 4, 6, 8, 9, 10, 12, 14, 15, 18, 19, 20, 21, 25, 26, 29, 33, 35, 36, 37, 39, 41, 45, 46, 47, 48, 54, 55, 56, 58, 59, 61, 62, 63, 65, 66, 68, 69, 70, 72, 73, 75, 76, 77, 78, 80, 81, 83, 85, 87, 88, 89, 91, 92, 93, 94, 95, 96, 97, 98, 100, 102, 103, 104, 105, 106, 107, 108, 109, 111, 112, 113, 114, 117, 118, 121, 122, 123, 124, 126, 127, 128, 132, 134, 135, 136, 137, 138, 139, 140, 142, 144, 146, 147, 148, 149, 150, 152, 153, 154, 155, 156, 157, 159, 161, 163, 164, 166, 167, 168, 170, 172, 173, 174, 175, 176, 177, 178, 179, 180, 183, 184, 185, 186, 187, 188, 189, 193, 199]"
agent_c,L0,short,130,58,72,10,0.35,200,"[1, 4, 7, 8, 10, 13, 14, 15, 17, 19, 20, 21, 22, 24, 25, 26, 27, 28, 29, 30, 31, 35, 40, 41, 43, 44, 46, 47, 49, 50, 53, 55, 57, 58, 59, 61, 62, 63, 64, 66, 70, 71, 72, 73, 76, 77, 78, 80, 81, 82, 83, 84, 86, 87, 88, 89, 91, 92, 94, 95, 96, 97, 98, 100, 101, 102, 103, 104, 105, 106, 108, 109, 110, 112, 114, 115, 116, 117, 118, 120, 121, 122, 123, 125, 126, 127, 128, 129, 130, 131, 132, 134, 135, 136, 137, 139, 140, 141, 142, 143, 147, 148, 149, 150, 151, 154, 156, 158, 159, 160, 161, 162, 163, 164, 167, 169, 171, 174, 175, 176, 177, 178, 182, 185, 186, 187, 189, 190, 191, 193]"
agent_c,L0,short,126,58,68,12,0.37,200,"[0, 2, 4, 5, 7, 8, 10, 13, 15, 17, 18, 19, 20, 21, 22, 23, 24, 26, 27, 29, 30, 33, 34, 35, 36, 38, 40, 43, 46, 47, 48, 51, 53, 54, 55, 56, 58, 59, 60, 62, 64, 65, 66, 67, 68, 70, 72, 74, 75, 77, 78, 79, 81, 82, 84, 85, 86, 87, 88, 89, 90, 91, 93, 94, 95, 97, 99, 100, 102, 105, 106, 110, 111, 113, 115, 116, 117, 119, 120, 125, 126, 128, 129, 130, 133, 134, 135, 136, 137, 139, 140, 141, 142, 144, 145, 146, 148, 151, 152, 153, 156, 158, 159, 160, 162, 165, 167, 169, 170, 171, 172, 173, 174, 176, 177, 178, 179, 181, 184, 186, 187, 190, 192, 197, 198, 199]"
agent_c,L0,short,139,66,73,9,0.305,200,"[2, 3, 4, 5, 6, 8, 10, 11, 13, 14, 15, 18, 19, 20, 21, 22, 24, 25, 26, 27, 29, 31, 34, 35, 36, 37, 38, 39, 40, 42, 43, 44, 46, 48, 49, 50, 51, 52, 53, 54, 55, 56, 58, 59, 61, 67, 68, 69, 71, 72, 73, 74, 75, 77, 78, 80, 83, 86, 87, 88, 89, 92, 94, 95, 96, 97, 98, 100, 101, 102, 103, 105, 108, 109, 110, 111, 112, 113, 114, 115, 116, 117, 118, 119, 120, 124, 125, 126, 127, 128, 129, 132, 133, 134, 136, 137, 138, 139, 141, 142, 143, 144, 145, 146, 147, 148, 149, 150, 151, 152, 153, 155, 157, 158, 159, 160, 161, 162, 163, 165, 166, 167, 169, 170, 172, 175, 176, 177, 178, 180, 181, 182, 183, 184, 187, 188, 190, 191, 192]"
agent_c,L0,short,127,76,51,9,0.365,200,"[0, 1, 2, 3, 5, 8, 10, 11, 13, 14, 15, 19, 21, 22, 23, 24, 25, 27, 29, 31, 34, 37, 39, 40, 41, 42, 43, 44, 45, 46, 47, 48, 49, 50, 52, 53, 58, 59, 60, 61, 62, 63, 64, 66, 68, 70, 71, 72, 73, 74, 75, 76, 77, 79, 80, 81, 83, 84, 85, 88, 89, 91, 93, 94, 95, 96, 98, 101, 102, 103, 106, 107, 108, 114, 115, 117, 118, 119, 120, 121, 122, 123, 124, 125, 127, 129, 130, 135, 136, 137, 138, 140, 141, 142, 143, 146, 147, 148, 149, 151, 152, 153, 154, 155, 157, 158, 159, 161, 163, 165, 166, 168, 169, 170, 172, 174, 175, 178, 182, 183, 184, 185, 188, 189, 191, 194, 197]"
agent_c,L0,short,135,62,73,6,0.325,200,"[0, 1, 2, 4, 6, 7, 9, 10, 12, 14, 15, 16, 17, 18, 20, 22, 23, 24, 26, 27, 30, 32, 33, 34, 35, 37, 38, 40, 43, 45, 46, 48, 49, 50, 51, 52, 53, 54, 55, 57, 58, 59, 60, 63, 64, 66, 68, 69, 70, 72, 73, 74, 75, 76, 77, 79, 80, 81, 82, 84, 86, 88, 89, 90, 93, 94, 96, 97, 98, 100, 101, 102, 103, 104, 105, 106, 108, 110, 111, 112, 113, 114, 116, 117, 118, 119, 120, 122, 123, 124, 126, 127, 128, 129, 130, 132, 133, 134, 135, 136, 137, 138, 140, 141, 142, 143, 144, 145, 146, 147, 148, 149, 152, 153, 156, 158, 162, 163, 164, 167, 169, 170, 171, 172, 175, 179, 181, 182, 183, 184, 186, 189, 193, 195, 196]"
agent_c,L0,short,126,52,74,7,0.37,200,"[2, 8, 9, 10, 13, 14, 15, 17, 18, 19, 20, 21, 23, 24, 26, 27, 28, 29, 30, 31, 32, 33, 37, 38, 39, 40, 41, 42, 46, 47, 48, 49, 50, 53, 54, 55, 57, 58, 59, 61, 62, 64, 65, 66, 67, 71, 72, 73, 74, 75, 76, 77, 79, 80, 82, 84, 85, 86, 87, 88, 89, 91, 92, 94, 95, 97, 99, 101, 102, 103, 106, 107, 108, 110, 112, 113, 114, 116, 117, 118, 119, 120, 121, 123, 125, 129, 130, 132, 135, 136, 137, 138, 141, 142, 143, 145, 146, 147, 149, 150, 151, 153, 154, 155, 156, 158, 159, 160, 162, 163, 164, 165, 166, 169, 171, 174, 176, 179, 180, 182, 183, 185, 186, 188, 189, 191]"
agent_c,L0,short,133,49,84,11,0.335,200,"[1, 2, 3, 6, 7, 8, 9, 10, 12, 16, 17, 19, 20, 21, 22, 24, 26, 27, 28, 30, 33, 34, 35, 36, 37, 38, 40, 41, 43, 44, 45, 47, 48, 50, 52, 53, 54, 55, 56, 57, 58, 59, 60, 61, 62, 64, 68, 70, 71, 72, 73, 74, 75, 77, 78, 79, 84, 85, 87, 89, 90, 91, 92, 94, 95, 98, 99, 100, 102, 103, 104, 105, 106, 107, 109, 110, 111, 112, 113, 114, 115, 116, 117, 118, 119, 121, 122, 123, 125, 127, 128, 130, 131, 133, 134, 136, 137, 141, 143, 144, 146, 147, 148, 149, 150, 153, 154, 155, 156, 158, 161, 162, 163, 164, 165, 166, 167, 168, 169, 170, 171, 175, 177, 178, 180, 183, 184, 185, 188, 189, 190, 191, 193]"
agent_c,L0,short,132,65,67,10,0.34,200,"[0, 1, 2, 3, 4, 5, 7, 8, 9, 10, 11, 12, 13, 14, 15, 17, 18, 19, 20, 21, 22, 24, 26, 29, 31, 32, 33, 34, 37, 38, 39, 40, 41, 42, 44, 45, 46, 48, 50, 52, 53, 54, 55, 56, 57, 58, 62, 63, 64, 65, 68, 70, 71, 72, 73, 75, 76, 79, 82, 84, 85, 87, 88, 89, 90, 92, 96, 97, 98, 99, 100, 102, 103, 104, 105, 106, 107, 108, 113, 114, 115, 116, 117, 118, 121, 123, 126, 127, 128, 129, 130, 131, 133, 134, 136, 137, 138, 139, 141, 142, 143, 144, 146, 147, 148, 150, 151, 152, 153, 154, 155, 156, 157, 160, 162, 163, 164, 165, 168, 171, 173, 175, 177, 181, 182, 184, 188, 193, 195, 196, 197, 198]"
agent_c,L0,short,132,48,84,9,0.34,200,"[1, 3, 4, 5, 7, 11, 12, 15, 17, 18, 19, 20, 21, 23, 24, 25, 26, 27, 28, 29, 30, 31, 32, 34, 35, 37, 38, 39, 40, 42, 43, 44, 45, 46, 47, 49, 50, 51, 52, 53, 55, 56, 57, 58, 62, 63, 64, 65, 66, 67, 69, 70, 71, 72, 73, 74, 76, 77, 79, 80, 83, 85, 86, 88, 89, 91, 92, 93, 95, 96, 98, 99, 100, 102, 105, 107, 108, 109, 110, 111, 112, 113, 115, 116, 117, 118, 122, 125, 126, 128, 129, 130, 133, 136, 137, 139, 142, 143, 144, 145, 146, 147, 148, 149, 151, 152, 155, 156, 158, 159, 160, 161, 162, 164, 167, 169, 171, 172, 173, 177, 178, 182, 184, 185, 186, 187, 188, 189, 190, 191, 192, 195]"
agent_c,L0,short,127,65,62,5,0.365,200,"[2, 3, 5, 6, 7, 8, 9, 10, 12, 13, 14, 15, 17, 18, 19, 21, 22, 24, 25, 27, 28, 30, 31, 32, 33, 34, 35, 36, 37, 38, 40, 41, 42, 45, 46, 47, 49, 50, 52, 53, 54, 58, 60, 61, 62, 65, 67, 69, 70, 71, 73, 74, 77, 79, 80, 81, 83, 84, 86, 87, 88, 92, 93, 94, 95, 96, 97, 98, 100, 101, 103, 104, 105, 109, 112, 114, 116, 117, 118, 120, 121, 122, 123, 124, 125, 126, 127, 128, 130, 131, 132, 134, 135, 137, 138, 139, 141, 144, 145, 146, 148, 149, 153, 154, 157, 159, 161, 163, 165, 166, 167, 169, 173, 174, 176, 177, 179, 180, 183, 184, 185, 186, 192, 193, 194, 195, 196]"
agent_c,L0,short,130,60,70,4,0.35,200,"[1, 2, 3, 5, 6, 7, 9, 10, 11, 12, 13, 15, 17, 18, 19, 21, 22, 24, 25, 27, 28, 29, 30, 31, 33, 34, 36, 37, 42, 43, 44, 45, 46, 47, 48, 51, 53, 56, 57, 58, 59, 60, 64, 66, 67, 68, 69, 72, 73, 74, 77, 78, 79, 80, 81, 82, 83, 84, 85, 87, 88, 89, 90, 91, 94, 95, 96, 97, 100, 102, 104, 106, 107, 108, 109, 111, 112, 113, 114, 115, 116, 120, 121, 123, 124, 126, 127, 128, 129, 130, 131, 132, 133, 136, 137, 138, 140, 141, 142, 144, 146, 147, 148, 149, 150, 151, 152, 155, 156, 158, 159, 162, 163, 165, 166, 167, 171, 172, 174, 175, 176, 177, 178, 181, 182, 187, 188, 194, 197, 198]"
agent_c,L0,short,121,53,68,4,0.395,200,"[1, 2, 4, 5, 6, 8, 10, 13, 14, 15, 18, 21, 22, 23, 24, 33, 34, 35, 36, 37, 38, 40, 41, 42, 43, 46, 47, 48, 49, 51, 52, 53, 55, 57, 58, 59, 62, 63, 64, 66, 68, 71, 73, 74, 76, 77, 78, 79, 80, 81, 83, 85, 86, 87, 88, 89, 92, 95, 96, 97, 98, 99, 100, 101, 102, 103, 106, 107, 109, 112, 114, 116, 117, 118, 119, 122, 123, 125, 126, 127, 128, 129, 130, 134, 135, 137, 138, 139, 140, 142, 145, 147, 148, 149, 150, 152, 153, 154, 155, 157, 158, 159, 160, 161, 163, 164, 165, 166, 167, 170, 171, 172, 174, 175, 177, 179, 182, 184, 186, 191, 199]"
agent_c,L0,short,129,74,55,15,0.355,200,"[1, 2, 3, 5, 6, 7, 10, 11, 12, 13, 14, 16, 17, 18, 19, 20, 21, 22, 23, 25, 26, 27, 28, 32, 34, 37, 39, 41, 43, 45, 46, 47, 52, 55, 58, 59, 60, 61, 62, 64, 65, 66, 68, 70, 71, 72, 74, 75, 76, 77, 78, 79, 80, 82, 83, 85, 87, 88, 89, 90, 91, 92, 95, 96, 97, 98, 100, 101, 102, 103, 104, 108, 109, 110, 111, 112, 113, 116, 117, 118, 119, 121, 123, 124, 125, 126, 127, 128, 129, 131, 133, 136, 137, 138, 139, 140, 142, 143, 144, 145, 146, 147, 150, 154, 155, 156, 158, 160, 161, 162, 163, 165, 166, 170, 173, 174, 175, 176, 177, 179, 181, 184, 185, 186, 188, 189, 196, 197, 198]"
agent_c,L0,short,139,74,65,3,0.305,200,"[0, 1, 2, 4, 5, 6, 7, 8, 10, 11, 12, 13, 15, 16, 17, 18, 19, 21, 22, 24, 25, 27, 28, 30, 31, 32, 33, 34, 35, 37, 38, 40, 41, 42, 44, 46, 47, 48, 49, 50, 51, 54, 56, 60, 61, 62, 63, 64, 65, 66, 67, 69, 70, 73, 76, 77, 78, 79, 80, 81, 82, 85, 86, 87, 88, 89, 91, 92, 95, 96, 98, 99, 100, 101, 102, 103, 104, 105, 106, 107, 108, 109, 110, 111, 112, 113, 114, 116, 117, 119, 120, 121, 122, 123, 124, 125, 127, 129, 130, 131, 132, 133, 134, 135, 136, 139, 140, 141, 142, 145, 146, 148, 149, 151, 155, 156, 157, 158, 159, 160, 162, 166, 169, 172, 173, 175, 176, 177, 179, 180, 185, 186, 190, 191, 193, 194, 195, 196, 197]"
agent_c,L0,short,128,57,71,11,0.36,200,"[0, 2, 3, 4, 5, 6, 7, 10, 11, 12, 13, 14, 16, 18, 19, 20, 21, 23, 24, 26, 27, 33, 35, 36, 37, 38, 42, 45, 46, 47, 50, 51, 52, 53, 58, 60, 61, 63, 64, 65, 68, 69, 70, 72, 75, 76, 77, 78, 79, 83, 84, 85, 86, 87, 89, 90, 92, 93, 94, 95, 98, 99, 100, 101, 103, 104, 105, 108, 110, 111, 112, 113, 119, 121, 124, 125, 126, 127, 129, 130, 131, 132, 133, 134, 135, 137, 138, 139, 140, 141, 142, 145, 146, 147, 148, 150, 151, 153, 154, 156, 158, 159, 161, 162, 163, 165, 166, 168, 169, 170, 171, 172, 173, 174, 175, 177, 179, 180, 181, 183, 184, 186, 188, 193, 194, 195, 196, 197]"
agent_c,L0,short,134,51,83,13,0.33,200,"[0, 1, 2, 6, 7, 8, 9, 10, 12, 13, 15, 16, 17, 18, 19, 22, 24, 25, 26, 27, 28, 30, 31, 32, 33, 34, 36, 37, 38, 39, 40, 41, 42, 47, 48, 49, 50, 51, 52, 53, 54, 55, 56, 60, 62, 63, 64, 66, 67, 68, 69, 70, 71, 72, 73, 74, 77, 78, 80, 81, 82, 86, 87, 89, 90, 91, 93, 94, 95, 98, 99, 101, 102, 103, 104, 109, 110, 112, 113, 114, 115, 116, 117, 118, 119, 120, 122, 123, 124, 126, 127, 128, 129, 131, 133, 134, 135, 136, 137, 139, 140, 141, 142, 143, 144, 145, 147, 148, 149, 150, 152, 153, 154, 155, 156, 157, 158, 159, 160, 161, 163, 167, 169, 170, 174, 175, 177, 183, 185, 186, 187, 194, 196, 198]"
agent_c,L0,short,122,53,69,17,0.39,200,"[1, 3, 8, 9, 12, 13, 14, 15, 16, 17, 18, 19, 22, 23, 24, 25, 26, 27, 28, 29, 32, 35, 37, 38, 39, 40, 41, 42, 43, 44, 45, 47, 51, 52, 53, 54, 55, 56, 59, 62, 63, 64, 65, 66, 72, 73, 74, 75, 76, 77, 78, 79, 80, 81, 82, 83, 85, 86, 87, 88, 89, 91, 92, 93, 95, 97, 98, 99, 104, 106, 108, 110, 111, 112, 113, 114, 115, 120, 122, 123, 124, 126, 128, 129, 130, 131, 133, 134, 136, 138, 139, 140, 143, 145, 146, 148, 150, 151, 152, 154, 155, 156, 157, 158, 159, 162, 163, 164, 167, 172, 173, 174, 176, 177, 179, 181, 183, 185, 186, 189, 190, 195]"
agent_c,L0,short,136,66,70,5,0.32,200,"[0, 2, 3, 4, 5, 6, 8, 9, 10, 14, 16, 18, 19, 20, 21, 22, 23, 27, 29, 30, 32, 35, 36, 37, 39, 40, 41, 43, 44, 45, 46, 47, 48, 49, 50, 51, 53, 54, 55, 56, 57, 58, 59, 61, 62, 63, 64, 65, 67, 68, 69, 70, 72, 74, 77, 79, 80, 81, 82, 84, 85, 86, 88, 91, 92, 95, 96, 97, 98, 100, 101, 102, 103, 104, 105, 106, 108, 109, 110, 112, 113, 115, 117, 118, 120, 121, 122, 123, 124, 125, 127, 128, 130, 134, 135, 136, 137, 138, 139, 140, 142, 144, 147, 149, 150, 151, 152, 153, 154, 155, 157, 158, 160, 161, 162, 164, 167, 171, 172, 173, 175, 176, 177, 178, 179, 180, 181, 182, 184, 185, 186, 187, 191, 192, 195, 196]"
agent_c,L0,short,129,67,62,6,0.355,200,"[0, 1, 2, 3, 5, 6, 7, 8, 9, 11, 13, 15, 17, 18, 19, 21, 22, 23, 24, 25, 26, 27, 28, 29, 30, 34, 36, 37, 38, 39, 42, 43, 45, 46, 47, 48, 50, 52, 55, 56, 58, 59, 61, 63, 64, 66, 68, 69, 70, 71, 75, 76, 77, 79, 81, 83, 86, 87, 89, 91, 95, 99, 102, 103, 104, 106, 107, 108, 109, 110, 111, 114, 115, 116, 117, 119, 120, 121, 122, 123, 124, 125, 127, 128, 129, 130, 132, 133, 134, 136, 137, 139, 140, 141, 143, 145, 146, 149, 150, 152, 154, 155, 157, 158, 159, 160, 161, 162, 165, 166, 167, 168, 169, 171, 174, 175, 177, 178, 179, 181, 182, 183, 185, 186, 187, 188, 189, 197, 198]"
agent_c,L0,short,136,81,55,12,0.32,200,"[0, 2, 4, 5, 7, 8, 9, 11, 12, 13, 14, 15, 16, 17, 18, 21, 22, 23, 26, 27, 28, 29, 33, 34, 35, 36, 37, 39, 40, 41, 42, 43, 46, 47, 48, 49, 51, 53, 54, 55, 56, 57, 58, 59, 60, 62, 64, 66, 68, 69, 70, 71, 73, 77, 78, 79, 81, 83, 84, 85, 88, 90, 92, 93, 95, 96, 97, 99, 100, 102, 104, 107, 108, 109, 110, 111, 113, 115, 117, 118, 122, 123, 124, 125, 126, 128, 129, 130, 131, 132, 135, 137, 138, 141, 142, 143, 144, 145, 146, 147, 148, 149, 151, 152, 153, 154, 155, 156, 157, 158, 159, 160, 161, 162, 163, 164, 165, 166, 168, 169, 170, 171, 173, 175, 177, 178, 179, 180, 181, 183, 184, 185, 186, 188, 189, 191]"
agent_c,L0,short,132,71,61,10,0.34,200,"[0, 2, 3, 6, 7, 8, 10, 12, 13, 15, 16, 17, 18, 19, 20, 24, 25, 26, 29, 30, 31, 33, 34, 36, 39, 42, 43, 44, 45, 46, 50, 53, 55, 56, 58, 59, 60, 61, 63, 64, 65, 66, 68, 69, 70, 71, 72, 73, 74, 75, 77, 78, 79, 80, 81, 83, 85, 87, 89, 90, 91, 92, 93, 94, 98, 101, 102, 103, 105, 108, 109, 110, 111, 112, 115, 116, 117, 119, 121, 122, 123, 125, 127, 128, 130, 132, 133, 134, 137, 138, 139, 140, 141, 142, 143, 145, 148, 149, 150, 151, 152, 153, 154, 155, 156, 157, 158, 159, 160, 161, 162, 163, 164, 166, 168, 171, 172, 173, 174, 175, 176, 179, 180, 181, 183, 184, 189, 190, 191, 192, 194, 195]"
agent_c,L0,short,131,70,61,13,0.345,200,"[1, 4, 5, 6, 9, 10, 12, 13, 15, 16, 17, 19, 20, 21, 23, 24, 25, 27, 29, 32, 33, 34, 35, 36, 37, 38, 40, 41, 44, 45, 46, 47, 49, 50, 52, 53, 54, 56, 57, 58, 61, 62, 63, 65, 67, 69, 70, 71, 72, 76, 77, 78, 79, 80, 82, 83, 85, 87, 88, 89, 90, 91, 93, 94, 95, 96, 98, 99, 100, 101, 102, 107, 108, 109, 110, 112, 113, 114, 117, 118, 119, 120, 121, 125, 126, 129, 130, 131, 134, 135, 137, 138, 140, 141, 142, 144, 145, 146, 147, 148, 150, 151, 153, 155, 156, 157, 158, 159, 161, 162, 163, 164, 166, 167, 168, 169, 171, 173, 174, 175, 176, 178, 180, 182, 183, 184, 185, 186, 189, 195, 197]"
agent_c,L0,short,131,64,67,4,0.345,200,"[0, 4, 5, 6, 7, 8, 11, 14, 15, 16, 17, 18, 19, 20, 21, 23, 25, 26, 28, 29, 30, 32, 33, 34, 36, 37, 38, 39, 41, 42, 43, 46, 47, 48, 50, 51, 52, 54, 55, 56, 57, 58, 62, 63, 65, 67, 69, 70, 71, 72, 74, 75, 76, 78, 79, 80, 82, 83, 86, 88, 89, 90, 91, 93, 94, 95, 97, 99, 100, 101, 103, 105, 107, 109, 111, 114, 115, 117, 119, 120, 121, 122, 123, 125, 126, 127, 129, 130, 131, 132, 133, 134, 135, 136, 138, 142, 143, 145, 146, 147, 148, 150, 151, 156, 158, 159, 160, 161, 164, 165, 166, 167, 168, 170, 171, 172, 173, 175, 176, 177, 178, 179, 180, 185, 186, 189, 192, 193, 194, 195, 196]"
agent_c,L0,short,121,61,60,13,0.395,200,"[1, 4, 6, 7, 8, 9, 10, 13, 14, 16, 18, 19, 20, 21, 22, 23, 24, 30, 33, 34, 36, 37, 38, 39, 40, 42, 44, 45, 46, 47, 48, 49, 52, 53, 54, 56, 57, 58, 59, 61, 62, 63, 66, 67, 69, 72, 73, 74, 75, 76, 79, 80, 83, 84, 85, 86, 87, 89, 90, 91, 93, 95, 96, 97, 99, 102, 104, 105, 107, 108, 109, 113, 115, 117, 118, 119, 121, 122, 123, 124, 127, 128, 129, 132, 133, 137, 139, 140, 141, 142, 144, 145, 146, 148, 149, 150, 151, 152, 153, 155, 160, 161, 162, 165, 167, 170, 172, 173, 174, 176, 177, 178, 180, 184, 185, 186, 188, 189, 190, 191, 198]"
agent_c,L0,short,128,66,62,10,0.36,200,"[1, 2, 4, 6, 7, 9, 10, 11, 13, 15, 17, 20, 21, 23, 25, 26, 27, 30, 32, 33, 36, 37, 40, 41, 42, 43, 45, 46, 47, 48, 49, 50, 52, 53, 57, 59, 60, 61, 62, 64, 65, 66, 68, 71, 72, 74, 75, 76, 77, 79, 83, 84, 85, 86, 87, 88, 89, 90, 93, 95, 97, 100, 101, 102, 103, 106, 108, 109, 113, 114, 115, 116, 117, 118, 119, 120, 121, 125, 127, 128, 130, 132, 133, 134, 135, 136, 138, 140, 141, 142, 143, 144, 147, 149, 150, 152, 153, 155, 157, 158, 159, 160, 161, 162, 163, 164, 165, 166, 167, 168, 170, 172, 173, 174, 175, 177, 178, 179, 180, 181, 182, 184, 186, 190, 191, 194, 196, 197]"
agent_c,L0,short,132,71,61,5,0.34,200,"[0, 1, 2, 4, 6, 7, 8, 9, 12, 14, 15, 17, 18, 19, 20, 22, 23, 24, 25, 26, 31, 32, 33, 34, 35, 37, 38, 39, 40, 41, 46, 47, 48, 49, 50, 51, 55, 56, 59, 61, 62, 64, 65, 68, 69, 70, 71, 74, 75, 77, 78, 79, 81, 82, 83, 84, 85, 87, 88, 91, 92, 93, 94, 95, 96, 97, 99, 100, 101, 102, 103, 105, 106, 107, 110, 111, 112, 113, 116, 117, 118, 120, 121, 125, 126, 128, 129, 131, 132, 135, 137, 138, 139, 140, 141, 142, 143, 145, 146, 147, 148, 149, 150, 151, 152, 154, 155, 156, 157, 159, 160, 162, 164, 165, 169, 170, 172, 173, 174, 176, 178, 179, 180, 181, 183, 184, 185, 190, 192, 193, 194, 196]"
agent_c,L0,short,129,67,62,9,0.355,200,"[2, 4, 6, 7, 10, 13, 14, 15, 16, 17, 18, 19, 20, 21, 22, 23, 25, 29, 30, 31, 32, 34, 35, 36, 40, 41, 42, 44, 48, 49, 51, 52, 53, 55, 59, 62, 63, 64, 65, 66, 67, 68, 69, 70, 71, 72, 73, 74, 75, 76, 77, 78, 79, 80, 83, 84, 86, 87, 89, 92, 93, 94, 95, 97, 98, 99, 102, 104, 106, 107, 108, 110, 111, 112, 115, 116, 117, 118, 120, 121, 125, 126, 127, 129, 131, 132, 133, 135, 137, 138, 139, 140, 141, 143, 145, 147, 148, 151, 152, 153, 154, 155, 156, 157, 158, 159, 160, 162, 168, 169, 170, 171, 173, 174, 177, 178, 179, 180, 181, 182, 183, 186, 189, 191, 192, 193, 194, 195, 197]"
agent_c,L0,short,133,74,59,6,0.335,200,"[1, 5, 6, 9, 10, 11, 12, 15, 16, 17, 22, 24, 25, 26, 27, 28, 29, 31, 32, 33, 36, 37, 38, 40, 43, 44, 45, 46, 48, 49, 52, 53, 54, 55, 57, 58, 59, 60, 62, 63, 65, 67, 68, 69, 70, 73, 74, 75, 76, 77, 78, 82, 84, 85, 86, 87, 88, 89, 92, 93, 94, 95, 97, 100, 101, 102, 103, 104, 105, 106, 108, 109, 110, 111, 112, 113, 114, 115, 116, 119, 120, 121, 123, 124, 126, 127, 130, 131, 133, 134, 135, 136, 137, 138, 139, 140, 141, 142, 143, 144, 145, 147, 149, 150, 151, 152, 153, 154, 155, 156, 157, 158, 159, 161, 162, 163, 164, 165, 166, 167, 168, 169, 172, 174, 176, 177, 178, 180, 183, 192, 197, 198, 199]"
agent_c,L0,short,123,69,54,12,0.385,200,"[0, 1, 2, 3, 4, 6, 8, 13, 15, 17, 19, 20, 21, 24, 25, 26, 27, 30, 31, 32, 34, 39, 41, 42, 43, 44, 47, 48, 49, 50, 51, 52, 54, 55, 59, 60, 61, 62, 63, 64, 65, 67, 68, 69, 70, 71, 72, 74, 75, 76, 77, 79, 80, 82, 86, 87, 88, 92, 94, 95, 97, 98, 105, 106, 109, 110, 113, 115, 116, 118, 121, 122, 123, 126, 127, 128, 129, 130, 131, 132, 134, 135, 136, 139, 140, 143, 144, 145, 146, 148, 149, 150, 151, 153, 155, 156, 157, 160, 161, 163, 165, 166, 167, 168, 170, 172, 173, 175, 177, 178, 179, 182, 183, 185, 186, 187, 188, 189, 191, 193, 194, 195, 197]"
agent_c,L0,short,133,66,67,11,0.335,200,"[1, 2, 3, 4, 6, 7, 9, 10, 12, 13, 14, 15, 17, 18, 19, 21, 24, 25, 26, 27, 28, 31, 33, 34, 35, 36, 37, 38, 41, 42, 43, 44, 45, 46, 47, 48, 49, 50, 51, 53, 55, 56, 58, 60, 61, 63, 64, 66, 67, 68, 69, 70, 71, 74, 75, 76, 79, 80, 81, 82, 83, 85, 86, 87, 89, 91, 92, 93, 94, 96, 97, 98, 99, 102, 103, 104, 105, 107, 108, 109, 110, 111, 112, 113, 114, 117, 120, 121, 122, 123, 124, 125, 126, 127, 128, 129, 131, 133, 134, 137, 140, 141, 142, 143, 147, 149, 150, 152, 153, 154, 155, 156, 157, 158, 159, 161, 162, 164, 167, 169, 170, 171, 172, 175, 176, 177, 180, 181, 184, 186, 187, 196, 198]"
agent_c,L0,short,120,60,60,7,0.4,200,"[1, 2, 4, 6, 7, 8, 9, 10, 15, 16, 18, 19, 21, 22, 25, 26, 28, 29, 30, 32, 34, 35, 37, 39, 41, 42, 44, 46, 49, 50, 51, 53, 54, 55, 56, 57, 59, 60, 62, 64, 67, 68, 70, 71, 74, 75, 76, 77, 78, 79, 81, 83, 84, 85, 86, 87, 89, 90, 91, 92, 94, 96, 98, 100, 103, 104, 106, 108, 109, 110, 113, 117, 118, 120, 121, 122, 124, 126, 130, 131, 134, 136, 138, 140, 142, 144, 145, 146, 147, 149, 150, 151, 153, 156, 158, 159, 164, 165, 167, 169, 170, 171, 174, 175, 176, 178, 179, 180, 181, 182, 183, 184, 186, 187, 188, 189, 190, 192, 197, 198]"
agent_c,L0,short,125,56,69,11,0.375,200,"[0, 2, 4, 10, 15, 16, 17, 18, 19, 21, 22, 23, 24, 25, 26, 28, 29, 30, 31, 36, 37, 39, 40, 41, 42, 43, 45, 46, 47, 48, 49, 51, 54, 55, 56, 57, 58, 59, 60, 61, 64, 65, 66, 69, 70, 73, 74, 76, 77, 78, 83, 85, 87, 88, 89, 91, 92, 93, 95, 98, 99, 100, 101, 102, 103, 104, 105, 106, 107, 108, 109, 113, 114, 115, 117, 118, 119, 121, 122, 125, 126, 127, 130, 131, 132, 134, 135, 136, 137, 138, 139, 140, 142, 145, 146, 151, 152, 153, 155, 156, 159, 161, 162, 163, 165, 166, 167, 168, 170, 172, 173, 175, 177, 179, 181, 182, 186, 187, 188, 189, 190, 191, 192, 193, 198]"
agent_c,L0,short,134,66,68,5,0.33,200,"[0, 1, 3, 8, 12, 15, 16, 17, 18, 19, 20, 21, 25, 27, 28, 29, 30, 31, 32, 34, 36, 40, 41, 42, 43, 44, 45, 46, 48, 50, 53, 55, 56, 57, 58, 59, 60, 61, 62, 63, 64, 65, 66, 69, 71, 72, 73, 74, 75, 78, 80, 81, 83, 84, 85, 87, 88, 89, 90, 92, 93, 94, 95, 99, 100, 101, 102, 103, 104, 105, 107, 109, 110, 111, 112, 113, 114, 116, 119, 120, 121, 122, 123, 124, 125, 129, 130, 131, 132, 133, 134, 136, 137, 140, 141, 142, 144, 145, 146, 147, 149, 152, 153, 154, 155, 157, 159, 160, 161, 162, 163, 164, 165, 167, 168, 169, 170, 171, 172, 173, 174, 175, 177, 181, 182, 183, 184, 189, 190, 191, 192, 193, 194, 195]"
agent_c,L0,short,135,63,72,5,0.325,200,"[2, 4, 5, 6, 7, 8, 9, 10, 11, 13, 14, 15, 18, 19, 20, 23, 24, 25, 30, 32, 33, 35, 36, 39, 40, 41, 43, 44, 45, 47, 48, 49, 50, 51, 52, 53, 54, 55, 56, 57, 58, 59, 60, 61, 62, 63, 65, 67, 69, 70, 71, 74, 75, 76, 78, 79, 80, 81, 82, 83, 84, 85, 87, 90, 91, 93, 94, 95, 96, 98, 99, 100, 101, 103, 104, 105, 106, 107, 108, 109, 110, 111, 113, 114, 116, 117, 119, 120, 121, 122, 123, 125, 127, 128, 129, 131, 132, 133, 134, 136, 137, 138, 140, 142, 143, 144, 145, 146, 149, 150, 152, 154, 156, 157, 158, 159, 163, 164, 165, 166, 167, 168, 169, 171, 172, 173, 174, 175, 176, 178, 181, 185, 186, 191, 197]"
agent_c,L0,short,135,43,92,9,0.325,200,"[0, 1, 2, 4, 5, 6, 7, 8, 10, 12, 13, 14, 16, 17, 18, 19, 23, 24, 25, 26, 30, 32, 33, 34, 38, 39, 40, 41, 42, 43, 44, 45, 46, 48, 49, 51, 52, 55, 56, 57, 58, 59, 60, 61, 62, 65, 67, 68, 69, 70, 71, 74, 75, 77, 79, 80, 81, 83, 84, 85, 86, 87, 89, 90, 92, 93, 94, 97, 98, 99, 100, 101, 103, 105, 107, 108, 111, 112, 116, 117, 118, 119, 120, 121, 126, 127, 128, 129, 130, 132, 133, 134, 135, 136, 138, 140, 141, 143, 144, 145, 146, 147, 150, 152, 153, 154, 155, 156, 157, 161, 164, 167, 168, 171, 172, 173, 174, 175, 176, 178, 179, 180, 181, 182, 183, 184, 185, 189, 190, 191, 192, 193, 194, 195, 196]"
agent_c,L0,short,127,63,64,12,0.365,200,"[0, 1, 2, 3, 4, 5, 7, 8, 9, 10, 11, 12, 13, 14, 19, 21, 23, 25, 26, 27, 28, 31, 32, 33, 35, 36, 37, 40, 41, 42, 43, 44, 48, 49, 51, 53, 54, 55, 56, 57, 59, 60, 61, 62, 63, 64, 65, 67, 68, 69, 72, 73, 74, 77, 79, 80, 83, 84, 85, 86, 87, 88, 91, 93, 94, 95, 96, 97, 104, 105, 106, 107, 109, 111, 112, 113, 115, 116, 119, 120, 121, 122, 123, 125, 126, 130, 132, 133, 136, 139, 143, 145, 147, 149, 150, 151, 153, 154, 155, 156, 157, 158, 161, 163, 164, 165, 167, 168, 169, 172, 173, 176, 178, 179, 180, 182, 183, 184, 185, 186, 187, 191, 192, 193, 194, 195, 197]"
agent_c,L0,short,134,59,75,10,0.33,200,"[1, 3, 5, 6, 7, 8, 10, 12, 15, 17, 18, 19, 20, 21, 22, 23, 24, 27, 28, 29, 30, 32, 33, 35, 36, 38, 40, 43, 45, 46, 47, 48, 49, 50, 51, 52, 55, 56, 57, 58, 59, 60, 61, 62, 63, 64, 66, 67, 69, 71, 72, 73, 74, 75, 76, 77, 79, 80, 81, 83, 84, 87, 88, 90, 93, 95, 96, 98, 99, 100, 101, 102, 104, 105, 106, 107, 109, 112, 113, 115, 119, 120, 121, 123, 124, 125, 126, 127, 128, 129, 130, 133, 134, 135, 136, 137, 138, 139, 141, 142, 143, 146, 147, 148, 149, 151, 152, 153, 156, 158, 159, 160, 164, 165, 166, 167, 169, 170, 171, 173, 174, 175, 177, 181, 182, 183, 184, 185, 186, 188, 193, 194, 195, 197]"
agent_c,L0,short,126,61,65,9,0.37,200,"[3, 4, 6, 7, 8, 9, 12, 14, 15, 16, 17, 19, 20, 22, 24, 26, 27, 28, 29, 30, 31, 33, 34, 35, 37, 42, 46, 47, 48, 49, 50, 51, 53, 54, 56, 57, 59, 61, 62, 63, 64, 66, 69, 70, 71, 72, 75, 78, 79, 81, 83, 85, 86, 87, 88, 90, 91, 92, 93, 94, 95, 96, 97, 99, 100, 102, 103, 104, 105, 106, 107, 108, 109, 110, 111, 112, 114, 115, 116, 118, 119, 122, 123, 125, 126, 127, 128, 129, 130, 131, 132, 133, 135, 136, 139, 140, 142, 143, 145, 146, 148, 149, 151, 159, 160, 161, 162, 164, 167, 168, 169, 170, 171, 174, 175, 176, 177, 178, 179, 181, 182, 185, 187, 189, 190, 196]"
agent_c,L0,short,126,58,68,9,0.37,200,"[5, 6, 9, 11, 14, 15, 16, 17, 18, 21, 22, 23, 24, 25, 27, 28, 29, 32, 33, 37, 39, 42, 43, 44, 45, 46, 47, 48, 49, 51, 52, 54, 55, 61, 62, 64, 65, 68, 69, 70, 71, 73, 75, 76, 77, 79, 80, 81, 83, 85, 86, 89, 93, 98, 99, 100, 101, 102, 103, 104, 106, 107, 108, 110, 111, 112, 113, 114, 115, 117, 118, 119, 121, 122, 123, 125, 126, 127, 131, 132, 133, 134, 135, 137, 138, 139, 140, 143, 147, 148, 149, 150, 151, 152, 153, 154, 155, 157, 159, 162, 163, 164, 165, 166, 167, 168, 169, 170, 171, 172, 173, 174, 175, 176, 178, 179, 180, 182, 183, 186, 188, 190, 196, 197, 198, 199]"
agent_c,L0,short,129,50,79,7,0.355,200,"[2, 3, 4, 7, 8, 11, 12, 13, 15, 16, 17, 20, 21, 22, 23, 25, 26, 28, 29, 30, 31, 32, 34, 35, 38, 39, 40, 41, 42, 43, 44, 45, 46, 48, 49, 52, 53, 54, 55, 56, 58, 59, 60, 62, 63, 65, 66, 67, 68, 72, 73, 75, 76, 77, 78, 79, 80, 81, 83, 85, 86, 87, 88, 89, 90, 92, 94, 95, 96, 97, 98, 100, 106, 107, 108, 109, 111, 113, 114, 116, 121, 124, 125, 126, 127, 128, 129, 132, 133, 134, 136, 138, 140, 142, 144, 145, 146, 147, 149, 150, 151, 152, 153, 154, 157, 158, 160, 161, 162, 164, 165, 166, 168, 170, 171, 172, 173, 174, 176, 177, 178, 184, 185, 188, 189, 196, 197, 198, 199]"
agent_c,L0,short,122,66,56,7,0.39,200,"[0, 5, 8, 9, 12, 13, 15, 16, 17, 18, 19, 20, 21, 22, 24, 25, 26, 28, 30, 31, 33, 34, 35, 36, 37, 38, 39, 42, 43, 48, 50, 51, 56, 58, 60, 64, 65, 66, 67, 68, 71, 72, 73, 74, 75, 78, 79, 81, 82, 86, 87, 90, 91, 92, 94, 96, 97, 99, 100, 101, 102, 106, 107, 110, 111, 112, 114, 116, 117, 118, 119, 121, 125, 126, 127, 128, 129, 130, 131, 135, 138, 139, 140, 141, 142, 143, 144, 146, 147, 149, 150, 151, 154, 156, 157, 158, 159, 160, 161, 163, 164, 165, 167, 169, 172, 174, 175, 176, 179, 181, 182, 184, 186, 187, 188, 189, 190, 191, 196, 197, 198, 199]"
agent_c,L0,short,130,57,73,7,0.35,200,"[0, 1, 2, 3, 5, 6, 7, 8, 9, 10, 13, 14, 16, 18, 19, 23, 24, 25, 26, 31, 33, 34, 35, 36, 38, 39, 41, 43, 46, 47, 48, 49, 51, 53, 56, 57, 59, 60, 61, 62, 63, 64, 65, 66, 67, 68, 69, 73, 74, 75, 77, 78, 80, 82, 84, 85, 87, 88, 89, 91, 92, 93, 94, 96, 97, 99, 100, 101, 103, 105, 106, 107, 108, 110, 112, 113, 114, 115, 116, 117, 118, 119, 120, 121, 124, 126, 128, 131, 132, 133, 136, 138, 139, 140, 142, 145, 146, 147, 149, 150, 151, 153, 154, 157, 158, 160, 161, 164, 165, 166, 167, 168, 169, 170, 171, 173, 174, 176, 177, 178, 181, 182, 183, 184, 186, 187, 189, 197, 198, 199]"
agent_c,L0,short,120,74,46,20,0.4,200,"[0, 2, 3, 4, 5, 6, 7, 9, 10, 12, 13, 14, 15, 16, 18, 19, 20, 21, 22, 23, 24, 25, 26, 27, 29, 30, 31, 32, 33, 34, 35, 37, 38, 39, 40, 41, 42, 43, 46, 48, 49, 52, 53, 55, 56, 58, 59, 60, 61, 65, 68, 69, 72, 74, 76, 78, 79, 81, 83, 84, 85, 86, 87, 89, 91, 93, 94, 95, 96, 97, 99, 100, 101, 105, 107, 109, 110, 113, 114, 117, 122, 123, 124, 126, 128, 129, 134, 135, 138, 141, 142, 143, 146, 148, 149, 150, 151, 152, 155, 156, 157, 158, 159, 160, 161, 163, 164, 165, 166, 169, 170, 171, 174, 179, 180, 181, 185, 189, 191, 194]"
agent_c,L0,short,134,52,82,6,0.33,200,"[0, 1, 2, 3, 6, 8, 10, 12, 13, 15, 16, 20, 21, 22, 24, 25, 26, 27, 28, 29, 30, 31, 32, 33, 35, 37, 38, 40, 42, 43, 44, 45, 46, 47, 52, 53, 54, 55, 56, 57, 58, 59, 60, 61, 64, 65, 66, 69, 70, 71, 74, 75, 76, 77, 78, 80, 81, 83, 84, 85, 86, 87, 88, 90, 91, 93, 94, 95, 97, 98, 99, 101, 102, 103, 105, 108, 109, 111, 112, 114, 115, 116, 120, 122, 123, 124, 125, 126, 127, 128, 129, 131, 132, 135, 136, 137, 138, 140, 141, 142, 144, 145, 146, 147, 148, 149, 150, 152, 153, 154, 158, 159, 160, 163, 164, 165, 167, 168, 169, 171, 173, 176, 177, 178, 179, 180, 184, 187, 188, 189, 191, 197, 198, 199]"
agent_c,L0,short,129,63,66,12,0.355,200,"[0, 1, 4, 5, 6, 7, 8, 10, 11, 14, 16, 18, 20, 21, 22, 23, 24, 26, 27, 28, 29, 31, 32, 33, 35, 38, 39, 40, 42, 44, 45, 48, 50, 53, 55, 57, 59, 61, 63, 64, 65, 67, 69, 71, 72, 73, 74, 76, 77, 79, 81, 82, 84, 85, 86, 89, 90, 91, 92, 93, 94, 96, 98, 100, 101, 102, 104, 105, 106, 107, 108, 109, 110, 111, 113, 116, 117, 118, 119, 120, 122, 125, 126, 128, 129, 130, 131, 133, 134, 135, 136, 140, 141, 142, 143, 145, 147, 148, 149, 151, 152, 153, 154, 156, 158, 159, 160, 161, 163, 166, 167, 170, 172, 173, 175, 176, 177, 178, 180, 181, 182, 183, 185, 189, 190, 191, 192, 193, 195]"
agent_c,L0,short,124,55,69,8,0.38,200,"[1, 2, 4, 5, 8, 9, 10, 11, 14, 16, 17, 22, 23, 25, 26, 27, 28, 29, 30, 31, 32, 33, 34, 35, 36, 38, 44, 45, 46, 47, 48, 50, 51, 52, 53, 54, 55, 56, 58, 59, 62, 65, 66, 70, 71, 72, 73, 74, 76, 78, 80, 82, 83, 84, 87, 88, 89, 90, 92, 93, 94, 95, 96, 97, 98, 99, 100, 101, 102, 103, 104, 105, 107, 108, 109, 111, 112, 113, 114, 115, 116, 120, 123, 124, 125, 126, 128, 131, 132, 134, 137, 138, 141, 142, 143, 146, 149, 150, 151, 154, 155, 159, 160, 164, 165, 167, 170, 172, 174, 175, 176, 179, 180, 183, 184, 186, 187, 188, 189, 191, 194, 196, 197, 198]"
agent_c,L0,short,118,58,60,9,0.41,200,"[4, 6, 7, 8, 9, 11, 14, 16, 20, 21, 25, 29, 33, 34, 35, 36, 37, 38, 41, 42, 43, 44, 46, 47, 48, 49, 50, 51, 52, 54, 55, 56, 57, 60, 64, 65, 66, 68, 69, 74, 75, 76, 78, 79, 81, 82, 84, 85, 89, 90, 91, 93, 94, 95, 97, 98, 101, 102, 104, 107, 108, 109, 110, 111, 114, 115, 117, 118, 119, 120, 121, 122, 123, 124, 125, 127, 128, 130, 132, 134, 138, 139, 140, 142, 144, 146, 147, 149, 153, 154, 156, 157, 158, 159, 160, 161, 163, 164, 165, 166, 168, 170, 172, 173, 174, 175, 178, 179, 180, 181, 184, 185, 187, 188, 191, 196, 197, 198]"
agent_c,L0,short,130,80,50,9,0.35,200,"[0, 1, 2, 4, 5, 6, 7, 8, 9, 10, 11, 12, 13, 15, 16, 17, 20, 21, 22, 23, 25, 27, 32, 33, 36, 38, 39, 40, 41, 42, 43, 44, 45, 46, 47, 48, 49, 51, 52, 53, 55, 56, 61, 63, 65, 66, 67, 68, 69, 70, 71, 72, 73, 74, 77, 79, 81, 82, 83, 84, 85, 86, 87, 89, 90, 91, 96, 98, 100, 101, 103, 104, 105, 106, 107, 109, 110, 111, 112, 113, 114, 115, 117, 118, 119, 120, 122, 123, 124, 128, 130, 132, 134, 135, 136, 137, 139, 140, 142, 143, 144, 145, 148, 150, 151, 152, 154, 155, 156, 159, 161, 163, 164, 166, 168, 169, 170, 171, 173, 174, 176, 177, 178, 179, 181, 183, 186, 187, 189, 192]"
agent_c,L0,short,133,83,50,8,0.335,200,"[0, 1, 6, 7, 8, 9, 10, 11, 12, 13, 14, 15, 18, 20, 21, 22, 23, 24, 26, 28, 29, 32, 33, 34, 36, 38, 39, 40, 41, 43, 48, 49, 52, 53, 54, 55, 56, 57, 59, 61, 63, 66, 67, 68, 69, 70, 71, 72, 73, 74, 75, 77, 79, 80, 81, 82, 84, 85, 86, 87, 88, 89, 90, 92, 93, 94, 95, 97, 98, 99, 100, 102, 104, 105, 107, 108, 109, 111, 112, 114, 115, 116, 117, 118, 122, 123, 124, 125, 128, 129, 131, 132, 133, 134, 135, 137, 138, 139, 140, 142, 143, 144, 146, 148, 152, 153, 154, 155, 157, 158, 159, 160, 162, 164, 166, 167, 169, 172, 174, 175, 176, 177, 178, 179, 181, 182, 185, 186, 187, 188, 190, 192, 198]"
agent_c,L0,short,129,60,69,4,0.355,200,"[0, 2, 4, 6, 9, 11, 12, 13, 14, 15, 16, 17, 18, 19, 20, 24, 25, 26, 31, 32, 33, 36, 37, 38, 39, 40, 41, 44, 45, 46, 47, 49, 50, 51, 53, 54, 56, 57, 58, 59, 60, 61, 62, 63, 64, 66, 69, 71, 73, 76, 77, 78, 79, 80, 81, 83, 84, 87, 88, 90, 92, 93, 94, 95, 96, 98, 101, 104, 106, 107, 109, 110, 112, 114, 116, 118, 119, 122, 123, 124, 125, 126, 127, 130, 131, 132, 134, 139, 140, 141, 142, 143, 144, 145, 148, 149, 150, 151, 153, 154, 155, 156, 157, 158, 159, 160, 161, 163, 165, 167, 168, 169, 170, 172, 173, 174, 175, 176, 177, 179, 180, 181, 182, 183, 184, 185, 189, 194, 196]"
agent_c,L0,short,126,42,84,8,0.37,200,"[2, 4, 5, 6, 8, 10, 11, 13, 14, 15, 16, 18, 20, 21, 22, 25, 26, 28, 29, 31, 32, 34, 35, 36, 38, 39, 40, 42, 43, 44, 45, 48, 49, 50, 51, 52, 53, 55, 56, 57, 59, 60, 61, 62, 63, 64, 66, 67, 69, 70, 72, 73, 74, 75, 76, 77, 80, 82, 83, 84, 86, 87, 88, 89, 91, 94, 96, 97, 98, 99, 101, 102, 103, 104, 106, 107, 109, 110, 111, 112, 113, 116, 117, 118, 119, 120, 125, 126, 129, 130, 132, 133, 134, 138, 140, 141, 142, 143, 144, 146, 147, 148, 152, 153, 154, 156, 157, 158, 160, 162, 164, 166, 169, 170, 172, 174, 175, 179, 180, 181, 183, 187, 188, 189, 192, 193]"
agent_c,L0,short,133,68,65,5,0.335,200,"[1, 3, 4, 5, 6, 7, 9, 10, 11, 14, 15, 16, 17, 19, 21, 22, 24, 25, 26, 27, 28, 29, 31, 32, 33, 34, 37, 38, 40, 42, 43, 44, 46, 47, 48, 51, 52, 55, 57, 59, 60, 61, 63, 66, 67, 68, 69, 70, 71, 72, 73, 74, 75, 76, 77, 78, 79, 80, 81, 82, 84, 85, 86, 87, 90, 92, 93, 96, 97, 98, 99, 103, 104, 105, 106, 107, 109, 110, 111, 112, 113, 114, 116, 117, 118, 119, 123, 124, 125, 126, 129, 130, 131, 132, 134, 135, 136, 137, 140, 141, 142, 143, 144, 145, 146, 147, 148, 149, 151, 152, 154, 155, 156, 158, 159, 163, 164, 167, 168, 169, 170, 172, 175, 179, 180, 181, 182, 183, 184, 185, 192, 194, 197]"
agent_c,L0,short,129,65,64,17,0.355,200,"[0, 1, 2, 3, 4, 6, 7, 9, 12, 13, 15, 18, 19, 20, 22, 23, 25, 28, 29, 30, 31, 32, 33, 34, 36, 37, 38, 41, 42, 43, 44, 45, 46, 47, 48, 51, 53, 54, 55, 57, 59, 60, 61, 66, 67, 69, 70, 71, 72, 73, 74, 75, 76, 78, 80, 81, 82, 83, 85, 88, 90, 91, 92, 93, 94, 97, 98, 99, 100, 101, 102, 103, 104, 105, 106, 107, 110, 112, 113, 114, 116, 117, 120, 123, 124, 126, 128, 129, 130, 132, 134, 135, 137, 138, 140, 142, 145, 146, 150, 152, 154, 155, 156, 157, 158, 159, 160, 161, 163, 164, 166, 167, 168, 170, 172, 174, 175, 176, 177, 179, 180, 181, 184, 186, 187, 189, 190, 191, 197]"
agent_c,L0,short,127,50,77,4,0.365,200,"[0, 1, 2, 4, 6, 7, 8, 14, 20, 21, 22, 23, 26, 28, 29, 30, 31, 32, 34, 36, 37, 39, 40, 41, 42, 43, 44, 45, 46, 47, 49, 50, 53, 55, 56, 58, 59, 61, 62, 64, 65, 67, 68, 72, 73, 74, 75, 77, 78, 79, 80, 81, 82, 83, 85, 89, 92, 93, 94, 95, 96, 98, 100, 101, 102, 103, 104, 107, 108, 109, 110, 111, 112, 114, 115, 117, 118, 119, 121, 122, 123, 124, 126, 127, 129, 130, 137, 138, 139, 140, 141, 142, 143, 144, 146, 148, 149, 151, 152, 153, 154, 156, 158, 159, 161, 163, 164, 165, 166, 167, 170, 171, 173, 174, 175, 177, 178, 179, 180, 184, 186, 187, 192, 193, 194, 196, 197]"
agent_c,L0,short,126,61,65,13,0.37,200,"[0, 1, 2, 3, 5, 6, 7, 8, 9, 11, 12, 14, 15, 17, 18, 19, 20, 24, 25, 26, 27, 28, 30, 32, 37, 41, 42, 43, 44, 45, 47, 48, 49, 50, 51, 52, 53, 54, 55, 57, 58, 59, 60, 61, 63, 65, 66, 69, 71, 72, 73, 74, 76, 77, 78, 79, 80, 82, 83, 85, 86, 87, 88, 89, 94, 95, 96, 98, 100, 101, 102, 103, 104, 105, 108, 109, 110, 111, 116, 117, 118, 119, 120, 123, 124, 125, 127, 128, 130, 135, 136, 137, 138, 139, 140, 142, 143, 145, 147, 148, 151, 153, 154, 156, 158, 159, 164, 165, 166, 167, 168, 169, 171, 172, 173, 176, 178, 181, 183, 184, 185, 187, 188, 190, 191, 199]"
agent_c,L0,short,124,85,39,16,0.38,200,"[0, 1, 2, 3, 5, 7, 8, 10, 13, 14, 15, 19, 20, 21, 23, 25, 26, 27, 28, 29, 30, 31, 32, 35, 36, 38, 39, 40, 41, 42, 45, 47, 48, 52, 53, 55, 57, 64, 66, 67, 68, 69, 71, 72, 73, 74, 75, 78, 79, 80, 81, 82, 84, 85, 86, 87, 88, 91, 93, 94, 96, 97, 98, 99, 100, 101, 102, 104, 105, 106, 107, 108, 109, 110, 111, 112, 114, 115, 116, 118, 119, 120, 121, 122, 124, 125, 126, 127, 128, 129, 130, 131, 133, 134, 138, 141, 144, 146, 147, 149, 155, 157, 159, 160, 163, 165, 166, 168, 169, 170, 173, 174, 177, 180, 183, 184, 185, 186, 187, 188, 190, 194, 198, 199]"
agent_c,L0,short,119,67,52,13,0.405,200,"[3, 4, 5, 9, 10, 11, 12, 13, 15, 16, 18, 19, 21, 22, 24, 27, 29, 31, 36, 37, 39, 40, 41, 42, 44, 47, 49, 50, 51, 53, 54, 55, 56, 57, 58, 59, 60, 61, 62, 63, 64, 66, 70, 71, 76, 77, 78, 79, 80, 81, 82, 83, 85, 86, 87, 89, 98, 99, 101, 102, 103, 104, 106, 107, 110, 113, 116, 117, 119, 120, 121, 124, 127, 128, 130, 131, 132, 134, 135, 136, 137, 138, 139, 141, 142, 144, 145, 146, 149, 150, 151, 152, 153, 154, 155, 156, 157, 158, 161, 163, 164, 165, 166, 167, 168, 169, 172, 173, 174, 175, 176, 178, 179, 181, 182, 187, 189, 192, 197]"
agent_c,L0,short,132,78,54,11,0.34,200,"[0, 1, 3, 4, 5, 10, 11, 12, 13, 14, 15, 18, 20, 21, 22, 23, 25, 27, 30, 32, 33, 36, 38, 39, 40, 41, 42, 45, 46, 47, 49, 50, 52, 53, 54, 55, 56, 57, 58, 59, 60, 61, 62, 65, 66, 67, 68, 69, 70, 71, 72, 73, 77, 78, 80, 83, 84, 85, 86, 87, 88, 89, 91, 92, 94, 98, 99, 100, 101, 102, 103, 104, 105, 109, 110, 112, 114, 115, 117, 118, 120, 121, 122, 123, 125, 126, 127, 129, 130, 131, 132, 134, 135, 137, 138, 139, 140, 141, 144, 145, 146, 147, 148, 149, 151, 152, 153, 154, 155, 156, 157, 159, 161, 162, 164, 165, 166, 168, 169, 173, 174, 177, 178, 179, 180, 181, 184, 185, 187, 188, 189, 195]"
agent_c,L0,short,127,71,56,8,0.365,200,"[0, 2, 3, 4, 5, 7, 8, 9, 10, 11, 13, 14, 15, 18, 21, 27, 28, 29, 30, 31, 32, 34, 35, 37, 38, 40, 41, 42, 45, 46, 49, 50, 53, 54, 55, 56, 59, 60, 61, 62, 64, 66, 67, 68, 72, 73, 74, 75, 76, 78, 79, 80, 82, 83, 88, 89, 90, 92, 94, 96, 97, 99, 100, 101, 102, 105, 107, 108, 112, 113, 114, 115, 117, 118, 119, 120, 121, 122, 123, 124, 125, 126, 127, 130, 131, 133, 134, 135, 137, 138, 140, 141, 142, 144, 145, 146, 147, 149, 150, 151, 152, 153, 154, 155, 156, 158, 160, 162, 164, 168, 169, 170, 172, 173, 175, 177, 179, 183, 184, 185, 186, 187, 189, 190, 191, 192, 193]"
agent_c,L0,short,134,84,50,6,0.33,200,"[1, 2, 5, 6, 7, 9, 10, 11, 12, 13, 15, 16, 17, 18, 19, 20, 21, 22, 23, 24, 25, 26, 28, 29, 30, 31, 32, 33, 35, 36, 38, 39, 42, 43, 47, 49, 50, 51, 53, 55, 57, 59, 62, 67, 68, 69, 71, 72, 73, 74, 75, 78, 80, 82, 83, 84, 85, 86, 87, 91, 92, 93, 95, 96, 97, 98, 100, 102, 104, 105, 106, 107, 108, 109, 110, 111, 112, 113, 114, 116, 117, 118, 119, 120, 121, 122, 123, 124, 128, 129, 130, 131, 132, 133, 134, 136, 139, 142, 143, 144, 145, 150, 155, 157, 158, 159, 160, 161, 162, 163, 164, 165, 166, 167, 168, 170, 171, 173, 176, 177, 178, 179, 180, 181, 182, 183, 184, 185, 188, 191, 192, 193, 194, 197]"
agent_c,L0,short,123,69,54,11,0.385,200,"[0, 1, 2, 3, 4, 7, 8, 11, 13, 14, 15, 16, 18, 19, 20, 21, 22, 23, 24, 32, 34, 35, 37, 38, 39, 40, 42, 45, 48, 49, 50, 51, 52, 53, 54, 57, 59, 60, 61, 62, 63, 64, 65, 67, 68, 70, 71, 72, 75, 77, 79, 80, 83, 84, 86, 89, 90, 91, 93, 94, 95, 99, 100, 101, 102, 103, 104, 105, 108, 109, 110, 111, 113, 114, 115, 117, 118, 119, 120, 122, 125, 126, 127, 128, 130, 133, 135, 137, 139, 140, 141, 143, 148, 149, 150, 151, 153, 155, 158, 160, 161, 163, 165, 167, 169, 171, 174, 175, 176, 177, 178, 179, 180, 181, 182, 183, 184, 186, 187, 188, 189, 197, 199]"
agent_c,L0,short,132,55,77,12,0.34,200,"[0, 1, 2, 3, 4, 5, 6, 7, 9, 11, 13, 14, 16, 17, 19, 20, 22, 23, 25, 26, 28, 29, 30, 31, 34, 35, 37, 38, 39, 40, 41, 42, 43, 45, 46, 47, 49, 50, 51, 52, 54, 55, 56, 57, 58, 59, 60, 62, 66, 67, 68, 69, 71, 72, 76, 78, 79, 80, 81, 84, 85, 86, 87, 88, 94, 96, 97, 98, 102, 104, 106, 110, 111, 112, 113, 114, 115, 116, 117, 118, 120, 121, 122, 123, 127, 129, 130, 134, 135, 136, 138, 139, 140, 141, 142, 143, 145, 147, 150, 151, 152, 155, 156, 157, 158, 160, 161, 162, 163, 164, 165, 166, 167, 168, 170, 172, 173, 175, 176, 177, 179, 182, 183, 184, 185, 187, 189, 190, 193, 194, 196, 197]"
agent_c,L0,short,137,48,89,5,0.315,200,"[3, 4, 6, 8, 9, 10, 11, 12, 13, 14, 16, 18, 20, 21, 22, 23, 25, 27, 29, 30, 31, 33, 35, 37, 38, 39, 40, 41, 42, 43, 44, 46, 47, 48, 51, 52, 54, 55, 56, 57, 58, 59, 61, 62, 63, 64, 65, 66, 67, 68, 69, 70, 71, 72, 74, 77, 78, 79, 80, 82, 83, 84, 85, 86, 87, 88, 89, 92, 94, 95, 98, 99, 100, 102, 103, 105, 106, 107, 108, 110, 114, 117, 118, 119, 120, 121, 122, 123, 127, 128, 129, 131, 132, 133, 134, 135, 138, 139, 140, 141, 142, 144, 146, 148, 149, 151, 152, 154, 155, 156, 157, 158, 159, 161, 162, 163, 164, 167, 168, 169, 170, 171, 172, 173, 174, 175, 176, 177, 180, 181, 182, 183, 184, 191, 192, 193, 194]"
agent_c,L0,short,131,60,71,10,0.345,200,"[0, 1, 2, 3, 4, 5, 6, 7, 8, 9, 10, 12, 14, 15, 16, 17, 19, 20, 21, 22, 24, 25, 26, 27, 28, 29, 32, 33, 34, 35, 38, 39, 41, 42, 43, 44, 46, 47, 48, 49, 50, 52, 53, 54, 55, 57, 58, 60, 62, 63, 64, 65, 68, 69, 70, 74, 75, 76, 77, 78, 79, 80, 81, 83, 85, 86, 88, 89, 90, 91, 92, 93, 94, 96, 97, 102, 103, 105, 106, 108, 109, 112, 113, 115, 116, 117, 120, 121, 122, 124, 125, 126, 130, 131, 132, 134, 135, 136, 138, 139, 140, 142, 146, 147, 149, 150, 151, 152, 154, 155, 157, 158, 159, 164, 165, 166, 168, 172, 173, 175, 176, 177, 179, 180, 181, 182, 183, 185, 186, 187, 191]"
agent_c,L0,short,126,53,73,7,0.37,200,"[0, 1, 2, 3, 4, 5, 6, 7, 8, 9, 10, 12, 13, 14, 16, 17, 18, 19, 20, 22, 23, 27, 28, 29, 31, 32, 33, 35, 37, 38, 42, 44, 46, 48, 49, 50, 51, 52, 53, 56, 57, 58, 60, 61, 65, 67, 68, 70, 72, 73, 74, 75, 78, 79, 80, 81, 82, 83, 87, 88, 91, 93, 94, 96, 97, 99, 100, 104, 105, 109, 112, 113, 114, 116, 117, 118, 119, 120, 121, 122, 123, 124, 125, 127, 128, 129, 131, 132, 138, 139, 141, 142, 145, 147, 148, 149, 150, 151, 152, 153, 155, 157, 158, 159, 160, 161, 162, 163, 166, 167, 170, 172, 174, 175, 177, 178, 179, 182, 184, 185, 186, 188, 189, 191, 198, 199]"
agent_c,L0,short,145,74,71,5,0.275,200,"[0, 1, 3, 5, 6, 8, 9, 10, 11, 12, 13, 14, 15, 16, 17, 18, 19, 22, 23, 25, 27, 28, 29, 30, 32, 33, 34, 38, 39, 40, 41, 42, 43, 44, 45, 46, 48, 49, 50, 51, 52, 54, 56, 58, 59, 60, 61, 63, 64, 65, 67, 68, 69, 70, 71, 72, 73, 74, 76, 77, 78, 79, 80, 82, 83, 84, 85, 87, 88, 89, 90, 91, 92, 93, 94, 96, 97, 98, 99, 100, 101, 102, 103, 104, 105, 106, 107, 109, 112, 113, 114, 115, 116, 117, 118, 120, 121, 122, 124, 125, 126, 127, 131, 132, 133, 134, 135, 137, 140, 141, 143, 144, 145, 147, 149, 150, 151, 152, 153, 154, 155, 157, 158, 160, 162, 165, 166, 167, 168, 169, 170, 173, 175, 176, 177, 178, 179, 180, 184, 185, 190, 191, 196, 197, 198]"
agent_c,L0,short,129,46,83,9,0.355,200,"[0, 1, 2, 3, 4, 6, 8, 11, 12, 15, 16, 17, 18, 19, 20, 22, 23, 24, 25, 28, 30, 31, 32, 33, 34, 36, 37, 38, 39, 41, 42, 44, 45, 47, 48, 49, 50, 51, 52, 53, 54, 55, 56, 57, 58, 59, 61, 64, 65, 67, 68, 70, 71, 72, 75, 76, 79, 80, 83, 84, 85, 86, 88, 90, 91, 92, 94, 95, 98, 99, 101, 102, 104, 105, 106, 108, 109, 112, 113, 114, 116, 120, 121, 122, 123, 124, 125, 126, 127, 128, 129, 131, 132, 133, 134, 135, 136, 137, 138, 144, 147, 150, 151, 153, 154, 155, 156, 157, 158, 159, 160, 161, 162, 163, 166, 167, 169, 172, 174, 182, 184, 187, 188, 189, 190, 192, 193, 194, 196]"
agent_c,L0,short,126,46,80,13,0.37,200,"[1, 2, 7, 9, 10, 11, 12, 13, 14, 15, 18, 19, 21, 22, 23, 24, 26, 27, 29, 30, 31, 32, 33, 34, 37, 38, 41, 44, 45, 46, 47, 48, 50, 51, 52, 54, 56, 57, 58, 59, 60, 62, 63, 66, 67, 68, 71, 74, 75, 76, 80, 81, 82, 84, 86, 87, 89, 90, 91, 92, 93, 95, 96, 97, 98, 99, 101, 105, 111, 112, 113, 115, 116, 119, 120, 121, 122, 124, 125, 126, 129, 131, 132, 134, 135, 136, 137, 138, 139, 140, 141, 142, 143, 145, 146, 147, 148, 150, 151, 154, 156, 157, 160, 161, 162, 163, 164, 165, 168, 169, 170, 173, 174, 176, 179, 181, 182, 183, 184, 185, 186, 187, 188, 189, 190, 191]"
agent_c,L0,short,137,57,80,6,0.315,200,"[0, 1, 3, 4, 5, 6, 7, 9, 10, 12, 14, 15, 16, 17, 20, 21, 23, 24, 26, 27, 28, 29, 30, 33, 35, 37, 39, 40, 41, 42, 43, 44, 45, 47, 48, 50, 51, 55, 56, 57, 58, 59, 60, 62, 63, 64, 65, 66, 67, 68, 69, 70, 73, 74, 76, 77, 79, 80, 81, 82, 83, 84, 86, 87, 88, 89, 91, 93, 94, 95, 99, 100, 101, 102, 104, 105, 106, 107, 109, 111, 113, 114, 115, 116, 118, 123, 125, 126, 127, 129, 130, 132, 133, 134, 135, 136, 138, 140, 141, 142, 143, 145, 146, 148, 149, 151, 153, 154, 155, 156, 158, 159, 160, 163, 164, 165, 166, 167, 168, 170, 171, 172, 173, 175, 176, 178, 180, 182, 183, 187, 188, 189, 191, 196, 197, 198, 199]"
agent_c,L0,short,136,61,75,5,0.32,200,"[0, 3, 4, 5, 6, 7, 8, 10, 11, 16, 17, 18, 19, 20, 21, 22, 23, 24, 25, 26, 27, 28, 30, 32, 33, 34, 35, 36, 37, 38, 39, 40, 41, 43, 44, 45, 46, 47, 48, 49, 50, 51, 52, 54, 55, 56, 57, 58, 61, 62, 63, 65, 68, 73, 75, 76, 77, 79, 80, 81, 82, 83, 85, 86, 87, 88, 89, 90, 92, 94, 96, 97, 98, 99, 100, 101, 103, 105, 106, 107, 111, 113, 114, 115, 116, 118, 119, 121, 122, 124, 126, 127, 128, 129, 133, 135, 136, 137, 141, 142, 143, 144, 147, 148, 149, 150, 151, 152, 153, 154, 155, 156, 157, 159, 160, 161, 164, 165, 166, 167, 168, 172, 173, 174, 175, 178, 179, 182, 183, 185, 186, 190, 191, 194, 195, 196]"
agent_c,L0,short,136,72,64,8,0.32,200,"[0, 1, 2, 3, 4, 5, 6, 8, 10, 11, 12, 14, 17, 18, 21, 22, 23, 24, 25, 26, 27, 28, 30, 31, 32, 33, 34, 36, 37, 39, 41, 43, 45, 47, 48, 51, 53, 55, 57, 58, 60, 61, 62, 63, 65, 69, 70, 72, 75, 76, 77, 78, 79, 80, 82, 83, 85, 86, 89, 90, 91, 92, 93, 95, 96, 100, 101, 102, 103, 104, 106, 107, 108, 110, 112, 117, 118, 121, 122, 123, 124, 125, 126, 127, 129, 130, 131, 132, 133, 134, 136, 138, 139, 141, 142, 143, 144, 145, 146, 147, 148, 149, 151, 153, 154, 155, 156, 157, 158, 159, 160, 161, 162, 163, 164, 169, 170, 171, 173, 175, 177, 178, 179, 181, 182, 184, 185, 187, 188, 189, 192, 193, 194, 197, 198, 199]"
agent_c,L0,short,125,52,73,15,0.375,200,"[3, 4, 5, 7, 9, 12, 15, 16, 17, 19, 20, 21, 22, 23, 24, 25, 27, 28, 29, 32, 33, 34, 35, 36, 38, 40, 41, 42, 44, 45, 47, 48, 49, 50, 51, 53, 54, 55, 57, 59, 60, 61, 62, 63, 64, 66, 67, 68, 69, 73, 74, 75, 76, 77, 78, 79, 80, 82, 83, 84, 86, 88, 89, 90, 91, 92, 95, 96, 97, 98, 100, 101, 102, 103, 104, 107, 109, 110, 113, 114, 119, 120, 121, 122, 123, 124, 125, 126, 127, 128, 129, 133, 135, 137, 138, 143, 147, 151, 152, 154, 155, 161, 162, 163, 166, 167, 168, 169, 170, 175, 179, 181, 182, 183, 185, 186, 190, 191, 192, 194, 195, 196, 197, 198, 199]"
agent_c,L0,short,131,59,72,5,0.345,200,"[0, 1, 2, 3, 5, 8, 9, 10, 11, 12, 13, 14, 15, 21, 22, 23, 25, 28, 29, 30, 31, 32, 34, 35, 37, 38, 39, 41, 42, 45, 46, 49, 52, 55, 58, 59, 62, 63, 64, 65, 66, 68, 69, 70, 71, 72, 73, 74, 75, 77, 78, 79, 81, 84, 85, 86, 88, 89, 90, 91, 92, 93, 94, 95, 96, 97, 98, 99, 100, 101, 102, 103, 106, 108, 109, 110, 112, 113, 118, 119, 120, 122, 124, 125, 126, 128, 129, 130, 131, 132, 133, 134, 137, 138, 139, 140, 143, 144, 145, 146, 147, 148, 150, 151, 152, 153, 154, 156, 158, 159, 160, 161, 162, 163, 164, 166, 167, 168, 170, 171, 174, 176, 177, 178, 179, 182, 189, 190, 191, 192, 194]"
agent_c,L0,short,136,72,64,4,0.32,200,"[0, 1, 4, 9, 10, 11, 12, 14, 16, 17, 18, 20, 21, 22, 24, 25, 27, 29, 30, 32, 33, 34, 35, 36, 37, 39, 40, 41, 42, 43, 44, 46, 47, 48, 49, 50, 52, 53, 54, 56, 57, 59, 61, 62, 63, 64, 65, 66, 68, 69, 70, 71, 72, 73, 75, 76, 77, 78, 80, 82, 85, 86, 87, 88, 89, 90, 91, 92, 94, 95, 96, 98, 99, 100, 102, 103, 104, 105, 106, 108, 110, 111, 112, 113, 115, 116, 117, 118, 120, 121, 122, 123, 126, 127, 128, 132, 133, 135, 137, 138, 140, 142, 143, 144, 147, 148, 150, 151, 152, 154, 155, 156, 157, 158, 160, 161, 163, 164, 166, 168, 169, 172, 173, 174, 176, 177, 180, 187, 188, 189, 190, 194, 195, 196, 197, 198]"
agent_c,L0,short,117,40,77,7,0.415,200,"[0, 2, 5, 9, 10, 14, 15, 17, 18, 19, 20, 21, 22, 23, 24, 25, 26, 29, 31, 33, 34, 36, 37, 38, 39, 43, 46, 47, 48, 49, 52, 53, 54, 57, 60, 61, 62, 63, 65, 66, 67, 68, 69, 70, 71, 75, 76, 81, 83, 84, 85, 88, 89, 90, 93, 94, 96, 98, 100, 101, 102, 104, 107, 108, 109, 115, 116, 118, 119, 121, 122, 124, 126, 128, 129, 131, 133, 134, 135, 137, 138, 139, 141, 143, 145, 147, 149, 150, 153, 156, 157, 158, 160, 161, 162, 163, 166, 167, 168, 170, 171, 172, 177, 179, 180, 182, 183, 184, 185, 186, 189, 190, 194, 196, 197, 198, 199]"
agent_c,L0,short,126,51,75,11,0.37,200,"[3, 5, 6, 8, 10, 11, 13, 14, 15, 16, 18, 22, 23, 25, 27, 29, 31, 32, 34, 35, 36, 37, 39, 41, 43, 44, 46, 47, 49, 50, 52, 53, 54, 56, 60, 61, 62, 65, 66, 67, 68, 70, 72, 73, 74, 75, 77, 79, 80, 81, 82, 83, 84, 85, 92, 93, 94, 95, 96, 97, 98, 99, 100, 101, 102, 103, 104, 106, 110, 111, 112, 113, 114, 117, 119, 121, 122, 125, 126, 127, 128, 130, 131, 132, 133, 137, 138, 139, 141, 143, 144, 145, 147, 148, 149, 150, 151, 152, 154, 156, 158, 159, 160, 161, 163, 164, 165, 167, 169, 171, 172, 173, 174, 175, 176, 177, 178, 179, 181, 184, 188, 189, 190, 191, 192, 199]"
agent_c,L0,short,122,59,63,14,0.39,200,"[0, 2, 3, 5, 7, 8, 11, 12, 16, 18, 19, 20, 21, 23, 24, 25, 26, 27, 28, 29, 30, 32, 33, 36, 37, 38, 44, 45, 46, 47, 48, 49, 50, 51, 52, 55, 56, 58, 60, 62, 63, 65, 66, 67, 69, 70, 71, 72, 73, 74, 78, 79, 80, 81, 82, 83, 85, 89, 91, 92, 93, 96, 97, 98, 99, 100, 101, 102, 104, 105, 109, 111, 113, 114, 115, 117, 118, 121, 122, 123, 125, 129, 130, 131, 135, 136, 137, 140, 141, 142, 143, 144, 146, 147, 148, 149, 150, 152, 154, 156, 158, 159, 160, 161, 162, 164, 165, 166, 167, 168, 171, 172, 174, 175, 176, 177, 182, 183, 188, 189, 190, 194]"
agent_c,L0,short,129,81,48,17,0.355,200,"[0, 2, 3, 4, 5, 6, 7, 9, 10, 13, 14, 16, 17, 18, 19, 20, 21, 22, 23, 26, 27, 28, 29, 32, 36, 37, 39, 41, 42, 45, 47, 48, 50, 51, 52, 54, 55, 58, 59, 61, 64, 65, 66, 67, 68, 69, 70, 72, 74, 75, 76, 77, 78, 80, 83, 84, 85, 86, 87, 90, 91, 92, 93, 95, 96, 98, 99, 100, 101, 102, 107, 108, 110, 113, 116, 118, 120, 121, 122, 123, 125, 126, 127, 128, 129, 131, 132, 133, 135, 136, 137, 138, 140, 141, 143, 144, 146, 147, 148, 149, 150, 151, 152, 153, 156, 157, 158, 159, 160, 161, 162, 164, 165, 166, 167, 168, 172, 173, 175, 177, 179, 180, 181, 183, 184, 185, 189, 194, 196]"
agent_c,L0,short,138,74,64,8,0.31,200,"[0, 2, 4, 5, 6, 9, 10, 11, 13, 15, 16, 20, 22, 23, 24, 26, 27, 28, 29, 32, 34, 36, 37, 38, 39, 40, 42, 43, 44, 45, 46, 48, 49, 50, 51, 52, 53, 54, 55, 56, 57, 58, 59, 60, 61, 63, 64, 66, 67, 68, 69, 71, 72, 73, 74, 76, 78, 79, 80, 81, 82, 83, 84, 88, 89, 90, 91, 92, 93, 96, 98, 100, 101, 102, 103, 104, 106, 107, 109, 110, 111, 112, 113, 114, 115, 116, 118, 119, 120, 123, 124, 125, 126, 127, 129, 130, 132, 133, 135, 136, 137, 138, 139, 140, 141, 142, 143, 144, 145, 146, 147, 152, 154, 155, 156, 158, 159, 160, 161, 163, 164, 165, 166, 167, 168, 171, 172, 174, 176, 177, 179, 181, 183, 184, 185, 187, 189, 199]"
agent_c,L0,short,129,66,63,8,0.355,200,"[1, 3, 5, 6, 7, 8, 10, 12, 14, 15, 17, 19, 20, 21, 22, 23, 25, 26, 30, 31, 32, 34, 35, 37, 38, 39, 40, 42, 43, 44, 45, 47, 53, 55, 57, 58, 60, 61, 62, 63, 65, 67, 68, 69, 72, 74, 75, 78, 79, 81, 82, 83, 84, 85, 86, 87, 88, 89, 90, 92, 93, 94, 95, 96, 99, 100, 101, 103, 104, 106, 109, 110, 114, 115, 116, 117, 118, 119, 120, 121, 122, 123, 124, 126, 127, 128, 130, 132, 133, 134, 136, 137, 138, 140, 144, 145, 146, 147, 149, 152, 154, 156, 158, 159, 161, 162, 166, 167, 168, 170, 171, 172, 173, 174, 178, 179, 180, 181, 182, 184, 187, 188, 189, 190, 191, 192, 193, 198, 199]"
agent_c,L0,short,127,58,69,20,0.365,200,"[0, 1, 2, 4, 5, 7, 8, 10, 12, 13, 16, 17, 23, 24, 25, 26, 27, 28, 29, 30, 32, 33, 34, 36, 37, 40, 41, 42, 43, 44, 47, 48, 49, 50, 52, 53, 54, 58, 61, 63, 64, 65, 66, 67, 68, 72, 73, 74, 75, 79, 80, 81, 82, 86, 88, 89, 90, 91, 93, 94, 95, 96, 97, 98, 99, 100, 101, 102, 105, 106, 107, 108, 109, 111, 113, 114, 116, 117, 118, 120, 122, 123, 124, 126, 127, 128, 130, 131, 134, 135, 136, 137, 139, 141, 142, 143, 144, 145, 146, 148, 151, 153, 155, 156, 157, 160, 163, 164, 165, 170, 171, 172, 173, 175, 179, 180, 182, 183, 184, 186, 187, 188, 192, 194, 196, 197, 198]"
agent_c,L0,short,131,83,48,15,0.345,200,"[0, 1, 2, 3, 4, 5, 13, 14, 15, 18, 19, 21, 22, 23, 24, 26, 27, 28, 31, 32, 35, 37, 38, 39, 40, 41, 42, 43, 47, 48, 49, 52, 53, 54, 56, 57, 58, 60, 61, 62, 65, 67, 68, 70, 71, 74, 75, 76, 77, 78, 80, 81, 83, 85, 86, 87, 88, 89, 90, 91, 92, 93, 94, 95, 98, 99, 101, 104, 105, 107, 109, 110, 112, 114, 115, 116, 117, 118, 119, 121, 123, 125, 127, 128, 129, 130, 131, 132, 133, 134, 135, 136, 139, 140, 141, 143, 144, 145, 146, 147, 148, 149, 150, 151, 152, 153, 154, 155, 156, 158, 161, 163, 164, 166, 168, 170, 172, 173, 178, 183, 184, 185, 187, 189, 191, 192, 193, 194, 195, 196, 198]"
agent_c,L0,short,128,49,79,9,0.36,200,"[2, 3, 5, 8, 11, 12, 13, 14, 15, 16, 17, 19, 20, 21, 22, 23, 26, 27, 29, 30, 31, 32, 34, 35, 37, 38, 39, 40, 41, 42, 43, 45, 48, 51, 52, 53, 54, 56, 57, 59, 61, 63, 65, 68, 70, 71, 73, 74, 77, 78, 79, 80, 81, 83, 84, 85, 93, 94, 95, 96, 99, 101, 102, 104, 105, 107, 108, 109, 110, 113, 114, 115, 116, 117, 118, 120, 121, 123, 125, 126, 127, 128, 129, 130, 131, 132, 133, 134, 135, 136, 137, 138, 143, 144, 145, 152, 153, 155, 156, 157, 159, 160, 162, 164, 166, 167, 169, 171, 172, 174, 176, 177, 178, 180, 183, 185, 186, 187, 188, 189, 191, 192, 193, 194, 195, 196, 197, 199]"
agent_c,L0,short,141,71,70,5,0.295,200,"[2, 3, 4, 5, 6, 7, 9, 10, 11, 12, 14, 15, 16, 18, 19, 20, 21, 22, 26, 28, 29, 31, 32, 33, 34, 35, 37, 38, 39, 40, 41, 43, 44, 46, 48, 49, 50, 52, 53, 54, 55, 56, 57, 60, 61, 62, 63, 64, 66, 67, 68, 69, 70, 73, 74, 75, 77, 79, 80, 82, 85, 86, 87, 88, 89, 91, 92, 93, 95, 96, 98, 99, 100, 101, 102, 103, 104, 105, 108, 109, 112, 113, 114, 115, 116, 117, 118, 119, 120, 122, 123, 124, 125, 126, 127, 128, 129, 130, 132, 135, 136, 139, 142, 143, 146, 147, 148, 149, 150, 151, 152, 153, 155, 159, 161, 162, 163, 165, 167, 168, 169, 170, 171, 172, 173, 175, 176, 178, 179, 180, 182, 183, 184, 186, 188, 190, 191, 192, 193, 194, 196]"
agent_c,L0,short,130,61,69,9,0.35,200,"[0, 5, 6, 9, 10, 15, 16, 17, 19, 24, 27, 28, 29, 30, 32, 33, 35, 36, 37, 40, 41, 42, 43, 44, 45, 46, 47, 48, 49, 50, 53, 54, 55, 57, 58, 59, 60, 61, 62, 65, 66, 68, 69, 70, 71, 72, 73, 74, 75, 76, 77, 78, 79, 80, 82, 83, 84, 85, 86, 87, 88, 89, 90, 91, 92, 94, 96, 98, 99, 100, 102, 103, 104, 105, 107, 108, 109, 110, 111, 112, 113, 115, 116, 117, 118, 119, 120, 121, 122, 123, 124, 126, 129, 131, 132, 133, 135, 136, 137, 138, 142, 145, 149, 150, 151, 153, 154, 155, 157, 158, 161, 162, 167, 169, 170, 171, 172, 173, 174, 178, 179, 180, 185, 186, 187, 188, 191, 197, 198, 199]"
agent_c,L0,short,126,46,80,9,0.37,200,"[0, 3, 5, 6, 7, 8, 9, 10, 11, 12, 13, 14, 15, 16, 17, 18, 19, 20, 21, 25, 27, 28, 29, 30, 31, 32, 35, 36, 37, 38, 40, 42, 43, 44, 47, 51, 52, 53, 54, 57, 60, 63, 64, 65, 66, 67, 68, 70, 71, 73, 74, 75, 77, 78, 80, 81, 82, 83, 85, 86, 87, 88, 89, 90, 91, 93, 94, 95, 96, 97, 99, 101, 103, 104, 106, 107, 108, 110, 113, 114, 116, 120, 123, 124, 125, 126, 127, 128, 130, 131, 133, 134, 135, 137, 139, 141, 144, 147, 148, 149, 150, 152, 153, 154, 156, 159, 162, 163, 164, 165, 168, 169, 171, 173, 177, 178, 179, 180, 181, 182, 183, 187, 194, 196, 197, 198]"
agent_c,L0,short,124,54,70,18,0.38,200,"[2, 3, 4, 5, 7, 9, 10, 11, 12, 13, 14, 15, 17, 19, 20, 21, 23, 25, 26, 27, 29, 30, 33, 35, 40, 41, 42, 43, 44, 45, 46, 48, 50, 51, 52, 53, 54, 55, 56, 57, 59, 60, 66, 70, 72, 73, 74, 75, 76, 77, 78, 84, 87, 88, 89, 91, 93, 94, 96, 97, 98, 100, 101, 102, 109, 110, 111, 112, 113, 115, 116, 117, 120, 123, 125, 126, 127, 129, 131, 132, 133, 137, 139, 142, 143, 144, 145, 146, 147, 148, 149, 150, 152, 153, 156, 157, 158, 159, 160, 161, 165, 166, 167, 169, 170, 171, 172, 174, 175, 176, 178, 179, 180, 183, 185, 186, 187, 188, 189, 190, 191, 192, 193, 194]"
agent_c,L0,short,126,60,66,7,0.37,200,"[0, 1, 2, 3, 4, 5, 7, 8, 9, 12, 14, 15, 17, 19, 20, 21, 22, 23, 25, 26, 27, 28, 32, 34, 36, 37, 40, 41, 43, 46, 47, 50, 52, 53, 54, 55, 57, 58, 59, 60, 63, 64, 65, 67, 68, 69, 70, 74, 75, 77, 78, 81, 83, 84, 85, 86, 89, 91, 92, 93, 94, 96, 97, 98, 99, 100, 104, 105, 106, 108, 109, 110, 111, 114, 116, 121, 123, 124, 125, 126, 128, 129, 131, 132, 133, 134, 135, 136, 137, 139, 141, 143, 146, 149, 150, 151, 154, 155, 157, 158, 159, 160, 162, 163, 164, 165, 167, 168, 169, 170, 171, 173, 174, 175, 176, 177, 180, 182, 183, 185, 186, 191, 192, 195, 196, 197]"
agent_c,L0,short,129,63,66,11,0.355,200,"[0, 1, 2, 6, 8, 9, 10, 12, 13, 14, 15, 16, 17, 19, 21, 23, 24, 26, 27, 28, 29, 31, 34, 36, 37, 38, 41, 44, 46, 47, 49, 50, 51, 53, 54, 55, 58, 62, 65, 66, 67, 69, 71, 72, 73, 74, 75, 77, 78, 79, 81, 82, 83, 86, 87, 88, 89, 90, 91, 94, 96, 101, 104, 106, 107, 108, 110, 111, 112, 113, 114, 115, 116, 118, 121, 122, 123, 125, 126, 128, 129, 130, 132, 133, 134, 135, 136, 137, 138, 140, 141, 142, 143, 145, 146, 147, 149, 154, 156, 158, 159, 160, 161, 162, 163, 164, 165, 166, 167, 168, 169, 171, 173, 175, 177, 178, 179, 181, 184, 185, 186, 187, 188, 190, 192, 195, 196, 198, 199]"
agent_c,L0,short,134,45,89,11,0.33,200,"[0, 2, 4, 6, 7, 10, 11, 12, 13, 15, 16, 17, 18, 19, 20, 21, 22, 24, 25, 27, 28, 30, 32, 33, 34, 38, 39, 40, 41, 44, 45, 46, 47, 50, 52, 53, 54, 56, 57, 58, 60, 62, 63, 64, 65, 66, 67, 69, 70, 71, 72, 73, 74, 75, 76, 77, 79, 80, 81, 82, 84, 85, 86, 87, 89, 91, 92, 97, 98, 99, 101, 102, 107, 108, 109, 110, 111, 115, 116, 118, 119, 120, 121, 123, 124, 125, 127, 128, 129, 130, 131, 132, 133, 136, 137, 138, 139, 140, 142, 144, 146, 147, 148, 149, 151, 156, 157, 158, 160, 161, 163, 164, 166, 167, 168, 169, 170, 171, 173, 176, 178, 179, 180, 181, 182, 183, 184, 185, 186, 187, 193, 194, 197, 198]"
agent_c,L0,short,117,53,64,13,0.415,200,"[0, 1, 2, 3, 7, 9, 11, 14, 19, 20, 23, 25, 28, 29, 30, 32, 34, 36, 37, 38, 39, 40, 43, 44, 46, 49, 51, 52, 55, 56, 57, 59, 62, 63, 64, 67, 68, 71, 72, 73, 75, 76, 77, 78, 79, 81, 82, 83, 85, 86, 87, 89, 90, 93, 94, 95, 99, 100, 102, 104, 106, 109, 110, 112, 113, 114, 116, 117, 118, 119, 120, 121, 123, 127, 128, 129, 130, 131, 132, 133, 134, 136, 142, 143, 144, 146, 147, 148, 149, 150, 151, 154, 157, 159, 161, 163, 164, 165, 166, 171, 174, 175, 176, 178, 179, 184, 185, 186, 187, 188, 190, 191, 193, 195, 196, 197, 199]"
agent_c,L0,short,130,71,59,5,0.35,200,"[1, 2, 3, 5, 8, 9, 10, 13, 14, 15, 16, 17, 19, 20, 21, 23, 24, 25, 26, 28, 29, 30, 31, 33, 34, 35, 36, 38, 41, 42, 44, 45, 46, 47, 49, 50, 52, 53, 55, 56, 57, 59, 60, 62, 65, 66, 67, 68, 69, 71, 73, 74, 75, 77, 78, 79, 81, 82, 83, 84, 85, 86, 87, 89, 90, 91, 92, 95, 97, 98, 99, 100, 101, 103, 104, 105, 106, 107, 108, 109, 110, 111, 113, 115, 116, 118, 119, 125, 128, 131, 133, 136, 137, 138, 139, 142, 144, 147, 148, 151, 152, 153, 154, 155, 156, 157, 158, 159, 160, 161, 162, 163, 164, 165, 168, 170, 172, 174, 176, 177, 178, 179, 180, 182, 183, 186, 188, 194, 195, 198]"
agent_c,L0,short,130,58,72,8,0.35,200,"[1, 2, 3, 5, 6, 8, 9, 10, 11, 12, 14, 15, 16, 17, 18, 20, 21, 22, 26, 27, 28, 29, 30, 31, 33, 34, 35, 36, 37, 40, 41, 42, 43, 44, 45, 46, 47, 50, 52, 54, 55, 58, 61, 62, 65, 66, 68, 69, 71, 72, 73, 74, 75, 76, 77, 78, 79, 81, 84, 86, 87, 89, 90, 93, 94, 95, 97, 99, 100, 102, 104, 105, 107, 109, 110, 111, 114, 118, 119, 120, 122, 124, 125, 126, 127, 128, 129, 132, 133, 134, 135, 139, 141, 142, 143, 144, 146, 148, 149, 150, 153, 154, 156, 158, 160, 161, 162, 165, 166, 167, 169, 171, 173, 174, 175, 176, 177, 179, 180, 181, 183, 184, 188, 189, 190, 191, 192, 193, 194, 199]"
agent_c,L0,short,129,57,72,5,0.355,200,"[0, 2, 4, 5, 6, 7, 8, 9, 10, 12, 13, 14, 15, 17, 19, 20, 21, 23, 24, 26, 28, 29, 30, 31, 32, 35, 36, 37, 38, 39, 42, 43, 44, 45, 47, 48, 49, 50, 52, 53, 54, 55, 57, 58, 59, 60, 61, 63, 64, 65, 67, 69, 70, 73, 74, 75, 76, 77, 80, 84, 86, 87, 88, 91, 92, 93, 94, 96, 97, 99, 100, 101, 102, 106, 108, 109, 110, 111, 115, 116, 117, 119, 120, 121, 122, 123, 124, 128, 129, 132, 133, 134, 135, 137, 138, 139, 140, 143, 144, 145, 147, 149, 151, 152, 153, 154, 155, 156, 157, 158, 160, 161, 162, 163, 164, 165, 166, 168, 172, 174, 177, 178, 181, 184, 190, 191, 192, 193, 198]"
agent_c,L0,short,120,64,56,8,0.4,200,"[0, 1, 3, 6, 9, 11, 12, 13, 14, 16, 17, 19, 20, 21, 23, 25, 32, 34, 36, 38, 40, 44, 45, 47, 48, 51, 54, 55, 57, 60, 61, 62, 63, 64, 66, 68, 69, 70, 72, 73, 75, 78, 79, 80, 81, 83, 84, 86, 87, 88, 91, 93, 96, 97, 99, 102, 103, 104, 105, 106, 108, 109, 110, 112, 113, 114, 115, 116, 117, 118, 119, 120, 122, 123, 125, 127, 128, 129, 130, 131, 132, 133, 135, 137, 139, 140, 142, 143, 144, 145, 146, 147, 149, 151, 152, 153, 154, 158, 159, 160, 161, 162, 164, 165, 167, 168, 169, 174, 176, 177, 179, 180, 182, 183, 184, 186, 190, 191, 192, 193]"
agent_c,L0,short,125,69,56,8,0.375,200,"[0, 2, 3, 4, 5, 7, 8, 11, 12, 13, 15, 16, 20, 21, 22, 23, 25, 26, 27, 28, 29, 30, 31, 36, 38, 39, 40, 41, 42, 43, 47, 48, 49, 51, 52, 53, 54, 56, 57, 60, 62, 63, 64, 66, 68, 69, 70, 74, 78, 79, 80, 81, 88, 89, 90, 91, 92, 93, 94, 96, 97, 100, 101, 102, 103, 108, 109, 110, 111, 112, 113, 115, 116, 119, 120, 121, 123, 124, 125, 126, 127, 129, 133, 136, 137, 139, 140, 142, 143, 144, 146, 147, 150, 151, 153, 156, 157, 159, 160, 162, 165, 166, 170, 171, 172, 173, 174, 175, 176, 177, 178, 180, 181, 182, 183, 184, 187, 188, 190, 191, 192, 193, 194, 195, 199]"
agent_c,L0,short,133,62,71,8,0.335,200,"[0, 1, 2, 3, 4, 7, 8, 9, 10, 13, 14, 15, 16, 19, 20, 23, 24, 26, 28, 29, 30, 31, 33, 34, 35, 36, 37, 38, 39, 40, 41, 43, 44, 46, 48, 49, 50, 51, 53, 54, 56, 57, 58, 59, 61, 62, 64, 65, 67, 68, 69, 72, 73, 74, 76, 77, 78, 79, 80, 81, 82, 83, 84, 86, 88, 89, 91, 94, 97, 98, 100, 101, 103, 104, 106, 107, 108, 110, 112, 113, 114, 115, 116, 117, 118, 119, 120, 123, 125, 126, 127, 130, 131, 132, 134, 135, 137, 138, 139, 142, 143, 144, 146, 147, 148, 149, 151, 153, 154, 156, 157, 158, 160, 162, 163, 164, 165, 166, 168, 170, 171, 173, 174, 175, 176, 177, 181, 183, 184, 185, 186, 190, 198]"
agent_c,L50,short,121,66,55,15,0.395,200,"[1, 2, 3, 4, 5, 6, 8, 10, 11, 13, 14, 17, 20, 21, 23, 24, 25, 26, 29, 31, 32, 35, 36, 37, 38, 39, 40, 45, 47, 48, 51, 52, 53, 54, 57, 58, 60, 61, 62, 63, 64, 65, 66, 68, 70, 72, 75, 76, 77, 80, 81, 84, 85, 86, 87, 89, 91, 93, 94, 95, 96, 98, 99, 100, 101, 103, 104, 105, 107, 108, 109, 110, 111, 113, 117, 122, 124, 125, 126, 128, 129, 130, 131, 134, 135, 136, 137, 138, 139, 141, 143, 144, 145, 147, 148, 151, 152, 156, 157, 158, 159, 160, 161, 164, 165, 166, 168, 170, 171, 176, 177, 178, 179, 182, 183, 189, 191, 194, 195, 196, 197]"
agent_c,L50,short,121,54,67,7,0.395,200,"[3, 4, 5, 8, 9, 10, 15, 17, 18, 19, 21, 22, 23, 24, 26, 27, 28, 29, 30, 31, 35, 39, 40, 41, 43, 45, 48, 49, 51, 53, 55, 57, 58, 59, 60, 61, 62, 63, 64, 67, 68, 70, 73, 76, 80, 85, 86, 87, 89, 92, 94, 95, 96, 97, 100, 101, 104, 106, 107, 108, 109, 110, 112, 113, 115, 117, 119, 120, 121, 122, 123, 124, 126, 128, 129, 130, 131, 132, 133, 136, 139, 141, 143, 144, 145, 146, 147, 149, 150, 151, 152, 153, 154, 155, 156, 158, 160, 161, 162, 164, 166, 170, 171, 172, 174, 175, 176, 178, 179, 182, 184, 185, 186, 187, 188, 189, 190, 195, 196, 197, 198]"
agent_c,L50,short,120,79,41,18,0.4,200,"[0, 2, 5, 7, 9, 11, 15, 16, 17, 19, 22, 23, 24, 25, 27, 29, 31, 35, 36, 38, 41, 42, 45, 47, 48, 49, 51, 55, 56, 57, 58, 59, 61, 62, 63, 64, 65, 66, 68, 70, 71, 73, 74, 75, 76, 79, 80, 81, 82, 84, 85, 87, 88, 91, 92, 96, 97, 98, 99, 100, 101, 102, 103, 105, 106, 108, 110, 117, 119, 120, 121, 123, 124, 126, 127, 128, 129, 130, 132, 135, 136, 138, 139, 140, 144, 146, 147, 148, 149, 150, 151, 152, 154, 159, 160, 162, 164, 167, 168, 169, 173, 174, 175, 176, 177, 178, 180, 181, 182, 184, 185, 186, 188, 189, 190, 191, 192, 193, 194, 195]"
agent_c,L50,short,130,70,60,15,0.35,200,"[1, 2, 6, 7, 8, 9, 10, 11, 12, 14, 16, 17, 18, 19, 21, 22, 23, 24, 26, 27, 28, 31, 32, 34, 35, 37, 39, 40, 41, 43, 46, 48, 49, 50, 52, 54, 55, 56, 57, 59, 60, 61, 62, 63, 64, 65, 66, 67, 68, 69, 72, 74, 75, 76, 77, 78, 79, 80, 81, 85, 86, 87, 89, 91, 92, 93, 96, 98, 101, 102, 103, 104, 105, 106, 108, 109, 110, 112, 113, 114, 116, 117, 118, 119, 120, 121, 122, 123, 124, 127, 128, 129, 131, 133, 135, 136, 137, 138, 141, 142, 143, 144, 145, 149, 152, 153, 154, 155, 159, 161, 162, 163, 164, 169, 170, 171, 174, 175, 176, 177, 178, 179, 184, 187, 188, 189, 195, 197, 198, 199]"
agent_c,L50,short,125,65,60,9,0.375,200,"[1, 3, 4, 5, 6, 9, 10, 12, 13, 15, 17, 18, 20, 21, 25, 27, 28, 29, 30, 31, 32, 33, 34, 35, 37, 39, 41, 42, 45, 46, 48, 49, 50, 52, 53, 54, 55, 58, 60, 61, 62, 63, 64, 66, 67, 70, 72, 73, 75, 76, 77, 79, 80, 81, 82, 83, 85, 86, 87, 88, 89, 92, 94, 97, 98, 99, 100, 102, 103, 104, 105, 106, 107, 108, 109, 111, 113, 114, 115, 116, 117, 118, 121, 122, 123, 124, 126, 131, 132, 134, 135, 136, 138, 141, 144, 145, 146, 149, 150, 151, 152, 153, 154, 156, 157, 159, 161, 162, 165, 167, 168, 170, 171, 173, 174, 175, 178, 181, 182, 183, 184, 185, 186, 187, 191]"
agent_c,L50,short,127,60,67,13,0.365,200,"[1, 2, 4, 5, 6, 7, 8, 9, 11, 13, 14, 19, 21, 23, 24, 25, 26, 28, 29, 30, 31, 34, 36, 37, 39, 42, 43, 44, 45, 46, 47, 48, 49, 50, 53, 54, 55, 58, 59, 60, 61, 62, 65, 66, 67, 70, 71, 74, 75, 77, 79, 80, 81, 82, 83, 84, 85, 88, 89, 90, 91, 92, 93, 94, 95, 98, 99, 101, 102, 103, 104, 106, 107, 108, 110, 111, 113, 114, 115, 116, 117, 118, 121, 125, 126, 127, 128, 129, 130, 131, 132, 133, 134, 135, 138, 139, 140, 143, 145, 146, 150, 153, 155, 156, 158, 159, 161, 163, 164, 165, 166, 167, 171, 173, 174, 176, 178, 181, 182, 184, 185, 186, 188, 194, 195, 196, 197]"
agent_c,L50,short,125,65,60,10,0.375,200,"[0, 1, 2, 3, 4, 6, 9, 11, 12, 13, 14, 15, 16, 18, 19, 22, 24, 25, 27, 31, 32, 33, 34, 35, 36, 39, 40, 41, 43, 46, 47, 50, 52, 53, 54, 57, 58, 59, 60, 63, 64, 67, 69, 70, 71, 72, 73, 74, 75, 76, 77, 78, 80, 81, 82, 84, 85, 86, 87, 88, 89, 90, 91, 92, 93, 95, 96, 97, 100, 103, 106, 108, 110, 112, 115, 116, 117, 119, 120, 122, 123, 124, 128, 130, 131, 132, 134, 135, 137, 138, 142, 144, 145, 148, 149, 151, 152, 154, 155, 157, 160, 161, 164, 165, 166, 171, 172, 173, 174, 175, 176, 178, 180, 182, 183, 185, 186, 188, 189, 190, 195, 196, 197, 198, 199]"
agent_c,L50,short,123,48,75,14,0.385,200,"[0, 1, 2, 3, 5, 7, 8, 12, 17, 18, 20, 21, 22, 24, 25, 26, 27, 29, 30, 31, 32, 34, 35, 36, 39, 40, 41, 44, 45, 47, 48, 50, 51, 52, 53, 54, 56, 57, 59, 61, 66, 68, 69, 70, 71, 72, 73, 74, 80, 81, 82, 84, 87, 88, 89, 90, 92, 94, 95, 96, 102, 103, 105, 106, 111, 112, 113, 114, 115, 116, 117, 119, 120, 122, 127, 128, 129, 130, 131, 132, 134, 136, 137, 138, 139, 140, 141, 142, 144, 145, 146, 147, 149, 151, 152, 153, 154, 155, 157, 158, 159, 160, 163, 164, 166, 167, 169, 171, 174, 177, 178, 181, 182, 184, 185, 186, 187, 188, 189, 190, 191, 192, 194]"
agent_c,L50,short,126,70,56,1,0.37,200,"[2, 5, 7, 8, 10, 12, 13, 15, 18, 19, 20, 21, 22, 23, 24, 25, 27, 32, 33, 34, 36, 37, 38, 39, 40, 42, 43, 44, 45, 47, 48, 50, 52, 53, 54, 56, 57, 59, 68, 69, 70, 72, 73, 74, 76, 77, 78, 79, 82, 83, 84, 86, 87, 88, 89, 91, 92, 94, 95, 96, 97, 98, 99, 100, 101, 102, 103, 106, 107, 108, 110, 111, 112, 113, 114, 115, 118, 119, 121, 123, 124, 125, 126, 127, 128, 129, 131, 132, 133, 134, 137, 138, 140, 141, 143, 144, 147, 150, 151, 152, 153, 154, 156, 157, 158, 159, 160, 162, 163, 164, 167, 168, 171, 172, 173, 175, 176, 177, 178, 179, 180, 183, 188, 190, 192, 193]"
agent_c,L50,short,127,64,63,7,0.365,200,"[2, 5, 6, 8, 11, 12, 15, 16, 18, 19, 20, 22, 23, 24, 25, 26, 28, 29, 30, 31, 32, 35, 38, 39, 40, 41, 42, 43, 44, 45, 46, 47, 48, 49, 51, 52, 54, 55, 57, 58, 59, 60, 62, 63, 66, 68, 70, 72, 73, 74, 75, 76, 78, 79, 80, 82, 83, 85, 87, 88, 90, 91, 92, 93, 95, 97, 98, 99, 102, 103, 105, 108, 110, 111, 112, 113, 116, 117, 119, 120, 122, 124, 125, 126, 127, 129, 130, 131, 132, 133, 135, 137, 139, 140, 141, 142, 143, 144, 146, 148, 149, 150, 151, 153, 154, 155, 159, 160, 163, 165, 166, 167, 169, 171, 172, 174, 177, 178, 180, 183, 186, 187, 188, 189, 190, 192, 199]"
agent_c,L50,short,128,82,46,8,0.36,200,"[0, 1, 2, 3, 4, 7, 8, 10, 11, 12, 13, 15, 16, 18, 19, 20, 21, 22, 23, 24, 26, 28, 30, 31, 32, 34, 35, 36, 37, 38, 40, 41, 44, 45, 49, 50, 52, 53, 54, 56, 58, 59, 60, 61, 62, 64, 65, 66, 68, 69, 70, 72, 73, 74, 75, 76, 77, 80, 81, 83, 84, 86, 87, 88, 89, 90, 91, 92, 93, 94, 95, 98, 99, 103, 104, 105, 106, 109, 110, 112, 113, 115, 117, 118, 119, 120, 122, 124, 125, 128, 130, 132, 133, 134, 135, 136, 137, 138, 141, 142, 143, 146, 147, 148, 150, 152, 153, 156, 157, 158, 159, 160, 162, 163, 164, 165, 166, 169, 171, 172, 173, 174, 175, 176, 184, 187, 195, 196]"
agent_c,L50,short,124,71,53,10,0.38,200,"[1, 2, 3, 4, 6, 7, 9, 10, 12, 15, 16, 18, 19, 20, 23, 25, 28, 29, 30, 31, 34, 35, 36, 37, 38, 40, 43, 44, 46, 47, 50, 52, 53, 54, 55, 56, 57, 58, 59, 60, 61, 62, 66, 68, 70, 71, 72, 73, 74, 75, 76, 77, 82, 83, 84, 87, 88, 89, 90, 91, 92, 93, 94, 96, 97, 101, 103, 104, 105, 106, 108, 109, 110, 113, 114, 117, 118, 119, 120, 121, 124, 125, 127, 131, 133, 134, 135, 136, 137, 138, 139, 140, 141, 143, 144, 145, 146, 147, 149, 151, 152, 153, 155, 156, 157, 159, 160, 162, 163, 164, 165, 170, 172, 173, 175, 176, 177, 178, 179, 181, 187, 188, 191, 199]"
agent_c,L50,short,129,65,64,9,0.355,200,"[0, 1, 2, 3, 4, 6, 7, 8, 9, 11, 13, 14, 16, 17, 18, 19, 21, 22, 23, 26, 27, 28, 32, 33, 34, 35, 37, 38, 39, 40, 41, 42, 44, 50, 53, 54, 55, 56, 59, 60, 61, 62, 64, 65, 66, 67, 68, 69, 70, 73, 74, 76, 77, 78, 79, 80, 81, 83, 86, 91, 92, 93, 95, 96, 97, 98, 99, 100, 102, 103, 104, 105, 106, 108, 110, 111, 113, 114, 115, 116, 118, 119, 120, 122, 123, 124, 125, 126, 127, 128, 130, 132, 133, 134, 136, 137, 138, 139, 140, 143, 144, 145, 146, 149, 153, 154, 156, 157, 159, 161, 162, 163, 165, 166, 167, 169, 170, 171, 172, 174, 175, 180, 181, 182, 183, 184, 186, 188, 197]"
agent_c,L50,short,130,80,50,6,0.35,200,"[0, 1, 5, 10, 12, 14, 15, 16, 17, 18, 19, 20, 21, 22, 23, 25, 26, 28, 30, 31, 32, 33, 34, 35, 37, 38, 40, 41, 42, 44, 45, 46, 47, 48, 49, 52, 54, 56, 58, 59, 61, 62, 64, 65, 66, 67, 68, 69, 70, 71, 73, 75, 76, 78, 79, 80, 81, 85, 86, 90, 92, 93, 94, 95, 96, 97, 98, 99, 100, 101, 103, 105, 108, 109, 110, 111, 113, 115, 116, 117, 119, 120, 123, 127, 128, 130, 135, 136, 137, 139, 140, 141, 143, 144, 145, 146, 148, 150, 152, 153, 156, 157, 158, 159, 160, 161, 162, 163, 164, 166, 167, 168, 169, 170, 173, 175, 176, 177, 178, 179, 180, 181, 185, 186, 187, 188, 189, 190, 191, 192]"
agent_c,L50,short,131,60,71,9,0.345,200,"[1, 2, 3, 4, 5, 6, 8, 11, 12, 13, 15, 16, 17, 19, 22, 24, 26, 28, 29, 30, 31, 32, 35, 36, 38, 39, 40, 42, 43, 45, 47, 54, 56, 57, 60, 61, 62, 63, 65, 70, 74, 75, 76, 77, 78, 79, 80, 81, 82, 83, 85, 86, 87, 89, 90, 91, 92, 94, 95, 96, 97, 98, 99, 100, 101, 103, 104, 105, 106, 107, 108, 111, 112, 113, 114, 116, 117, 118, 120, 122, 123, 124, 125, 126, 128, 131, 132, 133, 134, 135, 137, 138, 139, 140, 141, 142, 143, 145, 146, 148, 150, 151, 152, 154, 155, 156, 157, 158, 159, 160, 162, 163, 164, 165, 166, 167, 168, 171, 175, 176, 178, 181, 184, 185, 188, 189, 190, 196, 197, 198, 199]"
agent_c,L50,short,122,52,70,12,0.39,200,"[0, 3, 4, 5, 6, 7, 8, 9, 10, 12, 15, 16, 17, 18, 20, 21, 22, 23, 24, 25, 27, 30, 31, 32, 34, 36, 37, 39, 41, 43, 44, 45, 46, 47, 49, 54, 58, 59, 61, 64, 66, 67, 70, 71, 76, 79, 80, 81, 82, 83, 84, 86, 87, 88, 89, 92, 95, 97, 98, 100, 101, 103, 107, 109, 110, 111, 112, 113, 116, 117, 119, 123, 125, 126, 127, 129, 130, 131, 134, 135, 138, 140, 141, 142, 143, 144, 145, 146, 147, 149, 150, 151, 152, 153, 154, 155, 156, 157, 158, 159, 161, 162, 165, 168, 170, 172, 173, 175, 177, 178, 179, 180, 182, 183, 184, 186, 187, 189, 190, 191, 192, 196]"
agent_c,L50,short,129,70,59,5,0.355,200,"[1, 2, 5, 6, 8, 9, 11, 15, 16, 18, 19, 20, 21, 23, 26, 27, 28, 29, 31, 33, 34, 35, 36, 38, 39, 40, 41, 43, 44, 45, 46, 48, 51, 52, 53, 54, 56, 57, 58, 59, 60, 61, 63, 64, 65, 66, 67, 68, 69, 70, 71, 72, 73, 74, 75, 77, 79, 82, 84, 86, 87, 88, 89, 91, 92, 93, 94, 95, 97, 98, 99, 100, 101, 102, 103, 104, 106, 107, 109, 111, 112, 117, 118, 120, 121, 122, 124, 125, 126, 127, 129, 131, 132, 136, 137, 140, 141, 143, 144, 145, 147, 148, 149, 151, 153, 156, 161, 162, 163, 164, 165, 166, 167, 168, 169, 170, 171, 172, 173, 174, 175, 178, 180, 182, 184, 190, 192, 194, 195]"
agent_c,L50,short,132,54,78,10,0.34,200,"[2, 3, 4, 5, 6, 7, 8, 10, 12, 13, 16, 17, 18, 19, 20, 21, 23, 24, 25, 26, 27, 28, 31, 33, 34, 35, 38, 39, 42, 44, 45, 46, 48, 49, 51, 56, 58, 59, 60, 63, 64, 65, 67, 68, 69, 70, 71, 73, 74, 75, 76, 77, 79, 80, 81, 83, 86, 87, 89, 90, 91, 92, 93, 94, 95, 96, 97, 99, 100, 102, 103, 104, 105, 108, 109, 110, 111, 113, 114, 115, 116, 118, 119, 120, 121, 122, 123, 125, 126, 128, 130, 131, 132, 133, 136, 137, 139, 140, 141, 142, 144, 145, 146, 149, 150, 152, 154, 155, 156, 157, 158, 159, 161, 163, 167, 168, 169, 172, 173, 174, 175, 176, 177, 178, 179, 181, 184, 186, 187, 188, 190, 199]"
agent_c,L50,short,129,73,56,8,0.355,200,"[0, 1, 2, 3, 4, 5, 10, 12, 13, 14, 15, 16, 18, 19, 20, 21, 22, 23, 24, 28, 29, 30, 31, 32, 34, 37, 38, 39, 41, 42, 44, 45, 46, 48, 51, 53, 55, 56, 58, 62, 63, 64, 66, 67, 68, 70, 72, 73, 74, 75, 77, 78, 79, 80, 82, 83, 84, 85, 87, 88, 89, 92, 94, 95, 96, 97, 98, 100, 101, 103, 106, 108, 109, 111, 112, 113, 116, 118, 119, 121, 122, 123, 124, 125, 127, 128, 130, 133, 134, 135, 136, 137, 139, 141, 142, 143, 144, 145, 146, 147, 148, 149, 150, 151, 153, 154, 155, 156, 157, 158, 159, 160, 161, 164, 166, 168, 172, 175, 176, 177, 180, 184, 188, 189, 195, 196, 197, 198, 199]"
agent_c,L50,short,134,56,78,6,0.33,200,"[0, 1, 2, 3, 4, 5, 6, 8, 10, 11, 12, 14, 15, 16, 17, 18, 19, 20, 23, 25, 27, 28, 29, 30, 31, 35, 36, 37, 39, 40, 41, 42, 43, 44, 45, 47, 48, 50, 51, 52, 53, 54, 55, 56, 57, 58, 59, 61, 62, 66, 67, 68, 69, 70, 72, 73, 74, 76, 77, 79, 80, 81, 82, 83, 86, 88, 90, 91, 92, 93, 94, 95, 96, 97, 98, 100, 101, 102, 103, 104, 105, 106, 108, 110, 111, 112, 113, 114, 116, 117, 119, 120, 121, 124, 125, 126, 127, 128, 129, 130, 131, 132, 140, 141, 142, 143, 145, 146, 147, 148, 149, 150, 151, 155, 156, 158, 162, 164, 165, 166, 168, 169, 173, 174, 175, 176, 177, 178, 181, 187, 189, 196, 198, 199]"
agent_c,L50,short,128,76,52,11,0.36,200,"[1, 3, 5, 7, 8, 9, 10, 11, 12, 13, 14, 15, 17, 18, 19, 20, 22, 23, 26, 28, 30, 32, 35, 36, 37, 40, 42, 43, 45, 46, 49, 52, 54, 55, 57, 58, 61, 62, 63, 64, 65, 66, 67, 70, 71, 72, 73, 74, 75, 77, 78, 79, 80, 81, 82, 84, 87, 88, 89, 90, 95, 96, 97, 99, 100, 101, 106, 107, 108, 109, 114, 116, 117, 118, 119, 120, 121, 122, 123, 124, 126, 127, 129, 131, 132, 133, 134, 137, 138, 139, 141, 144, 146, 147, 149, 150, 151, 152, 153, 154, 156, 157, 158, 159, 160, 162, 164, 165, 166, 168, 169, 170, 171, 172, 174, 175, 176, 177, 178, 179, 182, 183, 185, 186, 188, 189, 191, 199]"
agent_c,L50,short,135,57,78,8,0.325,200,"[0, 2, 3, 4, 8, 9, 10, 11, 12, 17, 19, 20, 21, 22, 23, 25, 26, 27, 28, 29, 30, 32, 33, 34, 35, 36, 38, 39, 43, 44, 45, 48, 49, 51, 52, 53, 54, 55, 57, 59, 61, 62, 63, 65, 66, 68, 72, 73, 74, 75, 76, 77, 78, 79, 80, 81, 82, 83, 84, 85, 86, 87, 88, 89, 90, 91, 92, 94, 95, 96, 97, 99, 100, 101, 102, 103, 104, 105, 109, 111, 113, 115, 117, 118, 119, 121, 122, 123, 125, 126, 127, 128, 130, 131, 132, 133, 134, 136, 140, 144, 146, 148, 150, 151, 152, 154, 155, 156, 157, 158, 161, 162, 163, 165, 167, 168, 170, 171, 172, 174, 175, 178, 182, 183, 184, 185, 187, 190, 191, 192, 193, 194, 195, 196, 197]"
agent_c,L50,short,125,56,69,10,0.375,200,"[1, 2, 3, 4, 5, 6, 8, 9, 12, 13, 14, 16, 17, 19, 20, 21, 22, 23, 24, 25, 26, 29, 30, 31, 33, 36, 37, 38, 39, 40, 41, 42, 43, 45, 46, 47, 48, 49, 50, 51, 52, 53, 54, 55, 56, 58, 59, 60, 63, 64, 65, 67, 68, 71, 73, 74, 75, 77, 80, 81, 83, 84, 85, 86, 87, 90, 92, 96, 97, 98, 100, 101, 103, 108, 110, 111, 113, 114, 116, 117, 118, 120, 121, 122, 124, 125, 126, 127, 128, 130, 132, 133, 134, 136, 137, 138, 139, 140, 143, 146, 148, 151, 152, 155, 157, 159, 160, 162, 166, 167, 168, 169, 170, 171, 172, 173, 177, 178, 179, 183, 187, 188, 189, 190, 192]"
agent_c,L50,short,127,66,61,11,0.365,200,"[0, 1, 2, 3, 6, 9, 12, 14, 15, 16, 17, 19, 22, 23, 24, 29, 31, 32, 33, 34, 35, 39, 40, 42, 43, 44, 46, 47, 49, 51, 54, 55, 57, 59, 61, 62, 63, 64, 67, 68, 70, 71, 73, 74, 75, 76, 77, 78, 80, 83, 84, 85, 86, 88, 89, 90, 91, 92, 96, 100, 101, 102, 106, 107, 108, 109, 110, 111, 112, 113, 114, 115, 116, 117, 120, 121, 122, 123, 126, 127, 128, 129, 130, 131, 133, 134, 135, 136, 137, 138, 139, 140, 141, 142, 143, 144, 145, 146, 147, 148, 149, 151, 155, 156, 157, 158, 159, 163, 165, 166, 168, 170, 171, 172, 175, 177, 178, 180, 182, 183, 184, 185, 188, 193, 194, 195, 196]"
agent_c,L50,short,122,54,68,13,0.39,200,"[0, 1, 2, 3, 4, 5, 7, 8, 9, 10, 11, 12, 15, 16, 18, 21, 23, 24, 25, 26, 30, 31, 32, 34, 35, 37, 40, 42, 43, 45, 49, 50, 52, 53, 54, 55, 56, 57, 59, 60, 61, 63, 65, 66, 67, 68, 69, 70, 71, 72, 75, 77, 78, 79, 80, 82, 83, 86, 87, 88, 89, 91, 93, 95, 99, 101, 106, 108, 111, 112, 114, 115, 117, 118, 119, 120, 122, 123, 124, 125, 126, 127, 128, 129, 130, 135, 136, 142, 144, 145, 146, 147, 148, 149, 151, 152, 153, 155, 156, 157, 158, 159, 160, 161, 163, 167, 169, 173, 175, 177, 178, 179, 180, 187, 188, 190, 191, 192, 193, 194, 196, 197]"
agent_c,L50,short,132,64,68,8,0.34,200,"[0, 1, 2, 3, 4, 5, 6, 7, 9, 10, 11, 12, 13, 14, 16, 17, 18, 19, 23, 25, 27, 28, 29, 30, 31, 32, 33, 34, 35, 36, 37, 39, 40, 41, 43, 44, 45, 49, 51, 52, 54, 55, 56, 58, 63, 65, 66, 67, 68, 69, 71, 73, 75, 76, 77, 78, 79, 81, 82, 83, 84, 85, 86, 87, 89, 90, 92, 93, 94, 95, 97, 98, 99, 101, 102, 103, 104, 105, 107, 109, 110, 111, 112, 113, 115, 116, 117, 118, 122, 123, 124, 126, 128, 129, 130, 131, 132, 133, 135, 136, 137, 139, 140, 141, 142, 143, 146, 147, 148, 149, 151, 153, 154, 155, 156, 158, 161, 164, 165, 167, 169, 170, 172, 173, 174, 175, 180, 183, 191, 192, 193, 194]"
agent_c,L50,short,121,54,67,11,0.395,200,"[0, 1, 2, 3, 6, 7, 8, 11, 14, 15, 17, 22, 23, 24, 25, 27, 29, 32, 33, 34, 35, 37, 39, 41, 42, 45, 46, 48, 49, 50, 51, 52, 55, 57, 58, 59, 61, 62, 63, 65, 67, 69, 70, 71, 74, 77, 80, 81, 82, 83, 84, 86, 87, 88, 90, 92, 93, 94, 97, 98, 99, 100, 101, 105, 106, 107, 109, 111, 113, 115, 116, 118, 119, 120, 122, 123, 125, 126, 129, 130, 131, 134, 139, 142, 143, 145, 147, 148, 150, 151, 152, 153, 154, 156, 157, 158, 160, 161, 163, 166, 169, 170, 171, 172, 175, 176, 179, 180, 181, 182, 183, 184, 186, 188, 189, 190, 191, 192, 193, 194, 195]"
agent_c,L50,short,128,58,70,5,0.36,200,"[1, 2, 3, 4, 6, 7, 8, 9, 10, 11, 12, 13, 14, 15, 17, 18, 19, 20, 21, 23, 24, 26, 27, 28, 29, 31, 32, 33, 34, 36, 39, 41, 43, 46, 49, 51, 52, 55, 56, 57, 58, 59, 60, 61, 63, 66, 68, 69, 70, 73, 75, 76, 77, 78, 79, 80, 83, 85, 87, 88, 89, 93, 95, 96, 97, 100, 101, 103, 104, 105, 111, 112, 114, 115, 117, 118, 119, 121, 122, 123, 125, 127, 130, 131, 133, 134, 135, 136, 137, 138, 139, 141, 143, 145, 146, 148, 149, 151, 153, 154, 155, 156, 157, 158, 159, 160, 161, 162, 163, 164, 165, 166, 167, 168, 170, 172, 176, 177, 178, 179, 182, 183, 185, 186, 190, 191, 192, 194]"
agent_c,L50,short,134,76,58,8,0.33,200,"[2, 4, 5, 6, 7, 8, 9, 12, 13, 16, 17, 18, 19, 20, 21, 22, 24, 26, 27, 28, 29, 32, 33, 35, 36, 37, 38, 39, 41, 42, 43, 44, 45, 46, 47, 48, 49, 50, 51, 52, 55, 56, 57, 58, 60, 61, 63, 64, 65, 68, 70, 71, 72, 73, 77, 79, 81, 82, 83, 84, 86, 88, 89, 90, 91, 92, 93, 95, 97, 98, 99, 100, 101, 102, 103, 104, 106, 108, 109, 110, 111, 112, 114, 115, 116, 117, 118, 119, 121, 122, 123, 124, 126, 127, 128, 129, 130, 131, 132, 134, 135, 137, 140, 141, 142, 144, 145, 146, 147, 148, 149, 152, 154, 157, 158, 159, 160, 162, 163, 164, 165, 169, 170, 171, 172, 173, 175, 178, 182, 184, 188, 196, 197, 198]"
agent_c,L50,short,125,82,43,3,0.375,200,"[0, 2, 4, 6, 8, 9, 10, 11, 14, 15, 16, 20, 21, 23, 27, 28, 29, 30, 31, 33, 36, 37, 38, 39, 40, 42, 43, 44, 47, 50, 51, 52, 56, 58, 59, 63, 64, 66, 67, 71, 72, 73, 74, 75, 76, 78, 80, 81, 83, 84, 86, 87, 88, 89, 90, 91, 92, 94, 95, 99, 100, 101, 102, 103, 104, 105, 106, 107, 110, 112, 113, 114, 115, 116, 117, 118, 120, 121, 124, 125, 128, 130, 131, 132, 135, 136, 137, 138, 140, 141, 144, 145, 146, 147, 148, 151, 153, 154, 155, 156, 157, 158, 159, 160, 163, 164, 166, 167, 168, 170, 172, 173, 175, 176, 177, 179, 181, 182, 184, 187, 190, 192, 193, 195, 198]"
agent_c,L50,short,121,49,72,11,0.395,200,"[1, 2, 3, 4, 6, 7, 12, 13, 17, 19, 20, 21, 22, 23, 25, 27, 28, 29, 31, 33, 35, 36, 38, 39, 40, 41, 42, 44, 45, 46, 48, 50, 51, 52, 53, 57, 58, 59, 60, 63, 67, 68, 69, 71, 73, 74, 75, 76, 77, 79, 80, 81, 82, 85, 86, 87, 91, 92, 93, 94, 96, 97, 98, 101, 102, 106, 107, 108, 109, 111, 112, 113, 114, 115, 116, 117, 119, 121, 123, 124, 127, 128, 129, 130, 133, 134, 136, 137, 138, 140, 141, 142, 143, 145, 147, 149, 150, 151, 152, 153, 154, 155, 156, 157, 159, 160, 162, 164, 166, 168, 169, 171, 173, 181, 182, 185, 186, 187, 188, 191, 193]"
agent_c,L50,short,118,64,54,12,0.41,200,"[0, 1, 2, 3, 4, 5, 6, 7, 8, 9, 10, 12, 13, 14, 16, 21, 22, 23, 24, 25, 26, 28, 30, 32, 33, 34, 35, 36, 37, 38, 39, 40, 43, 44, 46, 48, 49, 52, 55, 57, 59, 60, 61, 62, 63, 64, 65, 66, 68, 70, 71, 72, 73, 74, 76, 77, 82, 83, 87, 89, 90, 92, 93, 94, 95, 99, 101, 105, 106, 107, 108, 111, 112, 114, 115, 119, 121, 125, 126, 127, 130, 134, 135, 137, 138, 141, 142, 143, 144, 147, 148, 150, 151, 152, 153, 155, 156, 157, 158, 160, 164, 165, 166, 168, 171, 173, 174, 176, 179, 180, 184, 185, 186, 187, 189, 190, 192, 193]"
agent_c,L50,short,130,56,74,8,0.35,200,"[0, 1, 2, 3, 4, 5, 6, 7, 8, 9, 10, 11, 13, 14, 15, 17, 18, 19, 20, 22, 23, 24, 25, 26, 27, 28, 29, 31, 32, 33, 36, 37, 38, 39, 40, 41, 42, 45, 46, 47, 48, 49, 52, 56, 57, 59, 60, 65, 66, 67, 68, 69, 70, 71, 72, 73, 74, 75, 76, 77, 79, 80, 84, 85, 87, 88, 89, 90, 91, 92, 93, 96, 98, 101, 102, 103, 104, 106, 107, 108, 109, 110, 111, 112, 115, 116, 120, 123, 124, 125, 126, 129, 132, 133, 136, 138, 139, 141, 142, 143, 145, 146, 148, 152, 154, 155, 156, 157, 158, 159, 160, 161, 162, 164, 165, 166, 167, 168, 170, 171, 176, 177, 178, 180, 181, 183, 188, 190, 191, 195]"
agent_c,L50,short,128,55,73,11,0.36,200,"[0, 1, 2, 3, 4, 5, 6, 7, 8, 9, 10, 11, 12, 13, 16, 17, 18, 19, 24, 25, 26, 27, 28, 29, 31, 33, 34, 35, 36, 37, 38, 41, 42, 46, 48, 49, 50, 51, 52, 53, 55, 56, 58, 60, 61, 62, 64, 65, 66, 67, 69, 70, 71, 72, 73, 75, 76, 77, 78, 79, 80, 81, 83, 84, 86, 88, 92, 93, 94, 95, 97, 99, 102, 103, 104, 106, 107, 108, 110, 111, 112, 113, 115, 116, 117, 118, 119, 122, 123, 124, 125, 126, 128, 131, 132, 133, 136, 138, 140, 141, 142, 143, 144, 145, 146, 147, 148, 149, 150, 151, 155, 159, 160, 161, 162, 165, 166, 172, 175, 178, 179, 180, 181, 182, 183, 185, 188, 196]"
agent_c,L50,short,123,62,61,10,0.385,200,"[1, 7, 8, 10, 11, 12, 13, 15, 16, 18, 19, 20, 21, 22, 25, 26, 27, 28, 29, 30, 31, 32, 34, 35, 36, 37, 38, 39, 40, 41, 42, 44, 47, 51, 54, 55, 57, 58, 59, 61, 63, 67, 68, 70, 71, 72, 73, 74, 75, 78, 79, 80, 81, 82, 83, 86, 87, 88, 90, 91, 92, 93, 94, 96, 97, 101, 103, 104, 105, 106, 108, 110, 111, 112, 115, 116, 118, 119, 120, 122, 124, 126, 128, 129, 131, 132, 133, 134, 135, 136, 138, 139, 140, 142, 144, 145, 146, 147, 148, 149, 151, 153, 155, 156, 157, 158, 160, 163, 164, 165, 169, 170, 173, 174, 175, 177, 178, 181, 184, 185, 187, 191, 198]"
agent_c,L50,short,130,70,60,16,0.35,200,"[0, 1, 2, 3, 4, 5, 7, 10, 15, 16, 17, 19, 20, 24, 25, 26, 28, 30, 31, 33, 36, 37, 38, 40, 41, 42, 45, 47, 48, 49, 50, 51, 52, 53, 55, 57, 58, 59, 61, 63, 64, 65, 66, 67, 68, 69, 72, 73, 74, 75, 76, 77, 79, 81, 82, 83, 84, 85, 87, 88, 90, 95, 96, 97, 99, 103, 104, 105, 107, 109, 110, 111, 114, 115, 116, 117, 119, 121, 122, 124, 126, 127, 129, 130, 133, 136, 137, 138, 139, 140, 141, 142, 143, 146, 147, 148, 153, 156, 157, 158, 159, 160, 162, 163, 164, 166, 168, 169, 170, 172, 174, 175, 177, 178, 179, 180, 181, 182, 183, 184, 185, 186, 187, 189, 190, 191, 192, 193, 196, 197]"
agent_c,L50,short,130,75,55,8,0.35,200,"[0, 1, 3, 5, 6, 7, 8, 10, 12, 13, 14, 16, 18, 19, 22, 23, 24, 25, 26, 31, 32, 33, 34, 35, 37, 39, 40, 41, 45, 46, 47, 48, 49, 51, 52, 53, 54, 55, 56, 57, 58, 61, 62, 64, 65, 66, 67, 68, 69, 70, 71, 72, 74, 77, 78, 79, 80, 81, 82, 83, 84, 85, 87, 88, 90, 91, 94, 95, 99, 104, 105, 107, 108, 109, 110, 114, 117, 118, 120, 121, 122, 123, 124, 126, 127, 128, 129, 131, 132, 133, 134, 135, 137, 138, 139, 140, 141, 142, 143, 144, 145, 146, 147, 149, 150, 151, 152, 153, 155, 158, 159, 161, 162, 163, 165, 166, 168, 173, 176, 177, 178, 179, 180, 181, 182, 185, 189, 190, 191, 194]"
agent_c,L50,short,130,60,70,8,0.35,200,"[0, 1, 4, 6, 8, 9, 11, 12, 13, 14, 15, 18, 19, 20, 23, 24, 25, 26, 28, 31, 32, 33, 34, 35, 37, 38, 39, 41, 42, 44, 45, 46, 47, 48, 51, 52, 54, 56, 57, 58, 61, 62, 63, 64, 65, 66, 67, 68, 70, 71, 72, 73, 74, 75, 76, 78, 79, 80, 81, 82, 84, 86, 87, 88, 90, 92, 93, 94, 95, 96, 97, 98, 99, 100, 101, 102, 104, 109, 111, 112, 113, 115, 116, 117, 119, 120, 124, 125, 127, 129, 131, 132, 133, 134, 136, 138, 139, 140, 142, 144, 145, 146, 147, 149, 150, 151, 152, 153, 154, 155, 157, 158, 159, 160, 162, 163, 164, 169, 173, 174, 176, 180, 181, 183, 184, 186, 189, 190, 196, 197]"
agent_c,L50,short,131,64,67,5,0.345,200,"[1, 2, 3, 4, 6, 7, 9, 10, 11, 12, 13, 14, 15, 17, 18, 19, 20, 21, 23, 27, 29, 30, 32, 33, 34, 36, 37, 38, 39, 40, 41, 43, 44, 47, 48, 49, 50, 51, 53, 55, 56, 57, 60, 61, 64, 65, 67, 70, 71, 72, 73, 74, 76, 77, 78, 80, 81, 82, 83, 84, 85, 86, 89, 90, 91, 93, 94, 95, 96, 100, 101, 103, 106, 109, 111, 113, 114, 115, 116, 118, 119, 120, 121, 123, 124, 125, 127, 128, 129, 130, 131, 133, 134, 135, 137, 138, 139, 140, 141, 142, 144, 145, 146, 147, 148, 149, 151, 152, 153, 155, 156, 158, 159, 160, 162, 163, 168, 169, 173, 175, 177, 182, 183, 184, 186, 188, 193, 194, 195, 196, 197]"
agent_c,L50,short,130,79,51,7,0.35,200,"[0, 1, 2, 3, 4, 5, 7, 8, 10, 11, 12, 14, 16, 17, 18, 19, 20, 22, 24, 26, 28, 30, 31, 36, 37, 38, 39, 40, 41, 42, 43, 44, 45, 46, 47, 51, 53, 54, 55, 56, 58, 62, 63, 64, 65, 66, 67, 68, 70, 71, 72, 75, 77, 79, 81, 82, 83, 85, 86, 87, 88, 92, 93, 94, 96, 97, 98, 99, 100, 102, 103, 107, 108, 109, 110, 111, 112, 115, 116, 117, 119, 120, 122, 125, 126, 127, 129, 133, 134, 137, 138, 139, 140, 141, 142, 143, 147, 148, 149, 150, 151, 153, 154, 155, 156, 157, 158, 159, 162, 163, 165, 166, 168, 169, 170, 173, 174, 175, 177, 178, 179, 180, 181, 186, 187, 188, 189, 191, 198, 199]"
agent_c,L50,short,129,61,68,8,0.355,200,"[0, 3, 5, 6, 7, 8, 9, 10, 11, 12, 13, 14, 16, 17, 18, 19, 22, 23, 24, 25, 26, 27, 29, 30, 33, 34, 35, 36, 38, 39, 40, 42, 43, 45, 46, 48, 50, 51, 52, 54, 55, 56, 57, 58, 59, 61, 62, 64, 65, 66, 68, 69, 70, 71, 72, 74, 75, 77, 78, 81, 83, 84, 85, 87, 88, 91, 92, 95, 96, 98, 99, 100, 101, 102, 103, 105, 109, 110, 111, 112, 114, 116, 117, 118, 120, 121, 122, 123, 125, 126, 127, 128, 129, 131, 133, 134, 135, 137, 138, 139, 141, 142, 143, 145, 149, 150, 151, 153, 154, 155, 157, 160, 161, 162, 163, 165, 167, 168, 171, 172, 173, 175, 176, 178, 183, 186, 188, 196, 197]"
agent_c,L50,short,128,79,49,9,0.36,200,"[2, 3, 4, 6, 7, 10, 11, 12, 13, 14, 15, 16, 17, 23, 24, 25, 28, 30, 31, 34, 35, 37, 39, 42, 43, 45, 46, 47, 49, 50, 52, 55, 56, 57, 58, 60, 61, 62, 63, 64, 65, 66, 67, 68, 70, 73, 74, 75, 77, 78, 82, 83, 85, 86, 87, 89, 90, 91, 92, 93, 94, 95, 96, 97, 98, 99, 101, 102, 103, 104, 106, 108, 109, 111, 112, 113, 114, 115, 117, 118, 120, 121, 122, 123, 124, 125, 127, 131, 132, 134, 135, 137, 138, 139, 140, 142, 144, 146, 147, 148, 149, 150, 151, 155, 156, 157, 159, 160, 164, 169, 170, 171, 172, 173, 175, 176, 177, 179, 180, 181, 186, 187, 188, 189, 190, 197, 198, 199]"
agent_c,L50,short,132,54,78,8,0.34,200,"[0, 3, 4, 5, 7, 10, 11, 12, 15, 16, 19, 21, 23, 24, 25, 26, 28, 29, 31, 33, 34, 36, 37, 38, 39, 40, 41, 42, 43, 44, 46, 47, 50, 51, 53, 54, 55, 57, 59, 60, 61, 62, 63, 64, 65, 66, 67, 69, 70, 71, 74, 75, 77, 79, 80, 81, 82, 83, 84, 85, 86, 87, 88, 89, 90, 91, 92, 94, 95, 96, 97, 98, 99, 103, 107, 108, 109, 110, 111, 112, 113, 115, 116, 120, 124, 126, 128, 129, 130, 133, 134, 136, 138, 140, 142, 143, 144, 145, 146, 148, 149, 150, 151, 152, 153, 155, 156, 157, 159, 160, 165, 166, 167, 169, 170, 171, 172, 174, 175, 179, 183, 184, 188, 190, 191, 192, 193, 194, 195, 196, 197, 198]"
agent_c,L50,short,123,48,75,12,0.385,200,"[0, 1, 2, 3, 4, 6, 7, 10, 11, 12, 13, 17, 21, 23, 24, 25, 27, 28, 30, 31, 33, 34, 35, 36, 39, 40, 42, 43, 44, 45, 46, 49, 50, 52, 55, 57, 58, 59, 60, 61, 62, 63, 64, 65, 66, 67, 68, 71, 73, 76, 78, 79, 80, 84, 86, 87, 88, 91, 92, 95, 99, 100, 101, 103, 108, 111, 113, 115, 116, 117, 118, 119, 123, 124, 126, 127, 128, 129, 131, 133, 134, 135, 136, 137, 138, 139, 140, 141, 142, 143, 144, 146, 147, 148, 149, 150, 151, 154, 155, 157, 158, 160, 161, 162, 163, 167, 168, 169, 170, 171, 173, 174, 175, 177, 180, 182, 184, 185, 187, 191, 194, 195, 197]"
agent_c,L50,short,134,57,77,4,0.33,200,"[0, 1, 2, 3, 4, 6, 7, 8, 9, 10, 11, 12, 13, 15, 16, 17, 18, 19, 21, 23, 24, 25, 26, 27, 28, 30, 31, 32, 34, 35, 36, 38, 39, 40, 42, 43, 44, 45, 46, 47, 50, 52, 54, 55, 56, 57, 60, 64, 66, 67, 69, 72, 74, 75, 76, 77, 78, 79, 80, 81, 82, 83, 84, 87, 88, 89, 91, 93, 94, 95, 96, 98, 99, 100, 101, 106, 109, 110, 113, 114, 115, 116, 117, 118, 119, 122, 124, 125, 126, 127, 128, 129, 130, 131, 132, 134, 135, 137, 138, 140, 141, 142, 146, 148, 149, 151, 152, 153, 154, 155, 157, 158, 159, 160, 162, 164, 166, 167, 168, 170, 171, 172, 175, 177, 178, 179, 182, 183, 184, 190, 191, 193, 194, 195]"
agent_c,L50,short,129,70,59,8,0.355,200,"[0, 1, 2, 3, 4, 7, 8, 9, 11, 12, 13, 14, 16, 17, 19, 20, 21, 23, 24, 25, 26, 28, 30, 31, 32, 34, 35, 36, 37, 40, 41, 42, 43, 44, 45, 46, 51, 53, 54, 57, 58, 61, 62, 64, 65, 66, 67, 68, 70, 71, 74, 75, 77, 79, 80, 81, 82, 84, 85, 87, 88, 89, 91, 94, 95, 98, 99, 101, 102, 103, 104, 105, 108, 109, 110, 113, 115, 117, 118, 119, 122, 123, 127, 129, 131, 133, 134, 135, 136, 138, 139, 140, 143, 145, 147, 150, 151, 153, 155, 156, 157, 158, 159, 160, 162, 165, 166, 167, 168, 169, 170, 171, 172, 173, 174, 176, 177, 179, 181, 185, 186, 187, 188, 189, 190, 192, 193, 194, 195]"
agent_c,L50,short,130,64,66,7,0.35,200,"[0, 2, 3, 5, 6, 7, 8, 9, 10, 13, 14, 15, 16, 19, 20, 21, 22, 23, 24, 25, 28, 29, 30, 33, 34, 35, 36, 37, 38, 39, 41, 42, 43, 46, 47, 48, 49, 50, 51, 52, 53, 54, 56, 58, 59, 60, 61, 62, 65, 67, 69, 70, 72, 73, 74, 75, 76, 77, 79, 80, 81, 83, 84, 85, 87, 88, 89, 90, 91, 92, 93, 95, 97, 98, 99, 100, 101, 103, 105, 107, 110, 111, 113, 114, 115, 118, 119, 120, 122, 124, 125, 126, 127, 128, 130, 131, 132, 133, 135, 136, 137, 138, 140, 141, 143, 144, 146, 147, 149, 151, 155, 157, 160, 161, 162, 163, 164, 168, 169, 175, 178, 179, 181, 183, 184, 189, 190, 192, 193, 194]"
agent_c,L50,short,134,49,85,7,0.33,200,"[1, 3, 4, 6, 9, 11, 12, 13, 14, 15, 16, 18, 19, 21, 22, 23, 24, 25, 26, 28, 30, 31, 32, 33, 34, 35, 36, 37, 38, 39, 40, 41, 42, 44, 45, 46, 47, 48, 49, 51, 52, 53, 54, 55, 57, 58, 59, 61, 62, 63, 65, 66, 67, 70, 71, 73, 74, 75, 76, 77, 78, 79, 80, 85, 87, 88, 89, 90, 91, 92, 93, 94, 95, 96, 97, 98, 99, 100, 102, 103, 104, 105, 107, 108, 110, 111, 113, 114, 115, 116, 118, 119, 122, 124, 126, 127, 128, 129, 130, 132, 133, 134, 135, 136, 138, 140, 142, 143, 144, 145, 147, 151, 152, 154, 155, 156, 158, 159, 160, 161, 162, 164, 165, 166, 167, 168, 169, 170, 171, 178, 183, 189, 190, 192]"
agent_c,L50,short,130,57,73,4,0.35,200,"[0, 1, 3, 4, 6, 7, 8, 9, 10, 11, 12, 14, 15, 16, 19, 21, 22, 23, 24, 25, 28, 29, 30, 31, 32, 33, 34, 36, 37, 38, 40, 42, 45, 46, 50, 51, 53, 55, 57, 59, 60, 61, 62, 64, 65, 67, 68, 70, 71, 72, 73, 74, 75, 76, 77, 78, 79, 80, 84, 86, 87, 92, 93, 94, 95, 96, 99, 100, 101, 102, 103, 104, 105, 106, 107, 108, 109, 110, 117, 119, 121, 122, 124, 128, 130, 132, 133, 136, 137, 138, 139, 140, 141, 142, 143, 145, 146, 147, 148, 149, 150, 151, 152, 153, 154, 159, 161, 162, 163, 164, 165, 166, 167, 168, 169, 170, 171, 175, 176, 177, 178, 179, 182, 187, 188, 189, 190, 191, 192, 199]"
agent_c,L50,short,128,50,78,9,0.36,200,"[2, 3, 4, 6, 7, 8, 9, 10, 11, 13, 14, 15, 16, 18, 20, 22, 24, 25, 27, 29, 31, 33, 34, 36, 37, 39, 40, 41, 42, 43, 44, 45, 46, 48, 49, 51, 53, 54, 55, 56, 57, 59, 61, 63, 65, 67, 68, 69, 70, 71, 72, 73, 74, 75, 78, 80, 81, 84, 85, 87, 88, 90, 91, 92, 94, 95, 96, 97, 98, 99, 100, 101, 102, 103, 104, 107, 108, 110, 111, 112, 113, 114, 115, 116, 118, 119, 120, 122, 123, 125, 126, 129, 130, 132, 133, 136, 137, 140, 142, 144, 146, 147, 148, 149, 150, 151, 153, 154, 156, 158, 159, 161, 163, 164, 167, 169, 171, 172, 173, 174, 175, 178, 182, 183, 186, 187, 193, 198]"
agent_c,L50,short,128,73,55,7,0.36,200,"[1, 2, 4, 5, 6, 8, 10, 12, 15, 16, 17, 18, 19, 20, 21, 24, 25, 26, 30, 32, 33, 35, 36, 37, 39, 40, 44, 47, 51, 53, 54, 55, 57, 60, 62, 67, 69, 70, 71, 72, 74, 75, 76, 78, 79, 80, 82, 83, 84, 85, 86, 88, 89, 93, 94, 95, 96, 99, 100, 102, 104, 105, 108, 110, 111, 112, 114, 115, 116, 117, 118, 119, 120, 121, 122, 123, 124, 126, 127, 128, 129, 130, 131, 133, 134, 135, 136, 138, 139, 140, 142, 143, 144, 145, 146, 147, 149, 150, 151, 153, 154, 155, 156, 157, 158, 159, 161, 163, 164, 165, 167, 168, 169, 171, 172, 174, 175, 176, 177, 178, 180, 181, 183, 188, 191, 194, 195, 196]"
agent_c,L50,short,122,68,54,9,0.39,200,"[0, 1, 2, 3, 4, 7, 8, 9, 10, 11, 12, 14, 16, 17, 18, 19, 22, 23, 26, 27, 29, 30, 33, 35, 36, 38, 39, 40, 42, 45, 46, 47, 48, 49, 50, 52, 54, 55, 56, 58, 59, 61, 63, 66, 67, 68, 69, 70, 73, 75, 76, 77, 78, 79, 82, 83, 84, 87, 88, 90, 91, 92, 93, 95, 96, 98, 100, 102, 105, 106, 107, 109, 110, 111, 112, 114, 116, 117, 118, 119, 124, 125, 127, 128, 129, 132, 134, 136, 138, 139, 140, 141, 142, 144, 145, 147, 149, 152, 153, 156, 157, 160, 162, 164, 165, 166, 168, 169, 173, 174, 175, 176, 177, 178, 184, 185, 188, 193, 194, 196, 197, 198]"
agent_c,L50,short,133,58,75,4,0.335,200,"[0, 1, 2, 4, 6, 7, 9, 10, 12, 13, 14, 15, 17, 18, 19, 20, 21, 23, 24, 25, 27, 28, 29, 31, 34, 36, 38, 39, 40, 41, 42, 44, 45, 46, 49, 50, 55, 56, 60, 61, 62, 63, 66, 69, 70, 72, 73, 78, 80, 81, 83, 84, 86, 87, 90, 92, 93, 94, 96, 97, 98, 99, 100, 101, 103, 104, 106, 107, 108, 109, 110, 111, 112, 113, 116, 117, 118, 119, 120, 121, 122, 123, 124, 125, 126, 127, 129, 130, 131, 132, 133, 135, 137, 138, 139, 140, 141, 142, 143, 144, 146, 147, 148, 149, 150, 151, 152, 153, 154, 155, 159, 160, 164, 165, 166, 167, 170, 171, 172, 175, 176, 178, 180, 184, 186, 187, 189, 190, 195, 196, 197, 198, 199]"
agent_c,L50,short,132,63,69,11,0.34,200,"[0, 1, 3, 4, 5, 6, 9, 10, 14, 15, 16, 17, 19, 20, 22, 23, 24, 25, 27, 28, 29, 31, 32, 33, 37, 39, 40, 41, 43, 44, 45, 46, 47, 49, 51, 53, 54, 55, 56, 57, 59, 60, 63, 64, 65, 66, 69, 70, 71, 72, 73, 74, 75, 77, 78, 79, 80, 82, 83, 84, 89, 90, 91, 92, 93, 94, 95, 98, 100, 101, 102, 103, 108, 110, 113, 114, 115, 116, 118, 120, 121, 123, 124, 125, 128, 129, 130, 133, 134, 135, 136, 137, 138, 139, 140, 141, 142, 143, 145, 146, 147, 148, 149, 150, 151, 152, 154, 155, 156, 157, 158, 161, 162, 163, 164, 165, 168, 169, 170, 171, 172, 174, 175, 179, 180, 181, 183, 185, 187, 192, 196, 199]"
agent_c,L50,short,123,67,56,13,0.385,200,"[0, 2, 5, 6, 7, 9, 11, 13, 15, 16, 17, 19, 20, 22, 23, 25, 26, 27, 28, 29, 30, 31, 33, 35, 37, 40, 43, 44, 45, 47, 49, 51, 53, 54, 55, 59, 61, 64, 65, 66, 67, 68, 69, 71, 72, 73, 74, 75, 76, 77, 79, 80, 81, 82, 83, 84, 85, 86, 88, 93, 94, 95, 102, 103, 104, 105, 106, 107, 108, 109, 110, 111, 112, 114, 115, 116, 117, 119, 120, 121, 123, 125, 126, 128, 129, 131, 134, 135, 136, 141, 144, 148, 149, 150, 153, 154, 156, 157, 159, 161, 163, 164, 167, 169, 170, 171, 172, 173, 174, 175, 177, 178, 180, 181, 183, 185, 186, 188, 189, 190, 191, 192, 193]"
agent_c,L50,short,133,63,70,10,0.335,200,"[1, 2, 3, 4, 7, 8, 10, 11, 12, 13, 14, 15, 16, 17, 18, 19, 21, 22, 23, 24, 25, 26, 27, 28, 29, 30, 31, 32, 34, 35, 36, 42, 44, 46, 49, 50, 51, 54, 55, 57, 58, 59, 60, 63, 64, 66, 67, 68, 70, 71, 72, 74, 75, 76, 77, 79, 81, 82, 83, 84, 86, 87, 88, 90, 93, 94, 96, 97, 98, 99, 100, 101, 103, 104, 105, 106, 113, 114, 115, 117, 118, 119, 120, 121, 122, 123, 124, 125, 126, 128, 132, 134, 135, 136, 137, 139, 141, 144, 145, 146, 147, 150, 151, 152, 155, 156, 159, 162, 163, 165, 166, 167, 168, 169, 170, 171, 172, 173, 174, 177, 178, 179, 180, 183, 184, 187, 188, 189, 190, 191, 192, 193, 195]"
agent_c,L50,short,129,61,68,5,0.355,200,"[0, 2, 4, 5, 8, 10, 11, 12, 14, 16, 17, 18, 20, 22, 23, 24, 27, 30, 32, 35, 38, 40, 42, 43, 44, 45, 47, 49, 50, 52, 53, 54, 55, 56, 57, 58, 59, 61, 62, 64, 65, 66, 67, 70, 71, 72, 73, 74, 75, 76, 78, 79, 80, 82, 83, 84, 85, 86, 87, 88, 89, 90, 91, 92, 93, 95, 97, 98, 99, 100, 101, 102, 103, 106, 108, 109, 110, 111, 112, 116, 117, 118, 119, 120, 122, 124, 125, 126, 127, 132, 134, 137, 138, 140, 143, 144, 146, 147, 148, 149, 151, 152, 153, 156, 157, 158, 159, 160, 162, 163, 165, 167, 169, 170, 171, 175, 176, 178, 179, 181, 182, 183, 185, 186, 187, 188, 189, 195, 199]"
agent_c,L50,short,133,59,74,6,0.335,200,"[0, 1, 2, 4, 5, 6, 7, 8, 10, 11, 12, 13, 14, 15, 16, 17, 19, 20, 22, 25, 27, 28, 29, 31, 32, 33, 34, 35, 36, 37, 41, 42, 43, 44, 45, 46, 47, 48, 49, 50, 51, 53, 55, 56, 57, 58, 59, 61, 62, 64, 65, 67, 69, 72, 73, 74, 75, 76, 77, 78, 79, 82, 84, 85, 86, 87, 90, 92, 93, 94, 95, 97, 98, 99, 100, 101, 102, 103, 104, 105, 106, 107, 111, 112, 113, 116, 119, 120, 123, 124, 125, 126, 127, 128, 129, 130, 132, 133, 134, 135, 136, 138, 140, 142, 144, 145, 147, 148, 149, 152, 153, 154, 155, 157, 158, 159, 162, 163, 164, 168, 169, 172, 174, 175, 177, 178, 181, 187, 188, 189, 190, 198, 199]"
agent_c,L50,short,134,76,58,6,0.33,200,"[0, 1, 2, 3, 5, 6, 7, 8, 9, 10, 11, 12, 17, 20, 21, 22, 23, 25, 26, 31, 33, 34, 35, 36, 37, 38, 39, 40, 42, 44, 46, 47, 48, 49, 52, 54, 55, 57, 58, 59, 60, 61, 62, 63, 64, 65, 68, 69, 70, 71, 73, 75, 77, 78, 79, 80, 81, 82, 83, 85, 86, 87, 89, 90, 91, 92, 93, 94, 95, 97, 98, 99, 100, 101, 104, 107, 110, 113, 115, 116, 117, 118, 119, 120, 121, 122, 123, 124, 126, 127, 129, 130, 132, 133, 134, 136, 137, 138, 139, 142, 143, 144, 145, 146, 148, 150, 151, 152, 154, 155, 156, 157, 158, 162, 163, 165, 167, 168, 169, 172, 174, 175, 176, 177, 182, 183, 184, 185, 187, 188, 193, 194, 195, 199]"
agent_c,L50,short,130,56,74,6,0.35,200,"[1, 3, 4, 5, 6, 8, 9, 11, 12, 13, 15, 16, 17, 18, 19, 20, 21, 22, 23, 24, 25, 27, 28, 29, 30, 31, 32, 33, 35, 37, 38, 41, 42, 43, 46, 47, 48, 49, 50, 52, 53, 54, 56, 57, 58, 59, 60, 61, 62, 63, 64, 66, 68, 69, 70, 71, 72, 73, 74, 75, 77, 78, 79, 80, 82, 83, 84, 86, 87, 91, 92, 93, 94, 96, 97, 98, 99, 100, 101, 102, 103, 108, 113, 114, 115, 118, 119, 124, 125, 126, 128, 130, 132, 134, 136, 137, 139, 140, 142, 143, 148, 152, 153, 154, 155, 156, 160, 161, 162, 163, 164, 165, 166, 167, 168, 169, 170, 172, 173, 175, 176, 178, 179, 183, 184, 185, 186, 189, 191, 194]"
agent_c,L50,short,138,77,61,10,0.31,200,"[0, 1, 2, 4, 5, 6, 7, 8, 9, 11, 12, 13, 14, 16, 17, 19, 20, 21, 22, 24, 26, 28, 29, 34, 35, 36, 38, 41, 42, 43, 44, 47, 48, 49, 50, 52, 53, 54, 56, 58, 59, 61, 62, 63, 64, 65, 66, 68, 69, 70, 72, 73, 74, 75, 77, 78, 79, 80, 81, 83, 84, 86, 87, 88, 89, 91, 92, 94, 95, 96, 97, 98, 99, 101, 102, 103, 104, 105, 106, 107, 109, 110, 111, 112, 113, 114, 115, 116, 117, 118, 121, 122, 124, 127, 130, 131, 132, 134, 135, 137, 138, 139, 140, 143, 144, 145, 146, 147, 149, 152, 154, 155, 156, 158, 160, 161, 162, 163, 164, 165, 166, 167, 168, 170, 171, 172, 173, 174, 177, 178, 179, 187, 188, 189, 190, 197, 198, 199]"
agent_c,L50,short,130,83,47,9,0.35,200,"[0, 1, 2, 3, 4, 5, 7, 9, 10, 11, 12, 13, 14, 18, 21, 22, 23, 25, 26, 28, 33, 34, 35, 37, 38, 39, 42, 43, 44, 45, 46, 47, 48, 51, 52, 53, 54, 56, 57, 58, 59, 60, 61, 62, 64, 65, 66, 69, 70, 73, 74, 75, 79, 81, 82, 84, 87, 90, 92, 94, 96, 98, 99, 100, 101, 102, 103, 104, 105, 106, 110, 112, 113, 114, 115, 116, 119, 121, 122, 123, 125, 126, 127, 128, 129, 130, 133, 134, 135, 136, 137, 140, 142, 144, 145, 146, 147, 148, 150, 151, 152, 153, 155, 156, 157, 159, 160, 161, 163, 164, 166, 169, 172, 173, 175, 176, 177, 178, 182, 183, 184, 185, 186, 187, 188, 194, 195, 196, 197, 198]"
agent_c,L50,short,129,66,63,12,0.355,200,"[1, 3, 4, 7, 9, 12, 14, 17, 18, 19, 22, 25, 26, 27, 28, 29, 31, 32, 34, 35, 37, 39, 41, 42, 43, 45, 46, 48, 49, 52, 53, 54, 56, 57, 58, 59, 60, 61, 62, 63, 64, 66, 67, 68, 69, 70, 72, 75, 76, 78, 79, 81, 83, 84, 85, 86, 89, 90, 91, 94, 95, 98, 101, 102, 103, 104, 105, 106, 107, 108, 110, 111, 112, 113, 114, 115, 116, 117, 120, 121, 123, 124, 125, 126, 128, 129, 130, 131, 133, 134, 135, 137, 139, 141, 142, 143, 144, 145, 146, 149, 152, 153, 157, 158, 160, 163, 164, 166, 168, 169, 171, 172, 174, 175, 177, 178, 179, 180, 182, 184, 185, 188, 189, 190, 191, 192, 193, 194, 196]"
agent_c,L50,short,128,62,66,17,0.36,200,"[0, 3, 4, 5, 6, 8, 9, 11, 12, 13, 14, 16, 17, 19, 20, 22, 23, 25, 27, 28, 29, 30, 33, 34, 35, 36, 37, 38, 39, 42, 43, 44, 47, 48, 52, 53, 56, 57, 58, 59, 61, 64, 66, 67, 68, 69, 70, 73, 74, 75, 76, 77, 78, 79, 80, 81, 82, 84, 85, 86, 87, 88, 89, 91, 92, 93, 95, 97, 99, 100, 103, 104, 105, 106, 107, 108, 109, 110, 112, 114, 115, 117, 118, 120, 121, 122, 123, 124, 125, 126, 127, 129, 130, 131, 133, 134, 135, 136, 137, 138, 140, 142, 143, 144, 145, 146, 147, 148, 150, 151, 152, 153, 163, 165, 170, 173, 175, 179, 180, 181, 183, 184, 186, 191, 192, 193, 195, 197]"
agent_c,L50,short,131,54,77,12,0.345,200,"[0, 1, 2, 3, 4, 7, 9, 11, 12, 14, 16, 17, 18, 19, 20, 21, 23, 24, 25, 26, 27, 29, 30, 34, 35, 37, 38, 40, 41, 43, 44, 46, 47, 48, 50, 51, 52, 53, 54, 56, 58, 59, 61, 62, 63, 64, 65, 66, 69, 70, 71, 72, 73, 76, 78, 79, 81, 82, 84, 86, 87, 88, 89, 91, 92, 96, 97, 98, 99, 100, 101, 102, 104, 105, 106, 109, 110, 111, 112, 113, 115, 116, 118, 119, 121, 122, 124, 127, 128, 129, 131, 132, 133, 134, 136, 137, 138, 139, 140, 142, 143, 144, 146, 147, 148, 149, 150, 151, 153, 155, 156, 157, 158, 159, 160, 161, 163, 166, 168, 169, 170, 171, 172, 173, 174, 175, 176, 183, 187, 195, 196]"
agent_c,L50,short,131,61,70,7,0.345,200,"[0, 2, 4, 5, 6, 7, 8, 9, 11, 12, 13, 14, 16, 18, 19, 20, 21, 23, 24, 26, 28, 29, 30, 32, 33, 35, 36, 37, 38, 39, 41, 42, 43, 45, 47, 48, 49, 50, 52, 54, 55, 59, 61, 62, 63, 64, 65, 66, 67, 68, 70, 72, 73, 74, 75, 76, 80, 81, 82, 84, 85, 86, 87, 90, 92, 93, 94, 99, 100, 101, 102, 103, 104, 105, 106, 107, 108, 111, 113, 115, 117, 119, 120, 121, 122, 123, 125, 126, 127, 128, 129, 130, 131, 133, 134, 137, 138, 139, 141, 142, 143, 144, 145, 146, 148, 149, 150, 151, 152, 153, 156, 157, 158, 162, 163, 164, 165, 166, 167, 170, 171, 172, 173, 174, 176, 178, 184, 185, 186, 188, 192]"
agent_c,L50,short,121,55,66,6,0.395,200,"[1, 2, 3, 4, 7, 8, 9, 12, 13, 15, 16, 17, 19, 20, 23, 25, 26, 27, 28, 29, 30, 32, 33, 34, 37, 38, 40, 41, 42, 43, 45, 46, 49, 50, 51, 52, 54, 55, 57, 60, 62, 63, 64, 66, 70, 72, 73, 74, 77, 79, 81, 83, 84, 86, 87, 91, 95, 96, 97, 98, 101, 102, 103, 105, 106, 109, 110, 111, 112, 113, 114, 116, 120, 122, 123, 124, 127, 128, 130, 131, 132, 135, 136, 139, 140, 141, 143, 145, 147, 148, 149, 150, 151, 152, 153, 154, 156, 157, 158, 159, 160, 161, 162, 165, 166, 168, 171, 172, 173, 176, 177, 178, 181, 182, 183, 186, 187, 188, 190, 193, 199]"
agent_c,L50,short,127,44,83,8,0.365,200,"[1, 2, 3, 4, 5, 6, 7, 9, 10, 11, 12, 13, 14, 15, 16, 17, 18, 19, 20, 21, 22, 23, 26, 28, 29, 30, 31, 32, 33, 34, 36, 37, 38, 40, 41, 42, 43, 47, 48, 49, 50, 51, 53, 54, 57, 58, 60, 61, 63, 64, 65, 67, 69, 70, 73, 74, 76, 78, 79, 80, 81, 82, 83, 85, 86, 88, 90, 91, 92, 95, 96, 97, 98, 100, 105, 109, 110, 113, 115, 116, 118, 119, 121, 122, 123, 124, 125, 127, 129, 130, 133, 134, 135, 136, 139, 140, 142, 144, 145, 146, 148, 149, 152, 153, 155, 156, 158, 161, 162, 163, 164, 165, 170, 171, 173, 174, 175, 179, 180, 185, 186, 187, 188, 190, 196, 197, 199]"
agent_c,L50,short,139,31,108,8,0.305,200,"[2, 3, 4, 5, 6, 8, 9, 10, 11, 12, 13, 14, 15, 16, 17, 18, 19, 20, 22, 23, 24, 27, 28, 29, 30, 31, 32, 33, 35, 38, 40, 41, 42, 43, 44, 45, 46, 48, 49, 50, 51, 52, 53, 56, 57, 58, 59, 60, 61, 62, 64, 65, 66, 67, 68, 69, 70, 71, 72, 73, 74, 75, 76, 77, 78, 79, 80, 81, 83, 84, 85, 86, 87, 88, 89, 92, 94, 96, 98, 99, 102, 103, 104, 106, 107, 108, 110, 112, 113, 114, 115, 116, 118, 119, 120, 122, 123, 125, 127, 128, 129, 131, 132, 134, 135, 136, 137, 138, 139, 141, 143, 145, 146, 147, 149, 150, 152, 154, 156, 158, 159, 160, 161, 162, 163, 164, 165, 170, 171, 173, 175, 176, 182, 183, 184, 185, 186, 187, 197]"
agent_c,L50,short,129,52,77,5,0.355,200,"[2, 3, 4, 5, 6, 7, 8, 9, 11, 12, 15, 17, 21, 22, 26, 28, 29, 30, 31, 32, 34, 35, 36, 37, 38, 39, 40, 41, 43, 45, 46, 48, 49, 50, 51, 53, 54, 55, 56, 60, 61, 63, 64, 65, 66, 68, 69, 70, 72, 73, 76, 77, 78, 79, 81, 82, 84, 85, 86, 88, 90, 91, 92, 93, 94, 96, 97, 98, 99, 100, 101, 102, 104, 106, 107, 108, 109, 111, 113, 114, 115, 116, 117, 119, 120, 121, 122, 123, 125, 126, 127, 129, 132, 133, 135, 136, 137, 138, 139, 141, 142, 143, 144, 145, 146, 147, 149, 150, 152, 153, 154, 155, 157, 160, 161, 164, 165, 166, 169, 170, 175, 176, 177, 178, 181, 184, 189, 190, 198]"
agent_c,L50,short,130,54,76,8,0.35,200,"[0, 1, 2, 5, 6, 10, 11, 13, 14, 15, 16, 17, 18, 19, 20, 24, 28, 29, 30, 32, 33, 34, 35, 38, 40, 43, 46, 48, 50, 51, 54, 55, 57, 58, 61, 62, 64, 65, 67, 69, 71, 72, 73, 75, 76, 77, 78, 80, 83, 84, 85, 86, 87, 88, 89, 90, 91, 92, 93, 94, 98, 99, 100, 103, 105, 106, 108, 109, 110, 111, 112, 113, 114, 115, 118, 119, 120, 121, 122, 123, 126, 127, 128, 130, 131, 132, 133, 136, 138, 140, 141, 142, 143, 144, 145, 146, 147, 148, 149, 151, 152, 154, 155, 156, 157, 158, 159, 160, 161, 162, 164, 165, 166, 167, 170, 171, 173, 175, 176, 178, 181, 183, 185, 186, 187, 188, 190, 194, 198, 199]"
agent_c,L50,short,120,62,58,14,0.4,200,"[0, 3, 5, 6, 7, 8, 10, 11, 12, 13, 14, 15, 17, 18, 19, 20, 23, 24, 25, 26, 28, 29, 31, 32, 33, 34, 35, 36, 37, 38, 40, 41, 42, 43, 44, 47, 51, 52, 53, 55, 60, 61, 65, 66, 67, 70, 72, 73, 75, 76, 78, 80, 82, 83, 86, 89, 90, 91, 92, 94, 95, 96, 98, 99, 100, 103, 108, 110, 112, 113, 114, 115, 116, 118, 119, 121, 122, 123, 124, 125, 126, 129, 130, 131, 132, 133, 134, 136, 137, 138, 139, 141, 142, 144, 145, 146, 149, 153, 155, 158, 159, 160, 161, 162, 163, 165, 166, 167, 169, 170, 171, 172, 177, 178, 184, 185, 186, 187, 188, 192]"
agent_c,L50,short,125,67,58,16,0.375,200,"[0, 2, 3, 5, 6, 7, 8, 9, 11, 13, 15, 16, 18, 20, 21, 22, 23, 24, 25, 26, 27, 28, 30, 31, 32, 34, 35, 37, 38, 39, 41, 45, 46, 47, 50, 53, 54, 57, 59, 63, 64, 68, 70, 71, 72, 73, 74, 75, 76, 77, 79, 80, 81, 83, 84, 87, 91, 93, 94, 97, 98, 102, 103, 104, 107, 108, 115, 116, 118, 121, 122, 123, 124, 127, 130, 131, 133, 134, 135, 136, 137, 138, 139, 141, 142, 143, 145, 146, 148, 149, 150, 151, 152, 153, 154, 156, 158, 159, 161, 162, 163, 164, 166, 167, 169, 170, 171, 172, 174, 175, 177, 178, 179, 181, 182, 183, 186, 188, 189, 190, 191, 192, 193, 195, 197]"
agent_c,L50,short,130,69,61,15,0.35,200,"[0, 4, 5, 6, 8, 9, 10, 11, 12, 13, 14, 15, 16, 17, 18, 19, 20, 21, 22, 23, 24, 25, 27, 28, 31, 32, 33, 35, 36, 37, 38, 40, 41, 42, 44, 45, 46, 48, 50, 51, 52, 54, 57, 59, 60, 61, 62, 64, 65, 66, 68, 69, 70, 71, 74, 75, 77, 78, 79, 80, 82, 83, 84, 88, 89, 91, 92, 94, 95, 98, 100, 101, 106, 107, 108, 109, 110, 111, 112, 113, 115, 116, 117, 119, 120, 121, 122, 124, 125, 126, 128, 129, 130, 131, 133, 134, 135, 136, 137, 138, 139, 140, 141, 144, 145, 147, 154, 155, 157, 158, 159, 161, 162, 163, 164, 166, 167, 170, 172, 173, 174, 175, 178, 179, 180, 186, 187, 191, 198, 199]"
agent_c,L50,short,129,58,71,8,0.355,200,"[0, 1, 2, 3, 4, 5, 6, 7, 8, 10, 11, 12, 13, 14, 16, 21, 22, 23, 24, 26, 28, 30, 31, 33, 35, 36, 37, 38, 39, 41, 42, 43, 46, 47, 48, 51, 52, 54, 55, 56, 59, 60, 61, 62, 63, 64, 65, 66, 67, 69, 70, 71, 72, 73, 75, 76, 78, 79, 82, 84, 85, 87, 88, 89, 90, 91, 92, 93, 94, 95, 96, 98, 99, 100, 101, 102, 105, 106, 109, 110, 112, 115, 116, 117, 119, 120, 121, 122, 127, 128, 129, 131, 133, 135, 136, 137, 139, 140, 142, 144, 145, 146, 147, 149, 151, 152, 153, 155, 156, 157, 158, 159, 160, 165, 166, 167, 168, 169, 171, 174, 175, 176, 179, 181, 187, 188, 189, 190, 191]"
agent_c,L50,short,134,57,77,5,0.33,200,"[1, 2, 5, 6, 7, 9, 10, 12, 14, 16, 17, 18, 19, 21, 22, 23, 24, 26, 27, 28, 31, 32, 34, 35, 36, 38, 39, 40, 41, 42, 45, 46, 49, 50, 51, 52, 53, 55, 57, 58, 59, 60, 61, 62, 63, 64, 67, 71, 72, 74, 75, 76, 77, 79, 80, 81, 82, 83, 86, 87, 88, 89, 90, 91, 92, 93, 94, 95, 96, 97, 98, 99, 101, 102, 103, 105, 106, 107, 109, 110, 111, 112, 113, 114, 115, 116, 117, 118, 119, 120, 124, 125, 127, 128, 129, 130, 134, 136, 137, 138, 139, 140, 141, 142, 143, 146, 147, 148, 150, 151, 152, 153, 154, 155, 156, 157, 159, 160, 161, 162, 163, 164, 165, 167, 168, 169, 171, 177, 178, 179, 180, 186, 190, 193]"
agent_c,L50,short,127,78,49,9,0.365,200,"[0, 3, 4, 5, 7, 10, 11, 13, 16, 18, 19, 20, 21, 22, 23, 25, 27, 28, 29, 30, 31, 33, 34, 35, 37, 38, 40, 43, 44, 45, 46, 47, 48, 49, 50, 51, 52, 54, 55, 57, 58, 60, 61, 62, 63, 69, 70, 71, 72, 73, 74, 75, 76, 77, 80, 83, 84, 85, 86, 89, 93, 94, 97, 98, 99, 101, 102, 103, 104, 106, 107, 108, 109, 112, 114, 115, 116, 117, 118, 119, 121, 122, 123, 124, 125, 129, 131, 132, 134, 136, 137, 138, 139, 140, 144, 145, 146, 148, 150, 151, 152, 156, 157, 158, 159, 160, 162, 163, 164, 165, 167, 168, 171, 172, 173, 175, 177, 179, 180, 181, 182, 185, 189, 190, 191, 193, 195]"
agent_c,L50,short,127,42,85,14,0.365,200,"[0, 1, 2, 3, 6, 7, 9, 10, 11, 12, 13, 14, 15, 16, 19, 20, 21, 23, 24, 25, 26, 27, 28, 29, 30, 31, 32, 33, 38, 39, 40, 41, 42, 46, 47, 49, 50, 51, 52, 54, 55, 59, 60, 63, 64, 65, 67, 71, 72, 75, 76, 77, 78, 80, 81, 82, 84, 89, 90, 92, 93, 94, 95, 97, 98, 100, 101, 102, 103, 105, 107, 108, 111, 112, 113, 114, 115, 116, 117, 118, 119, 120, 121, 122, 124, 125, 126, 128, 130, 131, 132, 134, 137, 138, 139, 141, 142, 143, 144, 147, 150, 152, 153, 154, 155, 157, 158, 160, 162, 163, 164, 165, 166, 167, 168, 170, 171, 173, 176, 177, 178, 181, 182, 183, 185, 192, 194]"
agent_c,L50,short,128,38,90,6,0.36,200,"[0, 1, 3, 4, 6, 7, 8, 9, 10, 12, 13, 14, 15, 16, 17, 18, 19, 20, 21, 22, 27, 31, 32, 33, 34, 35, 36, 37, 39, 42, 43, 44, 45, 48, 49, 50, 55, 56, 57, 58, 60, 61, 62, 65, 66, 67, 68, 69, 70, 71, 72, 74, 75, 76, 77, 80, 81, 83, 84, 85, 86, 87, 88, 90, 92, 95, 96, 97, 98, 99, 101, 102, 103, 106, 108, 110, 111, 112, 113, 114, 115, 116, 118, 119, 122, 123, 124, 125, 126, 128, 130, 131, 132, 135, 136, 137, 139, 142, 143, 144, 147, 149, 150, 151, 153, 155, 157, 159, 160, 163, 166, 167, 168, 170, 171, 172, 173, 175, 176, 178, 179, 180, 181, 182, 186, 192, 194, 196]"
agent_c,L50,short,128,48,80,9,0.36,200,"[2, 3, 4, 5, 6, 7, 8, 9, 11, 12, 15, 17, 18, 19, 22, 23, 24, 25, 26, 27, 28, 29, 30, 31, 35, 36, 39, 40, 43, 45, 46, 47, 51, 52, 53, 54, 55, 58, 59, 60, 61, 62, 63, 64, 65, 66, 67, 69, 70, 72, 76, 77, 80, 82, 83, 85, 86, 87, 90, 92, 94, 95, 96, 97, 98, 99, 101, 103, 105, 106, 107, 109, 110, 111, 112, 113, 114, 116, 117, 120, 123, 124, 126, 127, 128, 132, 133, 134, 135, 136, 138, 141, 142, 143, 145, 146, 147, 148, 149, 150, 151, 156, 157, 158, 159, 160, 161, 162, 165, 166, 167, 168, 171, 172, 176, 177, 178, 181, 182, 186, 188, 191, 192, 193, 194, 196, 197, 199]"
agent_c,L50,short,132,63,69,10,0.34,200,"[0, 1, 2, 6, 7, 8, 9, 10, 11, 12, 14, 15, 16, 19, 20, 21, 22, 24, 26, 27, 28, 30, 32, 33, 38, 39, 41, 42, 43, 44, 45, 46, 47, 48, 50, 53, 54, 55, 57, 61, 62, 63, 65, 66, 67, 69, 70, 71, 73, 74, 75, 76, 78, 80, 81, 82, 85, 86, 89, 90, 92, 93, 94, 95, 97, 98, 99, 100, 102, 103, 106, 107, 109, 110, 111, 112, 114, 115, 116, 119, 121, 122, 123, 124, 125, 127, 128, 130, 131, 132, 133, 135, 136, 138, 139, 140, 141, 142, 143, 144, 145, 146, 148, 149, 153, 154, 155, 156, 157, 158, 159, 161, 162, 166, 169, 172, 173, 177, 179, 181, 182, 183, 185, 189, 190, 191, 192, 193, 194, 195, 196, 198]"
agent_c,L50,short,127,72,55,12,0.365,200,"[0, 2, 3, 7, 8, 9, 11, 12, 13, 15, 16, 17, 19, 21, 22, 23, 24, 25, 26, 27, 28, 29, 33, 35, 37, 38, 39, 40, 43, 44, 45, 46, 48, 50, 53, 54, 55, 56, 59, 61, 64, 65, 66, 67, 69, 70, 71, 74, 78, 79, 80, 82, 84, 85, 86, 87, 88, 89, 90, 91, 92, 95, 99, 101, 104, 105, 106, 109, 110, 112, 113, 114, 115, 116, 117, 118, 120, 121, 122, 123, 124, 125, 127, 130, 131, 132, 133, 134, 135, 136, 137, 138, 139, 140, 142, 143, 144, 146, 150, 151, 153, 154, 155, 156, 157, 160, 162, 163, 164, 168, 169, 170, 171, 176, 177, 180, 182, 183, 185, 186, 187, 188, 189, 196, 197, 198, 199]"
agent_c,L50,short,134,59,75,8,0.33,200,"[0, 1, 3, 4, 5, 6, 7, 13, 15, 16, 18, 21, 22, 23, 26, 27, 28, 29, 30, 32, 33, 35, 36, 37, 38, 40, 41, 42, 44, 45, 47, 49, 51, 52, 53, 54, 55, 56, 57, 58, 59, 60, 62, 64, 66, 67, 68, 69, 70, 71, 73, 74, 75, 77, 80, 81, 84, 86, 87, 89, 90, 91, 92, 95, 96, 97, 98, 99, 100, 102, 103, 104, 105, 106, 107, 109, 110, 111, 113, 114, 115, 116, 117, 118, 119, 120, 122, 124, 125, 126, 127, 130, 131, 132, 133, 134, 135, 136, 138, 139, 140, 141, 144, 145, 146, 149, 150, 151, 152, 153, 154, 155, 156, 157, 160, 161, 162, 163, 164, 166, 168, 169, 170, 172, 177, 179, 180, 182, 186, 187, 189, 190, 191, 192]"
agent_c,L50,short,127,55,72,11,0.365,200,"[3, 4, 5, 7, 9, 10, 13, 15, 16, 19, 20, 21, 22, 23, 24, 26, 27, 28, 29, 30, 31, 32, 33, 34, 36, 38, 41, 42, 45, 47, 48, 50, 51, 52, 53, 54, 56, 57, 58, 60, 61, 62, 64, 65, 66, 71, 72, 73, 74, 78, 79, 80, 81, 82, 84, 85, 86, 87, 88, 89, 90, 93, 94, 95, 96, 97, 99, 101, 102, 105, 108, 110, 111, 114, 116, 117, 118, 119, 121, 122, 123, 124, 125, 126, 131, 134, 135, 136, 138, 139, 140, 141, 144, 146, 147, 148, 149, 150, 151, 152, 153, 154, 158, 159, 160, 162, 163, 165, 166, 167, 168, 170, 171, 173, 174, 175, 178, 179, 180, 181, 184, 185, 190, 192, 193, 194, 195]"
agent_c,L50,short,134,70,64,9,0.33,200,"[1, 2, 3, 5, 6, 9, 10, 11, 13, 14, 15, 16, 17, 20, 21, 22, 25, 26, 27, 28, 29, 32, 33, 34, 36, 38, 39, 40, 43, 44, 45, 46, 47, 48, 49, 50, 51, 52, 53, 54, 55, 57, 58, 60, 61, 63, 64, 66, 68, 69, 71, 72, 74, 75, 76, 77, 78, 79, 80, 81, 82, 83, 84, 87, 88, 89, 90, 91, 92, 93, 94, 96, 97, 98, 99, 100, 101, 102, 104, 105, 106, 110, 111, 113, 114, 115, 117, 119, 121, 123, 124, 127, 128, 129, 130, 132, 133, 134, 135, 136, 137, 140, 141, 142, 143, 146, 147, 148, 149, 151, 152, 153, 154, 156, 157, 158, 162, 164, 165, 167, 169, 171, 173, 174, 176, 177, 178, 184, 185, 186, 187, 189, 195, 196]"
agent_c,L50,short,122,56,66,13,0.39,200,"[1, 4, 5, 6, 9, 10, 11, 12, 14, 17, 19, 21, 22, 23, 24, 26, 27, 31, 34, 35, 36, 37, 38, 39, 44, 45, 46, 47, 50, 52, 53, 54, 55, 56, 60, 61, 63, 64, 65, 66, 67, 68, 69, 70, 71, 74, 75, 76, 77, 78, 79, 81, 84, 85, 87, 88, 90, 91, 92, 97, 98, 99, 100, 101, 103, 104, 110, 113, 115, 116, 117, 118, 119, 120, 122, 124, 128, 129, 130, 131, 133, 134, 136, 137, 138, 140, 141, 144, 145, 148, 150, 151, 152, 155, 156, 157, 158, 159, 160, 161, 162, 164, 165, 166, 168, 169, 170, 171, 172, 173, 174, 175, 177, 181, 182, 184, 185, 187, 189, 194, 197, 198]"
agent_c,L50,short,122,54,68,10,0.39,200,"[1, 3, 4, 6, 7, 13, 15, 16, 17, 18, 19, 20, 21, 23, 24, 26, 30, 32, 33, 35, 36, 37, 41, 44, 45, 46, 49, 52, 53, 54, 56, 57, 58, 60, 62, 64, 65, 66, 67, 70, 71, 75, 76, 78, 79, 80, 81, 83, 85, 87, 88, 91, 92, 93, 94, 95, 98, 100, 101, 102, 103, 108, 109, 110, 111, 112, 113, 115, 116, 118, 119, 120, 121, 123, 124, 125, 126, 127, 128, 129, 130, 133, 134, 135, 136, 137, 138, 140, 141, 143, 144, 145, 146, 147, 149, 150, 152, 154, 157, 158, 159, 160, 163, 166, 167, 168, 169, 170, 171, 174, 175, 176, 178, 179, 180, 181, 183, 186, 191, 192, 193, 199]"
agent_c,L50,short,118,77,41,12,0.41,200,"[2, 5, 6, 7, 8, 9, 10, 12, 13, 17, 18, 19, 20, 22, 23, 27, 28, 29, 31, 33, 34, 36, 37, 39, 40, 45, 46, 47, 48, 49, 50, 51, 52, 53, 57, 60, 61, 62, 64, 65, 66, 67, 70, 72, 73, 75, 78, 80, 81, 82, 83, 84, 85, 86, 88, 89, 90, 92, 93, 94, 96, 98, 101, 102, 104, 105, 107, 108, 109, 110, 111, 112, 114, 115, 117, 118, 121, 124, 125, 126, 127, 128, 129, 131, 132, 133, 134, 135, 137, 139, 141, 144, 146, 147, 148, 150, 151, 154, 156, 158, 160, 161, 163, 164, 165, 166, 167, 179, 180, 181, 182, 184, 186, 188, 191, 192, 193, 196]"
agent_c,L50,short,134,46,88,5,0.33,200,"[1, 2, 4, 5, 6, 7, 9, 10, 11, 12, 13, 14, 15, 16, 19, 20, 21, 23, 24, 25, 26, 28, 31, 32, 33, 34, 35, 36, 37, 38, 39, 40, 41, 43, 44, 45, 48, 49, 50, 54, 56, 57, 58, 59, 62, 64, 65, 66, 67, 72, 73, 74, 75, 77, 79, 80, 81, 83, 84, 85, 86, 87, 88, 89, 90, 91, 92, 94, 98, 99, 100, 101, 102, 103, 104, 105, 106, 109, 110, 111, 112, 113, 114, 115, 117, 118, 121, 122, 123, 124, 125, 126, 127, 129, 131, 133, 134, 135, 136, 137, 138, 139, 141, 142, 145, 146, 147, 149, 150, 152, 154, 155, 157, 159, 160, 161, 164, 167, 168, 170, 171, 172, 173, 174, 175, 176, 177, 178, 179, 180, 182, 189, 190, 191]"
agent_c,L50,short,126,68,58,12,0.37,200,"[0, 1, 3, 6, 7, 8, 9, 10, 12, 13, 14, 15, 17, 18, 19, 20, 21, 22, 26, 27, 28, 29, 30, 31, 32, 33, 35, 42, 43, 44, 46, 49, 55, 56, 57, 59, 60, 61, 62, 63, 64, 65, 66, 67, 68, 70, 71, 72, 74, 75, 76, 77, 81, 82, 85, 86, 87, 88, 90, 94, 96, 99, 100, 101, 102, 104, 106, 111, 112, 114, 115, 117, 118, 119, 121, 122, 123, 125, 126, 128, 129, 130, 131, 134, 135, 136, 137, 138, 139, 140, 141, 143, 144, 145, 147, 149, 152, 153, 155, 157, 158, 159, 160, 161, 162, 163, 164, 165, 167, 169, 170, 172, 173, 174, 176, 180, 181, 182, 183, 186, 187, 188, 192, 193, 194, 197]"
agent_c,L50,short,127,46,81,9,0.365,200,"[0, 1, 2, 3, 5, 6, 7, 8, 10, 11, 13, 14, 15, 16, 17, 18, 19, 20, 21, 22, 23, 24, 27, 28, 29, 30, 31, 34, 36, 38, 40, 42, 43, 45, 46, 48, 49, 51, 52, 53, 55, 56, 57, 58, 60, 61, 64, 65, 68, 71, 72, 74, 75, 76, 77, 78, 79, 80, 82, 83, 87, 88, 89, 90, 91, 92, 93, 95, 96, 97, 98, 99, 101, 102, 105, 106, 107, 108, 109, 110, 111, 115, 117, 118, 119, 120, 121, 123, 124, 125, 128, 129, 131, 132, 133, 134, 135, 136, 137, 140, 141, 142, 145, 147, 149, 152, 153, 158, 160, 163, 164, 165, 166, 167, 169, 170, 172, 173, 174, 176, 178, 184, 185, 186, 187, 190, 199]"
agent_c,L50,short,135,61,74,9,0.325,200,"[1, 2, 3, 4, 5, 6, 7, 9, 10, 11, 15, 16, 17, 18, 21, 24, 25, 26, 27, 28, 30, 31, 32, 34, 35, 36, 38, 40, 45, 46, 49, 50, 51, 52, 53, 54, 55, 56, 57, 58, 59, 60, 61, 62, 63, 65, 66, 69, 70, 71, 72, 73, 74, 76, 77, 78, 81, 83, 85, 86, 87, 88, 89, 90, 91, 92, 93, 94, 95, 96, 97, 98, 99, 101, 102, 103, 104, 105, 106, 108, 109, 110, 111, 112, 113, 114, 115, 117, 118, 120, 124, 126, 127, 128, 129, 130, 131, 132, 134, 135, 136, 139, 140, 141, 144, 145, 146, 147, 148, 153, 154, 155, 159, 160, 163, 164, 167, 170, 171, 172, 173, 175, 176, 178, 179, 180, 181, 182, 184, 185, 187, 195, 196, 197, 198]"
agent_c,L50,short,127,69,58,9,0.365,200,"[0, 1, 2, 3, 4, 5, 6, 7, 9, 10, 11, 12, 13, 15, 16, 17, 20, 22, 23, 24, 25, 26, 27, 29, 31, 32, 33, 35, 36, 39, 40, 41, 42, 43, 44, 47, 48, 49, 50, 52, 53, 54, 55, 59, 60, 61, 62, 63, 64, 65, 67, 69, 70, 71, 72, 73, 74, 75, 77, 80, 81, 86, 89, 90, 91, 94, 95, 99, 100, 101, 103, 105, 106, 107, 111, 113, 115, 116, 119, 121, 122, 125, 127, 128, 131, 132, 133, 134, 135, 136, 137, 138, 140, 142, 143, 144, 146, 148, 150, 151, 152, 153, 154, 155, 156, 159, 160, 162, 163, 164, 165, 166, 167, 171, 172, 173, 174, 176, 178, 179, 181, 184, 189, 190, 192, 193, 194]"
agent_c,L50,short,132,65,67,7,0.34,200,"[0, 1, 3, 4, 5, 7, 8, 9, 11, 12, 13, 14, 15, 16, 18, 20, 22, 23, 25, 26, 27, 28, 29, 30, 33, 35, 36, 40, 42, 43, 45, 48, 49, 50, 51, 53, 55, 56, 59, 60, 61, 62, 63, 64, 65, 66, 71, 72, 73, 76, 77, 78, 79, 83, 84, 85, 87, 88, 89, 90, 91, 93, 97, 98, 100, 101, 102, 106, 107, 108, 111, 112, 114, 115, 116, 117, 119, 120, 121, 122, 123, 125, 126, 127, 128, 129, 130, 132, 133, 134, 135, 137, 138, 141, 142, 143, 144, 145, 146, 147, 148, 149, 150, 151, 152, 153, 154, 155, 158, 160, 161, 163, 165, 166, 168, 169, 170, 172, 175, 176, 177, 178, 179, 180, 181, 183, 188, 189, 191, 192, 193, 194]"
agent_c,L50,short,128,74,54,9,0.36,200,"[0, 1, 2, 3, 4, 5, 6, 7, 8, 9, 11, 12, 13, 14, 15, 16, 17, 18, 20, 22, 23, 24, 25, 27, 28, 29, 31, 32, 33, 34, 35, 38, 40, 41, 42, 43, 45, 47, 50, 54, 55, 56, 58, 61, 62, 64, 65, 66, 67, 68, 69, 71, 72, 73, 74, 75, 76, 77, 78, 80, 82, 84, 85, 86, 87, 91, 96, 97, 98, 100, 101, 103, 104, 105, 106, 107, 109, 110, 114, 117, 124, 125, 127, 128, 130, 131, 133, 136, 137, 138, 139, 140, 141, 143, 146, 147, 148, 151, 152, 153, 155, 159, 161, 162, 163, 164, 165, 166, 167, 168, 169, 170, 171, 172, 175, 178, 179, 180, 182, 183, 184, 185, 186, 187, 188, 194, 195, 199]"
agent_c,L50,short,127,64,63,9,0.365,200,"[2, 3, 4, 6, 8, 9, 10, 11, 13, 14, 16, 17, 18, 20, 21, 22, 24, 25, 27, 30, 31, 32, 33, 35, 39, 42, 44, 45, 46, 47, 48, 49, 50, 53, 55, 56, 57, 58, 62, 63, 67, 68, 69, 70, 72, 73, 74, 77, 78, 79, 80, 81, 82, 83, 84, 86, 89, 90, 91, 92, 93, 94, 96, 97, 98, 99, 100, 102, 104, 105, 107, 109, 110, 111, 114, 115, 117, 118, 119, 120, 122, 123, 124, 125, 127, 128, 129, 130, 133, 135, 137, 139, 140, 141, 142, 146, 148, 149, 151, 152, 155, 157, 159, 160, 161, 162, 163, 164, 165, 166, 167, 168, 170, 172, 173, 174, 175, 178, 180, 184, 188, 189, 190, 192, 193, 194, 196]"
agent_c,L50,short,128,53,75,10,0.36,200,"[0, 1, 3, 5, 6, 7, 9, 10, 11, 14, 15, 16, 17, 19, 20, 21, 22, 23, 24, 25, 29, 31, 33, 34, 36, 37, 39, 42, 43, 44, 45, 48, 49, 51, 52, 53, 54, 55, 56, 57, 58, 60, 61, 63, 64, 65, 67, 69, 71, 72, 74, 75, 77, 79, 80, 81, 84, 88, 90, 92, 95, 97, 98, 101, 102, 103, 104, 105, 106, 108, 109, 110, 112, 114, 120, 121, 122, 124, 125, 127, 128, 129, 130, 132, 133, 134, 135, 137, 138, 139, 141, 142, 146, 147, 148, 149, 150, 152, 154, 155, 156, 158, 159, 160, 162, 163, 164, 166, 167, 169, 170, 171, 172, 174, 175, 176, 178, 180, 181, 182, 183, 185, 189, 190, 193, 194, 195, 196]"
agent_c,L50,short,132,65,67,5,0.34,200,"[0, 1, 2, 4, 5, 8, 9, 10, 11, 12, 13, 14, 16, 17, 18, 20, 21, 22, 24, 25, 26, 28, 29, 30, 31, 34, 35, 36, 37, 39, 40, 41, 42, 43, 45, 47, 48, 49, 50, 52, 53, 55, 56, 57, 61, 62, 63, 65, 66, 67, 68, 69, 70, 71, 72, 74, 75, 76, 77, 81, 85, 86, 87, 88, 90, 91, 92, 93, 94, 97, 98, 100, 101, 105, 106, 107, 108, 110, 112, 113, 116, 118, 119, 120, 121, 122, 123, 127, 128, 130, 131, 132, 133, 134, 135, 137, 138, 140, 141, 142, 143, 144, 145, 146, 148, 149, 151, 152, 153, 154, 155, 156, 158, 159, 160, 161, 166, 167, 170, 171, 174, 175, 177, 178, 181, 186, 187, 189, 190, 191, 192, 198]"
agent_c,L50,short,130,66,64,11,0.35,200,"[0, 2, 3, 4, 5, 7, 10, 11, 12, 14, 15, 16, 18, 19, 20, 21, 23, 24, 25, 28, 29, 30, 31, 32, 34, 35, 39, 40, 41, 42, 43, 44, 45, 46, 47, 48, 50, 51, 53, 54, 59, 61, 62, 64, 65, 68, 69, 71, 73, 74, 77, 78, 80, 81, 82, 83, 84, 85, 86, 87, 90, 91, 93, 94, 95, 98, 99, 101, 102, 103, 104, 105, 106, 108, 109, 110, 111, 112, 116, 117, 118, 122, 123, 124, 125, 127, 128, 130, 131, 133, 134, 135, 136, 137, 138, 139, 140, 142, 143, 144, 145, 146, 149, 150, 151, 152, 153, 154, 156, 158, 159, 160, 162, 163, 166, 169, 171, 172, 173, 174, 175, 177, 181, 182, 183, 184, 185, 186, 187, 191]"
agent_c,L50,short,136,55,81,5,0.32,200,"[0, 2, 3, 4, 5, 6, 7, 8, 9, 10, 11, 12, 14, 15, 17, 18, 20, 22, 23, 24, 25, 29, 30, 31, 32, 33, 36, 37, 38, 39, 40, 41, 42, 43, 44, 45, 46, 47, 48, 49, 50, 52, 53, 54, 55, 56, 60, 62, 63, 64, 65, 66, 69, 70, 72, 75, 76, 77, 78, 79, 81, 82, 83, 85, 86, 87, 88, 89, 91, 92, 93, 94, 95, 96, 98, 99, 101, 102, 103, 104, 105, 106, 107, 110, 111, 112, 113, 114, 115, 116, 117, 118, 119, 120, 122, 123, 125, 126, 127, 129, 130, 133, 136, 137, 138, 140, 141, 142, 143, 145, 147, 149, 150, 151, 153, 154, 157, 158, 159, 161, 162, 163, 164, 165, 166, 167, 168, 169, 170, 171, 178, 180, 181, 188, 189, 193]"
agent_c,L100,short,128,55,73,9,0.36,200,"[1, 4, 5, 6, 9, 10, 13, 14, 15, 17, 19, 20, 21, 22, 23, 24, 25, 26, 27, 28, 29, 31, 32, 33, 34, 36, 38, 40, 41, 44, 46, 47, 48, 49, 50, 51, 53, 54, 57, 58, 59, 60, 62, 63, 66, 68, 70, 73, 74, 76, 78, 79, 81, 83, 85, 86, 87, 88, 92, 93, 94, 95, 96, 97, 98, 99, 100, 101, 102, 103, 104, 105, 106, 107, 109, 110, 112, 113, 115, 116, 117, 118, 120, 121, 122, 123, 124, 125, 126, 128, 129, 130, 132, 133, 135, 136, 137, 139, 140, 141, 144, 145, 147, 148, 149, 150, 151, 152, 153, 154, 155, 157, 159, 160, 161, 162, 163, 164, 165, 166, 167, 172, 173, 178, 179, 180, 184, 192]"
agent_c,L100,short,119,56,63,14,0.405,200,"[1, 3, 4, 5, 6, 10, 11, 13, 14, 15, 16, 17, 22, 23, 24, 26, 27, 32, 33, 35, 36, 37, 41, 43, 44, 49, 50, 51, 52, 53, 55, 56, 58, 60, 61, 65, 66, 67, 69, 70, 71, 72, 73, 74, 75, 76, 78, 79, 80, 81, 84, 85, 87, 88, 90, 94, 97, 98, 100, 102, 104, 105, 106, 107, 108, 110, 112, 114, 115, 116, 118, 119, 120, 121, 123, 125, 128, 129, 130, 132, 133, 134, 135, 136, 138, 139, 141, 142, 143, 145, 147, 149, 150, 151, 153, 154, 157, 158, 159, 162, 163, 165, 166, 169, 171, 173, 174, 175, 176, 177, 179, 180, 182, 183, 184, 185, 186, 187, 194]"
agent_c,L100,short,132,49,83,6,0.34,200,"[0, 2, 4, 5, 7, 11, 12, 13, 14, 16, 17, 18, 19, 20, 21, 22, 23, 24, 28, 30, 31, 36, 37, 39, 41, 42, 43, 44, 45, 46, 47, 48, 50, 51, 52, 53, 55, 56, 59, 60, 61, 62, 63, 64, 65, 68, 69, 72, 73, 74, 75, 76, 77, 81, 82, 84, 85, 89, 90, 91, 92, 93, 94, 95, 96, 99, 100, 101, 102, 103, 105, 108, 109, 110, 111, 113, 114, 115, 116, 117, 118, 122, 124, 125, 126, 127, 128, 129, 130, 131, 133, 134, 135, 136, 137, 139, 140, 142, 143, 145, 146, 147, 148, 149, 150, 152, 153, 154, 156, 159, 160, 161, 162, 163, 164, 165, 166, 167, 169, 170, 171, 172, 173, 175, 176, 177, 184, 185, 187, 188, 197, 198]"
agent_c,L100,short,127,76,51,6,0.365,200,"[1, 3, 5, 6, 7, 8, 10, 12, 13, 17, 18, 21, 23, 26, 27, 28, 29, 32, 35, 37, 40, 41, 42, 43, 44, 45, 46, 47, 48, 50, 52, 53, 54, 58, 59, 60, 61, 62, 63, 64, 65, 66, 68, 70, 71, 72, 74, 75, 76, 78, 80, 81, 82, 84, 86, 87, 88, 89, 90, 91, 92, 93, 97, 98, 100, 101, 102, 103, 105, 106, 107, 108, 111, 113, 114, 116, 118, 119, 122, 123, 124, 126, 127, 129, 130, 131, 132, 133, 134, 135, 136, 137, 138, 139, 141, 142, 143, 145, 146, 149, 150, 152, 154, 155, 156, 157, 158, 160, 161, 162, 163, 164, 167, 168, 170, 171, 174, 176, 178, 180, 183, 188, 189, 190, 191, 198, 199]"
agent_c,L100,short,132,67,65,9,0.34,200,"[0, 2, 5, 7, 8, 9, 10, 11, 12, 13, 14, 15, 16, 17, 18, 19, 21, 23, 24, 27, 29, 30, 32, 34, 35, 37, 40, 41, 43, 45, 46, 47, 48, 49, 52, 53, 55, 56, 57, 58, 59, 60, 61, 62, 63, 64, 65, 66, 67, 69, 71, 72, 73, 74, 77, 78, 79, 80, 82, 83, 84, 86, 87, 88, 90, 91, 92, 95, 96, 98, 100, 101, 102, 104, 105, 106, 107, 108, 109, 111, 114, 115, 117, 119, 120, 122, 123, 126, 127, 129, 130, 131, 132, 133, 135, 136, 137, 139, 140, 142, 143, 144, 145, 147, 148, 151, 152, 153, 154, 155, 156, 158, 159, 161, 162, 164, 166, 167, 171, 172, 173, 174, 175, 176, 177, 178, 179, 186, 187, 188, 189, 199]"
agent_c,L100,short,130,80,50,7,0.35,200,"[0, 1, 2, 4, 5, 6, 7, 8, 9, 10, 11, 12, 13, 14, 15, 16, 17, 18, 19, 20, 21, 22, 24, 26, 29, 31, 32, 33, 34, 35, 36, 39, 40, 41, 44, 45, 47, 49, 50, 52, 54, 57, 58, 59, 60, 61, 62, 63, 65, 66, 67, 68, 69, 71, 72, 75, 76, 77, 80, 81, 83, 84, 85, 87, 88, 89, 90, 91, 92, 94, 95, 96, 99, 101, 102, 103, 104, 107, 108, 109, 111, 112, 113, 114, 115, 116, 118, 119, 121, 122, 124, 125, 126, 128, 131, 132, 133, 135, 137, 139, 141, 143, 144, 145, 146, 147, 149, 150, 151, 152, 154, 155, 158, 159, 162, 163, 164, 166, 168, 169, 173, 174, 175, 181, 184, 185, 186, 194, 196, 198]"
agent_c,L100,short,119,54,65,13,0.405,200,"[0, 2, 4, 6, 7, 9, 10, 11, 12, 13, 15, 17, 19, 22, 24, 25, 27, 28, 29, 30, 32, 33, 35, 36, 39, 41, 42, 45, 46, 47, 48, 49, 50, 52, 53, 56, 57, 58, 61, 62, 63, 64, 67, 70, 71, 72, 73, 74, 75, 76, 77, 78, 79, 82, 83, 87, 88, 89, 90, 91, 92, 93, 96, 97, 98, 99, 100, 102, 107, 108, 109, 112, 113, 114, 115, 116, 117, 118, 119, 121, 122, 125, 128, 129, 131, 133, 134, 135, 137, 140, 144, 149, 150, 154, 158, 159, 161, 162, 163, 165, 166, 167, 168, 171, 174, 175, 178, 182, 183, 184, 185, 186, 187, 190, 191, 192, 195, 197, 199]"
agent_c,L100,short,130,65,65,3,0.35,200,"[0, 1, 2, 3, 4, 5, 6, 7, 9, 10, 12, 13, 17, 18, 20, 22, 24, 25, 26, 28, 29, 30, 31, 32, 36, 37, 41, 42, 44, 45, 46, 47, 48, 49, 50, 52, 54, 55, 56, 57, 58, 59, 60, 61, 62, 64, 66, 67, 68, 70, 73, 75, 77, 78, 80, 81, 82, 83, 84, 86, 88, 89, 90, 91, 92, 94, 96, 98, 99, 100, 103, 105, 106, 108, 109, 111, 114, 115, 118, 119, 120, 121, 123, 124, 125, 126, 127, 128, 130, 131, 132, 133, 134, 135, 136, 137, 139, 140, 141, 142, 143, 144, 145, 147, 149, 150, 153, 154, 155, 156, 157, 158, 159, 160, 162, 164, 166, 168, 169, 170, 172, 174, 175, 176, 181, 183, 185, 186, 195, 196]"
agent_c,L100,short,131,69,62,6,0.345,200,"[0, 2, 3, 4, 5, 6, 8, 9, 10, 12, 13, 14, 15, 16, 17, 19, 20, 22, 24, 25, 26, 27, 28, 29, 30, 31, 32, 33, 34, 39, 42, 43, 44, 45, 46, 47, 48, 49, 50, 51, 54, 57, 58, 59, 61, 62, 64, 66, 67, 68, 69, 71, 72, 73, 74, 75, 76, 77, 78, 81, 82, 84, 86, 87, 88, 89, 90, 91, 92, 93, 94, 96, 98, 99, 100, 102, 103, 104, 105, 107, 108, 109, 110, 111, 112, 114, 115, 116, 117, 118, 119, 120, 121, 122, 123, 125, 126, 127, 128, 130, 131, 132, 133, 134, 135, 136, 139, 141, 142, 143, 144, 145, 147, 148, 149, 150, 152, 154, 155, 157, 158, 164, 166, 167, 168, 173, 176, 177, 180, 189, 191]"
agent_c,L100,short,129,78,51,9,0.355,200,"[0, 1, 2, 3, 5, 6, 7, 10, 11, 13, 16, 18, 19, 21, 22, 23, 24, 26, 27, 28, 29, 30, 31, 33, 34, 38, 39, 41, 43, 44, 46, 47, 48, 49, 50, 51, 52, 54, 55, 56, 57, 61, 62, 63, 65, 66, 69, 70, 71, 72, 73, 74, 76, 78, 79, 80, 81, 82, 83, 85, 86, 87, 90, 92, 95, 97, 98, 101, 102, 103, 105, 106, 107, 108, 109, 111, 112, 114, 115, 116, 117, 118, 119, 120, 122, 123, 125, 126, 128, 129, 130, 132, 133, 134, 135, 137, 138, 140, 141, 142, 143, 144, 145, 147, 148, 150, 151, 153, 155, 156, 157, 159, 163, 166, 167, 168, 169, 170, 171, 174, 175, 176, 177, 178, 180, 182, 190, 191, 194]"
agent_c,L100,short,124,76,48,3,0.38,200,"[1, 2, 3, 4, 5, 7, 8, 9, 10, 11, 12, 13, 16, 17, 19, 20, 21, 23, 25, 26, 27, 28, 30, 31, 32, 34, 35, 39, 41, 42, 43, 44, 45, 46, 55, 56, 57, 59, 60, 63, 64, 65, 66, 67, 68, 69, 70, 75, 76, 77, 79, 82, 83, 84, 85, 87, 88, 90, 92, 98, 99, 101, 102, 103, 104, 105, 106, 107, 110, 113, 114, 115, 116, 120, 121, 122, 123, 124, 126, 128, 130, 131, 132, 135, 136, 138, 139, 140, 141, 144, 145, 146, 147, 149, 150, 151, 153, 155, 156, 158, 159, 160, 161, 162, 163, 164, 166, 168, 169, 172, 173, 175, 176, 177, 178, 179, 180, 181, 182, 188, 190, 191, 192, 199]"
agent_c,L100,short,119,64,55,8,0.405,200,"[0, 6, 7, 12, 14, 18, 20, 21, 23, 24, 26, 28, 30, 31, 32, 36, 38, 39, 41, 42, 43, 44, 45, 47, 48, 50, 51, 52, 54, 56, 58, 59, 63, 65, 69, 70, 71, 72, 73, 74, 76, 77, 78, 79, 81, 82, 85, 86, 87, 88, 90, 91, 93, 94, 95, 96, 97, 98, 99, 103, 104, 105, 106, 108, 109, 110, 111, 113, 114, 115, 118, 119, 120, 122, 123, 125, 126, 129, 130, 131, 133, 135, 138, 141, 142, 144, 145, 146, 147, 148, 150, 152, 154, 155, 159, 160, 161, 163, 165, 166, 167, 168, 169, 170, 171, 172, 173, 174, 176, 177, 179, 180, 184, 185, 186, 187, 192, 195, 198]"
agent_c,L100,short,128,57,71,5,0.36,200,"[0, 2, 5, 6, 7, 8, 9, 11, 12, 14, 16, 17, 18, 19, 20, 21, 22, 23, 24, 26, 29, 33, 34, 35, 36, 40, 42, 43, 44, 45, 46, 47, 48, 49, 50, 54, 55, 56, 57, 58, 61, 62, 64, 65, 67, 69, 70, 72, 73, 74, 75, 77, 78, 79, 80, 82, 83, 84, 85, 87, 89, 90, 91, 92, 93, 94, 95, 97, 98, 99, 102, 103, 106, 107, 108, 109, 110, 111, 112, 114, 117, 118, 119, 120, 122, 123, 124, 125, 127, 128, 130, 134, 135, 136, 137, 138, 140, 141, 142, 145, 146, 147, 150, 151, 152, 153, 154, 155, 156, 157, 159, 162, 163, 164, 166, 167, 168, 171, 173, 177, 178, 179, 180, 182, 190, 191, 192, 193]"
agent_c,L100,short,122,71,51,14,0.39,200,"[0, 1, 3, 4, 6, 7, 10, 11, 12, 13, 14, 15, 18, 21, 22, 24, 26, 32, 33, 35, 36, 37, 39, 40, 41, 42, 43, 44, 46, 49, 50, 55, 57, 58, 59, 60, 61, 62, 63, 64, 65, 67, 71, 72, 74, 75, 76, 77, 78, 79, 80, 81, 82, 85, 87, 89, 90, 91, 93, 94, 97, 98, 99, 100, 102, 107, 110, 111, 112, 114, 115, 116, 117, 118, 119, 120, 124, 125, 126, 127, 129, 130, 131, 133, 134, 136, 137, 138, 139, 144, 145, 146, 147, 148, 150, 151, 152, 154, 156, 158, 159, 162, 163, 165, 166, 167, 170, 171, 172, 173, 175, 177, 178, 180, 184, 185, 186, 187, 188, 190, 196, 199]"
agent_c,L100,short,118,52,66,16,0.41,200,"[1, 2, 3, 4, 5, 8, 11, 12, 13, 14, 17, 18, 20, 21, 22, 25, 26, 30, 31, 33, 34, 35, 36, 37, 38, 39, 40, 41, 43, 44, 46, 49, 50, 53, 55, 56, 57, 60, 61, 64, 65, 66, 68, 71, 72, 73, 74, 76, 81, 82, 83, 87, 90, 91, 92, 96, 97, 98, 100, 102, 103, 108, 109, 112, 113, 115, 116, 118, 121, 122, 124, 126, 127, 128, 129, 131, 132, 133, 135, 136, 137, 138, 141, 142, 143, 145, 146, 149, 152, 153, 156, 157, 158, 159, 160, 161, 162, 163, 164, 169, 170, 171, 172, 173, 174, 175, 177, 178, 179, 183, 185, 186, 187, 188, 192, 196, 197, 198]"
agent_c,L100,short,125,71,54,3,0.375,200,"[0, 3, 4, 5, 7, 8, 10, 11, 12, 13, 17, 18, 19, 20, 23, 24, 25, 26, 27, 28, 29, 31, 33, 34, 35, 36, 37, 38, 39, 42, 45, 47, 48, 49, 51, 53, 54, 56, 61, 62, 63, 65, 67, 71, 73, 74, 75, 78, 79, 80, 82, 83, 84, 85, 86, 87, 88, 90, 91, 92, 93, 95, 96, 99, 103, 104, 105, 106, 107, 110, 115, 119, 120, 122, 123, 124, 125, 127, 128, 129, 132, 134, 136, 137, 138, 139, 140, 141, 142, 143, 145, 146, 147, 148, 149, 150, 152, 153, 154, 155, 156, 157, 158, 159, 161, 162, 163, 164, 165, 166, 167, 168, 169, 172, 173, 174, 177, 178, 179, 180, 185, 186, 190, 191, 192]"
agent_c,L100,short,123,68,55,13,0.385,200,"[2, 3, 5, 9, 10, 11, 13, 16, 17, 18, 21, 22, 23, 24, 26, 27, 28, 29, 31, 32, 33, 34, 36, 37, 38, 39, 40, 42, 43, 44, 46, 47, 48, 49, 50, 52, 53, 55, 56, 60, 61, 62, 64, 66, 68, 69, 70, 71, 73, 74, 76, 78, 79, 80, 81, 84, 87, 88, 89, 90, 91, 92, 93, 94, 95, 97, 101, 102, 105, 108, 110, 111, 113, 114, 115, 121, 122, 123, 125, 126, 131, 132, 133, 134, 136, 137, 138, 139, 140, 142, 143, 148, 149, 150, 152, 153, 154, 155, 158, 159, 160, 165, 166, 167, 168, 169, 171, 172, 173, 175, 176, 179, 180, 181, 182, 183, 184, 186, 191, 192, 193, 194, 199]"
agent_c,L100,short,125,76,49,7,0.375,200,"[0, 1, 3, 4, 5, 6, 7, 10, 12, 13, 14, 16, 21, 22, 23, 24, 25, 26, 27, 28, 29, 31, 34, 35, 36, 37, 38, 40, 41, 42, 43, 44, 45, 46, 47, 49, 50, 52, 53, 55, 56, 58, 59, 60, 62, 63, 66, 67, 69, 70, 72, 73, 75, 76, 77, 81, 84, 85, 87, 88, 89, 90, 91, 92, 93, 94, 95, 97, 98, 99, 103, 105, 107, 108, 109, 110, 111, 112, 113, 115, 120, 121, 122, 123, 125, 126, 127, 128, 129, 131, 133, 135, 138, 140, 141, 143, 144, 146, 151, 152, 153, 155, 158, 160, 163, 164, 165, 166, 170, 171, 172, 173, 174, 175, 176, 177, 178, 180, 181, 182, 183, 184, 187, 195, 197]"
agent_c,L100,short,125,53,72,12,0.375,200,"[0, 2, 3, 4, 5, 7, 8, 9, 10, 12, 15, 16, 19, 21, 25, 26, 27, 28, 29, 30, 31, 35, 36, 37, 38, 39, 41, 42, 43, 46, 47, 49, 50, 51, 52, 53, 55, 56, 57, 61, 62, 63, 66, 67, 69, 70, 71, 73, 77, 78, 79, 82, 83, 84, 85, 89, 92, 93, 95, 96, 97, 98, 102, 104, 106, 107, 111, 112, 114, 116, 117, 118, 119, 121, 122, 124, 125, 126, 128, 129, 130, 131, 132, 133, 134, 135, 137, 141, 143, 144, 146, 147, 148, 149, 150, 151, 152, 153, 155, 156, 157, 158, 161, 163, 164, 165, 166, 169, 170, 171, 172, 173, 174, 176, 177, 180, 181, 182, 184, 185, 186, 187, 190, 197, 198]"
agent_c,L100,short,124,67,57,12,0.38,200,"[1, 2, 3, 4, 5, 6, 7, 10, 13, 18, 19, 20, 21, 22, 24, 27, 28, 30, 31, 32, 34, 35, 36, 37, 38, 39, 40, 43, 45, 47, 48, 49, 50, 52, 53, 54, 56, 57, 58, 59, 60, 62, 63, 64, 67, 69, 71, 72, 73, 74, 75, 77, 79, 80, 81, 82, 84, 86, 87, 88, 89, 90, 94, 96, 98, 100, 101, 103, 104, 105, 106, 107, 108, 111, 114, 117, 118, 120, 124, 125, 129, 130, 131, 132, 135, 136, 137, 138, 139, 140, 141, 142, 144, 145, 146, 147, 148, 149, 150, 151, 154, 155, 156, 157, 158, 159, 160, 162, 165, 166, 168, 169, 170, 171, 172, 173, 174, 175, 179, 180, 181, 183, 186, 194]"
agent_c,L100,short,127,44,83,6,0.365,200,"[2, 4, 5, 6, 7, 8, 10, 12, 13, 14, 15, 16, 18, 19, 21, 22, 23, 24, 25, 26, 27, 28, 29, 30, 31, 32, 33, 35, 36, 37, 38, 39, 43, 45, 47, 49, 52, 53, 54, 55, 57, 58, 60, 61, 63, 64, 65, 66, 67, 68, 69, 70, 71, 72, 73, 76, 77, 78, 79, 81, 83, 85, 87, 90, 91, 93, 95, 96, 98, 100, 101, 102, 103, 105, 106, 107, 109, 110, 111, 113, 114, 115, 116, 117, 119, 122, 126, 129, 130, 131, 132, 134, 136, 137, 139, 141, 142, 143, 145, 146, 147, 148, 149, 150, 151, 152, 153, 154, 156, 157, 158, 159, 162, 163, 164, 166, 167, 168, 170, 173, 178, 179, 181, 182, 183, 191, 193]"
agent_c,L100,short,129,66,63,8,0.355,200,"[0, 1, 3, 4, 5, 8, 10, 12, 13, 14, 15, 17, 18, 20, 21, 22, 23, 28, 32, 33, 34, 36, 39, 40, 41, 45, 46, 47, 49, 50, 52, 53, 54, 55, 56, 57, 58, 60, 61, 62, 64, 66, 67, 68, 69, 70, 71, 72, 74, 75, 76, 77, 80, 81, 82, 83, 84, 85, 86, 88, 89, 90, 91, 92, 93, 94, 97, 98, 99, 100, 101, 103, 104, 106, 108, 109, 111, 113, 114, 116, 118, 119, 120, 122, 123, 124, 125, 126, 128, 129, 131, 132, 133, 134, 135, 136, 137, 139, 140, 141, 143, 144, 147, 149, 150, 151, 153, 155, 156, 159, 160, 161, 163, 164, 165, 166, 168, 170, 171, 173, 174, 178, 179, 180, 181, 182, 185, 193, 194]"
agent_c,L100,short,123,55,68,7,0.385,200,"[1, 2, 3, 4, 5, 6, 8, 9, 10, 11, 12, 15, 17, 18, 19, 21, 22, 25, 26, 28, 30, 32, 35, 37, 38, 39, 40, 41, 43, 47, 48, 49, 52, 54, 55, 56, 57, 58, 60, 63, 64, 68, 70, 72, 73, 74, 77, 79, 80, 81, 82, 85, 87, 88, 89, 90, 92, 94, 98, 99, 101, 102, 103, 104, 106, 108, 110, 111, 115, 119, 121, 124, 125, 126, 128, 129, 130, 131, 133, 136, 138, 139, 140, 142, 143, 144, 148, 149, 150, 151, 152, 154, 155, 156, 157, 159, 161, 162, 164, 165, 166, 167, 169, 170, 171, 172, 173, 174, 175, 176, 177, 178, 179, 180, 185, 187, 188, 189, 195, 196, 197, 198, 199]"
agent_c,L100,short,131,72,59,6,0.345,200,"[0, 1, 2, 3, 5, 6, 8, 9, 10, 12, 13, 14, 15, 18, 19, 20, 21, 22, 24, 25, 27, 29, 30, 31, 33, 34, 35, 36, 38, 39, 40, 42, 43, 44, 45, 47, 48, 49, 50, 51, 52, 53, 55, 56, 58, 59, 61, 62, 63, 64, 66, 67, 68, 69, 70, 72, 74, 75, 76, 78, 82, 83, 84, 86, 87, 89, 90, 92, 93, 95, 96, 100, 102, 103, 104, 105, 106, 107, 108, 109, 110, 111, 114, 116, 117, 120, 121, 122, 123, 125, 126, 127, 129, 130, 131, 132, 136, 138, 140, 141, 142, 143, 144, 147, 148, 149, 150, 152, 153, 156, 157, 159, 160, 162, 163, 165, 166, 167, 171, 172, 173, 174, 175, 176, 178, 185, 186, 187, 188, 197, 198]"
agent_c,L100,short,126,65,61,7,0.37,200,"[0, 3, 5, 7, 9, 10, 12, 13, 15, 16, 18, 19, 20, 21, 22, 24, 26, 27, 28, 29, 32, 33, 34, 36, 37, 41, 42, 44, 48, 50, 51, 52, 54, 55, 57, 58, 59, 60, 61, 64, 65, 66, 67, 69, 71, 72, 75, 76, 77, 78, 79, 82, 83, 84, 85, 86, 87, 88, 90, 91, 93, 95, 96, 97, 98, 99, 100, 101, 102, 104, 106, 107, 109, 113, 114, 115, 117, 118, 119, 120, 121, 122, 123, 124, 126, 128, 132, 133, 134, 135, 136, 137, 140, 141, 142, 143, 145, 146, 148, 149, 151, 153, 155, 156, 158, 161, 163, 165, 166, 167, 168, 169, 170, 172, 176, 180, 181, 182, 183, 184, 185, 191, 192, 193, 194, 195]"
agent_c,L100,short,129,76,53,7,0.355,200,"[0, 1, 2, 4, 6, 7, 8, 9, 10, 11, 13, 14, 18, 19, 21, 22, 24, 25, 26, 28, 29, 30, 32, 35, 36, 40, 42, 43, 44, 46, 48, 49, 51, 53, 55, 56, 57, 58, 59, 63, 64, 65, 66, 67, 68, 69, 70, 71, 72, 74, 75, 78, 81, 82, 83, 86, 88, 91, 92, 93, 94, 95, 97, 98, 99, 100, 101, 103, 105, 106, 107, 109, 110, 111, 112, 113, 114, 116, 117, 119, 122, 123, 124, 126, 127, 129, 130, 131, 132, 133, 134, 135, 136, 137, 139, 143, 144, 145, 146, 147, 148, 149, 151, 152, 153, 154, 156, 158, 159, 161, 164, 165, 167, 168, 169, 171, 172, 173, 175, 179, 180, 181, 182, 183, 184, 185, 192, 193, 198]"
agent_c,L100,short,125,46,79,6,0.375,200,"[2, 3, 4, 5, 6, 7, 8, 10, 13, 14, 15, 16, 18, 19, 20, 21, 25, 26, 27, 29, 30, 31, 32, 33, 35, 36, 37, 40, 41, 43, 44, 45, 46, 47, 48, 49, 50, 52, 53, 54, 55, 56, 57, 58, 59, 60, 61, 62, 64, 65, 68, 69, 70, 73, 74, 75, 77, 80, 81, 82, 83, 84, 85, 86, 90, 93, 95, 96, 99, 100, 101, 103, 107, 109, 110, 112, 113, 114, 115, 118, 119, 120, 124, 127, 128, 130, 131, 132, 133, 135, 136, 137, 139, 140, 141, 142, 143, 145, 147, 148, 152, 155, 158, 159, 160, 161, 162, 164, 167, 168, 169, 170, 171, 172, 173, 174, 177, 178, 179, 180, 182, 184, 185, 192, 195]"
agent_c,L100,short,122,55,67,13,0.39,200,"[0, 1, 3, 4, 5, 6, 7, 9, 10, 11, 12, 13, 14, 16, 19, 21, 25, 30, 31, 32, 34, 35, 36, 37, 39, 41, 42, 46, 47, 48, 49, 51, 52, 55, 58, 61, 62, 64, 66, 67, 68, 70, 72, 73, 77, 78, 79, 80, 84, 85, 86, 88, 89, 90, 93, 94, 95, 98, 99, 100, 101, 102, 104, 105, 106, 108, 109, 110, 111, 113, 117, 118, 119, 122, 123, 124, 125, 126, 127, 128, 129, 130, 131, 133, 134, 135, 139, 140, 142, 144, 146, 149, 150, 152, 153, 154, 155, 156, 157, 158, 159, 161, 163, 165, 167, 168, 170, 171, 174, 175, 176, 178, 179, 183, 184, 186, 187, 188, 190, 197, 198, 199]"
agent_c,L100,short,117,57,60,15,0.415,200,"[1, 2, 4, 5, 6, 7, 8, 10, 11, 12, 13, 15, 16, 17, 18, 19, 20, 22, 23, 24, 25, 26, 28, 29, 30, 31, 33, 34, 35, 36, 38, 39, 43, 44, 47, 48, 50, 52, 57, 58, 60, 61, 64, 65, 66, 67, 68, 69, 70, 71, 74, 75, 76, 77, 78, 79, 80, 86, 87, 89, 90, 93, 94, 95, 96, 97, 101, 103, 104, 107, 110, 112, 113, 117, 120, 121, 122, 123, 124, 125, 128, 130, 131, 132, 133, 134, 136, 138, 142, 143, 144, 146, 147, 149, 150, 151, 153, 154, 155, 161, 164, 167, 168, 169, 170, 171, 176, 178, 181, 185, 187, 188, 189, 191, 197, 198, 199]"
agent_c,L100,short,129,36,93,10,0.355,200,"[1, 2, 3, 4, 7, 8, 9, 10, 11, 13, 15, 17, 18, 19, 20, 22, 23, 24, 25, 26, 28, 31, 32, 33, 34, 35, 36, 37, 38, 39, 40, 41, 42, 43, 44, 45, 46, 48, 49, 51, 52, 55, 56, 57, 58, 60, 61, 62, 63, 64, 66, 67, 69, 71, 73, 74, 75, 76, 77, 78, 79, 80, 81, 82, 84, 90, 91, 93, 94, 95, 96, 98, 101, 102, 106, 107, 109, 111, 112, 114, 115, 116, 117, 118, 119, 120, 121, 123, 124, 127, 128, 129, 130, 131, 132, 133, 136, 137, 138, 139, 140, 144, 145, 146, 147, 148, 149, 150, 153, 154, 155, 156, 157, 158, 160, 161, 163, 164, 166, 167, 170, 175, 176, 177, 178, 180, 188, 189, 193]"
agent_c,L100,short,128,68,60,7,0.36,200,"[0, 1, 2, 3, 4, 5, 8, 11, 12, 14, 16, 18, 19, 20, 21, 22, 23, 25, 26, 27, 28, 29, 30, 32, 36, 38, 39, 41, 42, 43, 44, 45, 46, 48, 50, 51, 53, 54, 56, 57, 59, 60, 61, 63, 64, 65, 66, 68, 70, 73, 78, 81, 82, 83, 85, 86, 89, 90, 91, 92, 93, 94, 95, 96, 98, 99, 102, 103, 104, 105, 107, 109, 110, 111, 112, 113, 115, 117, 118, 119, 121, 122, 125, 126, 128, 129, 130, 131, 132, 133, 134, 135, 136, 138, 140, 141, 143, 144, 145, 146, 147, 148, 149, 150, 151, 152, 153, 154, 156, 157, 161, 162, 163, 164, 167, 168, 170, 171, 173, 174, 175, 180, 183, 184, 185, 193, 194, 195]"
agent_c,L100,short,125,60,65,10,0.375,200,"[2, 3, 4, 7, 8, 10, 11, 12, 13, 15, 16, 17, 18, 19, 20, 21, 22, 23, 24, 25, 26, 28, 29, 30, 33, 35, 36, 37, 40, 42, 44, 46, 47, 49, 54, 55, 57, 58, 60, 62, 63, 64, 65, 67, 68, 69, 70, 74, 76, 77, 78, 79, 80, 81, 82, 83, 87, 88, 89, 91, 92, 93, 94, 96, 98, 99, 100, 101, 102, 103, 104, 105, 110, 111, 113, 115, 116, 118, 119, 120, 121, 124, 125, 127, 129, 130, 131, 132, 133, 135, 136, 138, 139, 140, 144, 145, 146, 147, 148, 151, 152, 155, 156, 157, 160, 161, 163, 164, 167, 169, 170, 171, 173, 174, 175, 176, 178, 179, 180, 181, 183, 189, 191, 192, 193]"
agent_c,L100,short,127,65,62,9,0.365,200,"[0, 2, 3, 4, 6, 7, 8, 9, 10, 11, 14, 16, 18, 19, 20, 21, 23, 24, 25, 26, 27, 29, 30, 31, 33, 35, 36, 37, 38, 39, 40, 42, 43, 44, 45, 46, 47, 48, 49, 50, 52, 53, 54, 56, 57, 60, 64, 65, 66, 67, 68, 70, 72, 73, 75, 79, 81, 82, 83, 84, 85, 86, 87, 89, 90, 93, 94, 95, 96, 97, 98, 100, 101, 102, 103, 105, 106, 109, 111, 114, 116, 117, 118, 119, 120, 121, 122, 123, 126, 127, 133, 135, 136, 137, 138, 139, 140, 143, 144, 145, 147, 148, 150, 152, 153, 154, 155, 158, 159, 160, 161, 162, 163, 165, 166, 168, 170, 172, 176, 179, 180, 182, 188, 190, 191, 198, 199]"
agent_c,L100,short,122,58,64,7,0.39,200,"[0, 1, 2, 6, 7, 10, 12, 16, 17, 18, 20, 22, 23, 26, 27, 28, 32, 35, 36, 38, 39, 40, 41, 44, 46, 47, 48, 49, 50, 52, 53, 54, 55, 56, 57, 58, 59, 62, 64, 65, 67, 68, 69, 70, 71, 72, 73, 76, 77, 78, 81, 83, 84, 85, 86, 87, 90, 92, 94, 95, 96, 98, 100, 101, 103, 104, 106, 107, 108, 109, 110, 114, 115, 117, 119, 122, 123, 124, 125, 126, 128, 129, 130, 131, 133, 134, 136, 139, 140, 141, 142, 143, 144, 146, 147, 148, 149, 150, 154, 155, 156, 158, 159, 161, 162, 163, 164, 165, 166, 167, 170, 172, 174, 176, 177, 178, 180, 181, 188, 189, 190, 191]"
agent_c,L100,short,119,49,70,18,0.405,200,"[0, 1, 2, 3, 6, 7, 8, 9, 12, 13, 15, 19, 20, 21, 23, 26, 27, 28, 29, 30, 31, 33, 35, 38, 39, 44, 45, 46, 47, 51, 53, 54, 58, 59, 62, 63, 64, 65, 66, 67, 68, 70, 73, 75, 76, 78, 80, 81, 82, 83, 84, 85, 87, 90, 91, 92, 93, 96, 100, 101, 102, 103, 105, 107, 108, 110, 111, 112, 113, 114, 115, 117, 120, 122, 124, 125, 126, 127, 128, 129, 131, 132, 133, 134, 135, 136, 137, 139, 140, 141, 145, 146, 147, 148, 152, 153, 154, 155, 156, 158, 161, 165, 168, 169, 170, 172, 173, 174, 175, 177, 178, 181, 182, 183, 186, 190, 192, 193, 195]"
agent_c,L100,short,120,67,53,14,0.4,200,"[0, 1, 2, 3, 4, 6, 9, 11, 12, 13, 16, 18, 19, 21, 22, 23, 25, 26, 27, 30, 31, 32, 33, 34, 35, 38, 39, 40, 41, 43, 44, 45, 48, 49, 50, 52, 53, 54, 55, 56, 57, 60, 61, 62, 64, 66, 67, 68, 71, 73, 74, 75, 77, 78, 80, 83, 84, 86, 87, 88, 90, 91, 92, 94, 95, 97, 101, 102, 106, 107, 108, 109, 110, 111, 112, 113, 114, 116, 117, 118, 119, 120, 121, 123, 124, 129, 130, 131, 133, 134, 135, 136, 137, 138, 139, 140, 141, 144, 147, 148, 150, 152, 153, 156, 157, 158, 160, 162, 163, 169, 170, 175, 180, 183, 184, 186, 187, 192, 194, 198]"
agent_c,L100,short,120,54,66,2,0.4,200,"[0, 2, 3, 4, 6, 7, 8, 9, 10, 14, 15, 16, 17, 19, 20, 21, 24, 25, 26, 27, 32, 33, 35, 37, 38, 39, 40, 42, 45, 46, 48, 49, 50, 55, 56, 59, 61, 65, 66, 67, 68, 69, 70, 71, 73, 75, 78, 79, 80, 83, 85, 86, 88, 89, 90, 93, 95, 96, 97, 98, 99, 100, 101, 102, 103, 104, 105, 106, 109, 111, 113, 119, 120, 121, 122, 123, 125, 126, 128, 129, 131, 132, 133, 134, 135, 136, 137, 141, 143, 145, 147, 148, 150, 151, 153, 154, 157, 158, 160, 162, 163, 164, 166, 169, 170, 171, 172, 174, 176, 177, 179, 180, 183, 184, 185, 187, 191, 193, 194, 197]"
agent_c,L100,short,129,51,78,3,0.355,200,"[0, 1, 2, 3, 4, 5, 8, 9, 10, 11, 12, 13, 14, 16, 17, 19, 21, 22, 23, 24, 25, 26, 28, 30, 31, 32, 33, 34, 35, 36, 38, 39, 43, 45, 46, 47, 49, 51, 52, 54, 55, 56, 57, 58, 59, 61, 63, 65, 66, 67, 68, 70, 72, 73, 74, 75, 76, 77, 78, 81, 82, 84, 85, 86, 87, 88, 89, 90, 91, 92, 93, 94, 96, 97, 100, 102, 103, 104, 107, 108, 109, 110, 111, 113, 114, 117, 119, 121, 123, 124, 127, 128, 130, 132, 133, 136, 137, 138, 139, 141, 142, 143, 147, 148, 149, 151, 154, 156, 157, 159, 160, 163, 164, 167, 169, 170, 171, 172, 173, 174, 175, 176, 177, 185, 187, 195, 196, 197, 199]"
agent_c,L100,short,119,55,64,7,0.405,200,"[0, 1, 3, 4, 7, 9, 10, 13, 15, 16, 17, 21, 22, 24, 26, 27, 28, 29, 30, 31, 33, 34, 35, 37, 38, 39, 40, 41, 42, 43, 44, 45, 47, 48, 49, 50, 52, 53, 54, 57, 58, 59, 61, 62, 63, 64, 65, 66, 69, 70, 71, 73, 74, 77, 78, 81, 85, 86, 87, 88, 89, 92, 93, 95, 96, 97, 99, 100, 103, 104, 106, 107, 110, 111, 113, 114, 116, 119, 121, 124, 126, 129, 130, 131, 133, 134, 135, 136, 138, 140, 141, 142, 145, 146, 149, 151, 156, 158, 161, 163, 164, 166, 167, 168, 170, 171, 172, 173, 174, 175, 176, 177, 178, 183, 188, 189, 190, 192, 194]"
agent_c,L100,short,124,63,61,6,0.38,200,"[0, 1, 2, 3, 6, 7, 8, 9, 10, 11, 12, 14, 17, 21, 23, 25, 26, 30, 32, 33, 35, 38, 39, 40, 41, 42, 46, 47, 49, 52, 53, 54, 55, 57, 58, 59, 61, 62, 63, 64, 65, 66, 71, 72, 73, 75, 77, 78, 79, 80, 81, 82, 83, 85, 89, 92, 93, 95, 96, 97, 99, 100, 101, 103, 104, 105, 106, 107, 108, 109, 111, 112, 113, 114, 116, 117, 119, 124, 125, 126, 127, 128, 130, 131, 132, 133, 135, 136, 137, 138, 140, 142, 143, 144, 145, 148, 150, 151, 152, 155, 156, 157, 159, 161, 162, 164, 165, 166, 167, 168, 170, 171, 172, 174, 178, 180, 182, 183, 184, 185, 187, 194, 195, 197]"
agent_c,L100,short,130,74,56,7,0.35,200,"[0, 2, 5, 6, 9, 11, 12, 13, 14, 16, 17, 18, 20, 21, 23, 24, 25, 26, 28, 29, 30, 32, 34, 42, 43, 44, 45, 46, 49, 50, 51, 53, 55, 56, 58, 59, 60, 61, 62, 63, 64, 66, 67, 69, 71, 73, 74, 75, 76, 77, 79, 80, 82, 84, 85, 86, 87, 88, 89, 93, 94, 96, 97, 99, 102, 104, 105, 106, 107, 108, 109, 110, 114, 115, 117, 119, 120, 121, 123, 124, 125, 127, 130, 131, 132, 133, 135, 136, 137, 138, 139, 140, 141, 142, 144, 145, 146, 147, 150, 151, 152, 153, 154, 156, 157, 159, 160, 162, 163, 164, 165, 167, 168, 169, 170, 171, 172, 174, 175, 176, 181, 182, 183, 184, 185, 186, 194, 195, 196, 197]"
agent_c,L100,short,130,84,46,8,0.35,200,"[0, 1, 4, 5, 8, 9, 10, 11, 13, 17, 18, 19, 20, 21, 22, 23, 26, 27, 28, 29, 30, 31, 32, 34, 35, 36, 38, 40, 44, 45, 47, 48, 49, 52, 53, 54, 56, 57, 58, 60, 61, 63, 65, 66, 67, 69, 70, 71, 73, 74, 77, 79, 80, 81, 82, 84, 85, 86, 87, 88, 89, 90, 91, 95, 98, 99, 101, 102, 103, 104, 105, 106, 107, 109, 111, 112, 113, 114, 116, 119, 120, 121, 122, 123, 124, 125, 126, 127, 129, 130, 131, 132, 133, 134, 136, 137, 138, 140, 141, 142, 144, 147, 150, 151, 153, 155, 156, 157, 159, 160, 162, 164, 165, 166, 167, 168, 169, 171, 172, 176, 177, 178, 179, 180, 182, 183, 190, 191, 192, 193]"
agent_c,L100,short,121,45,76,7,0.395,200,"[0, 2, 3, 6, 7, 8, 9, 13, 15, 16, 17, 19, 20, 23, 24, 25, 26, 27, 29, 31, 32, 33, 35, 36, 37, 38, 40, 41, 43, 44, 45, 46, 47, 48, 52, 54, 56, 57, 58, 59, 60, 61, 62, 63, 65, 67, 69, 74, 75, 78, 79, 81, 82, 83, 84, 85, 86, 87, 88, 89, 90, 91, 93, 94, 96, 97, 98, 99, 103, 104, 107, 108, 111, 112, 113, 115, 118, 120, 121, 122, 123, 124, 127, 128, 130, 131, 132, 133, 134, 135, 138, 139, 142, 143, 144, 147, 149, 150, 151, 152, 153, 155, 157, 158, 159, 160, 161, 162, 164, 165, 167, 170, 171, 173, 174, 177, 178, 179, 184, 189, 195]"
agent_c,L100,short,131,73,58,9,0.345,200,"[0, 2, 3, 4, 5, 6, 8, 9, 11, 13, 14, 15, 16, 17, 18, 19, 23, 24, 25, 27, 28, 29, 32, 34, 35, 36, 37, 38, 40, 41, 42, 43, 45, 46, 47, 48, 50, 51, 52, 53, 54, 55, 56, 58, 59, 60, 61, 62, 63, 64, 67, 68, 69, 72, 74, 75, 76, 77, 79, 81, 82, 83, 86, 87, 89, 92, 93, 94, 95, 96, 97, 99, 100, 101, 103, 104, 105, 109, 110, 111, 113, 115, 116, 117, 121, 122, 123, 124, 125, 126, 127, 128, 131, 132, 133, 134, 135, 137, 138, 139, 140, 141, 143, 144, 146, 147, 152, 153, 155, 156, 159, 160, 162, 165, 167, 168, 170, 173, 174, 175, 180, 181, 182, 184, 185, 192, 193, 194, 195, 196, 197]"
agent_c,L100,short,119,52,67,8,0.405,200,"[1, 2, 4, 6, 8, 9, 10, 12, 14, 15, 16, 18, 19, 20, 22, 25, 26, 28, 30, 31, 33, 35, 37, 42, 43, 44, 46, 47, 50, 52, 54, 56, 57, 59, 61, 62, 63, 64, 67, 69, 71, 72, 73, 74, 75, 77, 79, 80, 81, 83, 85, 86, 89, 90, 91, 92, 94, 95, 96, 98, 103, 104, 105, 106, 107, 108, 111, 112, 113, 114, 117, 118, 119, 122, 123, 125, 126, 127, 128, 130, 134, 136, 137, 139, 140, 144, 146, 147, 150, 151, 152, 153, 154, 155, 156, 159, 160, 161, 162, 163, 164, 165, 166, 167, 169, 171, 172, 173, 176, 177, 181, 184, 186, 188, 190, 192, 196, 198, 199]"
agent_c,L100,short,126,59,67,3,0.37,200,"[1, 2, 3, 4, 5, 7, 9, 10, 11, 12, 13, 14, 15, 16, 17, 18, 20, 21, 23, 25, 26, 27, 28, 29, 30, 31, 32, 33, 36, 40, 41, 42, 43, 44, 45, 47, 48, 49, 50, 52, 53, 55, 57, 58, 59, 60, 63, 64, 65, 66, 67, 68, 69, 71, 72, 74, 75, 76, 79, 81, 84, 86, 87, 88, 90, 92, 93, 94, 96, 98, 99, 100, 101, 103, 105, 106, 110, 111, 112, 113, 115, 116, 118, 119, 121, 122, 123, 125, 126, 127, 128, 130, 131, 134, 135, 136, 137, 138, 139, 140, 143, 146, 147, 148, 149, 150, 152, 153, 155, 157, 158, 159, 162, 163, 166, 169, 172, 175, 176, 177, 179, 185, 186, 188, 189, 198]"
agent_c,L100,short,128,61,67,9,0.36,200,"[2, 3, 4, 5, 7, 13, 14, 15, 16, 17, 18, 19, 20, 21, 22, 23, 24, 26, 27, 28, 29, 30, 31, 32, 34, 35, 37, 38, 39, 42, 43, 44, 45, 46, 49, 54, 55, 56, 57, 58, 59, 61, 62, 63, 64, 65, 67, 68, 69, 72, 73, 74, 75, 76, 77, 78, 81, 82, 83, 84, 85, 87, 89, 90, 91, 92, 93, 95, 96, 97, 98, 99, 103, 104, 106, 109, 110, 111, 112, 113, 114, 115, 116, 117, 119, 120, 124, 125, 126, 127, 128, 129, 131, 132, 134, 135, 136, 139, 140, 142, 143, 144, 145, 147, 149, 152, 154, 156, 157, 158, 159, 161, 163, 164, 166, 167, 169, 170, 171, 174, 180, 181, 182, 189, 190, 191, 192, 193]"
agent_c,L100,short,121,66,55,10,0.395,200,"[1, 2, 3, 4, 5, 6, 8, 9, 11, 17, 19, 21, 23, 25, 26, 27, 29, 31, 33, 36, 37, 38, 39, 40, 43, 45, 46, 49, 50, 51, 53, 54, 57, 58, 59, 61, 63, 64, 66, 67, 69, 71, 73, 75, 76, 78, 79, 80, 81, 82, 85, 86, 87, 88, 89, 92, 93, 95, 96, 97, 105, 106, 107, 108, 109, 110, 112, 115, 116, 117, 118, 119, 120, 122, 123, 125, 126, 127, 128, 129, 130, 131, 132, 133, 135, 136, 138, 139, 140, 142, 143, 144, 146, 147, 148, 150, 151, 152, 154, 155, 156, 157, 161, 162, 163, 164, 170, 171, 173, 177, 178, 180, 182, 183, 184, 185, 188, 192, 193, 194, 196]"
agent_c,L100,short,121,49,72,16,0.395,200,"[0, 3, 6, 7, 9, 12, 13, 14, 16, 17, 18, 19, 22, 23, 26, 27, 28, 29, 33, 34, 35, 37, 38, 40, 45, 47, 48, 49, 50, 51, 52, 53, 54, 57, 58, 59, 62, 63, 66, 67, 68, 69, 72, 75, 78, 79, 80, 82, 83, 84, 85, 89, 90, 91, 92, 97, 98, 100, 101, 102, 103, 105, 107, 108, 109, 110, 113, 115, 116, 117, 121, 122, 123, 124, 125, 128, 129, 130, 131, 132, 133, 134, 135, 137, 138, 140, 141, 142, 143, 144, 146, 147, 148, 149, 152, 153, 154, 155, 156, 157, 158, 160, 161, 162, 163, 165, 166, 169, 171, 172, 174, 175, 178, 180, 181, 185, 186, 187, 188, 189, 193]"
agent_c,L100,short,124,72,52,16,0.38,200,"[0, 1, 2, 3, 4, 5, 7, 10, 14, 15, 16, 18, 19, 20, 22, 24, 25, 27, 28, 29, 31, 32, 34, 35, 37, 40, 41, 42, 45, 46, 47, 48, 49, 50, 56, 57, 58, 60, 61, 62, 64, 65, 66, 69, 70, 74, 75, 78, 79, 80, 81, 83, 84, 85, 86, 87, 88, 89, 90, 91, 92, 96, 99, 100, 101, 102, 103, 105, 106, 107, 109, 110, 111, 112, 114, 118, 119, 121, 122, 124, 126, 129, 131, 132, 133, 134, 135, 136, 141, 142, 143, 144, 145, 149, 151, 152, 154, 155, 160, 161, 162, 163, 164, 166, 167, 168, 169, 170, 173, 174, 175, 176, 177, 178, 179, 180, 181, 182, 187, 188, 189, 190, 192, 193]"
agent_c,L100,short,135,60,75,1,0.325,200,"[1, 2, 3, 4, 5, 6, 7, 8, 9, 11, 12, 13, 14, 15, 16, 18, 19, 20, 22, 23, 24, 25, 27, 28, 30, 31, 32, 34, 35, 36, 37, 41, 43, 44, 46, 47, 48, 49, 50, 52, 53, 54, 55, 56, 58, 60, 61, 62, 63, 64, 65, 66, 67, 69, 70, 71, 72, 73, 74, 75, 77, 79, 81, 83, 84, 85, 86, 87, 90, 91, 92, 93, 98, 99, 100, 101, 102, 103, 105, 106, 107, 108, 111, 112, 114, 115, 116, 117, 118, 119, 121, 122, 123, 124, 125, 126, 128, 129, 130, 132, 134, 135, 137, 138, 139, 140, 141, 143, 145, 146, 147, 148, 151, 152, 153, 155, 156, 159, 160, 163, 164, 165, 166, 167, 168, 170, 176, 177, 178, 179, 180, 181, 189, 190, 192]"
agent_c,L100,short,128,73,55,5,0.36,200,"[0, 1, 3, 4, 5, 6, 8, 10, 14, 17, 18, 19, 20, 21, 22, 24, 25, 26, 28, 31, 32, 33, 34, 36, 37, 38, 39, 40, 41, 43, 44, 45, 48, 49, 52, 53, 54, 57, 58, 60, 61, 63, 64, 66, 67, 68, 70, 71, 72, 73, 74, 75, 76, 77, 78, 80, 81, 82, 83, 85, 86, 87, 89, 91, 94, 95, 96, 99, 101, 103, 104, 105, 106, 107, 109, 110, 112, 114, 115, 116, 117, 118, 120, 121, 122, 124, 125, 126, 127, 128, 129, 130, 131, 132, 133, 134, 135, 136, 138, 139, 140, 142, 143, 144, 146, 149, 153, 154, 155, 156, 158, 159, 160, 161, 167, 168, 170, 173, 174, 175, 177, 178, 183, 185, 186, 187, 189, 199]"
agent_c,L100,short,123,61,62,13,0.385,200,"[0, 3, 5, 6, 8, 10, 11, 13, 18, 19, 22, 23, 24, 26, 27, 28, 29, 30, 31, 32, 33, 34, 35, 39, 42, 43, 44, 46, 47, 49, 50, 52, 53, 54, 56, 58, 59, 60, 61, 62, 63, 65, 66, 68, 69, 70, 71, 72, 73, 75, 76, 81, 82, 84, 85, 89, 90, 92, 93, 94, 95, 100, 101, 102, 103, 104, 107, 108, 109, 110, 111, 112, 113, 114, 115, 116, 117, 118, 119, 121, 122, 124, 125, 126, 129, 130, 131, 132, 133, 134, 137, 138, 139, 141, 142, 144, 147, 149, 151, 153, 154, 155, 156, 157, 158, 160, 161, 162, 163, 164, 165, 167, 170, 173, 176, 177, 179, 181, 182, 184, 190, 191, 194]"
agent_c,L100,short,127,64,63,8,0.365,200,"[0, 2, 3, 4, 5, 6, 11, 13, 15, 16, 18, 19, 20, 21, 22, 23, 26, 28, 29, 30, 31, 32, 33, 36, 37, 38, 39, 43, 44, 46, 49, 50, 52, 55, 56, 57, 58, 60, 62, 64, 66, 69, 72, 74, 75, 76, 77, 78, 81, 82, 83, 84, 85, 88, 89, 91, 92, 93, 94, 95, 96, 98, 99, 100, 104, 105, 106, 108, 109, 110, 112, 113, 114, 118, 119, 120, 121, 122, 124, 125, 126, 127, 128, 129, 130, 131, 132, 133, 134, 135, 136, 138, 139, 140, 141, 143, 144, 145, 146, 147, 148, 150, 152, 153, 154, 156, 157, 158, 160, 161, 163, 165, 166, 167, 169, 170, 174, 175, 179, 180, 181, 182, 183, 185, 194, 195, 197]"
agent_c,L100,short,116,60,56,12,0.42,200,"[0, 1, 3, 5, 7, 9, 11, 15, 16, 17, 19, 22, 24, 26, 27, 28, 29, 30, 33, 34, 35, 37, 39, 40, 41, 42, 43, 44, 46, 48, 50, 51, 52, 55, 56, 57, 58, 59, 60, 62, 64, 66, 68, 70, 71, 73, 74, 77, 78, 81, 83, 84, 85, 86, 90, 92, 94, 95, 96, 99, 101, 102, 104, 105, 106, 111, 116, 117, 118, 119, 120, 121, 125, 127, 129, 132, 134, 135, 137, 138, 139, 140, 141, 143, 145, 146, 150, 151, 152, 154, 158, 160, 161, 162, 165, 166, 167, 168, 170, 172, 173, 174, 176, 177, 178, 179, 180, 181, 182, 183, 184, 186, 193, 197, 198, 199]"
agent_c,L100,short,128,52,76,14,0.36,200,"[0, 1, 2, 5, 6, 9, 10, 11, 12, 13, 15, 20, 25, 26, 27, 28, 30, 31, 32, 34, 35, 36, 37, 38, 39, 41, 42, 45, 46, 47, 49, 50, 51, 55, 57, 58, 59, 60, 62, 63, 64, 67, 68, 69, 70, 71, 72, 79, 80, 83, 84, 85, 87, 88, 89, 90, 91, 93, 94, 95, 96, 98, 100, 101, 104, 105, 106, 107, 108, 109, 110, 111, 113, 114, 115, 117, 118, 119, 120, 121, 124, 127, 128, 129, 132, 133, 134, 135, 137, 138, 140, 141, 142, 143, 144, 145, 146, 147, 148, 149, 150, 151, 152, 154, 155, 156, 157, 158, 159, 162, 163, 164, 166, 168, 169, 170, 171, 172, 173, 176, 178, 179, 186, 187, 188, 189, 197, 198]"
agent_c,L100,short,128,75,53,6,0.36,200,"[1, 2, 3, 4, 6, 7, 8, 9, 10, 11, 13, 14, 15, 16, 17, 18, 19, 21, 23, 24, 25, 26, 29, 30, 31, 32, 34, 35, 37, 38, 39, 40, 41, 42, 43, 46, 47, 50, 51, 52, 53, 56, 57, 58, 60, 61, 62, 63, 64, 65, 67, 68, 69, 70, 72, 74, 76, 80, 81, 82, 83, 84, 85, 87, 88, 89, 90, 91, 92, 93, 95, 96, 98, 100, 101, 102, 103, 105, 106, 108, 110, 111, 113, 114, 115, 116, 118, 119, 120, 122, 123, 124, 125, 126, 127, 129, 131, 134, 135, 136, 137, 138, 139, 140, 141, 143, 144, 145, 147, 148, 149, 151, 152, 157, 160, 164, 166, 169, 170, 171, 173, 174, 175, 177, 185, 186, 194, 197]"
agent_c,L100,short,125,52,73,9,0.375,200,"[4, 6, 7, 10, 11, 12, 13, 14, 18, 19, 20, 21, 22, 23, 29, 30, 32, 37, 38, 39, 41, 44, 45, 47, 48, 49, 50, 51, 52, 53, 54, 57, 59, 60, 62, 64, 65, 66, 67, 68, 69, 70, 71, 73, 74, 75, 76, 78, 79, 80, 83, 84, 85, 87, 88, 89, 91, 92, 93, 94, 96, 98, 99, 100, 102, 103, 108, 109, 110, 111, 113, 114, 116, 118, 119, 120, 122, 123, 124, 125, 126, 127, 128, 129, 131, 132, 133, 134, 135, 137, 138, 139, 141, 142, 143, 144, 145, 148, 149, 152, 154, 155, 156, 157, 158, 159, 160, 161, 162, 163, 164, 165, 166, 167, 169, 170, 171, 173, 174, 175, 177, 186, 193, 195, 196]"
agent_c,L100,short,124,78,46,17,0.38,200,"[0, 1, 2, 3, 4, 5, 6, 8, 10, 12, 13, 15, 17, 18, 23, 24, 25, 27, 29, 31, 32, 34, 35, 36, 37, 38, 40, 41, 44, 45, 46, 47, 48, 50, 51, 52, 53, 54, 55, 58, 59, 62, 66, 68, 70, 71, 72, 73, 74, 77, 78, 79, 80, 81, 84, 87, 88, 89, 90, 91, 93, 94, 96, 100, 101, 102, 104, 106, 107, 109, 111, 112, 113, 114, 117, 118, 119, 120, 121, 122, 123, 124, 125, 127, 128, 129, 130, 131, 132, 133, 134, 135, 136, 137, 138, 141, 142, 143, 144, 146, 147, 148, 149, 151, 152, 153, 154, 155, 158, 159, 160, 163, 164, 165, 168, 169, 170, 171, 175, 177, 183, 186, 190, 197]"
agent_c,L100,short,131,72,59,4,0.345,200,"[0, 1, 2, 3, 4, 6, 7, 8, 9, 10, 11, 12, 13, 16, 17, 18, 19, 20, 21, 22, 23, 24, 25, 26, 27, 28, 29, 30, 31, 32, 34, 35, 36, 38, 39, 40, 42, 43, 44, 45, 46, 49, 50, 51, 53, 55, 56, 57, 58, 59, 61, 62, 66, 67, 68, 69, 70, 71, 72, 76, 78, 79, 83, 84, 85, 86, 87, 88, 89, 90, 91, 94, 95, 96, 97, 100, 101, 102, 103, 105, 106, 107, 110, 112, 113, 114, 115, 116, 117, 119, 122, 124, 125, 127, 129, 131, 133, 134, 135, 136, 137, 138, 140, 141, 142, 145, 146, 147, 148, 149, 150, 151, 152, 153, 156, 157, 159, 161, 163, 165, 166, 167, 173, 175, 176, 177, 185, 187, 196, 197, 199]"
agent_c,L100,short,124,55,69,13,0.38,200,"[0, 1, 2, 3, 4, 5, 6, 7, 9, 11, 14, 15, 16, 18, 19, 20, 21, 24, 25, 27, 29, 30, 31, 32, 33, 35, 36, 38, 39, 40, 41, 42, 44, 45, 46, 48, 49, 50, 53, 55, 57, 58, 60, 65, 66, 70, 72, 73, 74, 75, 76, 77, 79, 80, 82, 84, 85, 86, 87, 88, 89, 91, 92, 93, 94, 96, 97, 98, 99, 101, 103, 105, 106, 107, 108, 109, 111, 114, 115, 116, 117, 119, 120, 121, 127, 128, 129, 133, 138, 139, 141, 142, 143, 144, 147, 148, 149, 150, 152, 156, 157, 159, 161, 162, 163, 166, 168, 169, 171, 172, 173, 174, 175, 176, 177, 178, 179, 181, 185, 186, 187, 188, 191, 199]"
agent_c,L100,short,121,55,66,7,0.395,200,"[2, 3, 4, 5, 7, 9, 10, 11, 12, 14, 15, 16, 17, 18, 20, 21, 22, 23, 24, 25, 26, 27, 29, 30, 31, 33, 34, 37, 43, 44, 45, 47, 48, 52, 53, 55, 56, 57, 58, 61, 62, 63, 67, 68, 69, 70, 73, 75, 76, 78, 79, 80, 82, 86, 87, 89, 90, 91, 94, 96, 98, 99, 100, 101, 102, 105, 107, 108, 109, 110, 112, 113, 114, 115, 116, 117, 119, 120, 121, 122, 123, 126, 129, 130, 131, 132, 134, 135, 136, 137, 138, 141, 142, 143, 145, 146, 147, 148, 150, 151, 153, 157, 158, 159, 160, 161, 163, 165, 168, 172, 175, 176, 177, 179, 180, 182, 186, 188, 189, 190, 193]"
agent_c,L100,short,126,53,73,10,0.37,200,"[0, 1, 2, 4, 7, 8, 9, 11, 13, 14, 15, 16, 17, 18, 19, 20, 21, 22, 23, 24, 25, 26, 29, 32, 34, 35, 37, 38, 39, 41, 43, 44, 45, 46, 49, 50, 51, 52, 53, 54, 55, 57, 59, 61, 62, 64, 66, 68, 70, 71, 72, 75, 77, 79, 80, 81, 82, 83, 84, 85, 86, 89, 91, 97, 98, 100, 101, 102, 103, 104, 105, 106, 109, 110, 111, 113, 114, 115, 116, 117, 119, 120, 126, 127, 131, 134, 135, 136, 137, 139, 140, 141, 143, 144, 145, 146, 147, 148, 149, 150, 154, 155, 157, 162, 164, 166, 168, 169, 171, 173, 174, 175, 177, 178, 181, 182, 183, 185, 186, 187, 189, 195, 196, 197, 198, 199]"
agent_c,L100,short,130,62,68,5,0.35,200,"[0, 1, 5, 6, 8, 9, 10, 11, 12, 16, 17, 18, 20, 21, 22, 23, 24, 25, 26, 27, 28, 31, 32, 33, 34, 35, 37, 38, 39, 40, 41, 43, 44, 45, 46, 48, 49, 52, 53, 54, 55, 57, 58, 59, 60, 61, 62, 65, 66, 67, 68, 70, 71, 72, 73, 74, 75, 76, 77, 78, 79, 80, 81, 84, 86, 87, 88, 89, 90, 92, 94, 97, 98, 101, 103, 105, 106, 108, 111, 114, 115, 116, 117, 118, 119, 121, 123, 124, 125, 126, 127, 128, 129, 130, 131, 132, 133, 134, 135, 139, 141, 142, 144, 148, 149, 151, 152, 153, 155, 157, 158, 161, 163, 165, 167, 169, 170, 172, 173, 174, 176, 177, 181, 182, 185, 186, 187, 196, 198, 199]"
agent_c,L100,short,120,55,65,10,0.4,200,"[0, 3, 4, 6, 7, 9, 12, 14, 15, 16, 17, 19, 20, 25, 27, 28, 31, 32, 34, 35, 37, 40, 43, 44, 47, 49, 51, 54, 55, 56, 57, 58, 61, 62, 63, 65, 66, 67, 68, 69, 70, 71, 72, 73, 75, 76, 78, 80, 81, 82, 83, 86, 88, 89, 90, 92, 94, 96, 97, 99, 100, 102, 104, 105, 109, 110, 113, 114, 115, 116, 118, 119, 121, 123, 124, 129, 130, 131, 132, 133, 134, 135, 136, 137, 138, 139, 140, 143, 144, 147, 148, 149, 150, 151, 152, 153, 155, 157, 158, 159, 161, 166, 167, 168, 169, 170, 172, 174, 176, 178, 179, 180, 181, 182, 183, 188, 189, 190, 192, 193]"
agent_c,L100,short,128,59,69,6,0.36,200,"[0, 1, 2, 4, 5, 6, 9, 11, 12, 13, 16, 21, 22, 23, 27, 28, 29, 31, 32, 33, 34, 35, 36, 37, 38, 39, 41, 42, 44, 45, 46, 47, 48, 49, 51, 52, 53, 54, 55, 56, 57, 58, 59, 60, 61, 63, 67, 70, 71, 72, 73, 74, 76, 77, 78, 80, 81, 82, 83, 84, 86, 88, 89, 92, 93, 94, 97, 98, 99, 100, 102, 103, 106, 108, 109, 110, 111, 112, 113, 114, 115, 116, 117, 118, 119, 123, 124, 126, 127, 129, 130, 131, 134, 135, 139, 143, 144, 145, 148, 149, 150, 152, 154, 155, 160, 162, 163, 164, 165, 166, 167, 169, 170, 171, 173, 174, 175, 176, 181, 182, 183, 184, 185, 186, 194, 195, 196, 197]"
agent_c,L100,short,123,45,78,3,0.385,200,"[0, 1, 2, 3, 6, 7, 8, 9, 11, 12, 13, 15, 16, 17, 18, 19, 20, 22, 23, 27, 28, 30, 31, 33, 35, 39, 40, 42, 43, 45, 46, 48, 49, 50, 53, 54, 57, 59, 60, 61, 63, 64, 66, 67, 74, 76, 78, 79, 81, 82, 83, 85, 86, 87, 88, 89, 90, 92, 94, 96, 98, 99, 100, 102, 103, 104, 105, 108, 109, 111, 112, 113, 114, 115, 116, 117, 118, 119, 120, 122, 124, 126, 128, 129, 130, 131, 132, 133, 134, 136, 137, 138, 139, 141, 142, 144, 146, 148, 149, 150, 153, 155, 156, 157, 158, 159, 163, 164, 166, 168, 169, 171, 173, 174, 176, 178, 179, 180, 185, 186, 187, 188, 191]"
agent_c,L100,short,118,53,65,7,0.41,200,"[1, 2, 4, 5, 6, 7, 8, 9, 10, 11, 12, 13, 15, 18, 19, 21, 22, 23, 24, 25, 26, 27, 28, 29, 31, 34, 35, 36, 39, 41, 43, 44, 45, 46, 49, 50, 52, 53, 54, 55, 56, 58, 59, 61, 62, 63, 64, 65, 66, 69, 71, 72, 73, 74, 75, 77, 83, 84, 87, 89, 90, 91, 92, 93, 96, 98, 99, 103, 105, 107, 108, 111, 114, 116, 117, 120, 121, 123, 124, 125, 126, 127, 131, 132, 134, 136, 139, 142, 143, 144, 145, 146, 148, 150, 152, 153, 154, 156, 159, 160, 162, 164, 166, 168, 169, 170, 172, 175, 176, 177, 178, 179, 181, 183, 184, 186, 192, 198]"
agent_c,L100,short,127,59,68,9,0.365,200,"[0, 1, 2, 3, 4, 5, 6, 9, 10, 11, 12, 13, 14, 17, 18, 19, 20, 21, 23, 26, 27, 28, 29, 30, 32, 33, 35, 36, 37, 38, 40, 43, 44, 46, 47, 50, 51, 52, 55, 56, 57, 58, 60, 64, 65, 66, 67, 72, 73, 76, 78, 80, 81, 83, 84, 85, 86, 87, 89, 95, 96, 99, 103, 104, 105, 107, 108, 109, 111, 112, 113, 114, 115, 116, 117, 118, 119, 120, 121, 122, 123, 126, 128, 129, 130, 131, 132, 133, 135, 136, 137, 138, 139, 140, 141, 142, 143, 144, 145, 147, 148, 151, 154, 155, 156, 158, 159, 160, 163, 166, 167, 168, 169, 171, 172, 173, 175, 177, 178, 181, 186, 188, 189, 190, 197, 198, 199]"
agent_c,L100,short,123,58,65,10,0.385,200,"[1, 2, 3, 4, 6, 7, 8, 9, 10, 11, 13, 15, 16, 19, 20, 21, 23, 24, 25, 26, 27, 32, 33, 34, 35, 36, 38, 41, 44, 45, 46, 47, 48, 50, 51, 52, 53, 54, 55, 56, 58, 60, 61, 62, 66, 69, 70, 71, 72, 73, 75, 76, 79, 80, 83, 87, 88, 89, 90, 93, 94, 96, 97, 98, 99, 100, 101, 102, 103, 104, 106, 108, 109, 113, 114, 115, 117, 120, 124, 126, 128, 131, 135, 137, 139, 140, 142, 144, 145, 146, 147, 149, 150, 151, 152, 153, 154, 155, 156, 159, 160, 161, 162, 163, 165, 166, 167, 168, 170, 171, 173, 174, 176, 180, 181, 184, 185, 186, 192, 193, 194, 195, 197]"
agent_c,L100,short,126,71,55,8,0.37,200,"[0, 2, 3, 4, 5, 6, 7, 8, 9, 10, 12, 14, 15, 16, 17, 18, 19, 20, 21, 23, 24, 25, 26, 27, 28, 29, 31, 32, 33, 35, 36, 37, 38, 40, 41, 43, 45, 46, 47, 49, 53, 54, 56, 58, 59, 61, 62, 65, 66, 67, 68, 70, 71, 73, 74, 75, 77, 78, 82, 83, 85, 90, 91, 92, 93, 94, 96, 97, 100, 101, 103, 104, 105, 107, 108, 110, 112, 114, 115, 116, 117, 118, 120, 123, 124, 127, 128, 129, 130, 131, 132, 134, 135, 136, 138, 139, 140, 142, 143, 144, 145, 147, 148, 149, 150, 152, 153, 154, 156, 157, 158, 159, 160, 161, 162, 164, 166, 167, 168, 170, 173, 178, 180, 181, 187, 192]"
agent_c,L100,short,127,64,63,7,0.365,200,"[0, 3, 4, 7, 8, 9, 10, 11, 12, 14, 15, 16, 18, 19, 20, 21, 23, 25, 26, 27, 30, 31, 32, 33, 34, 35, 37, 38, 39, 40, 41, 43, 45, 46, 47, 50, 51, 55, 56, 57, 58, 59, 60, 61, 63, 65, 66, 67, 68, 72, 73, 74, 78, 79, 82, 84, 88, 90, 91, 92, 93, 94, 95, 97, 98, 99, 100, 101, 103, 104, 106, 111, 113, 115, 116, 117, 118, 119, 120, 121, 122, 123, 124, 125, 126, 128, 129, 130, 133, 134, 135, 138, 139, 144, 147, 148, 149, 152, 154, 155, 157, 158, 159, 160, 161, 162, 163, 164, 165, 166, 168, 170, 172, 173, 174, 175, 176, 178, 179, 180, 185, 186, 188, 190, 197, 198, 199]"
agent_c,L100,short,122,60,62,13,0.39,200,"[1, 3, 6, 7, 8, 9, 10, 13, 14, 15, 17, 18, 20, 23, 24, 25, 26, 28, 30, 31, 32, 33, 34, 36, 39, 40, 42, 45, 47, 48, 49, 51, 52, 53, 55, 56, 58, 59, 61, 62, 63, 64, 65, 66, 67, 68, 69, 70, 71, 72, 73, 75, 76, 77, 78, 81, 82, 83, 85, 89, 91, 93, 94, 95, 97, 98, 99, 100, 101, 102, 105, 106, 108, 111, 112, 113, 114, 115, 116, 119, 120, 121, 122, 123, 125, 128, 130, 131, 132, 133, 136, 140, 143, 144, 145, 146, 147, 152, 155, 159, 160, 161, 162, 163, 164, 165, 166, 167, 169, 171, 173, 175, 178, 181, 182, 183, 184, 188, 189, 190, 198, 199]"
agent_c,L100,short,125,58,67,12,0.375,200,"[0, 2, 4, 7, 8, 14, 15, 18, 20, 21, 24, 25, 26, 27, 28, 29, 30, 31, 32, 33, 34, 36, 37, 38, 39, 40, 41, 42, 44, 47, 48, 49, 50, 51, 52, 54, 57, 59, 60, 61, 62, 65, 67, 68, 69, 70, 71, 72, 73, 74, 76, 79, 80, 82, 83, 84, 88, 90, 91, 92, 93, 94, 96, 97, 98, 99, 101, 104, 105, 106, 107, 108, 110, 111, 114, 115, 117, 118, 119, 120, 121, 123, 124, 126, 127, 128, 129, 131, 136, 137, 138, 140, 142, 144, 145, 146, 147, 148, 149, 152, 154, 158, 160, 161, 162, 163, 164, 166, 167, 168, 169, 171, 173, 175, 178, 179, 180, 181, 182, 184, 186, 192, 193, 194, 196]"
agent_c,L100,short,124,58,66,8,0.38,200,"[1, 2, 3, 4, 6, 7, 9, 13, 14, 17, 18, 19, 20, 22, 25, 28, 30, 31, 32, 33, 35, 36, 37, 38, 39, 41, 43, 44, 45, 46, 47, 50, 51, 52, 53, 54, 56, 57, 61, 62, 63, 64, 65, 67, 70, 71, 72, 74, 75, 76, 77, 78, 79, 81, 82, 83, 84, 87, 88, 89, 90, 91, 92, 93, 94, 95, 97, 99, 100, 105, 106, 107, 108, 109, 110, 111, 112, 114, 116, 117, 119, 120, 122, 123, 124, 125, 126, 127, 129, 130, 132, 133, 134, 135, 136, 138, 140, 141, 145, 147, 148, 149, 150, 154, 156, 159, 160, 164, 167, 168, 170, 171, 172, 173, 174, 178, 182, 185, 187, 188, 194, 195, 196, 197]"
agent_c,L100,short,123,52,71,16,0.385,200,"[1, 2, 3, 5, 6, 8, 10, 11, 12, 13, 15, 22, 23, 25, 26, 27, 28, 29, 30, 31, 32, 33, 34, 35, 36, 37, 38, 39, 41, 42, 43, 45, 46, 49, 51, 52, 53, 54, 56, 57, 60, 63, 65, 66, 67, 68, 69, 72, 74, 76, 79, 80, 81, 82, 83, 85, 87, 88, 89, 90, 91, 92, 93, 94, 95, 99, 108, 110, 112, 114, 115, 117, 118, 120, 121, 122, 123, 124, 125, 128, 129, 130, 132, 133, 135, 138, 139, 140, 141, 143, 144, 145, 147, 148, 149, 150, 152, 153, 154, 155, 158, 159, 161, 165, 166, 167, 168, 169, 170, 171, 173, 174, 175, 176, 180, 181, 182, 187, 188, 189, 190, 191, 193]"
agent_c,L100,short,122,80,42,6,0.39,200,"[0, 1, 4, 6, 7, 8, 9, 10, 12, 14, 16, 18, 20, 21, 22, 23, 24, 26, 29, 30, 31, 32, 35, 37, 39, 40, 41, 42, 43, 45, 46, 51, 54, 57, 58, 59, 60, 61, 62, 63, 64, 65, 66, 67, 70, 73, 74, 75, 76, 78, 79, 81, 84, 85, 86, 87, 88, 90, 93, 94, 95, 96, 97, 99, 100, 101, 104, 108, 109, 110, 111, 115, 116, 120, 122, 123, 124, 126, 128, 129, 132, 133, 135, 139, 140, 141, 142, 143, 144, 145, 146, 148, 149, 150, 153, 155, 156, 157, 159, 160, 162, 163, 164, 165, 167, 168, 169, 170, 172, 173, 175, 177, 178, 180, 183, 184, 185, 186, 187, 188, 189, 194]"
agent_c,L100,short,128,78,50,7,0.36,200,"[0, 1, 2, 4, 5, 6, 7, 9, 10, 11, 14, 15, 16, 17, 19, 20, 22, 24, 25, 26, 27, 28, 32, 33, 36, 37, 38, 39, 41, 42, 45, 47, 48, 49, 51, 52, 53, 55, 56, 58, 59, 61, 62, 63, 64, 65, 66, 70, 71, 72, 75, 76, 77, 78, 79, 80, 81, 83, 84, 85, 86, 88, 91, 92, 95, 97, 99, 101, 103, 104, 105, 106, 108, 109, 110, 112, 113, 115, 116, 117, 120, 121, 122, 123, 124, 126, 128, 130, 132, 134, 136, 137, 138, 140, 141, 143, 144, 145, 146, 148, 149, 150, 151, 152, 153, 156, 158, 160, 162, 163, 164, 165, 168, 170, 171, 172, 174, 175, 176, 178, 179, 185, 186, 187, 189, 197, 198, 199]"
agent_c,L100,short,129,68,61,10,0.355,200,"[0, 1, 3, 4, 5, 6, 9, 11, 12, 14, 15, 17, 18, 20, 21, 23, 24, 26, 27, 28, 30, 31, 33, 34, 35, 36, 37, 39, 40, 42, 43, 45, 46, 48, 49, 50, 52, 53, 54, 55, 56, 57, 58, 59, 60, 61, 62, 63, 64, 70, 73, 74, 75, 76, 77, 78, 79, 80, 82, 83, 85, 86, 87, 89, 90, 91, 94, 95, 97, 99, 100, 101, 102, 103, 104, 106, 107, 108, 111, 114, 115, 117, 118, 119, 120, 123, 128, 129, 131, 132, 134, 135, 136, 140, 141, 143, 144, 145, 146, 148, 149, 150, 151, 152, 154, 155, 156, 158, 159, 160, 162, 163, 164, 165, 167, 168, 170, 171, 172, 173, 174, 175, 177, 178, 179, 182, 190, 191, 192]"
agent_c,L100,short,133,57,76,3,0.335,200,"[0, 1, 2, 3, 5, 6, 8, 9, 10, 11, 12, 13, 14, 16, 17, 18, 19, 20, 23, 27, 28, 29, 30, 31, 32, 33, 34, 36, 37, 39, 40, 41, 43, 44, 45, 46, 47, 48, 51, 53, 56, 58, 59, 60, 61, 62, 63, 65, 66, 67, 69, 70, 71, 72, 74, 76, 77, 78, 79, 80, 81, 82, 84, 85, 87, 88, 91, 92, 94, 95, 97, 98, 99, 100, 101, 102, 103, 104, 105, 108, 110, 111, 113, 114, 115, 117, 119, 120, 123, 124, 125, 126, 127, 129, 132, 133, 134, 135, 137, 140, 141, 142, 143, 144, 145, 147, 148, 149, 150, 152, 153, 154, 155, 158, 159, 160, 161, 162, 163, 164, 165, 168, 169, 172, 173, 175, 182, 185, 186, 188, 197, 198, 199]"
agent_c,L100,short,132,57,75,9,0.34,200,"[0, 1, 2, 3, 5, 6, 8, 9, 10, 11, 12, 14, 15, 18, 19, 20, 23, 24, 25, 26, 27, 28, 30, 31, 32, 33, 35, 37, 38, 40, 41, 42, 43, 44, 46, 49, 50, 51, 52, 53, 54, 57, 59, 60, 61, 62, 63, 64, 65, 67, 68, 69, 70, 71, 72, 73, 76, 79, 80, 82, 83, 84, 85, 86, 87, 89, 91, 93, 94, 95, 96, 97, 99, 100, 102, 103, 104, 105, 107, 108, 109, 110, 111, 112, 114, 115, 116, 118, 119, 120, 122, 125, 127, 129, 130, 131, 132, 134, 135, 136, 137, 140, 141, 142, 144, 145, 147, 150, 151, 152, 153, 156, 158, 160, 162, 163, 164, 165, 169, 170, 171, 172, 173, 174, 175, 176, 178, 184, 185, 186, 188, 198]"
agent_c,L100,short,124,74,50,15,0.38,200,"[1, 2, 3, 4, 5, 6, 9, 11, 13, 14, 16, 18, 19, 22, 24, 25, 32, 33, 34, 36, 37, 42, 43, 45, 46, 47, 48, 49, 53, 54, 55, 59, 60, 63, 64, 65, 69, 70, 71, 72, 73, 74, 75, 76, 77, 78, 79, 82, 83, 84, 85, 86, 87, 88, 89, 92, 93, 94, 96, 97, 98, 99, 100, 101, 103, 104, 108, 110, 111, 112, 113, 114, 115, 118, 119, 120, 121, 122, 123, 124, 125, 127, 129, 130, 131, 132, 133, 134, 136, 137, 138, 139, 140, 141, 142, 143, 144, 145, 146, 147, 148, 149, 150, 151, 152, 154, 155, 156, 159, 162, 164, 168, 169, 170, 171, 172, 173, 174, 175, 177, 179, 186, 189, 198]"
agent_c,L100,short,133,62,71,8,0.335,200,"[0, 1, 2, 4, 5, 7, 9, 10, 11, 12, 13, 14, 15, 16, 18, 19, 20, 22, 24, 25, 27, 28, 30, 33, 34, 36, 37, 38, 39, 40, 41, 42, 45, 47, 48, 50, 51, 52, 53, 55, 56, 58, 60, 61, 62, 63, 64, 65, 67, 68, 71, 72, 74, 75, 76, 77, 78, 80, 81, 83, 84, 86, 87, 88, 89, 90, 91, 92, 93, 96, 97, 99, 100, 101, 102, 103, 105, 106, 107, 108, 109, 110, 111, 112, 113, 115, 116, 118, 119, 120, 121, 123, 125, 127, 130, 131, 134, 135, 137, 138, 139, 140, 141, 142, 143, 145, 146, 147, 148, 149, 150, 152, 154, 158, 159, 160, 161, 163, 165, 166, 168, 169, 170, 171, 172, 173, 180, 181, 182, 183, 184, 194, 196]"
agent_c,L100,short,126,74,52,16,0.37,200,"[0, 2, 4, 6, 8, 12, 13, 15, 16, 18, 20, 21, 22, 23, 26, 27, 29, 31, 32, 33, 34, 35, 36, 37, 38, 39, 40, 41, 43, 44, 47, 48, 49, 50, 51, 52, 53, 55, 56, 57, 59, 60, 61, 62, 63, 64, 67, 69, 70, 73, 74, 75, 77, 78, 79, 80, 81, 82, 87, 89, 93, 95, 97, 99, 100, 101, 102, 103, 104, 105, 106, 107, 108, 109, 110, 111, 112, 113, 114, 115, 116, 120, 124, 125, 127, 128, 129, 130, 131, 132, 133, 135, 136, 137, 138, 139, 140, 142, 143, 144, 145, 148, 151, 152, 153, 154, 155, 156, 157, 158, 159, 161, 162, 165, 168, 169, 170, 174, 175, 176, 177, 178, 179, 181, 189, 190]"
agent_c,L100,short,125,84,41,15,0.375,200,"[1, 2, 4, 5, 7, 10, 11, 12, 13, 14, 15, 16, 17, 18, 21, 23, 25, 26, 28, 29, 31, 33, 34, 36, 37, 38, 40, 41, 42, 44, 45, 46, 47, 49, 50, 51, 52, 53, 54, 55, 56, 58, 59, 61, 62, 64, 65, 67, 68, 69, 70, 71, 72, 73, 74, 76, 79, 81, 82, 83, 85, 86, 87, 88, 89, 90, 91, 92, 93, 98, 99, 100, 102, 103, 104, 105, 106, 108, 111, 115, 116, 117, 118, 119, 121, 122, 124, 125, 127, 128, 129, 131, 133, 137, 138, 139, 140, 141, 142, 143, 145, 148, 149, 152, 153, 154, 159, 160, 161, 163, 164, 166, 168, 169, 170, 173, 174, 175, 176, 183, 184, 185, 188, 196, 199]"
agent_c,L100,short,124,69,55,12,0.38,200,"[1, 2, 4, 5, 6, 7, 8, 9, 10, 14, 15, 16, 17, 19, 20, 21, 22, 23, 24, 25, 26, 27, 28, 29, 31, 33, 34, 36, 37, 41, 42, 43, 44, 45, 46, 50, 52, 53, 54, 55, 56, 58, 59, 61, 62, 63, 64, 65, 70, 71, 72, 76, 77, 80, 81, 82, 84, 85, 86, 88, 90, 91, 92, 93, 95, 97, 98, 102, 103, 105, 106, 107, 108, 110, 113, 118, 119, 121, 123, 124, 125, 127, 128, 129, 130, 131, 132, 133, 140, 141, 146, 147, 148, 149, 150, 152, 155, 156, 158, 159, 161, 162, 163, 164, 166, 167, 168, 171, 172, 173, 174, 176, 177, 178, 179, 180, 181, 182, 187, 188, 189, 191, 192, 199]"
agent_c,L100,short,128,55,73,10,0.36,200,"[1, 2, 3, 5, 6, 7, 8, 9, 10, 12, 13, 15, 16, 17, 18, 19, 20, 21, 23, 24, 25, 27, 28, 29, 30, 33, 34, 35, 37, 39, 40, 41, 42, 45, 47, 48, 49, 50, 51, 54, 55, 56, 58, 60, 61, 63, 64, 65, 66, 67, 71, 72, 73, 74, 77, 78, 79, 80, 81, 82, 85, 86, 88, 90, 91, 92, 93, 94, 98, 100, 101, 102, 103, 104, 105, 106, 107, 109, 110, 111, 112, 113, 115, 116, 121, 123, 124, 125, 126, 127, 128, 129, 131, 132, 134, 135, 136, 137, 139, 140, 142, 144, 145, 146, 148, 150, 151, 153, 154, 156, 157, 159, 161, 164, 165, 166, 167, 168, 169, 170, 174, 176, 178, 179, 180, 183, 191, 193]"
agent_c,L100,short,133,55,78,5,0.335,200,"[0, 1, 3, 5, 7, 8, 9, 10, 11, 13, 14, 15, 16, 17, 20, 21, 22, 23, 24, 26, 28, 29, 30, 31, 32, 33, 34, 35, 36, 37, 38, 39, 40, 41, 43, 45, 46, 47, 48, 49, 50, 53, 54, 55, 57, 58, 60, 61, 62, 64, 65, 66, 69, 70, 71, 72, 73, 74, 76, 78, 79, 80, 81, 82, 83, 84, 85, 87, 88, 89, 90, 91, 92, 93, 95, 96, 98, 99, 102, 103, 106, 107, 108, 110, 111, 112, 113, 114, 116, 120, 121, 122, 123, 124, 125, 126, 127, 130, 131, 132, 134, 135, 136, 137, 138, 139, 141, 142, 143, 144, 146, 147, 149, 150, 152, 153, 154, 156, 157, 158, 159, 160, 167, 169, 170, 175, 176, 177, 179, 180, 181, 182, 192]"
agent_c,L100,short,127,68,59,4,0.365,200,"[0, 2, 3, 4, 6, 8, 9, 11, 12, 14, 15, 16, 21, 23, 24, 25, 26, 27, 28, 29, 31, 32, 33, 34, 37, 38, 39, 40, 41, 42, 44, 45, 47, 48, 49, 51, 52, 53, 54, 56, 58, 59, 61, 62, 65, 66, 70, 71, 74, 76, 77, 78, 79, 81, 82, 83, 84, 85, 88, 89, 90, 91, 93, 94, 96, 97, 102, 104, 105, 106, 107, 108, 109, 110, 111, 112, 113, 115, 116, 117, 118, 119, 120, 123, 124, 125, 126, 127, 128, 129, 132, 133, 134, 135, 136, 137, 138, 139, 141, 143, 144, 146, 147, 148, 149, 154, 155, 157, 158, 160, 161, 162, 164, 165, 166, 168, 169, 171, 173, 174, 175, 181, 182, 185, 192, 194, 195]"
agent_c,L100,short,125,50,75,5,0.375,200,"[0, 3, 4, 6, 7, 8, 9, 10, 12, 13, 14, 15, 17, 18, 20, 21, 22, 25, 28, 29, 31, 32, 35, 36, 37, 40, 41, 42, 43, 45, 48, 49, 50, 51, 52, 54, 58, 59, 61, 62, 65, 66, 69, 70, 71, 73, 74, 77, 79, 80, 82, 84, 85, 88, 91, 93, 94, 95, 96, 97, 98, 99, 101, 104, 106, 107, 108, 110, 114, 115, 117, 120, 121, 124, 126, 127, 128, 129, 131, 132, 133, 135, 136, 137, 138, 141, 143, 144, 145, 147, 148, 149, 151, 152, 153, 154, 155, 156, 157, 158, 159, 160, 162, 163, 164, 166, 167, 169, 170, 171, 173, 174, 176, 177, 178, 179, 180, 185, 186, 187, 188, 189, 190, 198, 199]"
agent_c,L100,short,116,50,66,17,0.42,200,"[0, 1, 2, 5, 6, 9, 13, 15, 17, 18, 20, 21, 22, 25, 26, 30, 31, 32, 33, 35, 36, 38, 42, 43, 44, 45, 47, 50, 51, 52, 54, 56, 59, 61, 62, 64, 67, 68, 71, 73, 74, 75, 77, 78, 79, 80, 83, 85, 86, 90, 91, 93, 94, 96, 97, 99, 102, 104, 105, 106, 107, 108, 109, 113, 114, 115, 118, 119, 120, 121, 122, 123, 124, 126, 127, 129, 130, 131, 132, 133, 135, 136, 139, 142, 143, 144, 145, 147, 148, 149, 151, 152, 153, 154, 157, 158, 159, 160, 163, 165, 166, 167, 168, 170, 172, 174, 175, 176, 178, 179, 181, 182, 186, 187, 188, 195]"
agent_c,L100,short,125,39,86,7,0.375,200,"[0, 2, 4, 5, 6, 9, 10, 11, 12, 13, 15, 18, 19, 20, 21, 22, 28, 29, 31, 34, 35, 36, 37, 40, 41, 42, 43, 45, 46, 47, 48, 49, 50, 51, 52, 57, 58, 59, 60, 62, 66, 67, 68, 69, 71, 75, 76, 77, 78, 79, 80, 81, 82, 83, 84, 85, 86, 88, 89, 90, 91, 93, 95, 96, 100, 102, 103, 104, 107, 108, 109, 110, 111, 112, 113, 114, 116, 119, 121, 122, 123, 124, 125, 127, 128, 129, 131, 133, 134, 135, 136, 137, 138, 139, 140, 141, 143, 144, 145, 147, 148, 149, 150, 151, 153, 154, 156, 158, 160, 163, 167, 170, 171, 172, 173, 175, 176, 179, 184, 185, 186, 187, 194, 197, 198]"
agent_c,L100,short,127,79,48,10,0.365,200,"[0, 1, 2, 5, 6, 7, 9, 10, 13, 14, 15, 17, 18, 19, 21, 22, 23, 24, 25, 26, 27, 28, 29, 31, 33, 34, 35, 37, 39, 40, 41, 42, 43, 44, 46, 47, 48, 49, 50, 52, 54, 55, 56, 57, 59, 61, 64, 67, 68, 69, 71, 73, 74, 76, 77, 79, 80, 81, 83, 84, 89, 90, 91, 92, 93, 94, 95, 96, 97, 98, 99, 100, 101, 103, 105, 107, 108, 109, 110, 111, 112, 113, 114, 115, 116, 118, 122, 123, 125, 126, 127, 128, 130, 134, 135, 136, 137, 138, 139, 143, 148, 149, 150, 151, 154, 156, 157, 159, 160, 162, 164, 165, 166, 169, 171, 172, 173, 174, 178, 184, 185, 186, 192, 193, 194, 195, 196]"
agent_c,L100,short,126,83,43,8,0.37,200,"[2, 3, 4, 6, 7, 9, 11, 12, 13, 14, 15, 16, 17, 19, 22, 23, 24, 25, 26, 27, 31, 32, 34, 36, 37, 38, 40, 42, 43, 44, 48, 49, 50, 51, 52, 54, 55, 57, 58, 59, 61, 62, 64, 65, 66, 67, 68, 71, 72, 73, 74, 75, 76, 77, 78, 79, 80, 81, 82, 83, 85, 86, 87, 88, 90, 93, 95, 96, 97, 98, 99, 100, 102, 103, 104, 105, 108, 110, 111, 112, 113, 114, 115, 116, 117, 118, 119, 120, 121, 122, 125, 127, 128, 129, 130, 131, 134, 135, 136, 141, 144, 145, 147, 148, 150, 151, 153, 156, 157, 158, 159, 160, 162, 164, 165, 166, 168, 169, 171, 174, 176, 181, 187, 188, 189, 191]"
agent_c,L100,short,130,45,85,5,0.35,200,"[0, 2, 3, 4, 5, 6, 8, 9, 12, 16, 17, 18, 20, 21, 24, 25, 27, 28, 29, 31, 32, 33, 34, 35, 37, 38, 41, 42, 43, 44, 45, 46, 47, 48, 49, 50, 51, 52, 53, 55, 56, 58, 60, 61, 62, 63, 64, 65, 66, 67, 68, 69, 70, 71, 74, 75, 76, 77, 78, 79, 80, 81, 83, 84, 85, 86, 89, 90, 91, 92, 93, 96, 97, 98, 99, 101, 102, 103, 104, 105, 106, 107, 108, 109, 110, 111, 112, 114, 115, 116, 120, 121, 122, 123, 125, 129, 130, 131, 132, 134, 135, 138, 139, 140, 142, 143, 144, 145, 146, 147, 149, 152, 153, 155, 159, 161, 162, 164, 165, 166, 168, 169, 170, 176, 178, 180, 188, 189, 190, 192]"
agent_c,L100,short,123,51,72,9,0.385,200,"[2, 5, 6, 9, 10, 12, 13, 14, 16, 17, 18, 20, 22, 24, 26, 28, 29, 30, 32, 33, 36, 37, 39, 40, 43, 46, 47, 48, 50, 52, 54, 56, 57, 58, 59, 60, 62, 63, 64, 65, 67, 69, 71, 73, 74, 75, 76, 77, 78, 79, 81, 83, 84, 86, 87, 92, 93, 95, 96, 97, 98, 100, 101, 103, 107, 108, 109, 110, 111, 112, 113, 116, 117, 118, 119, 121, 125, 127, 129, 130, 132, 133, 134, 137, 138, 139, 140, 141, 143, 144, 145, 146, 147, 148, 151, 152, 154, 156, 157, 159, 160, 166, 167, 168, 169, 171, 172, 173, 175, 176, 177, 178, 179, 180, 181, 182, 183, 187, 188, 190, 192, 193, 194]"
agent_c,L100,short,130,46,84,4,0.35,200,"[0, 1, 2, 4, 7, 8, 9, 10, 11, 12, 13, 14, 15, 16, 17, 19, 20, 22, 23, 24, 27, 30, 31, 32, 34, 35, 36, 37, 40, 42, 43, 44, 45, 46, 48, 50, 51, 52, 53, 54, 55, 56, 57, 60, 62, 63, 64, 65, 66, 67, 69, 72, 74, 75, 76, 77, 78, 79, 80, 81, 82, 83, 84, 85, 86, 87, 91, 92, 93, 94, 96, 97, 98, 99, 100, 101, 102, 103, 104, 105, 106, 107, 108, 109, 110, 111, 112, 113, 114, 116, 118, 120, 122, 124, 125, 126, 129, 130, 131, 132, 133, 134, 135, 136, 137, 139, 141, 142, 143, 145, 146, 147, 150, 151, 152, 154, 159, 160, 163, 164, 165, 169, 171, 172, 176, 183, 184, 185, 186, 197]"
agent_c,L100,short,131,66,65,5,0.345,200,"[0, 1, 2, 3, 4, 5, 7, 8, 9, 10, 12, 16, 17, 19, 20, 21, 22, 23, 24, 26, 28, 30, 31, 32, 33, 34, 35, 38, 39, 40, 41, 43, 44, 46, 47, 48, 49, 50, 53, 54, 56, 57, 61, 62, 63, 64, 66, 67, 68, 69, 70, 71, 72, 75, 76, 77, 79, 80, 82, 87, 88, 89, 91, 92, 93, 94, 95, 96, 97, 98, 99, 101, 102, 103, 105, 106, 109, 110, 111, 113, 115, 117, 118, 119, 120, 121, 122, 123, 126, 127, 128, 129, 131, 134, 135, 138, 140, 141, 143, 145, 146, 147, 148, 149, 150, 151, 152, 153, 154, 155, 156, 157, 159, 160, 162, 165, 166, 167, 168, 169, 171, 173, 175, 181, 182, 183, 185, 186, 194, 195, 196]"
agent_c,L100,short,126,55,71,7,0.37,200,"[2, 4, 5, 6, 7, 8, 9, 10, 11, 12, 14, 15, 16, 17, 19, 20, 21, 23, 25, 27, 28, 29, 30, 33, 34, 35, 36, 39, 40, 41, 42, 43, 45, 46, 48, 50, 51, 55, 56, 61, 62, 63, 66, 67, 69, 70, 71, 72, 73, 75, 76, 77, 78, 79, 80, 82, 83, 84, 85, 87, 88, 90, 91, 94, 95, 96, 97, 98, 99, 101, 102, 104, 106, 108, 109, 110, 111, 112, 113, 114, 116, 117, 118, 119, 121, 125, 126, 131, 132, 133, 134, 136, 138, 139, 140, 142, 143, 144, 145, 146, 149, 151, 152, 153, 154, 155, 159, 160, 162, 163, 166, 167, 168, 169, 172, 173, 175, 179, 180, 182, 183, 184, 191, 192, 193, 194]"
agent_c,L100,short,124,53,71,14,0.38,200,"[0, 2, 3, 4, 5, 6, 7, 8, 9, 11, 12, 14, 15, 16, 17, 18, 19, 22, 23, 24, 28, 29, 30, 31, 38, 39, 41, 42, 44, 48, 49, 51, 52, 54, 58, 61, 62, 64, 65, 66, 67, 68, 69, 71, 73, 75, 77, 78, 80, 82, 84, 85, 86, 87, 91, 93, 95, 96, 97, 98, 99, 100, 101, 102, 103, 104, 105, 106, 107, 108, 111, 112, 113, 114, 116, 119, 120, 121, 123, 125, 126, 127, 128, 129, 130, 131, 132, 135, 136, 137, 138, 139, 140, 141, 142, 143, 145, 146, 148, 149, 150, 151, 153, 154, 156, 160, 161, 162, 163, 164, 165, 166, 168, 170, 172, 173, 175, 176, 178, 183, 191, 197, 198, 199]"
agent_c,L0,middle,84,52,32,1,0.5435,184,"[0, 1, 3, 7, 8, 9, 10, 11, 12, 13, 14, 15, 17, 18, 19, 22, 23, 24, 26, 28, 30, 32, 33, 35, 36, 37, 38, 39, 40, 41, 44, 47, 48, 50, 52, 53, 54, 57, 59, 61, 67, 68, 69, 72, 73, 74, 75, 76, 77, 78, 80, 86, 87, 88, 89, 90, 91, 92, 93, 94, 96, 97, 98, 99, 100, 112, 115, 116, 120, 135, 137, 138, 140, 152, 156, 157, 160, 173, 174, 175, 176, 177, 179, 181]"
agent_c,L0,middle,85,35,50,2,0.5405,185,"[0, 2, 3, 4, 5, 9, 11, 12, 13, 14, 15, 18, 19, 20, 21, 22, 26, 27, 28, 30, 31, 33, 34, 36, 37, 40, 41, 43, 44, 46, 48, 49, 51, 52, 53, 55, 57, 58, 59, 60, 66, 67, 68, 70, 71, 72, 73, 75, 76, 77, 81, 90, 92, 94, 95, 96, 98, 99, 100, 101, 112, 114, 116, 117, 118, 119, 122, 137, 138, 139, 141, 142, 143, 156, 157, 158, 159, 160, 161, 162, 164, 177, 180, 182, 183]"
agent_c,L0,middle,86,36,50,4,0.5376,186,"[1, 3, 5, 7, 9, 10, 14, 15, 17, 19, 20, 21, 22, 23, 24, 27, 28, 34, 38, 40, 43, 45, 46, 48, 49, 50, 51, 52, 53, 54, 56, 57, 58, 59, 60, 61, 64, 67, 68, 70, 71, 72, 73, 74, 75, 76, 78, 79, 81, 82, 83, 90, 91, 92, 93, 94, 95, 96, 97, 98, 99, 100, 101, 103, 116, 118, 119, 120, 121, 122, 125, 142, 143, 156, 157, 158, 162, 163, 175, 176, 178, 179, 180, 181, 182, 183]"
agent_c,L0,middle,82,24,58,1,0.5495,182,"[2, 4, 5, 6, 9, 10, 11, 12, 14, 15, 16, 19, 21, 22, 23, 24, 27, 28, 29, 30, 31, 32, 33, 34, 35, 36, 37, 38, 39, 40, 42, 45, 47, 51, 52, 53, 54, 55, 56, 58, 59, 60, 72, 73, 74, 75, 76, 77, 78, 79, 80, 86, 87, 88, 89, 90, 91, 92, 94, 95, 96, 101, 112, 114, 115, 117, 118, 119, 120, 135, 138, 140, 142, 143, 156, 159, 160, 162, 163, 177, 178, 179]"
agent_c,L0,middle,79,42,37,3,0.5587,179,"[1, 5, 6, 7, 8, 10, 12, 14, 17, 20, 21, 22, 23, 24, 25, 27, 28, 29, 30, 31, 33, 34, 35, 37, 38, 41, 42, 46, 47, 48, 49, 50, 51, 53, 55, 56, 57, 59, 61, 63, 64, 71, 72, 75, 76, 77, 79, 81, 82, 83, 84, 96, 97, 99, 100, 102, 104, 105, 106, 117, 118, 120, 121, 123, 125, 126, 141, 142, 143, 144, 145, 146, 160, 161, 162, 163, 164, 165, 166]"
agent_c,L0,middle,79,31,48,6,0.5587,179,"[0, 1, 2, 3, 4, 6, 7, 8, 9, 10, 13, 14, 15, 18, 19, 20, 22, 24, 25, 26, 27, 29, 31, 32, 34, 35, 37, 38, 39, 41, 45, 46, 47, 48, 53, 54, 55, 56, 57, 60, 62, 63, 64, 68, 69, 70, 72, 73, 74, 76, 78, 79, 80, 83, 92, 93, 94, 95, 97, 98, 99, 100, 101, 102, 104, 116, 120, 122, 126, 141, 143, 160, 161, 163, 171, 172, 174, 175, 176]"
agent_c,L0,middle,83,35,48,6,0.5464,183,"[1, 2, 4, 5, 6, 8, 9, 12, 13, 14, 15, 16, 23, 24, 26, 27, 28, 30, 31, 32, 33, 34, 36, 38, 39, 40, 44, 46, 48, 50, 52, 54, 55, 56, 57, 58, 59, 60, 61, 62, 63, 64, 65, 67, 69, 70, 71, 74, 79, 80, 81, 82, 90, 92, 97, 99, 100, 102, 113, 114, 115, 116, 117, 118, 120, 121, 122, 135, 140, 141, 142, 145, 158, 159, 160, 162, 163, 166, 175, 176, 177, 179, 181]"
agent_c,L0,middle,84,40,44,3,0.5435,184,"[0, 1, 3, 7, 10, 11, 12, 14, 15, 18, 20, 21, 25, 27, 30, 31, 32, 33, 34, 35, 36, 37, 38, 39, 40, 42, 43, 45, 48, 52, 53, 54, 55, 56, 57, 60, 61, 62, 63, 69, 70, 71, 72, 73, 74, 76, 79, 80, 81, 84, 94, 95, 99, 100, 104, 113, 114, 115, 116, 117, 118, 119, 121, 123, 137, 138, 139, 140, 141, 142, 143, 154, 157, 159, 161, 163, 164, 176, 177, 178, 179, 180, 181, 182]"
agent_c,L0,middle,78,23,55,9,0.5618,178,"[0, 1, 2, 4, 5, 6, 7, 8, 11, 12, 13, 14, 15, 17, 18, 19, 20, 22, 23, 25, 26, 28, 29, 30, 31, 33, 36, 38, 39, 43, 44, 45, 47, 51, 52, 55, 59, 60, 61, 62, 63, 64, 65, 66, 68, 70, 71, 73, 74, 75, 76, 77, 79, 87, 88, 89, 91, 92, 93, 97, 98, 99, 100, 101, 105, 119, 120, 129, 142, 143, 145, 159, 160, 161, 164, 174, 175, 176]"
agent_c,L0,middle,88,36,52,6,0.5319,188,"[0, 2, 4, 5, 6, 10, 13, 14, 16, 17, 18, 20, 21, 22, 24, 25, 28, 30, 33, 34, 37, 38, 39, 41, 43, 44, 45, 46, 48, 50, 52, 53, 54, 55, 56, 57, 58, 62, 64, 65, 66, 68, 70, 71, 72, 73, 74, 75, 78, 79, 88, 92, 93, 94, 95, 97, 98, 99, 111, 112, 113, 114, 115, 116, 117, 119, 124, 137, 138, 140, 141, 142, 143, 160, 161, 164, 165, 175, 176, 177, 179, 180, 181, 182, 183, 184, 185, 186]"
agent_c,L0,middle,82,48,34,2,0.5495,182,"[0, 1, 3, 4, 5, 6, 7, 9, 10, 11, 12, 14, 15, 19, 20, 21, 23, 24, 25, 29, 30, 32, 33, 34, 36, 38, 39, 40, 42, 43, 44, 45, 47, 49, 51, 54, 56, 57, 58, 59, 61, 62, 68, 69, 70, 74, 75, 79, 80, 81, 83, 90, 91, 93, 94, 96, 97, 100, 101, 103, 104, 117, 118, 119, 120, 122, 123, 124, 125, 140, 142, 143, 144, 146, 159, 160, 161, 162, 164, 167, 179, 180]"
agent_c,L0,middle,85,46,39,4,0.5405,185,"[0, 1, 2, 3, 5, 6, 8, 9, 10, 12, 14, 15, 16, 17, 19, 20, 21, 22, 25, 27, 30, 32, 33, 34, 35, 37, 38, 39, 41, 44, 45, 46, 50, 51, 52, 54, 56, 57, 59, 60, 61, 62, 63, 66, 67, 68, 69, 70, 72, 73, 75, 76, 77, 78, 79, 81, 82, 84, 97, 98, 100, 101, 103, 104, 107, 120, 124, 125, 126, 139, 141, 142, 144, 145, 146, 161, 163, 165, 166, 176, 177, 178, 179, 181, 182]"
agent_c,L0,middle,85,44,41,8,0.5405,185,"[0, 1, 4, 7, 8, 10, 12, 13, 14, 15, 16, 18, 19, 22, 23, 24, 25, 28, 29, 30, 31, 32, 33, 34, 36, 37, 38, 39, 40, 43, 45, 46, 47, 48, 49, 50, 51, 52, 53, 54, 56, 57, 58, 59, 60, 63, 76, 77, 78, 81, 82, 91, 92, 93, 94, 95, 96, 97, 98, 99, 100, 101, 105, 117, 121, 122, 123, 137, 139, 140, 141, 142, 144, 155, 158, 159, 160, 161, 162, 163, 176, 177, 180, 181, 182]"
agent_c,L0,middle,77,31,46,4,0.565,177,"[0, 1, 2, 3, 5, 6, 9, 10, 11, 12, 16, 17, 18, 19, 20, 22, 23, 24, 25, 29, 30, 34, 35, 40, 42, 43, 44, 45, 48, 49, 50, 51, 52, 55, 56, 58, 59, 61, 69, 70, 71, 72, 73, 76, 77, 79, 82, 89, 90, 95, 96, 97, 99, 101, 109, 111, 112, 113, 114, 115, 116, 117, 120, 121, 135, 136, 139, 140, 141, 156, 157, 158, 160, 162, 173, 174, 175]"
agent_c,L0,middle,82,29,53,7,0.5495,182,"[0, 1, 3, 4, 6, 7, 8, 9, 11, 12, 15, 17, 18, 19, 20, 22, 23, 24, 26, 27, 28, 29, 30, 32, 34, 35, 37, 39, 42, 47, 48, 50, 51, 52, 53, 54, 55, 56, 59, 61, 63, 64, 65, 66, 67, 68, 69, 71, 72, 73, 77, 80, 82, 83, 86, 94, 98, 99, 101, 102, 104, 115, 117, 118, 119, 121, 122, 123, 127, 140, 143, 144, 145, 159, 160, 161, 162, 165, 174, 175, 176, 179]"
agent_c,L0,middle,82,44,38,3,0.5495,182,"[0, 2, 4, 6, 7, 8, 9, 10, 11, 12, 13, 14, 15, 16, 18, 19, 20, 23, 24, 25, 27, 29, 30, 31, 32, 33, 35, 36, 37, 38, 39, 40, 41, 43, 44, 45, 49, 50, 51, 52, 53, 55, 56, 58, 59, 62, 72, 73, 74, 75, 77, 78, 79, 82, 92, 95, 96, 97, 100, 101, 112, 114, 116, 119, 120, 121, 122, 124, 138, 140, 142, 143, 157, 158, 159, 160, 161, 162, 163, 176, 179, 180]"
agent_c,L0,middle,86,32,54,4,0.5376,186,"[1, 2, 3, 4, 6, 7, 10, 11, 16, 18, 19, 20, 21, 22, 23, 25, 28, 29, 30, 31, 32, 33, 34, 35, 36, 38, 40, 42, 45, 46, 48, 49, 50, 51, 52, 53, 54, 55, 56, 57, 58, 59, 60, 62, 70, 72, 76, 77, 78, 80, 81, 82, 90, 91, 94, 95, 98, 99, 100, 101, 103, 115, 117, 119, 120, 121, 122, 137, 138, 139, 140, 141, 142, 155, 156, 157, 158, 161, 164, 177, 178, 179, 180, 181, 182, 183]"
agent_c,L0,middle,86,39,47,7,0.5376,186,"[0, 2, 3, 4, 7, 8, 10, 11, 12, 14, 15, 16, 18, 19, 20, 22, 23, 24, 25, 26, 28, 31, 32, 33, 34, 35, 38, 39, 40, 42, 43, 45, 46, 47, 50, 52, 56, 57, 59, 65, 66, 67, 68, 70, 71, 72, 73, 74, 75, 76, 78, 79, 83, 92, 93, 94, 97, 102, 114, 117, 119, 120, 121, 122, 136, 137, 139, 140, 141, 142, 152, 154, 157, 158, 159, 160, 161, 162, 163, 166, 179, 180, 181, 182, 183, 184]"
agent_c,L0,middle,88,42,46,5,0.5319,188,"[1, 2, 3, 5, 7, 10, 11, 12, 13, 14, 19, 20, 21, 23, 25, 27, 28, 29, 30, 31, 32, 36, 37, 38, 40, 43, 45, 46, 47, 48, 49, 50, 51, 53, 54, 55, 56, 57, 58, 59, 60, 63, 64, 66, 67, 68, 71, 72, 74, 75, 76, 77, 78, 80, 81, 83, 94, 95, 97, 98, 99, 100, 101, 102, 115, 116, 117, 118, 119, 121, 124, 138, 142, 157, 158, 159, 160, 164, 173, 174, 176, 177, 178, 179, 180, 181, 182, 183]"
agent_c,L0,middle,79,38,41,9,0.5587,179,"[0, 1, 2, 3, 5, 6, 9, 10, 12, 13, 14, 15, 16, 17, 19, 20, 21, 22, 25, 26, 27, 30, 32, 33, 34, 35, 36, 38, 39, 40, 42, 45, 46, 47, 48, 49, 50, 51, 52, 54, 55, 56, 58, 59, 60, 63, 67, 77, 78, 79, 80, 82, 85, 87, 96, 98, 100, 101, 102, 106, 108, 121, 122, 123, 124, 126, 127, 128, 132, 148, 149, 151, 161, 163, 164, 165, 166, 167, 171]"
agent_c,L0,middle,82,36,46,5,0.5495,182,"[0, 1, 2, 3, 4, 5, 6, 7, 8, 9, 10, 11, 12, 13, 16, 18, 19, 20, 22, 23, 24, 25, 26, 28, 29, 30, 31, 32, 33, 35, 36, 37, 38, 40, 48, 49, 50, 51, 52, 53, 54, 59, 60, 61, 62, 63, 64, 70, 71, 72, 73, 74, 76, 77, 78, 80, 82, 91, 92, 94, 98, 99, 101, 103, 115, 119, 120, 121, 124, 136, 140, 144, 158, 159, 161, 162, 163, 172, 174, 175, 176, 178]"
agent_c,L0,middle,79,32,47,8,0.5587,179,"[0, 1, 2, 3, 5, 7, 12, 13, 14, 15, 16, 19, 23, 24, 26, 27, 28, 29, 30, 31, 33, 35, 36, 37, 38, 41, 42, 45, 46, 47, 52, 53, 57, 58, 60, 61, 62, 63, 64, 65, 72, 76, 77, 78, 80, 81, 82, 83, 85, 86, 87, 93, 94, 96, 97, 98, 99, 100, 101, 102, 103, 105, 107, 122, 125, 128, 141, 142, 143, 144, 145, 147, 160, 162, 163, 165, 167, 168, 176]"
agent_c,L0,middle,82,23,59,3,0.5495,182,"[0, 2, 3, 4, 6, 7, 8, 9, 10, 11, 12, 15, 18, 19, 20, 21, 22, 23, 24, 25, 27, 28, 29, 30, 31, 32, 33, 35, 36, 37, 38, 40, 41, 43, 44, 46, 47, 48, 53, 56, 59, 61, 63, 70, 71, 72, 73, 74, 77, 78, 79, 81, 82, 83, 85, 86, 95, 96, 97, 98, 99, 100, 101, 102, 105, 107, 120, 122, 123, 126, 127, 144, 146, 149, 160, 162, 166, 167, 169, 170, 171, 173]"
agent_c,L0,middle,85,48,37,6,0.5405,185,"[0, 1, 2, 4, 5, 6, 7, 8, 9, 10, 13, 15, 17, 18, 20, 23, 25, 26, 27, 28, 29, 30, 31, 35, 36, 37, 38, 39, 42, 48, 49, 50, 51, 52, 54, 55, 58, 59, 60, 61, 62, 63, 64, 65, 66, 67, 70, 75, 76, 77, 78, 79, 80, 81, 83, 93, 94, 95, 96, 98, 99, 100, 101, 103, 115, 120, 121, 123, 136, 138, 139, 140, 141, 142, 145, 160, 162, 165, 173, 176, 178, 179, 180, 181, 182]"
agent_c,L0,middle,82,33,49,2,0.5495,182,"[0, 2, 3, 4, 6, 7, 9, 11, 15, 16, 17, 18, 19, 20, 21, 22, 24, 25, 26, 29, 30, 31, 34, 35, 36, 40, 42, 44, 47, 49, 50, 52, 54, 55, 57, 58, 59, 60, 64, 65, 66, 67, 69, 72, 75, 77, 79, 82, 87, 90, 91, 93, 94, 95, 96, 97, 99, 102, 103, 113, 115, 116, 117, 119, 120, 124, 137, 140, 141, 143, 144, 154, 157, 158, 159, 160, 161, 162, 164, 166, 178, 180]"
agent_c,L0,middle,77,35,42,5,0.565,177,"[0, 2, 3, 5, 6, 7, 8, 9, 10, 11, 12, 14, 15, 16, 18, 19, 22, 23, 24, 25, 26, 27, 28, 32, 33, 34, 35, 36, 38, 41, 42, 43, 45, 46, 47, 48, 49, 50, 52, 53, 54, 55, 56, 57, 59, 68, 72, 75, 77, 79, 85, 88, 91, 92, 93, 95, 96, 97, 99, 100, 103, 116, 118, 123, 137, 138, 139, 140, 142, 143, 153, 156, 157, 160, 161, 162, 163]"
agent_c,L0,middle,76,42,34,4,0.5682,176,"[0, 1, 2, 3, 5, 6, 8, 9, 11, 13, 15, 16, 20, 22, 24, 27, 28, 29, 31, 33, 34, 36, 38, 39, 40, 41, 42, 45, 46, 48, 51, 52, 53, 57, 58, 60, 66, 67, 70, 71, 73, 75, 77, 79, 80, 86, 87, 89, 91, 95, 96, 97, 99, 100, 101, 110, 111, 112, 113, 114, 117, 118, 119, 121, 122, 135, 139, 140, 141, 144, 155, 157, 159, 160, 162, 164]"
agent_c,L0,middle,86,41,45,3,0.5376,186,"[2, 3, 6, 7, 8, 11, 12, 15, 16, 17, 18, 19, 20, 21, 22, 24, 25, 28, 29, 31, 33, 37, 39, 41, 42, 45, 47, 49, 50, 52, 53, 54, 56, 57, 58, 59, 61, 62, 63, 65, 66, 67, 69, 70, 73, 74, 75, 77, 78, 82, 88, 89, 90, 91, 92, 93, 94, 95, 96, 97, 99, 112, 113, 114, 116, 117, 118, 119, 133, 135, 136, 137, 139, 141, 143, 158, 159, 162, 163, 173, 175, 176, 177, 179, 180, 183]"
agent_c,L0,middle,80,29,51,6,0.5556,180,"[0, 2, 4, 8, 9, 11, 12, 13, 15, 16, 17, 18, 19, 20, 23, 24, 26, 28, 29, 30, 31, 33, 35, 36, 37, 39, 40, 45, 46, 49, 50, 52, 53, 54, 55, 57, 60, 63, 64, 65, 67, 68, 71, 73, 75, 77, 78, 79, 83, 88, 92, 96, 97, 99, 101, 110, 114, 115, 116, 117, 118, 120, 121, 122, 123, 136, 137, 138, 140, 141, 142, 143, 158, 159, 161, 162, 165, 174, 177, 178]"
agent_c,L0,middle,74,34,40,5,0.5747,174,"[1, 2, 4, 5, 7, 9, 10, 14, 15, 16, 17, 20, 26, 28, 29, 34, 37, 38, 39, 40, 42, 43, 44, 45, 46, 47, 48, 49, 50, 52, 54, 55, 56, 57, 58, 59, 60, 63, 70, 71, 73, 74, 75, 76, 77, 78, 81, 89, 91, 92, 94, 96, 97, 98, 99, 101, 102, 104, 114, 116, 118, 119, 120, 123, 138, 139, 140, 145, 155, 156, 157, 159, 160, 163]"
agent_c,L0,middle,85,30,55,4,0.5405,185,"[0, 1, 3, 5, 7, 8, 9, 11, 12, 13, 14, 15, 17, 18, 20, 21, 22, 23, 25, 26, 29, 30, 32, 33, 34, 35, 36, 39, 40, 41, 42, 43, 46, 47, 48, 49, 51, 52, 53, 54, 55, 57, 58, 59, 60, 71, 74, 78, 79, 80, 81, 89, 90, 91, 92, 93, 94, 95, 96, 97, 98, 100, 101, 115, 116, 118, 120, 121, 123, 139, 140, 143, 155, 156, 157, 158, 159, 160, 162, 163, 164, 177, 181, 182, 183]"
agent_c,L0,middle,83,44,39,4,0.5464,183,"[0, 1, 3, 4, 5, 7, 8, 12, 14, 15, 16, 17, 18, 19, 21, 22, 27, 28, 31, 32, 37, 38, 41, 43, 44, 48, 49, 50, 52, 53, 54, 55, 56, 58, 60, 65, 68, 69, 71, 72, 73, 74, 75, 77, 78, 79, 84, 85, 88, 89, 90, 91, 94, 95, 96, 99, 101, 112, 113, 114, 115, 116, 117, 118, 120, 135, 137, 138, 140, 151, 152, 155, 156, 157, 158, 160, 172, 174, 175, 176, 177, 178, 180]"
agent_c,L0,middle,74,32,42,10,0.5747,174,"[1, 3, 5, 6, 7, 8, 9, 13, 14, 15, 19, 20, 21, 22, 25, 26, 27, 29, 30, 31, 32, 35, 37, 38, 39, 41, 43, 44, 45, 46, 47, 48, 49, 51, 52, 53, 55, 56, 57, 58, 59, 63, 72, 73, 74, 76, 77, 79, 80, 81, 85, 96, 100, 101, 102, 103, 105, 115, 116, 117, 119, 121, 122, 123, 126, 139, 141, 146, 157, 158, 160, 161, 163, 165]"
agent_c,L0,middle,86,31,55,4,0.5376,186,"[0, 4, 5, 6, 7, 8, 9, 10, 12, 14, 15, 19, 22, 23, 24, 25, 26, 28, 32, 33, 34, 35, 39, 40, 42, 43, 45, 46, 47, 48, 49, 50, 51, 53, 55, 56, 57, 58, 59, 60, 62, 64, 65, 66, 67, 70, 71, 73, 74, 75, 76, 77, 78, 80, 81, 82, 91, 95, 98, 99, 100, 102, 113, 118, 120, 121, 122, 134, 137, 138, 139, 140, 141, 143, 157, 159, 161, 163, 172, 174, 175, 176, 178, 181, 182, 183]"
agent_c,L0,middle,81,39,42,5,0.5525,181,"[0, 2, 3, 4, 5, 7, 8, 10, 11, 12, 13, 14, 15, 17, 18, 19, 20, 23, 26, 27, 28, 29, 30, 32, 33, 34, 36, 37, 41, 44, 48, 50, 52, 53, 54, 55, 56, 58, 59, 60, 63, 64, 65, 69, 70, 73, 74, 75, 77, 80, 82, 84, 94, 95, 97, 98, 100, 104, 116, 117, 118, 119, 122, 125, 137, 139, 140, 141, 142, 143, 156, 157, 159, 160, 162, 163, 172, 173, 177, 178, 179]"
agent_c,L0,middle,86,41,45,3,0.5376,186,"[0, 2, 3, 5, 7, 8, 10, 11, 15, 18, 21, 23, 25, 26, 28, 29, 30, 32, 33, 34, 37, 38, 39, 40, 43, 47, 50, 51, 52, 53, 54, 55, 56, 57, 60, 62, 64, 66, 67, 68, 70, 71, 72, 73, 74, 77, 78, 81, 82, 84, 85, 93, 94, 96, 97, 98, 100, 101, 104, 105, 119, 120, 121, 122, 123, 124, 126, 127, 139, 144, 145, 146, 147, 160, 161, 163, 164, 166, 167, 168, 177, 178, 179, 180, 181, 183]"
agent_c,L0,middle,81,47,34,3,0.5525,181,"[0, 1, 4, 5, 6, 8, 11, 12, 13, 14, 15, 16, 18, 19, 20, 21, 22, 25, 26, 27, 28, 29, 30, 31, 32, 34, 36, 37, 39, 43, 45, 49, 52, 54, 55, 56, 58, 60, 61, 64, 68, 69, 70, 71, 73, 74, 75, 76, 77, 78, 81, 89, 90, 91, 92, 93, 95, 97, 99, 109, 112, 113, 114, 116, 117, 118, 119, 132, 134, 136, 137, 139, 154, 155, 158, 159, 169, 173, 176, 177, 179]"
agent_c,L0,middle,76,30,46,7,0.5682,176,"[1, 3, 4, 5, 6, 8, 9, 10, 11, 12, 13, 14, 15, 16, 17, 19, 20, 23, 24, 25, 26, 28, 32, 33, 37, 38, 40, 41, 43, 45, 46, 47, 49, 51, 52, 53, 55, 58, 59, 60, 62, 68, 69, 74, 75, 76, 78, 80, 81, 82, 90, 92, 95, 99, 101, 102, 103, 105, 115, 117, 119, 121, 122, 123, 125, 139, 141, 143, 144, 145, 151, 161, 163, 164, 167, 168]"
agent_c,L0,middle,76,36,40,6,0.5682,176,"[0, 1, 3, 4, 5, 6, 9, 13, 14, 15, 16, 18, 19, 22, 23, 26, 27, 29, 30, 31, 33, 34, 36, 37, 38, 40, 41, 42, 43, 44, 45, 46, 47, 49, 51, 55, 56, 58, 65, 69, 70, 71, 72, 74, 76, 77, 78, 80, 81, 83, 92, 93, 95, 96, 97, 99, 100, 101, 102, 103, 104, 115, 118, 119, 121, 123, 125, 140, 141, 143, 144, 154, 158, 159, 162, 164]"
agent_c,L0,middle,77,32,45,4,0.565,177,"[2, 3, 4, 5, 7, 8, 9, 10, 11, 12, 13, 17, 18, 19, 22, 23, 24, 26, 30, 32, 33, 36, 39, 40, 45, 46, 47, 49, 51, 56, 60, 61, 62, 63, 64, 66, 67, 68, 71, 72, 73, 74, 75, 76, 77, 78, 79, 80, 82, 88, 89, 93, 94, 96, 97, 100, 101, 113, 114, 115, 116, 117, 121, 123, 135, 136, 137, 138, 142, 145, 161, 162, 163, 164, 171, 173, 175]"
agent_c,L0,middle,87,34,53,3,0.5348,187,"[1, 2, 7, 8, 9, 10, 11, 12, 13, 15, 17, 21, 24, 25, 26, 27, 28, 29, 30, 31, 32, 35, 36, 37, 38, 39, 40, 42, 47, 48, 49, 50, 52, 53, 54, 55, 56, 57, 58, 59, 60, 61, 62, 65, 70, 71, 72, 73, 74, 76, 77, 78, 82, 84, 92, 98, 102, 103, 116, 117, 118, 120, 121, 122, 123, 125, 136, 142, 144, 155, 156, 157, 158, 159, 160, 163, 165, 166, 168, 177, 178, 179, 180, 181, 183, 184, 185]"
agent_c,L0,middle,83,42,41,3,0.5464,183,"[0, 2, 5, 6, 7, 8, 10, 11, 13, 16, 17, 18, 19, 21, 22, 23, 24, 27, 29, 33, 34, 37, 38, 39, 40, 43, 50, 52, 53, 54, 55, 58, 59, 60, 61, 63, 64, 67, 68, 70, 71, 72, 74, 75, 76, 77, 78, 80, 81, 82, 84, 90, 94, 95, 96, 99, 100, 104, 105, 117, 118, 119, 120, 121, 122, 123, 127, 140, 145, 156, 157, 160, 161, 162, 163, 164, 165, 174, 175, 176, 179, 180, 181]"
agent_c,L0,middle,83,41,42,3,0.5464,183,"[0, 1, 7, 8, 9, 10, 11, 13, 14, 16, 17, 18, 19, 20, 22, 23, 24, 25, 26, 29, 31, 32, 33, 39, 43, 44, 46, 47, 48, 49, 50, 56, 57, 58, 59, 62, 63, 64, 65, 66, 67, 68, 70, 74, 76, 77, 79, 80, 86, 87, 88, 90, 93, 94, 95, 96, 97, 98, 99, 100, 111, 115, 116, 118, 119, 120, 133, 137, 138, 141, 153, 154, 155, 156, 157, 158, 159, 162, 174, 175, 176, 177, 180]"
agent_c,L0,middle,82,34,48,1,0.5495,182,"[1, 3, 5, 6, 8, 9, 11, 12, 13, 14, 15, 16, 19, 20, 24, 25, 26, 28, 29, 30, 31, 33, 34, 35, 37, 38, 39, 40, 43, 48, 49, 51, 54, 56, 57, 58, 60, 62, 63, 64, 67, 68, 69, 70, 72, 73, 74, 75, 78, 80, 88, 90, 91, 94, 95, 97, 98, 99, 100, 110, 114, 116, 118, 119, 120, 132, 133, 134, 135, 136, 137, 138, 140, 157, 160, 162, 171, 172, 174, 176, 179, 180]"
agent_c,L0,middle,82,30,52,1,0.5495,182,"[1, 3, 4, 7, 8, 11, 12, 15, 16, 17, 18, 19, 21, 22, 24, 25, 26, 27, 29, 30, 32, 33, 35, 36, 37, 39, 41, 43, 45, 48, 49, 54, 55, 58, 59, 61, 69, 70, 71, 72, 73, 75, 76, 77, 78, 80, 81, 82, 84, 91, 92, 96, 97, 98, 99, 101, 102, 103, 104, 106, 117, 119, 120, 121, 123, 124, 125, 138, 143, 144, 145, 157, 158, 159, 160, 161, 162, 163, 164, 165, 166, 180]"
agent_c,L0,middle,78,29,49,7,0.5618,178,"[0, 2, 4, 5, 7, 8, 9, 10, 11, 13, 14, 15, 17, 18, 20, 21, 22, 23, 24, 25, 27, 29, 32, 34, 36, 40, 43, 44, 45, 46, 47, 48, 49, 50, 55, 56, 57, 58, 63, 69, 71, 74, 76, 82, 86, 87, 88, 89, 90, 92, 93, 95, 97, 99, 100, 110, 111, 115, 116, 117, 118, 119, 120, 122, 123, 124, 137, 140, 142, 144, 155, 156, 157, 159, 160, 161, 162, 164]"
agent_c,L0,middle,83,29,54,3,0.5464,183,"[1, 2, 3, 5, 6, 7, 8, 9, 11, 13, 14, 15, 16, 17, 18, 19, 20, 21, 22, 25, 26, 27, 28, 29, 30, 34, 36, 37, 38, 39, 40, 42, 47, 48, 49, 50, 51, 52, 53, 54, 55, 56, 61, 65, 66, 67, 70, 71, 73, 74, 75, 77, 78, 79, 80, 81, 95, 99, 101, 102, 103, 115, 116, 118, 119, 120, 121, 123, 124, 126, 143, 144, 145, 159, 163, 164, 166, 174, 175, 177, 178, 180, 181]"
agent_c,L0,middle,78,37,41,8,0.5618,178,"[0, 3, 4, 7, 8, 9, 11, 12, 13, 15, 16, 17, 19, 21, 22, 23, 25, 26, 27, 28, 32, 33, 37, 39, 41, 44, 47, 50, 51, 52, 53, 55, 57, 58, 59, 62, 63, 64, 66, 67, 68, 69, 70, 71, 72, 74, 77, 78, 79, 82, 88, 89, 91, 95, 97, 98, 100, 112, 114, 117, 118, 119, 120, 122, 134, 135, 137, 138, 139, 140, 142, 156, 158, 160, 161, 172, 175, 176]"
agent_c,L0,middle,85,38,47,2,0.5405,185,"[1, 2, 3, 4, 5, 6, 7, 11, 12, 13, 14, 15, 16, 17, 18, 21, 22, 23, 24, 25, 27, 28, 30, 32, 35, 36, 39, 40, 42, 47, 48, 49, 50, 54, 55, 57, 58, 59, 60, 61, 62, 64, 65, 68, 70, 71, 72, 73, 75, 78, 79, 81, 82, 91, 92, 93, 94, 95, 96, 99, 100, 101, 102, 114, 118, 119, 120, 121, 122, 123, 136, 138, 139, 140, 142, 144, 160, 161, 163, 164, 165, 175, 178, 180, 181]"
agent_c,L0,middle,81,43,38,3,0.5525,181,"[1, 3, 5, 7, 11, 13, 14, 15, 17, 18, 21, 22, 24, 25, 26, 27, 29, 30, 32, 33, 36, 38, 39, 40, 41, 42, 45, 48, 49, 50, 51, 52, 54, 55, 56, 57, 58, 59, 60, 61, 62, 63, 64, 66, 69, 70, 72, 73, 74, 76, 79, 80, 81, 83, 92, 94, 95, 96, 97, 99, 101, 102, 113, 118, 122, 135, 137, 139, 141, 142, 143, 144, 146, 160, 162, 163, 164, 165, 167, 176, 179]"
agent_c,L0,middle,85,24,61,2,0.5405,185,"[0, 1, 4, 5, 6, 8, 10, 13, 14, 15, 16, 17, 19, 20, 23, 24, 26, 27, 28, 30, 31, 32, 33, 34, 37, 38, 39, 40, 42, 43, 44, 46, 47, 50, 53, 54, 56, 57, 58, 62, 67, 68, 69, 70, 71, 75, 76, 77, 79, 80, 81, 91, 94, 96, 98, 99, 101, 102, 112, 113, 114, 115, 117, 118, 119, 121, 122, 137, 138, 140, 141, 142, 154, 155, 157, 158, 159, 161, 162, 175, 176, 179, 180, 181, 182]"
agent_c,L0,middle,82,42,40,2,0.5495,182,"[0, 1, 2, 3, 7, 8, 10, 11, 13, 14, 15, 16, 17, 18, 19, 20, 21, 22, 27, 28, 30, 33, 34, 35, 36, 37, 41, 45, 48, 52, 53, 55, 56, 57, 58, 59, 61, 63, 65, 66, 67, 68, 71, 72, 73, 74, 76, 78, 79, 80, 82, 90, 91, 94, 96, 97, 98, 99, 100, 101, 102, 115, 116, 118, 121, 123, 137, 138, 141, 142, 143, 145, 158, 159, 163, 165, 173, 175, 176, 177, 179, 180]"
agent_c,L0,middle,84,33,51,1,0.5435,184,"[0, 1, 2, 3, 6, 7, 9, 10, 14, 16, 17, 20, 21, 23, 24, 25, 26, 28, 29, 30, 31, 32, 33, 34, 35, 37, 40, 42, 46, 47, 48, 50, 53, 55, 56, 57, 58, 59, 60, 62, 63, 64, 65, 67, 68, 69, 72, 73, 75, 76, 77, 78, 80, 81, 82, 90, 94, 95, 97, 98, 100, 101, 103, 120, 122, 123, 126, 138, 141, 142, 143, 144, 145, 148, 162, 163, 164, 165, 166, 167, 168, 178, 179, 182]"
agent_c,L0,middle,87,50,37,1,0.5348,187,"[1, 3, 5, 6, 7, 8, 10, 11, 13, 18, 19, 20, 22, 23, 24, 25, 27, 29, 30, 32, 34, 35, 37, 40, 42, 43, 46, 47, 48, 49, 50, 51, 56, 57, 58, 59, 61, 63, 64, 67, 68, 69, 70, 71, 73, 74, 75, 76, 77, 78, 79, 82, 90, 92, 96, 97, 98, 100, 101, 103, 114, 116, 117, 118, 119, 120, 122, 123, 135, 138, 139, 140, 142, 143, 157, 159, 160, 162, 163, 164, 176, 177, 178, 179, 180, 183, 184]"
agent_c,L0,middle,86,25,61,4,0.5376,186,"[0, 1, 2, 4, 5, 7, 9, 10, 11, 12, 14, 17, 18, 19, 20, 21, 23, 24, 27, 29, 30, 31, 33, 39, 42, 43, 46, 48, 51, 52, 53, 54, 55, 57, 58, 60, 63, 64, 65, 66, 67, 68, 69, 72, 74, 75, 76, 79, 80, 82, 88, 90, 91, 92, 93, 94, 95, 98, 100, 101, 102, 103, 104, 117, 118, 119, 120, 121, 122, 125, 140, 141, 142, 143, 144, 162, 164, 172, 174, 175, 177, 178, 179, 181, 182, 183]"
agent_c,L0,middle,86,36,50,5,0.5376,186,"[0, 1, 2, 3, 4, 6, 7, 8, 9, 10, 12, 14, 15, 17, 18, 20, 22, 23, 24, 25, 26, 30, 33, 34, 38, 39, 40, 41, 43, 44, 46, 47, 49, 50, 52, 53, 55, 56, 57, 58, 60, 67, 68, 69, 70, 71, 72, 76, 77, 79, 85, 86, 87, 88, 89, 90, 91, 93, 94, 95, 96, 97, 98, 99, 103, 115, 117, 118, 119, 121, 122, 123, 124, 127, 144, 145, 146, 159, 163, 164, 165, 166, 168, 181, 183, 184]"
agent_c,L0,middle,87,36,51,4,0.5348,187,"[0, 1, 2, 3, 5, 6, 7, 8, 11, 12, 16, 17, 18, 19, 20, 22, 23, 25, 29, 31, 32, 34, 35, 36, 37, 38, 39, 40, 42, 43, 45, 46, 47, 48, 49, 50, 51, 53, 55, 56, 58, 59, 60, 61, 62, 66, 73, 77, 78, 79, 82, 83, 84, 86, 96, 97, 98, 99, 100, 101, 102, 103, 104, 105, 118, 119, 120, 121, 122, 125, 126, 127, 142, 144, 145, 146, 147, 160, 162, 164, 165, 166, 167, 168, 169, 183, 185]"
agent_c,L0,middle,88,40,48,4,0.5319,188,"[2, 3, 4, 7, 11, 12, 14, 16, 17, 18, 19, 20, 22, 23, 24, 26, 27, 29, 31, 32, 33, 34, 35, 36, 39, 40, 41, 42, 45, 46, 48, 49, 50, 51, 52, 53, 57, 58, 61, 66, 67, 72, 74, 76, 77, 78, 79, 81, 87, 88, 89, 90, 91, 92, 94, 95, 96, 97, 98, 99, 100, 101, 102, 103, 104, 105, 119, 121, 123, 124, 125, 141, 142, 143, 145, 146, 148, 162, 163, 164, 166, 167, 180, 182, 183, 184, 185, 186]"
agent_c,L0,middle,81,27,54,4,0.5525,181,"[0, 1, 3, 5, 6, 8, 9, 10, 11, 13, 14, 15, 18, 20, 22, 23, 24, 25, 26, 27, 32, 33, 35, 37, 38, 39, 44, 48, 51, 52, 53, 55, 56, 57, 58, 61, 63, 64, 66, 69, 70, 72, 73, 74, 75, 77, 78, 79, 82, 88, 92, 93, 94, 95, 96, 97, 99, 100, 102, 105, 118, 124, 135, 137, 138, 140, 141, 142, 143, 145, 157, 161, 162, 163, 165, 173, 174, 175, 176, 177, 178]"
agent_c,L0,middle,83,42,41,2,0.5464,183,"[0, 1, 4, 5, 6, 9, 11, 12, 13, 14, 15, 16, 17, 19, 20, 21, 22, 25, 27, 28, 29, 30, 33, 34, 35, 38, 40, 46, 48, 50, 52, 53, 56, 57, 58, 60, 62, 64, 65, 66, 67, 68, 69, 71, 72, 73, 74, 75, 76, 77, 80, 81, 94, 96, 97, 98, 99, 101, 102, 113, 114, 118, 119, 120, 121, 122, 135, 137, 139, 141, 142, 157, 159, 160, 161, 163, 171, 172, 174, 176, 179, 180, 181]"
agent_c,L0,middle,83,39,44,2,0.5464,183,"[1, 2, 3, 4, 8, 9, 10, 11, 14, 15, 17, 18, 19, 21, 25, 30, 31, 33, 34, 35, 36, 37, 38, 39, 40, 41, 43, 44, 45, 46, 47, 48, 50, 51, 54, 55, 56, 59, 60, 65, 66, 67, 68, 70, 71, 72, 73, 74, 75, 76, 77, 78, 80, 87, 88, 89, 90, 91, 92, 95, 96, 97, 99, 100, 101, 114, 116, 118, 120, 121, 122, 137, 141, 143, 156, 157, 158, 159, 161, 162, 163, 180, 181]"
agent_c,L0,middle,85,47,38,4,0.5405,185,"[0, 2, 3, 6, 7, 8, 10, 11, 12, 13, 14, 16, 19, 22, 23, 25, 28, 29, 30, 31, 32, 34, 39, 41, 42, 43, 45, 46, 48, 49, 51, 53, 54, 55, 58, 60, 66, 68, 69, 72, 73, 75, 76, 77, 79, 83, 84, 86, 87, 92, 95, 96, 98, 99, 100, 109, 111, 114, 116, 117, 118, 119, 122, 134, 137, 138, 139, 141, 153, 154, 155, 156, 157, 159, 160, 171, 172, 173, 174, 175, 176, 177, 178, 179, 180]"
agent_c,L0,middle,78,35,43,3,0.5618,178,"[0, 1, 2, 3, 4, 5, 6, 7, 9, 10, 13, 14, 16, 17, 18, 19, 20, 21, 22, 23, 24, 27, 32, 33, 34, 35, 37, 38, 39, 40, 42, 46, 47, 51, 55, 56, 58, 59, 60, 61, 63, 64, 73, 76, 79, 80, 81, 82, 83, 84, 92, 95, 96, 98, 99, 100, 103, 104, 105, 106, 117, 119, 121, 125, 127, 139, 141, 142, 144, 145, 146, 158, 160, 161, 163, 165, 167, 168]"
agent_c,L0,middle,84,41,43,6,0.5435,184,"[0, 4, 5, 7, 9, 10, 12, 14, 17, 18, 19, 20, 21, 22, 24, 25, 26, 27, 29, 30, 32, 33, 35, 36, 37, 41, 42, 43, 44, 45, 46, 47, 49, 51, 53, 57, 58, 61, 68, 69, 70, 72, 74, 76, 77, 79, 80, 86, 88, 91, 92, 93, 96, 97, 98, 99, 100, 110, 113, 114, 117, 118, 119, 121, 135, 136, 139, 141, 151, 152, 153, 154, 155, 156, 157, 158, 159, 160, 162, 175, 176, 179, 181, 182]"
agent_c,L0,middle,89,19,70,5,0.5291,189,"[4, 5, 7, 9, 11, 13, 15, 16, 18, 19, 20, 21, 23, 24, 25, 26, 27, 28, 29, 30, 31, 34, 36, 37, 38, 39, 41, 42, 43, 48, 49, 50, 51, 52, 53, 54, 58, 59, 61, 62, 63, 64, 65, 66, 67, 68, 69, 70, 71, 72, 73, 74, 76, 77, 79, 80, 81, 82, 92, 93, 94, 95, 96, 97, 98, 99, 100, 101, 102, 103, 104, 107, 122, 124, 125, 141, 146, 162, 163, 164, 165, 166, 169, 182, 183, 184, 185, 186, 187]"
agent_c,L0,middle,76,47,29,6,0.5682,176,"[0, 1, 2, 3, 4, 5, 6, 7, 10, 12, 13, 14, 16, 18, 19, 22, 23, 24, 25, 26, 27, 30, 31, 32, 33, 34, 36, 37, 38, 42, 44, 45, 46, 47, 50, 51, 52, 53, 55, 56, 58, 59, 72, 75, 76, 78, 81, 86, 89, 90, 92, 95, 97, 98, 101, 111, 112, 113, 115, 116, 117, 118, 119, 122, 135, 138, 139, 141, 152, 153, 155, 158, 160, 161, 162, 174]"
agent_c,L0,middle,78,44,34,11,0.5618,178,"[0, 1, 4, 8, 11, 13, 14, 16, 17, 18, 19, 26, 27, 29, 30, 32, 33, 34, 38, 39, 40, 42, 43, 44, 45, 46, 47, 49, 51, 54, 56, 59, 61, 64, 65, 66, 67, 68, 69, 70, 71, 72, 74, 76, 78, 80, 85, 86, 88, 90, 91, 92, 93, 94, 95, 97, 98, 100, 111, 113, 114, 115, 122, 134, 137, 138, 140, 141, 143, 145, 146, 148, 159, 161, 163, 165, 166, 168]"
agent_c,L0,middle,86,33,53,2,0.5376,186,"[0, 1, 2, 5, 7, 8, 10, 11, 12, 15, 16, 17, 18, 21, 22, 24, 25, 26, 28, 29, 30, 31, 33, 34, 36, 37, 38, 39, 40, 41, 48, 50, 51, 52, 54, 55, 56, 57, 58, 59, 60, 61, 69, 70, 71, 72, 73, 74, 75, 76, 77, 82, 90, 91, 97, 98, 99, 100, 101, 102, 103, 115, 117, 120, 121, 122, 124, 137, 138, 139, 140, 142, 143, 158, 159, 162, 163, 172, 173, 176, 177, 178, 181, 182, 183, 184]"
agent_c,L0,middle,79,42,37,8,0.5587,179,"[2, 4, 5, 7, 8, 10, 11, 12, 15, 16, 18, 19, 21, 22, 25, 27, 28, 30, 35, 36, 37, 38, 39, 40, 41, 43, 44, 46, 48, 49, 50, 51, 53, 58, 61, 66, 68, 69, 70, 71, 72, 73, 74, 75, 77, 78, 80, 84, 90, 92, 93, 94, 95, 96, 98, 100, 101, 103, 113, 114, 115, 116, 117, 121, 125, 139, 140, 141, 142, 143, 144, 146, 158, 160, 161, 162, 164, 165, 169]"
agent_c,L0,middle,83,29,54,3,0.5464,183,"[0, 3, 6, 8, 9, 10, 12, 13, 15, 16, 18, 19, 21, 23, 24, 25, 27, 28, 29, 30, 31, 33, 36, 37, 38, 39, 41, 45, 46, 47, 48, 49, 50, 51, 52, 54, 57, 58, 59, 60, 62, 63, 64, 66, 68, 69, 71, 74, 76, 77, 78, 80, 90, 91, 93, 94, 96, 98, 99, 100, 116, 117, 118, 120, 131, 136, 137, 138, 139, 143, 156, 158, 159, 160, 168, 170, 171, 173, 176, 177, 178, 179, 180]"
agent_c,L0,middle,82,23,59,4,0.5495,182,"[0, 1, 3, 5, 6, 7, 8, 10, 11, 16, 19, 20, 22, 27, 28, 29, 30, 31, 32, 33, 34, 36, 37, 40, 41, 42, 43, 45, 46, 47, 48, 49, 50, 52, 53, 54, 56, 58, 59, 61, 70, 71, 72, 73, 74, 75, 76, 77, 79, 80, 81, 82, 83, 84, 93, 94, 95, 96, 97, 98, 101, 102, 103, 104, 108, 120, 123, 124, 125, 140, 143, 145, 157, 158, 161, 162, 163, 164, 165, 166, 167, 180]"
agent_c,L0,middle,83,25,58,2,0.5464,183,"[2, 4, 5, 7, 8, 11, 12, 13, 15, 16, 18, 20, 21, 24, 25, 27, 29, 31, 32, 33, 35, 36, 37, 38, 39, 40, 42, 44, 45, 47, 48, 49, 50, 52, 54, 55, 56, 57, 58, 59, 60, 67, 69, 70, 71, 72, 73, 74, 78, 79, 80, 86, 90, 91, 92, 95, 100, 111, 112, 113, 114, 115, 116, 117, 118, 119, 120, 122, 138, 139, 140, 144, 157, 158, 159, 160, 161, 164, 176, 177, 179, 180, 181]"
agent_c,L0,middle,77,38,39,3,0.565,177,"[1, 3, 6, 7, 8, 9, 14, 17, 19, 20, 21, 22, 23, 24, 28, 29, 31, 32, 33, 35, 36, 37, 38, 39, 40, 41, 42, 43, 44, 45, 46, 47, 48, 52, 53, 54, 55, 58, 60, 65, 67, 68, 69, 72, 73, 75, 76, 78, 80, 89, 92, 93, 95, 97, 98, 99, 109, 110, 111, 114, 116, 117, 118, 119, 135, 137, 139, 149, 150, 152, 153, 154, 158, 160, 170, 173, 174]"
agent_c,L0,middle,86,35,51,2,0.5376,186,"[1, 2, 3, 4, 5, 6, 7, 10, 11, 12, 13, 15, 16, 17, 19, 20, 23, 24, 25, 26, 28, 29, 30, 31, 32, 33, 34, 35, 36, 38, 40, 41, 42, 44, 45, 46, 47, 48, 49, 52, 53, 54, 55, 56, 57, 58, 60, 61, 63, 76, 77, 78, 79, 80, 81, 82, 91, 92, 96, 98, 99, 101, 102, 103, 115, 118, 120, 121, 122, 123, 141, 144, 155, 158, 160, 161, 163, 164, 176, 177, 178, 179, 181, 182, 183, 184]"
agent_c,L0,middle,79,38,41,1,0.5587,179,"[0, 1, 2, 3, 4, 7, 8, 10, 11, 12, 14, 17, 18, 19, 20, 21, 23, 24, 26, 27, 28, 32, 34, 36, 37, 39, 40, 41, 43, 44, 48, 49, 53, 54, 55, 56, 57, 58, 59, 60, 61, 62, 63, 64, 65, 67, 68, 69, 71, 72, 73, 76, 77, 79, 81, 83, 85, 95, 96, 98, 99, 100, 105, 117, 119, 120, 123, 126, 141, 142, 143, 144, 145, 146, 160, 162, 164, 166, 176]"
agent_c,L0,middle,80,23,57,5,0.5556,180,"[1, 2, 3, 4, 5, 7, 9, 13, 14, 16, 17, 18, 19, 20, 21, 22, 23, 26, 27, 28, 29, 32, 34, 36, 37, 38, 39, 41, 42, 43, 44, 49, 50, 51, 52, 53, 55, 56, 58, 59, 62, 63, 64, 65, 67, 68, 69, 73, 74, 75, 76, 77, 78, 85, 96, 97, 98, 100, 101, 102, 103, 104, 117, 118, 119, 120, 123, 124, 137, 140, 141, 143, 147, 160, 163, 164, 167, 175, 177, 178]"
agent_c,L0,middle,83,35,48,1,0.5464,183,"[0, 2, 4, 5, 6, 8, 9, 11, 12, 14, 16, 18, 19, 20, 23, 24, 25, 26, 28, 31, 33, 34, 37, 38, 39, 42, 43, 45, 46, 47, 48, 49, 50, 53, 54, 55, 57, 59, 60, 65, 66, 67, 68, 70, 71, 72, 73, 75, 76, 77, 78, 79, 80, 81, 88, 90, 91, 92, 93, 95, 96, 98, 99, 100, 101, 114, 116, 117, 118, 119, 120, 121, 122, 139, 141, 143, 158, 160, 161, 162, 176, 178, 180]"
agent_c,L0,middle,85,33,52,1,0.5405,185,"[4, 5, 7, 8, 9, 11, 13, 14, 15, 16, 17, 19, 20, 22, 23, 24, 25, 26, 27, 28, 29, 30, 32, 33, 34, 38, 39, 42, 43, 44, 48, 49, 50, 51, 52, 53, 54, 55, 57, 58, 60, 65, 66, 67, 68, 69, 70, 71, 72, 75, 76, 77, 78, 79, 80, 89, 90, 91, 92, 93, 97, 98, 99, 100, 114, 115, 116, 117, 118, 119, 121, 134, 137, 138, 140, 141, 158, 159, 161, 173, 174, 175, 177, 178, 182]"
agent_c,L0,middle,84,35,49,3,0.5435,184,"[0, 1, 2, 4, 5, 6, 7, 8, 10, 13, 16, 17, 18, 19, 20, 22, 23, 25, 26, 27, 28, 29, 31, 32, 33, 38, 39, 40, 41, 44, 45, 46, 48, 49, 51, 52, 54, 55, 56, 57, 58, 60, 69, 73, 75, 76, 77, 78, 79, 81, 88, 89, 92, 96, 98, 99, 101, 111, 112, 113, 115, 116, 117, 118, 123, 136, 140, 141, 151, 152, 153, 155, 156, 158, 159, 161, 172, 176, 177, 178, 179, 180, 181, 182]"
agent_c,L0,middle,78,37,41,5,0.5618,178,"[1, 2, 4, 6, 9, 12, 14, 15, 16, 17, 19, 20, 22, 24, 26, 27, 29, 32, 33, 35, 37, 39, 40, 41, 42, 43, 45, 46, 47, 48, 49, 50, 51, 52, 53, 54, 57, 59, 60, 61, 71, 73, 74, 75, 76, 78, 79, 80, 81, 89, 90, 92, 93, 94, 97, 98, 99, 100, 101, 112, 114, 116, 117, 118, 119, 122, 136, 138, 139, 142, 153, 154, 157, 158, 159, 160, 161, 166]"
agent_c,L0,middle,87,34,53,2,0.5348,187,"[0, 3, 4, 6, 7, 8, 9, 10, 11, 12, 13, 14, 15, 16, 20, 23, 24, 25, 28, 29, 31, 33, 34, 36, 37, 39, 44, 46, 47, 48, 50, 51, 52, 53, 54, 55, 56, 57, 58, 59, 60, 64, 65, 66, 69, 70, 73, 74, 75, 76, 77, 79, 80, 91, 96, 97, 98, 99, 100, 113, 114, 115, 116, 117, 118, 119, 121, 133, 137, 139, 141, 154, 155, 157, 158, 160, 161, 162, 164, 174, 176, 177, 178, 179, 180, 183, 184]"
agent_c,L0,middle,79,34,45,7,0.5587,179,"[0, 2, 3, 4, 6, 10, 11, 12, 13, 14, 15, 17, 18, 19, 20, 22, 23, 24, 25, 26, 28, 32, 33, 34, 35, 36, 37, 39, 41, 42, 43, 46, 47, 48, 50, 51, 52, 54, 56, 57, 59, 60, 61, 62, 63, 68, 76, 78, 79, 80, 81, 82, 83, 84, 92, 93, 94, 95, 97, 98, 99, 101, 102, 103, 104, 117, 119, 120, 121, 122, 123, 124, 142, 144, 159, 160, 161, 164, 166]"
agent_c,L0,middle,86,51,35,3,0.5376,186,"[0, 1, 3, 7, 8, 9, 10, 11, 12, 13, 14, 16, 18, 20, 21, 22, 23, 25, 26, 27, 28, 29, 30, 31, 32, 33, 34, 35, 38, 39, 40, 41, 54, 57, 58, 59, 60, 62, 64, 67, 70, 71, 73, 74, 76, 77, 79, 80, 81, 91, 92, 94, 97, 98, 99, 101, 103, 115, 116, 119, 120, 121, 122, 134, 137, 138, 139, 142, 154, 155, 156, 157, 158, 159, 160, 162, 171, 172, 174, 175, 176, 178, 179, 180, 181, 183]"
agent_c,L0,middle,78,30,48,5,0.5618,178,"[0, 1, 2, 3, 4, 5, 8, 9, 12, 13, 14, 17, 18, 19, 20, 23, 26, 27, 28, 29, 30, 31, 33, 34, 35, 36, 38, 41, 42, 43, 44, 45, 46, 48, 50, 51, 54, 55, 56, 57, 60, 61, 64, 73, 74, 76, 77, 79, 81, 82, 83, 90, 91, 93, 94, 96, 98, 99, 100, 101, 102, 105, 116, 118, 119, 120, 121, 123, 124, 140, 142, 144, 146, 161, 163, 164, 166, 167]"
agent_c,L0,middle,82,32,50,3,0.5495,182,"[0, 1, 2, 5, 7, 8, 9, 10, 11, 12, 14, 15, 17, 19, 21, 22, 24, 25, 27, 28, 31, 33, 34, 38, 40, 41, 42, 44, 48, 51, 53, 54, 55, 57, 58, 59, 63, 67, 68, 69, 71, 72, 74, 75, 76, 77, 79, 85, 86, 87, 92, 94, 98, 99, 108, 111, 112, 113, 116, 117, 118, 119, 132, 133, 134, 135, 136, 137, 138, 140, 153, 156, 157, 158, 161, 172, 174, 176, 177, 178, 179, 180]"
agent_c,L0,middle,78,37,41,2,0.5618,178,"[0, 1, 2, 5, 8, 10, 12, 13, 14, 15, 16, 17, 19, 22, 23, 24, 26, 27, 28, 30, 31, 34, 35, 36, 37, 39, 40, 41, 43, 44, 45, 49, 50, 51, 52, 55, 56, 60, 62, 64, 71, 72, 73, 75, 76, 78, 79, 80, 81, 82, 84, 94, 96, 98, 99, 100, 101, 102, 103, 105, 116, 119, 121, 124, 125, 139, 142, 144, 145, 146, 156, 161, 162, 163, 164, 165, 166, 167]"
agent_c,L0,middle,84,39,45,4,0.5435,184,"[1, 2, 6, 7, 8, 9, 12, 15, 17, 18, 21, 22, 23, 24, 25, 26, 27, 29, 32, 33, 36, 37, 38, 40, 41, 42, 43, 44, 45, 46, 47, 49, 50, 51, 52, 53, 56, 57, 58, 59, 61, 67, 68, 69, 70, 72, 73, 77, 79, 80, 81, 90, 92, 95, 96, 98, 99, 101, 111, 113, 114, 115, 117, 118, 121, 135, 136, 137, 138, 141, 142, 143, 154, 156, 157, 159, 161, 162, 163, 164, 165, 168, 181, 182]"
agent_c,L0,middle,88,40,48,3,0.5319,188,"[0, 1, 2, 3, 6, 7, 11, 13, 14, 15, 17, 19, 20, 21, 22, 23, 24, 25, 26, 27, 28, 30, 31, 32, 35, 36, 37, 38, 39, 43, 45, 46, 47, 48, 52, 53, 55, 57, 59, 61, 65, 66, 68, 69, 71, 72, 73, 74, 75, 77, 80, 82, 90, 91, 92, 93, 95, 97, 98, 99, 100, 106, 120, 121, 123, 136, 137, 138, 140, 141, 142, 143, 157, 159, 160, 161, 162, 163, 173, 174, 175, 177, 178, 179, 180, 181, 182, 183]"
agent_c,L0,middle,86,37,49,2,0.5376,186,"[1, 2, 3, 4, 5, 6, 7, 8, 11, 12, 15, 16, 17, 18, 19, 22, 24, 26, 29, 31, 32, 33, 35, 36, 38, 39, 40, 42, 43, 44, 48, 50, 53, 55, 56, 57, 59, 60, 61, 62, 63, 64, 65, 66, 67, 68, 73, 74, 75, 76, 77, 80, 91, 92, 93, 94, 95, 97, 99, 100, 103, 115, 117, 118, 120, 121, 123, 136, 138, 139, 140, 141, 142, 144, 159, 160, 163, 172, 174, 175, 176, 177, 178, 179, 182, 184]"
agent_c,L0,middle,84,31,53,7,0.5435,184,"[0, 1, 2, 4, 7, 8, 9, 10, 12, 13, 14, 16, 17, 18, 19, 21, 22, 23, 24, 25, 26, 27, 28, 30, 32, 34, 37, 38, 39, 40, 44, 45, 47, 48, 49, 53, 56, 58, 62, 65, 66, 69, 71, 72, 74, 75, 76, 77, 78, 80, 83, 89, 90, 95, 97, 98, 99, 101, 104, 117, 118, 120, 122, 123, 135, 138, 139, 140, 142, 143, 156, 157, 159, 161, 164, 172, 173, 174, 175, 177, 178, 180, 181, 182]"
agent_c,L0,middle,76,27,49,6,0.5682,176,"[3, 6, 8, 10, 11, 12, 14, 16, 18, 20, 21, 25, 26, 28, 30, 32, 35, 36, 37, 38, 39, 40, 41, 43, 44, 45, 47, 48, 49, 50, 51, 53, 54, 56, 57, 58, 59, 65, 66, 68, 73, 75, 76, 77, 78, 80, 88, 89, 90, 91, 93, 94, 95, 97, 98, 99, 110, 111, 112, 113, 115, 117, 118, 119, 123, 135, 139, 140, 141, 157, 160, 161, 162, 164, 172, 174]"
agent_c,L0,middle,86,44,42,6,0.5376,186,"[0, 3, 4, 5, 7, 8, 9, 11, 12, 13, 15, 17, 18, 19, 20, 21, 24, 25, 26, 28, 29, 30, 32, 33, 34, 36, 37, 38, 39, 41, 42, 43, 44, 45, 47, 48, 49, 50, 51, 52, 55, 56, 57, 58, 59, 71, 74, 76, 77, 78, 81, 89, 90, 93, 94, 95, 96, 97, 98, 99, 101, 105, 116, 119, 120, 121, 122, 123, 138, 139, 140, 142, 145, 156, 160, 161, 162, 163, 175, 176, 177, 179, 180, 181, 182, 183]"
agent_c,L0,middle,80,29,51,3,0.5556,180,"[0, 1, 2, 3, 5, 6, 8, 9, 10, 12, 13, 14, 15, 16, 17, 18, 19, 20, 21, 22, 24, 26, 27, 29, 30, 31, 32, 34, 35, 36, 37, 39, 41, 48, 49, 53, 56, 58, 59, 60, 61, 63, 64, 65, 69, 72, 73, 78, 81, 82, 88, 90, 91, 92, 95, 96, 97, 98, 99, 101, 102, 106, 120, 122, 123, 124, 125, 137, 139, 140, 141, 142, 143, 145, 159, 164, 165, 176, 177, 178]"
agent_c,L0,middle,78,37,41,3,0.5618,178,"[0, 1, 2, 4, 5, 6, 10, 11, 13, 14, 15, 16, 18, 20, 21, 22, 23, 26, 27, 29, 30, 33, 35, 36, 37, 39, 40, 42, 43, 44, 46, 47, 48, 49, 51, 52, 53, 54, 55, 56, 57, 59, 60, 62, 71, 72, 76, 77, 79, 81, 88, 90, 91, 95, 96, 98, 99, 100, 101, 112, 115, 117, 118, 120, 122, 135, 137, 138, 141, 143, 153, 156, 157, 160, 161, 162, 163, 175]"
agent_c,L0,middle,86,46,40,5,0.5376,186,"[1, 3, 5, 7, 9, 12, 15, 17, 20, 21, 22, 23, 24, 27, 30, 31, 32, 33, 35, 36, 39, 41, 44, 45, 47, 49, 50, 51, 53, 54, 55, 56, 57, 58, 59, 60, 62, 63, 64, 65, 67, 68, 71, 72, 73, 74, 75, 76, 78, 79, 81, 89, 90, 91, 92, 93, 95, 96, 98, 99, 101, 115, 116, 117, 118, 119, 120, 121, 122, 135, 138, 139, 140, 143, 157, 159, 160, 161, 162, 174, 175, 176, 178, 180, 181, 183]"
agent_c,L0,middle,79,51,28,8,0.5587,179,"[0, 1, 2, 4, 9, 10, 11, 12, 13, 15, 17, 18, 20, 24, 25, 26, 28, 29, 30, 31, 32, 33, 34, 35, 36, 37, 39, 40, 41, 42, 44, 47, 49, 51, 52, 53, 56, 57, 61, 69, 70, 71, 73, 75, 76, 78, 80, 86, 87, 88, 90, 92, 93, 94, 95, 96, 97, 99, 100, 112, 113, 114, 117, 124, 139, 142, 153, 155, 156, 157, 158, 160, 169, 170, 171, 173, 174, 175, 176]"
agent_c,L0,middle,85,39,46,1,0.5405,185,"[1, 2, 3, 4, 5, 6, 7, 8, 9, 11, 14, 15, 16, 17, 18, 19, 20, 23, 24, 25, 26, 28, 31, 33, 34, 35, 38, 40, 41, 43, 45, 46, 47, 48, 49, 50, 53, 55, 56, 58, 59, 60, 61, 69, 73, 74, 75, 76, 77, 80, 81, 89, 90, 91, 92, 93, 95, 97, 98, 99, 100, 101, 102, 113, 117, 120, 122, 137, 138, 139, 140, 143, 155, 158, 159, 160, 162, 163, 164, 176, 178, 179, 180, 181, 182]"
agent_c,L0,middle,85,50,35,9,0.5405,185,"[0, 1, 2, 3, 4, 5, 6, 7, 8, 9, 10, 12, 13, 14, 15, 18, 21, 22, 23, 24, 25, 27, 28, 31, 33, 35, 37, 39, 40, 42, 48, 50, 52, 53, 54, 56, 57, 59, 61, 62, 65, 66, 69, 71, 73, 75, 76, 77, 79, 81, 88, 90, 91, 92, 93, 94, 95, 96, 97, 99, 100, 102, 113, 118, 120, 121, 123, 136, 138, 139, 140, 147, 160, 162, 169, 170, 172, 173, 174, 176, 177, 180, 181, 182, 183]"
agent_c,L0,middle,90,34,56,1,0.5263,190,"[2, 3, 4, 5, 6, 7, 9, 10, 12, 14, 16, 18, 19, 20, 21, 23, 25, 27, 29, 31, 34, 36, 37, 38, 39, 41, 43, 45, 50, 51, 52, 53, 54, 56, 57, 58, 60, 62, 63, 64, 65, 67, 68, 70, 72, 75, 76, 83, 84, 85, 92, 93, 94, 97, 98, 100, 101, 102, 105, 117, 119, 120, 123, 124, 125, 126, 137, 140, 141, 142, 144, 145, 146, 159, 161, 162, 163, 164, 167, 176, 177, 178, 179, 180, 182, 183, 184, 185, 186, 187]"
agent_c,L0,middle,73,31,42,11,0.578,173,"[0, 2, 3, 4, 5, 6, 7, 8, 11, 13, 16, 17, 18, 23, 25, 28, 29, 33, 34, 35, 37, 43, 44, 45, 46, 47, 48, 51, 53, 54, 55, 57, 59, 60, 61, 62, 64, 65, 68, 70, 71, 72, 73, 74, 75, 77, 78, 82, 87, 88, 89, 93, 95, 96, 98, 100, 110, 111, 115, 119, 121, 132, 133, 134, 135, 136, 139, 140, 143, 155, 157, 160, 163]"
agent_c,L50,middle,70,23,47,9,0.5882,170,"[0, 1, 2, 3, 4, 7, 10, 13, 14, 15, 16, 17, 21, 22, 24, 25, 26, 28, 29, 31, 32, 33, 34, 35, 36, 38, 41, 49, 50, 51, 53, 54, 55, 57, 59, 61, 67, 68, 69, 70, 71, 72, 73, 76, 77, 81, 92, 93, 95, 96, 97, 98, 99, 105, 119, 122, 134, 135, 136, 137, 138, 140, 143, 153, 154, 155, 156, 158, 162, 168]"
agent_c,L50,middle,77,25,52,0,0.565,177,"[0, 3, 4, 8, 9, 10, 11, 12, 14, 17, 18, 19, 23, 24, 25, 27, 28, 29, 32, 34, 35, 39, 40, 41, 42, 43, 44, 46, 49, 50, 51, 57, 58, 59, 68, 69, 70, 72, 74, 78, 79, 86, 87, 90, 91, 94, 95, 96, 98, 99, 109, 110, 111, 112, 114, 117, 119, 132, 133, 134, 135, 136, 137, 138, 140, 141, 153, 154, 155, 156, 157, 158, 159, 161, 173, 174, 175]"
agent_c,L50,middle,72,34,38,9,0.5814,172,"[1, 2, 3, 4, 7, 8, 10, 11, 12, 13, 14, 15, 16, 17, 18, 22, 30, 32, 33, 35, 36, 37, 39, 42, 43, 44, 45, 47, 49, 50, 51, 52, 53, 55, 56, 57, 58, 59, 60, 70, 71, 75, 76, 77, 78, 79, 81, 91, 92, 93, 94, 97, 98, 99, 100, 102, 114, 116, 117, 118, 120, 124, 139, 140, 141, 142, 156, 157, 158, 161, 163, 170]"
agent_c,L50,middle,71,26,45,4,0.5848,171,"[0, 1, 3, 4, 6, 7, 8, 9, 10, 11, 12, 13, 15, 17, 18, 19, 26, 28, 29, 31, 32, 33, 34, 36, 37, 39, 40, 41, 42, 43, 44, 45, 46, 48, 50, 51, 52, 54, 57, 60, 71, 72, 75, 76, 77, 79, 80, 81, 91, 92, 93, 94, 95, 96, 97, 98, 100, 104, 116, 117, 118, 120, 121, 136, 137, 140, 141, 143, 155, 160, 162]"
agent_c,L50,middle,75,30,45,0,0.5714,175,"[0, 2, 3, 4, 6, 7, 10, 13, 14, 15, 16, 19, 20, 21, 22, 23, 24, 25, 26, 27, 30, 31, 32, 33, 34, 35, 36, 38, 39, 41, 42, 57, 58, 61, 62, 69, 70, 71, 73, 74, 82, 87, 88, 89, 90, 91, 92, 98, 100, 101, 102, 113, 114, 116, 119, 120, 121, 122, 133, 134, 137, 138, 141, 142, 143, 144, 155, 156, 159, 160, 161, 164, 170, 171, 172]"
agent_c,L50,middle,73,27,46,4,0.578,173,"[0, 3, 4, 8, 9, 12, 13, 14, 15, 16, 18, 20, 23, 24, 25, 26, 27, 28, 29, 30, 31, 33, 34, 35, 36, 38, 39, 42, 50, 51, 52, 53, 55, 57, 58, 60, 62, 71, 72, 73, 75, 78, 79, 80, 81, 83, 92, 93, 94, 95, 96, 100, 101, 103, 115, 117, 118, 121, 122, 124, 135, 139, 142, 144, 154, 155, 157, 158, 160, 163, 169, 170, 171]"
agent_c,L50,middle,76,37,39,7,0.5682,176,"[0, 1, 3, 4, 5, 6, 9, 12, 13, 16, 18, 19, 23, 24, 26, 29, 30, 31, 32, 35, 36, 37, 38, 42, 43, 44, 45, 48, 50, 51, 52, 56, 57, 58, 60, 70, 71, 72, 73, 74, 75, 77, 78, 80, 89, 90, 91, 92, 93, 95, 96, 98, 99, 108, 109, 110, 111, 112, 113, 116, 117, 118, 119, 120, 137, 138, 139, 140, 154, 155, 156, 157, 159, 160, 161, 164]"
agent_c,L50,middle,74,30,44,5,0.5747,174,"[0, 2, 4, 5, 6, 9, 11, 12, 15, 17, 18, 19, 21, 26, 27, 28, 29, 32, 34, 35, 38, 39, 40, 41, 42, 43, 46, 47, 49, 50, 53, 54, 55, 56, 57, 58, 59, 60, 61, 62, 74, 75, 76, 77, 78, 79, 83, 93, 94, 95, 96, 97, 98, 101, 103, 113, 114, 115, 117, 118, 119, 121, 122, 136, 138, 140, 141, 143, 157, 158, 159, 161, 162, 165]"
agent_c,L50,middle,80,39,41,4,0.5556,180,"[1, 2, 4, 6, 7, 8, 9, 10, 11, 13, 14, 15, 16, 17, 18, 19, 27, 28, 32, 33, 34, 35, 36, 37, 38, 42, 44, 45, 46, 47, 48, 51, 52, 53, 56, 59, 60, 72, 74, 75, 76, 77, 79, 80, 89, 90, 91, 92, 93, 94, 95, 99, 101, 111, 113, 114, 115, 116, 117, 118, 119, 120, 121, 135, 136, 137, 138, 139, 140, 141, 156, 158, 160, 161, 172, 173, 175, 176, 177, 178]"
agent_c,L50,middle,76,15,61,4,0.5682,176,"[1, 2, 3, 5, 6, 7, 9, 11, 14, 15, 16, 18, 19, 23, 24, 25, 27, 28, 29, 30, 31, 32, 33, 36, 38, 39, 41, 42, 43, 46, 47, 48, 50, 51, 53, 54, 55, 57, 58, 59, 70, 71, 73, 74, 75, 76, 77, 78, 79, 92, 93, 94, 95, 96, 99, 100, 101, 102, 108, 121, 122, 123, 125, 126, 142, 143, 144, 145, 146, 159, 160, 161, 162, 163, 164, 166]"
agent_c,L50,middle,79,38,41,7,0.5587,179,"[0, 1, 2, 4, 5, 6, 7, 11, 12, 13, 14, 15, 16, 17, 18, 21, 22, 23, 25, 26, 27, 28, 29, 30, 32, 33, 35, 36, 38, 42, 53, 54, 56, 57, 59, 65, 66, 67, 68, 69, 70, 71, 72, 74, 76, 77, 79, 80, 91, 92, 93, 97, 100, 103, 115, 116, 117, 118, 120, 121, 122, 135, 137, 138, 140, 141, 142, 145, 157, 158, 159, 161, 162, 164, 172, 173, 174, 175, 176]"
agent_c,L50,middle,74,39,35,2,0.5747,174,"[0, 1, 4, 5, 8, 9, 13, 16, 18, 21, 22, 24, 26, 28, 30, 31, 32, 34, 35, 37, 39, 40, 44, 45, 47, 49, 50, 51, 55, 56, 58, 59, 60, 61, 62, 63, 64, 65, 66, 74, 75, 76, 78, 79, 80, 81, 82, 85, 86, 87, 96, 97, 98, 99, 104, 105, 106, 107, 122, 123, 126, 127, 140, 142, 143, 144, 146, 147, 161, 162, 163, 164, 165, 167]"
agent_c,L50,middle,70,37,33,6,0.5882,170,"[0, 1, 2, 6, 7, 8, 10, 12, 13, 14, 15, 16, 18, 20, 22, 23, 24, 25, 26, 28, 29, 31, 33, 34, 35, 36, 37, 38, 40, 52, 55, 56, 57, 58, 60, 62, 70, 71, 72, 73, 74, 75, 77, 78, 79, 80, 82, 84, 94, 97, 98, 99, 101, 102, 104, 116, 117, 120, 122, 123, 126, 139, 142, 143, 144, 157, 159, 161, 163, 164]"
agent_c,L50,middle,78,45,33,0,0.5618,178,"[0, 1, 2, 3, 4, 9, 10, 14, 15, 16, 17, 18, 19, 23, 26, 28, 31, 34, 35, 36, 37, 38, 39, 40, 42, 43, 44, 45, 47, 49, 50, 51, 52, 53, 54, 55, 57, 58, 59, 60, 71, 72, 73, 74, 75, 79, 80, 81, 92, 93, 94, 95, 97, 98, 99, 100, 101, 112, 116, 120, 121, 122, 137, 138, 139, 140, 141, 142, 144, 145, 146, 158, 160, 161, 163, 165, 166, 167]"
agent_c,L50,middle,77,37,40,2,0.565,177,"[0, 1, 2, 4, 5, 6, 7, 8, 9, 10, 11, 12, 13, 14, 17, 18, 19, 27, 28, 30, 33, 34, 35, 36, 38, 39, 40, 41, 42, 43, 44, 45, 46, 47, 48, 49, 51, 53, 54, 58, 59, 71, 72, 74, 76, 78, 80, 91, 92, 93, 94, 97, 98, 99, 109, 110, 114, 115, 117, 120, 133, 134, 135, 136, 137, 138, 139, 140, 141, 142, 156, 157, 158, 159, 160, 161, 162]"
agent_c,L50,middle,78,43,35,7,0.5618,178,"[0, 1, 2, 4, 8, 9, 11, 12, 14, 18, 19, 20, 22, 25, 27, 28, 29, 30, 31, 32, 35, 36, 38, 39, 41, 42, 43, 45, 46, 47, 56, 57, 58, 59, 60, 61, 63, 64, 65, 66, 68, 78, 79, 80, 82, 83, 84, 86, 87, 91, 100, 101, 102, 104, 105, 106, 107, 108, 122, 123, 124, 125, 126, 127, 130, 145, 148, 149, 151, 162, 163, 164, 165, 166, 167, 168, 169, 170]"
agent_c,L50,middle,79,28,51,2,0.5587,179,"[0, 1, 2, 3, 4, 5, 7, 8, 9, 11, 13, 15, 16, 17, 19, 20, 27, 30, 31, 32, 33, 34, 36, 37, 38, 39, 41, 45, 46, 47, 48, 49, 50, 51, 52, 53, 54, 55, 56, 57, 58, 59, 60, 74, 75, 76, 79, 81, 91, 93, 94, 95, 98, 99, 100, 110, 111, 112, 113, 114, 115, 116, 117, 118, 119, 120, 137, 139, 140, 141, 156, 157, 158, 160, 162, 163, 174, 175, 176]"
agent_c,L50,middle,73,26,47,3,0.578,173,"[0, 2, 3, 4, 6, 7, 9, 11, 15, 16, 19, 22, 23, 24, 25, 26, 27, 28, 29, 30, 31, 32, 33, 35, 36, 38, 39, 42, 43, 44, 45, 46, 47, 48, 49, 53, 55, 58, 59, 70, 73, 74, 75, 77, 78, 80, 89, 90, 91, 92, 93, 94, 95, 96, 98, 99, 110, 111, 113, 115, 117, 118, 119, 136, 138, 139, 142, 143, 155, 156, 159, 162, 165]"
agent_c,L50,middle,73,37,36,3,0.578,173,"[0, 1, 2, 3, 4, 6, 7, 8, 9, 10, 11, 12, 13, 15, 16, 18, 20, 23, 24, 25, 29, 30, 31, 33, 34, 35, 36, 37, 38, 39, 52, 53, 56, 57, 58, 59, 66, 67, 68, 69, 70, 71, 75, 76, 77, 79, 88, 90, 91, 92, 93, 95, 96, 98, 101, 116, 117, 118, 119, 120, 135, 136, 137, 138, 139, 140, 153, 154, 156, 157, 158, 159, 161]"
agent_c,L50,middle,81,31,50,5,0.5525,181,"[0, 1, 3, 4, 5, 8, 10, 11, 12, 13, 14, 15, 16, 17, 18, 20, 27, 28, 31, 32, 33, 34, 36, 37, 39, 40, 41, 42, 43, 46, 48, 50, 51, 54, 56, 57, 60, 71, 72, 73, 74, 76, 77, 78, 81, 91, 92, 93, 94, 95, 96, 97, 98, 99, 100, 101, 111, 116, 117, 118, 120, 122, 138, 141, 151, 152, 153, 154, 155, 157, 158, 159, 160, 162, 172, 173, 174, 176, 177, 178, 179]"
agent_c,L50,middle,76,38,38,5,0.5682,176,"[0, 4, 5, 7, 8, 9, 11, 12, 13, 15, 16, 17, 18, 19, 20, 21, 22, 23, 25, 26, 27, 28, 30, 31, 32, 35, 36, 37, 38, 39, 56, 57, 59, 60, 63, 69, 70, 72, 75, 76, 77, 78, 81, 89, 92, 93, 94, 95, 96, 98, 99, 101, 112, 113, 114, 115, 116, 117, 118, 119, 123, 135, 137, 139, 140, 142, 154, 155, 156, 157, 158, 161, 162, 163, 172, 174]"
agent_c,L50,middle,75,35,40,4,0.5714,175,"[0, 1, 3, 5, 6, 7, 8, 9, 10, 12, 14, 15, 16, 17, 18, 19, 21, 22, 24, 25, 26, 27, 28, 29, 30, 31, 32, 33, 35, 37, 38, 40, 41, 55, 56, 57, 60, 61, 62, 72, 73, 74, 78, 79, 80, 81, 82, 93, 94, 95, 98, 99, 100, 102, 115, 117, 118, 120, 121, 126, 138, 140, 141, 142, 143, 144, 155, 156, 157, 158, 160, 161, 162, 164, 172]"
agent_c,L50,middle,74,29,45,1,0.5747,174,"[1, 3, 5, 7, 8, 10, 12, 13, 15, 18, 20, 21, 23, 26, 28, 29, 30, 32, 33, 34, 35, 36, 38, 40, 42, 48, 49, 52, 53, 54, 56, 57, 58, 59, 60, 61, 63, 64, 74, 78, 80, 81, 82, 83, 84, 91, 93, 94, 95, 97, 99, 100, 102, 104, 105, 120, 123, 124, 125, 127, 138, 140, 141, 142, 143, 145, 146, 147, 160, 161, 163, 164, 166, 167]"
agent_c,L50,middle,77,37,40,2,0.565,177,"[0, 1, 2, 3, 4, 9, 10, 11, 13, 16, 18, 19, 22, 24, 25, 27, 28, 29, 30, 31, 32, 33, 34, 36, 39, 40, 48, 49, 50, 51, 52, 54, 58, 59, 60, 61, 69, 71, 72, 73, 75, 76, 77, 79, 80, 81, 82, 93, 94, 96, 97, 98, 102, 114, 115, 117, 118, 120, 121, 122, 137, 138, 139, 140, 141, 142, 143, 155, 156, 157, 160, 161, 163, 171, 172, 173, 174]"
agent_c,L50,middle,71,30,41,4,0.5848,171,"[1, 2, 3, 5, 6, 7, 8, 9, 12, 13, 14, 15, 19, 20, 22, 23, 25, 27, 29, 31, 32, 33, 36, 37, 38, 41, 48, 51, 52, 54, 55, 58, 59, 60, 65, 66, 67, 68, 69, 71, 73, 74, 77, 78, 79, 80, 89, 90, 91, 92, 97, 100, 101, 102, 114, 119, 120, 123, 137, 138, 140, 141, 143, 153, 155, 156, 157, 161, 162, 167, 169]"
agent_c,L50,middle,76,26,50,7,0.5682,176,"[1, 3, 5, 6, 7, 8, 9, 10, 11, 12, 13, 14, 15, 16, 21, 26, 27, 28, 29, 30, 32, 33, 34, 35, 36, 39, 40, 41, 42, 44, 45, 46, 48, 49, 50, 51, 52, 53, 54, 56, 57, 58, 59, 61, 62, 63, 65, 82, 83, 84, 95, 97, 98, 99, 100, 101, 102, 104, 116, 121, 122, 128, 142, 143, 144, 145, 146, 158, 159, 160, 161, 162, 163, 165, 166, 168]"
agent_c,L50,middle,84,34,50,3,0.5435,184,"[0, 1, 2, 3, 6, 7, 9, 11, 13, 14, 15, 19, 21, 22, 23, 24, 25, 26, 27, 28, 30, 31, 32, 33, 34, 35, 36, 37, 39, 40, 53, 55, 57, 58, 60, 61, 62, 63, 72, 73, 76, 77, 78, 80, 81, 84, 95, 97, 98, 101, 104, 115, 117, 118, 119, 120, 121, 123, 124, 137, 138, 139, 141, 142, 143, 144, 146, 157, 158, 159, 160, 161, 162, 163, 164, 166, 174, 175, 176, 177, 179, 180, 181, 182]"
agent_c,L50,middle,77,37,40,4,0.565,177,"[2, 3, 4, 7, 8, 9, 10, 11, 12, 13, 14, 15, 16, 17, 21, 30, 31, 36, 37, 38, 40, 41, 42, 43, 44, 47, 48, 49, 52, 53, 54, 55, 56, 57, 59, 60, 61, 62, 63, 64, 74, 75, 76, 78, 79, 80, 81, 82, 83, 84, 85, 97, 98, 99, 100, 104, 105, 107, 120, 121, 122, 123, 124, 125, 126, 141, 143, 144, 145, 146, 159, 160, 162, 163, 164, 165, 167]"
agent_c,L50,middle,80,38,42,1,0.5556,180,"[0, 1, 3, 4, 5, 9, 10, 11, 12, 13, 14, 15, 17, 19, 20, 21, 23, 24, 25, 26, 27, 30, 31, 32, 33, 36, 37, 39, 40, 41, 52, 53, 54, 55, 56, 59, 60, 61, 68, 69, 70, 71, 72, 73, 76, 78, 79, 82, 83, 95, 96, 101, 102, 103, 115, 117, 118, 119, 120, 121, 122, 123, 138, 140, 141, 142, 143, 144, 156, 157, 158, 159, 162, 163, 166, 173, 174, 175, 176, 177]"
agent_c,L50,middle,74,35,39,2,0.5747,174,"[0, 1, 2, 4, 5, 6, 7, 8, 9, 10, 11, 12, 13, 20, 25, 26, 28, 29, 30, 31, 32, 37, 40, 41, 43, 44, 46, 48, 49, 51, 52, 53, 54, 55, 56, 57, 58, 59, 60, 61, 74, 75, 76, 77, 78, 79, 80, 81, 91, 93, 94, 97, 98, 100, 102, 113, 114, 115, 118, 120, 121, 122, 137, 138, 139, 140, 142, 154, 156, 158, 159, 160, 161, 164]"
agent_c,L50,middle,72,37,35,2,0.5814,172,"[1, 3, 5, 7, 8, 9, 10, 11, 13, 14, 15, 16, 18, 19, 20, 21, 22, 25, 28, 29, 31, 32, 33, 36, 38, 40, 48, 49, 50, 51, 54, 56, 57, 60, 61, 63, 65, 73, 74, 75, 76, 78, 79, 80, 82, 84, 93, 98, 103, 105, 116, 117, 118, 119, 121, 122, 123, 126, 127, 137, 141, 142, 143, 144, 145, 147, 148, 160, 161, 162, 167, 168]"
agent_c,L50,middle,74,28,46,9,0.5747,174,"[0, 1, 3, 4, 6, 9, 11, 12, 13, 14, 16, 17, 19, 23, 24, 25, 26, 27, 29, 34, 35, 36, 37, 38, 40, 42, 44, 45, 46, 49, 50, 52, 53, 54, 56, 58, 59, 63, 73, 74, 75, 76, 77, 78, 80, 86, 95, 97, 99, 100, 102, 114, 115, 116, 117, 119, 123, 136, 138, 139, 141, 142, 145, 153, 154, 155, 156, 158, 159, 160, 161, 163, 164, 165]"
agent_c,L50,middle,73,25,48,4,0.578,173,"[0, 1, 2, 3, 4, 5, 8, 10, 11, 13, 14, 15, 18, 23, 24, 26, 27, 28, 29, 30, 32, 33, 34, 36, 38, 39, 48, 49, 51, 52, 53, 54, 55, 56, 57, 58, 59, 60, 70, 73, 76, 77, 78, 79, 80, 88, 92, 94, 98, 99, 100, 111, 112, 113, 114, 115, 118, 120, 132, 134, 135, 136, 137, 138, 139, 140, 157, 159, 162, 163, 168, 169, 171]"
agent_c,L50,middle,77,33,44,3,0.565,177,"[0, 1, 2, 3, 4, 6, 7, 8, 9, 10, 11, 13, 15, 16, 17, 18, 19, 20, 23, 24, 27, 29, 32, 33, 35, 36, 37, 39, 50, 51, 52, 53, 55, 58, 59, 67, 68, 70, 71, 73, 74, 75, 76, 78, 79, 80, 81, 94, 95, 96, 100, 101, 112, 115, 116, 118, 120, 122, 132, 134, 135, 136, 137, 138, 140, 141, 143, 155, 157, 158, 159, 160, 161, 163, 172, 174, 175]"
agent_c,L50,middle,77,33,44,3,0.565,177,"[1, 3, 6, 7, 9, 10, 11, 12, 15, 16, 17, 18, 20, 26, 27, 30, 33, 36, 38, 39, 40, 41, 42, 44, 47, 48, 50, 51, 53, 54, 55, 57, 58, 60, 69, 71, 72, 74, 75, 77, 78, 79, 80, 89, 90, 91, 92, 94, 95, 96, 97, 98, 99, 100, 101, 102, 114, 115, 116, 117, 120, 121, 122, 136, 139, 141, 143, 158, 159, 160, 161, 162, 164, 172, 173, 174, 175]"
agent_c,L50,middle,70,42,28,5,0.5882,170,"[0, 1, 2, 3, 4, 5, 7, 8, 9, 11, 12, 13, 17, 20, 22, 23, 24, 26, 28, 29, 30, 31, 32, 33, 34, 36, 37, 38, 39, 41, 52, 55, 56, 57, 60, 61, 70, 72, 74, 75, 76, 77, 78, 79, 80, 81, 83, 93, 94, 97, 98, 100, 105, 117, 118, 119, 120, 121, 123, 125, 139, 140, 142, 143, 145, 157, 158, 161, 163, 164]"
agent_c,L50,middle,74,46,28,3,0.5747,174,"[0, 1, 2, 5, 11, 12, 14, 15, 16, 18, 19, 20, 21, 22, 23, 24, 29, 33, 34, 35, 36, 38, 39, 41, 43, 51, 52, 53, 55, 59, 60, 62, 63, 70, 71, 76, 80, 82, 84, 90, 91, 92, 95, 97, 100, 101, 102, 103, 104, 105, 106, 108, 120, 122, 123, 124, 125, 126, 127, 128, 139, 140, 141, 143, 144, 147, 150, 161, 162, 163, 164, 165, 167, 170]"
agent_c,L50,middle,80,45,35,2,0.5556,180,"[0, 4, 5, 6, 7, 8, 10, 12, 13, 14, 17, 18, 19, 23, 27, 28, 29, 30, 32, 33, 37, 38, 39, 41, 42, 43, 44, 45, 46, 48, 49, 51, 52, 53, 54, 60, 70, 73, 74, 75, 77, 80, 88, 91, 92, 93, 94, 95, 96, 97, 99, 109, 110, 111, 112, 114, 116, 117, 118, 119, 132, 133, 135, 136, 140, 141, 143, 154, 155, 156, 158, 160, 161, 162, 163, 174, 175, 176, 177, 178]"
agent_c,L50,middle,76,31,45,11,0.5682,176,"[0, 2, 3, 7, 8, 10, 15, 16, 17, 18, 19, 22, 23, 25, 26, 27, 30, 31, 32, 33, 34, 35, 37, 39, 41, 43, 44, 45, 46, 49, 52, 53, 54, 56, 57, 58, 59, 61, 72, 73, 74, 75, 77, 79, 80, 81, 82, 93, 94, 95, 97, 98, 99, 100, 101, 105, 115, 119, 120, 123, 125, 130, 142, 143, 144, 145, 147, 157, 159, 160, 161, 162, 163, 164, 165, 167]"
agent_c,L50,middle,71,43,28,3,0.5848,171,"[1, 3, 4, 5, 8, 10, 11, 12, 14, 15, 16, 18, 20, 21, 22, 23, 25, 29, 30, 34, 35, 38, 39, 40, 47, 48, 50, 51, 52, 54, 55, 56, 57, 59, 60, 66, 67, 68, 69, 71, 72, 74, 75, 76, 77, 78, 79, 81, 91, 97, 98, 99, 101, 115, 116, 118, 120, 132, 133, 134, 137, 138, 139, 140, 153, 154, 156, 159, 160, 167, 168]"
agent_c,L50,middle,73,33,40,3,0.578,173,"[1, 2, 4, 5, 7, 11, 12, 13, 15, 16, 18, 19, 20, 23, 24, 25, 26, 27, 28, 30, 31, 32, 34, 36, 37, 38, 39, 49, 51, 52, 53, 55, 58, 59, 62, 69, 71, 72, 73, 75, 76, 77, 78, 80, 81, 91, 93, 94, 95, 96, 97, 98, 100, 101, 102, 116, 117, 118, 119, 120, 121, 124, 136, 143, 146, 156, 157, 159, 160, 162, 163, 164, 171]"
agent_c,L50,middle,71,38,33,6,0.5848,171,"[0, 1, 2, 4, 6, 7, 9, 10, 13, 14, 15, 18, 19, 20, 25, 26, 27, 29, 30, 31, 32, 33, 34, 36, 38, 40, 42, 47, 48, 49, 50, 51, 52, 53, 54, 55, 56, 57, 58, 60, 63, 76, 77, 78, 81, 90, 91, 92, 93, 94, 97, 98, 101, 111, 112, 113, 115, 116, 117, 120, 123, 140, 142, 153, 155, 158, 160, 161, 167, 168, 169]"
agent_c,L50,middle,69,36,33,7,0.5917,169,"[0, 1, 2, 3, 4, 5, 7, 8, 10, 11, 13, 14, 15, 17, 19, 26, 28, 30, 31, 32, 33, 34, 35, 36, 37, 38, 40, 42, 46, 47, 48, 49, 51, 53, 56, 57, 61, 74, 75, 78, 80, 87, 88, 89, 90, 91, 92, 93, 97, 98, 99, 102, 111, 112, 113, 117, 120, 122, 134, 135, 136, 140, 142, 154, 155, 157, 159, 161, 162]"
agent_c,L50,middle,79,22,57,1,0.5587,179,"[0, 1, 2, 3, 5, 6, 7, 9, 10, 11, 13, 14, 15, 16, 18, 19, 22, 23, 24, 25, 26, 27, 28, 29, 30, 31, 32, 33, 34, 35, 36, 37, 38, 39, 53, 54, 57, 58, 59, 61, 70, 71, 73, 74, 75, 76, 77, 78, 79, 80, 81, 94, 95, 96, 100, 101, 115, 116, 117, 118, 122, 138, 140, 141, 153, 154, 155, 156, 157, 158, 159, 160, 161, 171, 172, 174, 175, 176, 177]"
agent_c,L50,middle,75,38,37,2,0.5714,175,"[0, 1, 4, 5, 6, 7, 8, 9, 10, 11, 13, 16, 17, 18, 19, 20, 26, 28, 30, 35, 37, 38, 39, 45, 47, 48, 49, 50, 53, 54, 55, 56, 57, 58, 59, 65, 68, 70, 71, 72, 73, 75, 78, 79, 81, 92, 93, 96, 97, 98, 99, 100, 113, 114, 115, 116, 117, 120, 132, 133, 134, 135, 136, 137, 138, 139, 140, 154, 155, 156, 157, 158, 159, 161, 173]"
agent_c,L50,middle,75,26,49,3,0.5714,175,"[0, 1, 2, 3, 4, 6, 7, 8, 10, 11, 12, 15, 17, 18, 19, 20, 22, 23, 24, 25, 26, 27, 28, 29, 30, 31, 33, 34, 35, 40, 52, 57, 58, 59, 61, 70, 71, 72, 74, 77, 78, 80, 82, 89, 90, 91, 93, 94, 95, 99, 100, 101, 112, 113, 114, 115, 116, 117, 123, 136, 138, 139, 140, 141, 142, 154, 155, 156, 158, 159, 161, 162, 170, 171, 172]"
agent_c,L50,middle,75,34,41,4,0.5714,175,"[0, 2, 4, 6, 7, 8, 9, 12, 13, 14, 15, 16, 17, 18, 19, 25, 26, 27, 32, 33, 35, 37, 40, 41, 42, 44, 45, 46, 47, 49, 50, 51, 52, 53, 57, 58, 59, 71, 72, 73, 74, 75, 77, 79, 88, 89, 90, 91, 93, 96, 99, 100, 101, 112, 113, 116, 117, 118, 119, 120, 121, 122, 124, 140, 142, 143, 145, 157, 158, 160, 161, 162, 163, 165, 168]"
agent_c,L50,middle,80,24,56,1,0.5556,180,"[0, 2, 5, 6, 7, 8, 9, 10, 11, 12, 13, 15, 19, 24, 25, 26, 27, 28, 29, 30, 31, 33, 36, 37, 38, 39, 40, 41, 43, 46, 48, 50, 52, 53, 54, 57, 58, 59, 69, 70, 71, 72, 73, 74, 75, 78, 79, 80, 93, 94, 95, 97, 98, 99, 100, 110, 111, 112, 113, 114, 115, 118, 119, 121, 137, 138, 139, 141, 155, 157, 158, 159, 160, 161, 172, 173, 174, 175, 176, 178]"
agent_c,L50,middle,76,34,42,8,0.5682,176,"[1, 2, 3, 4, 5, 6, 8, 9, 11, 12, 13, 14, 15, 17, 18, 19, 27, 29, 30, 32, 33, 36, 37, 38, 40, 43, 45, 46, 49, 50, 51, 54, 55, 57, 59, 63, 71, 72, 74, 75, 76, 77, 78, 81, 90, 91, 92, 94, 96, 97, 98, 102, 111, 112, 115, 116, 118, 119, 122, 135, 136, 137, 140, 142, 146, 155, 156, 157, 159, 160, 161, 162, 163, 172, 173, 174]"
agent_c,L50,middle,72,36,36,1,0.5814,172,"[0, 2, 3, 4, 5, 6, 9, 10, 11, 12, 13, 14, 15, 16, 17, 19, 21, 22, 23, 24, 25, 26, 27, 29, 32, 33, 34, 35, 36, 37, 38, 39, 40, 55, 56, 57, 60, 61, 69, 70, 71, 72, 73, 75, 76, 77, 78, 81, 82, 92, 93, 94, 95, 96, 99, 100, 101, 102, 115, 121, 123, 135, 140, 141, 142, 144, 155, 157, 158, 160, 161, 164]"
agent_c,L50,middle,78,41,37,4,0.5618,178,"[0, 1, 2, 3, 4, 5, 6, 7, 8, 9, 10, 11, 12, 13, 14, 15, 16, 17, 20, 23, 26, 28, 32, 33, 34, 36, 37, 38, 40, 41, 52, 53, 54, 57, 58, 59, 60, 61, 68, 70, 71, 72, 73, 74, 76, 77, 78, 79, 80, 81, 84, 94, 98, 99, 100, 101, 102, 116, 118, 121, 123, 135, 137, 138, 139, 141, 143, 155, 156, 157, 159, 160, 161, 163, 172, 174, 175, 176]"
agent_c,L50,middle,86,37,49,5,0.5376,186,"[0, 1, 3, 4, 5, 6, 7, 8, 9, 11, 13, 14, 15, 17, 18, 19, 20, 21, 29, 30, 31, 32, 33, 35, 37, 42, 44, 46, 48, 49, 51, 52, 53, 54, 56, 57, 58, 59, 60, 61, 66, 76, 77, 80, 81, 82, 95, 97, 98, 99, 100, 101, 102, 103, 113, 114, 117, 118, 119, 122, 123, 138, 139, 140, 141, 142, 144, 145, 157, 158, 161, 162, 163, 164, 165, 174, 175, 176, 177, 178, 179, 180, 181, 182, 183, 184]"
agent_c,L50,middle,75,36,39,2,0.5714,175,"[0, 1, 2, 3, 4, 7, 8, 10, 12, 14, 15, 16, 19, 23, 24, 25, 26, 28, 29, 30, 32, 33, 34, 36, 37, 38, 41, 42, 46, 47, 49, 50, 52, 53, 54, 55, 56, 57, 58, 61, 63, 75, 77, 79, 81, 82, 93, 94, 97, 98, 99, 101, 102, 111, 115, 116, 117, 119, 120, 121, 122, 137, 138, 139, 140, 142, 144, 158, 159, 160, 161, 162, 163, 164, 165]"
agent_c,L50,middle,73,36,37,2,0.578,173,"[1, 2, 3, 4, 5, 6, 7, 8, 9, 10, 11, 12, 13, 14, 16, 19, 26, 27, 31, 32, 33, 35, 37, 38, 39, 40, 41, 47, 48, 49, 50, 53, 54, 56, 57, 58, 60, 71, 72, 76, 77, 79, 80, 88, 89, 91, 93, 96, 97, 98, 99, 101, 110, 112, 113, 114, 115, 116, 118, 119, 121, 122, 140, 142, 153, 155, 156, 157, 158, 160, 161, 162, 170]"
agent_c,L50,middle,76,26,50,5,0.5682,176,"[0, 1, 3, 5, 6, 7, 8, 10, 11, 12, 13, 14, 15, 16, 17, 18, 20, 29, 31, 32, 35, 36, 37, 38, 39, 40, 41, 46, 47, 48, 49, 50, 51, 53, 54, 55, 56, 57, 58, 59, 60, 62, 77, 78, 80, 81, 84, 94, 95, 96, 97, 98, 99, 100, 102, 104, 114, 116, 117, 120, 121, 123, 140, 141, 142, 143, 144, 156, 157, 158, 159, 161, 162, 163, 164, 174]"
agent_c,L50,middle,69,42,27,1,0.5917,169,"[0, 1, 2, 3, 4, 5, 7, 8, 9, 10, 11, 13, 14, 15, 18, 19, 22, 23, 24, 27, 28, 29, 30, 31, 32, 33, 37, 38, 39, 52, 54, 55, 56, 57, 58, 59, 66, 67, 68, 71, 72, 74, 79, 89, 93, 94, 95, 96, 97, 100, 111, 112, 113, 115, 117, 118, 119, 131, 133, 137, 138, 139, 151, 152, 154, 158, 159, 165, 166]"
agent_c,L50,middle,77,35,42,0,0.565,177,"[0, 2, 4, 5, 6, 7, 8, 9, 12, 14, 15, 16, 19, 23, 24, 26, 27, 28, 30, 31, 33, 34, 39, 43, 44, 45, 46, 47, 48, 49, 51, 52, 53, 54, 55, 56, 57, 58, 60, 61, 74, 75, 76, 78, 79, 80, 83, 93, 94, 95, 97, 98, 99, 104, 105, 118, 119, 120, 121, 125, 140, 141, 142, 143, 144, 145, 146, 147, 159, 160, 161, 162, 163, 164, 165, 166, 167]"
agent_c,L50,middle,80,41,39,5,0.5556,180,"[0, 1, 3, 4, 7, 10, 12, 14, 15, 20, 21, 26, 27, 29, 30, 31, 32, 34, 35, 38, 40, 42, 46, 47, 48, 50, 51, 54, 55, 57, 58, 60, 66, 67, 68, 69, 70, 71, 72, 73, 74, 78, 79, 88, 89, 90, 91, 92, 93, 95, 96, 97, 98, 101, 112, 113, 114, 115, 116, 117, 118, 119, 134, 135, 136, 137, 139, 140, 141, 156, 157, 159, 161, 162, 163, 174, 175, 176, 177, 178]"
agent_c,L50,middle,79,42,37,4,0.5587,179,"[3, 4, 5, 6, 7, 9, 10, 12, 13, 15, 16, 17, 20, 21, 22, 23, 24, 25, 27, 29, 30, 32, 34, 35, 37, 38, 39, 50, 52, 53, 56, 57, 58, 60, 68, 69, 70, 71, 72, 75, 76, 77, 78, 79, 80, 91, 92, 94, 96, 97, 99, 100, 113, 114, 115, 117, 118, 120, 132, 133, 134, 137, 138, 140, 152, 153, 154, 155, 157, 158, 159, 163, 170, 171, 172, 173, 174, 175, 177]"
agent_c,L50,middle,77,33,44,4,0.565,177,"[0, 2, 3, 4, 7, 8, 9, 10, 11, 17, 18, 19, 20, 24, 25, 26, 27, 28, 29, 30, 33, 34, 35, 36, 37, 39, 48, 50, 52, 53, 56, 57, 58, 59, 64, 65, 66, 67, 68, 69, 70, 72, 73, 74, 75, 76, 78, 83, 96, 98, 101, 111, 112, 113, 115, 117, 118, 119, 121, 134, 136, 137, 138, 139, 140, 141, 154, 155, 156, 157, 160, 161, 170, 171, 173, 174, 175]"
agent_c,L50,middle,72,21,51,7,0.5814,172,"[0, 1, 2, 3, 5, 7, 8, 9, 11, 12, 13, 14, 15, 16, 17, 20, 27, 31, 32, 36, 38, 39, 40, 41, 42, 44, 46, 47, 48, 50, 52, 54, 55, 57, 58, 61, 64, 75, 76, 77, 78, 79, 80, 81, 82, 84, 93, 95, 96, 97, 98, 101, 103, 108, 117, 121, 122, 123, 124, 138, 139, 142, 144, 153, 155, 156, 157, 158, 159, 160, 162, 164]"
agent_c,L50,middle,75,31,44,4,0.5714,175,"[2, 3, 4, 8, 9, 10, 11, 12, 13, 15, 16, 17, 18, 19, 21, 24, 26, 28, 29, 31, 35, 37, 38, 39, 40, 47, 48, 49, 53, 54, 57, 58, 59, 60, 65, 66, 70, 71, 72, 75, 76, 78, 79, 81, 83, 91, 92, 94, 96, 97, 99, 103, 115, 116, 118, 122, 135, 136, 137, 138, 139, 140, 141, 142, 153, 154, 155, 156, 157, 158, 159, 161, 164, 171, 173]"
agent_c,L50,middle,85,46,39,3,0.5405,185,"[0, 2, 6, 7, 8, 9, 10, 11, 12, 14, 15, 19, 20, 21, 22, 23, 28, 31, 33, 34, 36, 38, 39, 46, 47, 48, 49, 51, 52, 53, 54, 55, 56, 57, 58, 60, 66, 67, 68, 71, 72, 73, 74, 75, 76, 78, 80, 89, 91, 92, 95, 96, 98, 100, 101, 114, 115, 116, 117, 118, 119, 120, 121, 122, 135, 139, 142, 156, 157, 158, 159, 160, 161, 162, 165, 173, 174, 175, 176, 178, 179, 180, 181, 182, 183]"
agent_c,L50,middle,77,49,28,8,0.565,177,"[0, 1, 2, 3, 4, 5, 6, 8, 11, 12, 15, 16, 17, 19, 21, 22, 23, 24, 26, 27, 30, 33, 34, 36, 38, 39, 51, 52, 54, 57, 60, 65, 66, 68, 69, 70, 72, 73, 75, 76, 77, 78, 79, 80, 83, 94, 95, 97, 98, 99, 100, 101, 112, 113, 114, 115, 116, 117, 118, 119, 120, 122, 136, 138, 139, 140, 142, 143, 144, 157, 158, 159, 161, 162, 163, 164, 170]"
agent_c,L50,middle,72,29,43,11,0.5814,172,"[2, 3, 4, 5, 6, 7, 8, 9, 10, 12, 14, 15, 16, 19, 20, 26, 29, 30, 31, 32, 38, 39, 42, 44, 46, 47, 48, 50, 51, 52, 53, 54, 55, 56, 57, 58, 59, 60, 75, 76, 77, 78, 79, 80, 90, 91, 92, 94, 95, 96, 98, 99, 100, 105, 116, 118, 120, 121, 124, 136, 137, 138, 139, 140, 141, 142, 145, 157, 158, 160, 162, 169]"
agent_c,L50,middle,76,39,37,2,0.5682,176,"[0, 1, 2, 4, 8, 10, 11, 12, 13, 14, 15, 16, 19, 23, 25, 28, 29, 30, 34, 35, 36, 37, 38, 41, 42, 50, 52, 53, 54, 55, 57, 58, 59, 61, 62, 65, 71, 72, 73, 74, 76, 77, 78, 83, 90, 92, 95, 96, 98, 99, 100, 101, 103, 114, 116, 117, 118, 120, 122, 123, 138, 139, 141, 143, 144, 147, 157, 158, 160, 162, 163, 164, 165, 167, 173, 174]"
agent_c,L50,middle,83,40,43,3,0.5464,183,"[0, 1, 2, 3, 4, 7, 8, 9, 10, 11, 13, 16, 18, 21, 22, 23, 25, 26, 29, 30, 32, 33, 34, 35, 36, 37, 39, 49, 51, 52, 53, 54, 55, 56, 58, 59, 66, 67, 68, 70, 71, 73, 74, 76, 78, 79, 88, 92, 93, 94, 95, 100, 101, 113, 115, 116, 117, 118, 119, 121, 122, 136, 137, 138, 143, 154, 155, 156, 157, 158, 161, 162, 163, 171, 172, 173, 174, 175, 176, 178, 179, 180, 181]"
agent_c,L50,middle,77,29,48,1,0.565,177,"[1, 2, 4, 5, 6, 7, 8, 9, 10, 11, 12, 13, 14, 15, 16, 17, 18, 20, 21, 30, 33, 34, 35, 36, 37, 38, 39, 41, 44, 47, 48, 49, 50, 51, 52, 55, 56, 59, 61, 62, 64, 65, 66, 77, 79, 80, 81, 83, 84, 85, 86, 99, 101, 103, 106, 118, 121, 122, 123, 126, 140, 142, 143, 144, 147, 155, 156, 157, 158, 159, 160, 161, 162, 163, 164, 165, 166]"
agent_c,L50,middle,78,39,39,6,0.5618,178,"[2, 3, 5, 7, 9, 11, 12, 13, 14, 15, 16, 17, 18, 19, 21, 22, 23, 25, 26, 27, 29, 30, 31, 33, 34, 36, 37, 39, 40, 51, 52, 54, 55, 56, 58, 59, 60, 61, 64, 73, 74, 76, 77, 78, 80, 81, 85, 93, 97, 98, 99, 100, 101, 102, 103, 115, 116, 118, 119, 120, 121, 122, 123, 137, 138, 139, 141, 142, 144, 157, 158, 159, 160, 161, 162, 163, 175, 176]"
agent_c,L50,middle,71,39,32,4,0.5848,171,"[0, 1, 3, 4, 5, 6, 7, 8, 9, 10, 14, 15, 18, 19, 20, 21, 22, 23, 24, 25, 26, 28, 29, 30, 32, 33, 34, 35, 36, 38, 39, 42, 55, 57, 59, 60, 62, 71, 72, 73, 77, 79, 81, 89, 91, 93, 94, 95, 99, 100, 101, 102, 103, 114, 118, 119, 120, 121, 123, 134, 137, 138, 140, 143, 145, 158, 159, 160, 163, 164, 169]"
agent_c,L50,middle,81,47,34,3,0.5525,181,"[1, 2, 4, 5, 6, 7, 8, 9, 10, 12, 14, 15, 16, 17, 18, 19, 21, 22, 23, 25, 29, 30, 31, 32, 33, 34, 35, 36, 37, 38, 40, 43, 44, 55, 56, 58, 59, 61, 63, 64, 74, 76, 78, 79, 80, 81, 82, 83, 85, 95, 96, 97, 98, 99, 100, 101, 104, 117, 118, 120, 121, 122, 124, 137, 140, 141, 144, 156, 157, 160, 162, 163, 164, 166, 173, 174, 175, 176, 177, 178, 179]"
agent_c,L50,middle,81,29,52,3,0.5525,181,"[2, 3, 4, 5, 6, 7, 8, 9, 12, 14, 16, 17, 18, 19, 20, 22, 23, 25, 26, 27, 29, 30, 31, 32, 33, 34, 35, 37, 38, 39, 52, 53, 54, 55, 56, 57, 59, 61, 68, 70, 71, 72, 73, 74, 75, 77, 78, 79, 80, 83, 84, 85, 99, 100, 101, 104, 105, 107, 122, 124, 125, 126, 127, 128, 130, 143, 144, 145, 146, 147, 148, 150, 163, 164, 165, 167, 168, 169, 170, 178, 179]"
agent_c,L50,middle,78,32,46,7,0.5618,178,"[0, 1, 2, 3, 6, 7, 8, 10, 11, 13, 14, 16, 17, 21, 22, 24, 25, 26, 27, 28, 29, 31, 33, 34, 35, 36, 37, 38, 39, 51, 52, 53, 54, 55, 56, 57, 58, 61, 68, 69, 70, 71, 72, 73, 74, 76, 77, 78, 79, 80, 98, 99, 100, 113, 114, 115, 116, 117, 118, 120, 121, 126, 140, 141, 144, 146, 157, 158, 159, 160, 161, 163, 166, 167, 173, 174, 175, 176]"
agent_c,L50,middle,74,36,38,5,0.5747,174,"[0, 1, 2, 3, 4, 5, 7, 10, 11, 12, 13, 15, 16, 17, 22, 29, 32, 33, 36, 37, 38, 39, 40, 41, 42, 44, 46, 47, 48, 49, 50, 51, 52, 53, 57, 59, 61, 74, 75, 76, 79, 80, 81, 89, 90, 93, 94, 95, 98, 99, 101, 110, 113, 114, 116, 117, 118, 119, 120, 121, 122, 137, 139, 140, 141, 143, 156, 157, 158, 159, 161, 162, 164, 172]"
agent_c,L50,middle,82,41,41,6,0.5495,182,"[0, 2, 3, 4, 5, 8, 10, 14, 20, 21, 22, 23, 24, 25, 26, 27, 28, 30, 31, 32, 33, 34, 35, 37, 38, 40, 41, 42, 44, 52, 53, 54, 55, 56, 58, 62, 67, 75, 76, 77, 78, 80, 82, 83, 84, 91, 92, 96, 99, 100, 102, 103, 104, 117, 119, 121, 123, 124, 126, 137, 138, 140, 141, 142, 146, 147, 157, 159, 161, 162, 163, 164, 165, 166, 167, 174, 175, 176, 177, 178, 179, 180]"
agent_c,L50,middle,78,38,40,4,0.5618,178,"[2, 3, 5, 7, 10, 11, 12, 13, 14, 16, 18, 19, 23, 24, 26, 27, 28, 30, 32, 33, 35, 36, 38, 42, 43, 46, 48, 50, 52, 53, 56, 57, 58, 59, 68, 72, 73, 74, 75, 76, 78, 79, 80, 89, 92, 93, 94, 95, 96, 97, 98, 99, 100, 113, 114, 117, 120, 134, 135, 137, 139, 140, 141, 150, 152, 153, 154, 155, 157, 158, 159, 160, 162, 171, 172, 174, 175, 176]"
agent_c,L50,middle,77,31,46,6,0.565,177,"[0, 1, 2, 3, 6, 7, 8, 9, 12, 15, 16, 17, 18, 19, 25, 28, 29, 30, 31, 32, 33, 35, 37, 38, 39, 40, 44, 45, 46, 48, 49, 50, 51, 53, 54, 55, 56, 57, 58, 61, 74, 76, 77, 78, 79, 81, 91, 92, 94, 98, 99, 100, 102, 112, 113, 114, 115, 117, 118, 120, 121, 134, 135, 136, 138, 140, 143, 154, 155, 156, 157, 158, 159, 160, 161, 173, 175]"
agent_c,L50,middle,70,29,41,10,0.5882,170,"[1, 3, 4, 5, 6, 8, 11, 12, 13, 14, 16, 18, 19, 20, 21, 23, 24, 27, 28, 32, 33, 36, 39, 42, 47, 48, 51, 52, 54, 55, 60, 63, 67, 71, 72, 74, 75, 76, 77, 78, 79, 80, 82, 83, 86, 97, 102, 103, 105, 114, 116, 117, 119, 121, 122, 123, 128, 139, 140, 141, 142, 144, 145, 148, 158, 159, 162, 163, 164, 166]"
agent_c,L50,middle,82,32,50,4,0.5495,182,"[0, 1, 2, 3, 4, 5, 6, 7, 9, 11, 12, 14, 15, 16, 17, 18, 19, 20, 21, 25, 26, 27, 29, 32, 34, 35, 37, 38, 39, 52, 53, 54, 55, 57, 60, 66, 67, 68, 70, 72, 73, 74, 75, 77, 78, 80, 84, 93, 94, 97, 98, 99, 102, 103, 118, 119, 120, 121, 122, 123, 134, 136, 139, 140, 141, 142, 145, 157, 159, 160, 162, 164, 165, 171, 172, 173, 174, 175, 176, 178, 179, 180]"
agent_c,L50,middle,74,29,45,0,0.5747,174,"[0, 2, 3, 4, 6, 7, 8, 9, 13, 14, 15, 17, 19, 23, 24, 25, 26, 27, 28, 29, 30, 34, 36, 37, 38, 39, 40, 42, 43, 44, 47, 48, 49, 50, 52, 54, 55, 56, 58, 59, 71, 72, 75, 76, 77, 78, 79, 89, 90, 91, 92, 93, 95, 96, 97, 99, 113, 114, 115, 117, 118, 119, 135, 136, 137, 139, 152, 154, 156, 158, 159, 169, 170, 171]"
agent_c,L50,middle,71,32,39,6,0.5848,171,"[1, 3, 5, 6, 7, 8, 9, 11, 12, 13, 14, 15, 16, 18, 20, 22, 25, 26, 28, 29, 30, 31, 32, 33, 35, 38, 39, 41, 50, 51, 52, 54, 55, 58, 59, 62, 70, 72, 73, 76, 78, 79, 80, 90, 91, 92, 93, 94, 95, 97, 100, 102, 113, 115, 119, 120, 124, 137, 138, 139, 141, 144, 154, 155, 156, 157, 159, 160, 161, 162, 165]"
agent_c,L50,middle,72,40,32,6,0.5814,172,"[0, 1, 2, 5, 7, 8, 9, 10, 12, 13, 14, 15, 16, 17, 19, 20, 21, 23, 24, 27, 28, 29, 32, 33, 36, 37, 38, 41, 50, 51, 52, 53, 54, 55, 57, 60, 66, 69, 71, 72, 73, 74, 76, 78, 80, 93, 94, 95, 96, 97, 98, 99, 101, 103, 116, 117, 118, 119, 120, 121, 124, 138, 139, 140, 141, 142, 144, 158, 159, 161, 164, 169]"
agent_c,L50,middle,75,36,39,3,0.5714,175,"[0, 2, 3, 4, 5, 6, 7, 8, 9, 11, 12, 17, 18, 19, 20, 22, 30, 33, 34, 35, 36, 37, 39, 40, 41, 45, 46, 52, 54, 56, 57, 60, 62, 63, 64, 73, 74, 75, 76, 79, 80, 83, 84, 85, 86, 94, 97, 98, 99, 100, 101, 102, 104, 105, 106, 117, 118, 119, 120, 121, 123, 125, 126, 128, 143, 145, 146, 148, 158, 159, 160, 161, 165, 166, 167]"
agent_c,L50,middle,70,36,34,4,0.5882,170,"[0, 1, 2, 3, 4, 5, 6, 7, 8, 9, 10, 11, 12, 13, 14, 15, 16, 17, 19, 30, 31, 34, 35, 36, 37, 39, 40, 42, 43, 44, 45, 46, 49, 50, 51, 52, 54, 56, 61, 73, 75, 76, 77, 78, 82, 91, 93, 94, 95, 98, 99, 100, 101, 111, 114, 116, 119, 120, 121, 135, 137, 138, 141, 153, 154, 155, 157, 158, 159, 163]"
agent_c,L50,middle,84,47,37,0,0.5435,184,"[0, 1, 2, 3, 5, 6, 8, 12, 13, 14, 15, 16, 17, 18, 19, 20, 27, 28, 30, 31, 32, 33, 34, 35, 36, 37, 38, 39, 40, 44, 45, 46, 47, 50, 51, 53, 54, 55, 57, 58, 59, 60, 73, 74, 77, 78, 79, 80, 92, 93, 94, 95, 96, 97, 98, 99, 100, 111, 112, 113, 114, 115, 116, 117, 120, 137, 138, 141, 154, 155, 156, 159, 160, 161, 172, 173, 174, 175, 176, 177, 178, 180, 181, 182]"
agent_c,L50,middle,71,32,39,7,0.5848,171,"[0, 1, 2, 4, 5, 6, 9, 10, 11, 13, 14, 15, 17, 18, 19, 21, 22, 23, 24, 25, 26, 27, 28, 29, 31, 32, 36, 38, 39, 40, 52, 53, 55, 57, 58, 60, 67, 69, 70, 72, 73, 74, 75, 76, 77, 84, 92, 94, 95, 96, 97, 100, 114, 115, 116, 118, 122, 132, 133, 134, 135, 138, 139, 140, 152, 153, 154, 156, 157, 159, 160]"
agent_c,L50,middle,80,37,43,2,0.5556,180,"[0, 1, 2, 3, 4, 5, 6, 7, 8, 9, 10, 11, 12, 14, 16, 17, 19, 24, 28, 30, 31, 32, 34, 35, 36, 37, 38, 41, 50, 52, 53, 54, 55, 56, 58, 59, 68, 69, 70, 71, 72, 73, 74, 75, 77, 78, 79, 89, 90, 91, 92, 96, 98, 100, 113, 114, 115, 116, 117, 119, 120, 132, 136, 139, 141, 155, 156, 157, 158, 159, 160, 161, 162, 171, 172, 173, 174, 175, 177, 178]"
agent_c,L50,middle,75,40,35,2,0.5714,175,"[0, 1, 3, 6, 7, 8, 15, 17, 19, 20, 21, 29, 30, 32, 33, 35, 37, 38, 39, 40, 42, 43, 45, 46, 48, 49, 52, 54, 55, 57, 58, 60, 61, 64, 72, 74, 75, 76, 77, 79, 80, 81, 82, 84, 92, 93, 95, 97, 98, 99, 102, 103, 104, 106, 116, 118, 121, 122, 123, 124, 125, 126, 139, 140, 141, 142, 146, 157, 158, 160, 161, 162, 163, 165, 166]"
agent_c,L50,middle,76,31,45,5,0.5682,176,"[0, 2, 4, 5, 6, 7, 8, 10, 11, 12, 13, 14, 15, 16, 17, 18, 19, 20, 21, 22, 23, 24, 25, 26, 27, 29, 30, 31, 32, 33, 35, 36, 37, 38, 40, 54, 55, 56, 57, 61, 70, 71, 72, 73, 77, 78, 80, 89, 91, 94, 95, 96, 97, 98, 99, 101, 116, 118, 119, 120, 134, 136, 137, 139, 142, 153, 154, 155, 156, 157, 159, 160, 162, 171, 172, 174]"
agent_c,L50,middle,78,38,40,3,0.5618,178,"[0, 1, 3, 4, 5, 6, 7, 10, 11, 12, 13, 15, 17, 19, 20, 21, 22, 23, 25, 26, 27, 28, 29, 30, 31, 32, 34, 35, 36, 37, 38, 40, 41, 43, 47, 64, 72, 73, 76, 79, 82, 83, 84, 93, 94, 96, 98, 99, 100, 101, 102, 104, 105, 119, 120, 121, 124, 125, 136, 137, 138, 139, 140, 141, 144, 145, 156, 157, 160, 162, 163, 164, 165, 166, 172, 173, 175, 176]"
agent_c,L50,middle,77,23,54,0,0.565,177,"[0, 1, 3, 4, 6, 7, 8, 9, 14, 15, 17, 19, 20, 24, 25, 26, 27, 30, 31, 32, 34, 35, 38, 39, 40, 41, 44, 45, 46, 47, 48, 49, 51, 52, 54, 56, 58, 60, 62, 64, 74, 75, 77, 78, 79, 81, 83, 84, 95, 100, 101, 102, 103, 104, 120, 121, 122, 124, 139, 141, 142, 143, 144, 153, 154, 155, 156, 158, 159, 160, 161, 163, 164, 172, 173, 174, 175]"
agent_c,L50,middle,72,37,35,4,0.5814,172,"[0, 1, 2, 9, 10, 11, 12, 14, 15, 16, 17, 18, 19, 22, 23, 25, 26, 29, 30, 31, 32, 33, 34, 35, 36, 38, 39, 42, 51, 53, 54, 56, 57, 60, 65, 66, 68, 69, 70, 71, 72, 73, 75, 78, 80, 91, 94, 96, 97, 99, 101, 111, 112, 115, 117, 118, 120, 131, 133, 137, 138, 139, 141, 152, 153, 154, 155, 157, 158, 159, 160, 169]"
agent_c,L50,middle,74,33,41,6,0.5747,174,"[0, 2, 3, 5, 8, 10, 11, 12, 13, 14, 15, 16, 17, 19, 24, 25, 26, 27, 28, 30, 31, 33, 34, 38, 41, 43, 45, 46, 47, 48, 49, 50, 51, 52, 53, 54, 55, 57, 58, 59, 70, 71, 73, 75, 76, 77, 78, 79, 80, 81, 82, 83, 95, 96, 98, 101, 104, 115, 116, 117, 118, 120, 121, 122, 123, 139, 140, 141, 142, 144, 158, 159, 160, 165]"
agent_c,L50,middle,70,37,33,2,0.5882,170,"[0, 1, 2, 4, 5, 8, 11, 15, 16, 17, 18, 19, 27, 28, 29, 30, 31, 33, 34, 39, 41, 42, 45, 46, 47, 48, 49, 51, 52, 53, 54, 56, 57, 60, 62, 69, 70, 71, 73, 77, 78, 80, 81, 90, 91, 92, 93, 95, 96, 97, 99, 100, 101, 102, 113, 118, 119, 123, 135, 137, 138, 140, 142, 143, 155, 157, 159, 160, 161, 163]"
agent_c,L50,middle,74,29,45,6,0.5747,174,"[1, 2, 4, 6, 7, 8, 9, 11, 13, 14, 15, 16, 17, 18, 19, 21, 23, 24, 26, 27, 28, 29, 30, 31, 32, 34, 38, 39, 40, 42, 43, 46, 59, 60, 61, 62, 64, 66, 73, 74, 75, 76, 77, 78, 79, 80, 81, 82, 83, 86, 100, 102, 103, 104, 105, 118, 119, 120, 121, 122, 124, 126, 140, 142, 143, 144, 145, 157, 158, 161, 164, 166, 171, 172]"
agent_c,L50,middle,72,37,35,0,0.5814,172,"[0, 2, 3, 4, 5, 6, 7, 8, 11, 12, 13, 14, 15, 16, 17, 18, 19, 28, 30, 31, 32, 35, 37, 39, 40, 41, 43, 46, 47, 48, 49, 50, 53, 54, 55, 56, 57, 58, 59, 60, 61, 62, 63, 77, 79, 80, 81, 82, 83, 85, 96, 97, 98, 100, 102, 103, 104, 105, 120, 122, 123, 124, 125, 127, 128, 145, 147, 148, 158, 164, 167, 169]"
agent_c,L50,middle,67,36,31,7,0.5988,167,"[0, 1, 6, 8, 9, 10, 11, 12, 13, 15, 17, 18, 20, 27, 30, 31, 32, 34, 36, 37, 38, 40, 41, 42, 43, 45, 46, 47, 49, 50, 54, 55, 56, 57, 59, 61, 70, 71, 73, 74, 77, 78, 79, 82, 90, 95, 96, 97, 99, 100, 101, 113, 114, 115, 117, 118, 119, 122, 134, 135, 136, 141, 151, 154, 156, 158, 163]"
agent_c,L50,middle,77,38,39,6,0.565,177,"[0, 1, 2, 3, 5, 6, 7, 8, 10, 11, 14, 15, 16, 17, 18, 21, 27, 28, 29, 35, 36, 37, 38, 39, 42, 45, 46, 47, 48, 51, 53, 57, 58, 59, 70, 71, 72, 73, 74, 75, 77, 78, 82, 90, 91, 92, 93, 94, 95, 96, 97, 98, 99, 108, 109, 110, 111, 112, 113, 114, 116, 118, 119, 135, 137, 138, 139, 153, 158, 159, 160, 162, 171, 172, 173, 174, 175]"
agent_c,L50,middle,77,27,50,4,0.565,177,"[0, 3, 5, 7, 9, 10, 11, 12, 14, 15, 16, 18, 19, 20, 21, 22, 24, 25, 26, 27, 28, 29, 30, 31, 32, 33, 34, 36, 37, 39, 52, 53, 54, 55, 56, 57, 59, 67, 68, 70, 71, 74, 75, 77, 78, 80, 81, 83, 98, 99, 100, 101, 103, 115, 116, 117, 121, 122, 132, 134, 138, 139, 140, 141, 142, 153, 154, 157, 158, 159, 160, 161, 164, 171, 172, 174, 175]"
agent_c,L50,middle,71,54,17,2,0.5848,171,"[0, 2, 3, 4, 5, 6, 7, 8, 9, 11, 12, 14, 15, 16, 18, 19, 27, 29, 30, 31, 32, 33, 34, 35, 36, 38, 39, 40, 43, 44, 48, 49, 50, 54, 56, 57, 60, 71, 74, 75, 76, 77, 78, 79, 80, 90, 91, 95, 97, 98, 99, 100, 112, 115, 117, 118, 121, 133, 134, 135, 136, 137, 139, 140, 141, 154, 155, 156, 157, 158, 162]"
agent_c,L100,middle,82,46,36,5,0.5495,182,"[1, 2, 4, 6, 7, 10, 15, 16, 17, 18, 20, 22, 23, 24, 25, 27, 28, 29, 30, 31, 33, 34, 35, 36, 37, 38, 39, 40, 42, 43, 46, 47, 48, 49, 51, 53, 55, 58, 60, 70, 71, 72, 74, 75, 76, 77, 78, 79, 81, 99, 101, 112, 113, 114, 115, 116, 118, 119, 120, 134, 135, 137, 138, 140, 141, 151, 152, 153, 154, 155, 156, 157, 158, 159, 161, 171, 172, 173, 175, 177, 179, 180]"
agent_c,L100,middle,77,41,36,0,0.565,177,"[1, 2, 3, 4, 5, 7, 10, 11, 12, 13, 14, 16, 17, 18, 19, 20, 22, 23, 25, 28, 29, 31, 32, 33, 39, 43, 45, 46, 47, 49, 51, 56, 57, 58, 59, 65, 67, 68, 69, 70, 71, 72, 73, 74, 75, 76, 78, 79, 80, 93, 94, 96, 97, 98, 99, 100, 115, 116, 117, 118, 119, 120, 121, 122, 137, 139, 140, 141, 142, 158, 159, 160, 162, 169, 170, 172, 173]"
agent_c,L100,middle,73,33,40,4,0.578,173,"[1, 2, 4, 5, 6, 7, 8, 10, 11, 12, 14, 15, 16, 18, 20, 23, 24, 25, 26, 27, 28, 29, 31, 32, 33, 34, 35, 36, 38, 39, 41, 50, 51, 53, 54, 56, 58, 59, 60, 70, 71, 72, 73, 75, 77, 78, 79, 80, 82, 83, 86, 99, 101, 103, 105, 106, 122, 124, 125, 126, 127, 139, 141, 143, 146, 147, 148, 154, 164, 165, 168, 170, 171]"
agent_c,L100,middle,76,44,32,4,0.5682,176,"[1, 2, 3, 4, 5, 6, 7, 8, 9, 12, 14, 16, 18, 21, 27, 29, 31, 34, 37, 38, 39, 40, 42, 43, 44, 46, 48, 49, 50, 52, 53, 54, 55, 57, 58, 61, 69, 70, 71, 72, 73, 74, 75, 76, 77, 78, 80, 93, 96, 97, 98, 99, 100, 114, 115, 116, 118, 122, 135, 137, 138, 140, 143, 152, 153, 155, 156, 157, 159, 160, 161, 162, 163, 165, 173, 174]"
agent_c,L100,middle,75,29,46,2,0.5714,175,"[1, 3, 7, 9, 10, 11, 12, 13, 15, 16, 17, 18, 20, 21, 22, 23, 24, 25, 27, 28, 29, 30, 31, 32, 34, 35, 36, 37, 38, 39, 40, 41, 42, 43, 44, 45, 46, 47, 50, 51, 55, 56, 57, 59, 73, 75, 78, 80, 93, 96, 97, 98, 99, 113, 116, 117, 118, 119, 135, 137, 139, 141, 149, 150, 152, 153, 154, 155, 158, 159, 160, 161, 169, 172, 173]"
agent_c,L100,middle,73,37,36,7,0.578,173,"[0, 1, 3, 4, 6, 10, 12, 13, 14, 16, 17, 18, 20, 22, 23, 24, 25, 26, 27, 28, 29, 30, 32, 33, 34, 39, 40, 41, 42, 43, 45, 46, 47, 48, 50, 51, 52, 53, 55, 56, 57, 64, 76, 77, 79, 80, 92, 95, 96, 97, 99, 102, 113, 115, 117, 118, 120, 133, 135, 137, 138, 139, 140, 149, 151, 152, 154, 155, 156, 157, 158, 160, 168]"
agent_c,L100,middle,72,38,34,7,0.5814,172,"[0, 1, 2, 3, 4, 5, 6, 7, 8, 9, 10, 11, 13, 14, 15, 16, 19, 21, 22, 26, 31, 32, 33, 34, 35, 37, 40, 41, 42, 43, 44, 45, 46, 47, 48, 50, 52, 54, 55, 56, 58, 61, 63, 64, 79, 83, 84, 88, 101, 102, 105, 115, 117, 118, 119, 120, 122, 125, 139, 141, 142, 143, 145, 147, 154, 156, 157, 160, 163, 164, 165, 166]"
agent_c,L100,middle,80,28,52,2,0.5556,180,"[1, 2, 4, 5, 7, 8, 9, 10, 12, 13, 14, 15, 17, 19, 20, 21, 22, 23, 24, 25, 26, 29, 31, 33, 34, 37, 40, 45, 46, 47, 48, 49, 50, 51, 52, 53, 55, 57, 59, 60, 67, 70, 71, 72, 73, 74, 78, 79, 80, 82, 95, 97, 98, 100, 101, 116, 118, 120, 122, 134, 136, 140, 141, 151, 154, 155, 156, 158, 159, 160, 161, 168, 170, 171, 172, 173, 174, 176, 177, 178]"
agent_c,L100,middle,74,42,32,6,0.5747,174,"[1, 2, 4, 6, 7, 9, 10, 12, 14, 15, 18, 19, 20, 21, 22, 23, 24, 26, 27, 28, 30, 31, 33, 34, 35, 36, 37, 38, 39, 40, 41, 42, 50, 53, 54, 55, 56, 57, 58, 59, 60, 61, 63, 74, 75, 76, 79, 80, 81, 82, 85, 98, 100, 101, 104, 118, 119, 120, 123, 127, 138, 140, 143, 144, 145, 147, 158, 160, 161, 162, 165, 166, 168, 169]"
agent_c,L100,middle,79,41,38,5,0.5587,179,"[0, 4, 6, 7, 8, 9, 10, 11, 12, 13, 14, 15, 16, 18, 20, 21, 23, 24, 25, 26, 27, 28, 29, 30, 32, 34, 35, 36, 37, 41, 49, 50, 51, 52, 53, 56, 57, 61, 68, 69, 70, 72, 73, 74, 75, 76, 77, 80, 81, 95, 96, 97, 99, 100, 103, 117, 119, 121, 123, 124, 137, 138, 142, 143, 144, 146, 158, 159, 160, 162, 163, 164, 165, 171, 172, 173, 174, 176, 177]"
agent_c,L100,middle,76,35,41,2,0.5682,176,"[0, 1, 2, 3, 4, 7, 8, 10, 11, 12, 13, 15, 17, 20, 22, 23, 24, 25, 26, 28, 29, 30, 35, 37, 38, 39, 41, 42, 43, 49, 50, 52, 54, 57, 60, 61, 62, 64, 75, 76, 77, 78, 79, 81, 82, 84, 94, 96, 97, 98, 99, 100, 102, 104, 120, 121, 123, 124, 125, 137, 138, 139, 140, 141, 142, 143, 144, 146, 158, 159, 162, 163, 164, 166, 172, 173]"
agent_c,L100,middle,70,43,27,4,0.5882,170,"[0, 1, 2, 4, 6, 8, 10, 12, 13, 17, 18, 20, 21, 23, 24, 25, 27, 28, 30, 31, 33, 34, 35, 36, 39, 40, 45, 46, 47, 49, 51, 52, 54, 57, 58, 59, 60, 61, 68, 72, 73, 74, 75, 78, 79, 80, 81, 82, 94, 97, 98, 100, 101, 102, 103, 104, 120, 121, 122, 123, 126, 140, 142, 145, 155, 156, 158, 161, 162, 165]"
agent_c,L100,middle,84,30,54,6,0.5435,184,"[1, 2, 5, 6, 7, 9, 10, 11, 12, 13, 15, 16, 18, 19, 21, 22, 23, 25, 28, 30, 31, 33, 36, 38, 39, 40, 44, 47, 54, 55, 56, 57, 61, 64, 67, 68, 69, 70, 71, 73, 74, 76, 77, 78, 79, 80, 91, 93, 97, 99, 101, 114, 115, 116, 118, 119, 122, 134, 135, 136, 137, 138, 139, 140, 142, 156, 157, 158, 161, 164, 168, 169, 170, 171, 172, 173, 174, 175, 176, 177, 178, 179, 180, 182]"
agent_c,L100,middle,78,46,32,5,0.5618,178,"[0, 1, 3, 4, 5, 6, 10, 11, 12, 13, 14, 15, 17, 23, 25, 26, 27, 28, 29, 30, 31, 32, 33, 34, 36, 37, 41, 42, 43, 44, 46, 47, 48, 49, 53, 54, 56, 57, 58, 59, 60, 61, 74, 75, 79, 81, 92, 94, 95, 96, 97, 98, 99, 101, 114, 115, 117, 118, 119, 120, 121, 123, 124, 143, 145, 154, 155, 156, 157, 158, 159, 160, 161, 163, 164, 173, 175, 176]"
agent_c,L100,middle,78,17,61,0,0.5618,178,"[2, 3, 4, 5, 6, 7, 9, 10, 11, 12, 13, 14, 15, 16, 18, 19, 22, 23, 24, 25, 27, 28, 29, 30, 33, 35, 36, 37, 38, 39, 41, 42, 43, 44, 45, 46, 47, 48, 50, 51, 52, 53, 57, 58, 59, 76, 77, 79, 80, 92, 93, 94, 95, 96, 97, 98, 99, 100, 115, 116, 117, 118, 120, 121, 137, 139, 141, 142, 144, 155, 157, 158, 159, 161, 162, 165, 166, 176]"
agent_c,L100,middle,84,31,53,0,0.5435,184,"[0, 2, 3, 6, 8, 9, 10, 12, 13, 15, 17, 18, 19, 21, 22, 23, 24, 25, 26, 27, 34, 35, 36, 37, 38, 39, 40, 45, 48, 49, 50, 51, 52, 55, 56, 57, 60, 61, 71, 74, 76, 80, 81, 90, 91, 92, 93, 94, 95, 99, 100, 101, 102, 115, 116, 117, 118, 120, 122, 136, 137, 139, 140, 141, 142, 152, 153, 154, 155, 156, 157, 158, 160, 161, 162, 171, 174, 175, 176, 178, 179, 180, 181, 182]"
agent_c,L100,middle,77,34,43,3,0.565,177,"[0, 1, 2, 4, 6, 8, 9, 11, 12, 14, 16, 22, 24, 25, 26, 27, 30, 31, 32, 33, 34, 35, 36, 37, 38, 39, 40, 41, 42, 43, 44, 45, 54, 55, 58, 59, 60, 61, 62, 65, 77, 79, 80, 83, 84, 85, 98, 99, 101, 102, 104, 105, 119, 120, 121, 122, 123, 124, 125, 126, 138, 140, 141, 142, 143, 149, 158, 159, 160, 161, 162, 164, 165, 166, 167, 174, 175]"
agent_c,L100,middle,76,37,39,2,0.5682,176,"[0, 1, 2, 4, 6, 7, 8, 9, 11, 13, 14, 16, 17, 19, 20, 21, 22, 23, 25, 26, 27, 29, 31, 32, 33, 34, 35, 36, 37, 38, 42, 45, 46, 47, 49, 53, 55, 58, 59, 60, 61, 62, 63, 76, 79, 80, 83, 94, 97, 98, 100, 101, 102, 103, 116, 118, 119, 121, 123, 137, 138, 139, 140, 142, 143, 152, 153, 155, 156, 157, 158, 159, 160, 161, 164, 173]"
agent_c,L100,middle,77,48,29,3,0.565,177,"[0, 3, 5, 6, 7, 8, 10, 11, 13, 14, 15, 16, 17, 18, 19, 20, 21, 22, 23, 25, 27, 28, 30, 31, 32, 33, 35, 36, 37, 40, 48, 49, 52, 54, 55, 56, 57, 58, 59, 62, 72, 75, 76, 78, 79, 80, 82, 84, 96, 98, 102, 103, 104, 118, 120, 121, 122, 123, 124, 125, 139, 140, 141, 143, 144, 145, 155, 156, 157, 158, 159, 160, 161, 162, 164, 165, 175]"
agent_c,L100,middle,68,39,29,6,0.5952,168,"[0, 1, 2, 3, 4, 6, 8, 9, 12, 13, 14, 15, 16, 17, 18, 19, 22, 23, 24, 25, 26, 29, 30, 31, 32, 34, 36, 38, 39, 42, 43, 44, 46, 47, 48, 51, 53, 55, 56, 58, 59, 61, 73, 74, 75, 76, 78, 80, 85, 100, 101, 112, 113, 114, 116, 119, 121, 134, 135, 136, 137, 138, 141, 150, 154, 155, 160, 163]"
agent_c,L100,middle,80,35,45,3,0.5556,180,"[0, 3, 4, 5, 9, 10, 12, 13, 14, 15, 16, 21, 23, 26, 27, 28, 29, 30, 33, 37, 38, 39, 40, 41, 42, 46, 47, 49, 50, 51, 56, 58, 59, 64, 65, 66, 67, 68, 70, 72, 73, 74, 75, 76, 77, 78, 79, 95, 96, 98, 100, 114, 117, 118, 119, 121, 133, 134, 136, 137, 138, 139, 140, 151, 152, 153, 155, 156, 158, 159, 160, 166, 167, 169, 170, 172, 175, 176, 177, 178]"
agent_c,L100,middle,75,30,45,3,0.5714,175,"[0, 1, 2, 4, 5, 6, 7, 8, 10, 11, 12, 13, 14, 15, 16, 18, 19, 23, 25, 26, 27, 28, 30, 32, 33, 35, 36, 37, 38, 39, 41, 43, 44, 45, 47, 48, 49, 50, 51, 52, 54, 55, 56, 57, 58, 60, 76, 79, 80, 92, 93, 96, 98, 99, 100, 112, 119, 120, 121, 122, 137, 138, 139, 141, 142, 143, 153, 154, 155, 156, 157, 159, 160, 162, 165]"
agent_c,L100,middle,85,61,24,1,0.5405,185,"[0, 2, 3, 4, 5, 6, 7, 10, 11, 13, 15, 16, 17, 18, 20, 21, 23, 25, 26, 28, 30, 33, 37, 38, 42, 44, 45, 50, 51, 53, 55, 56, 57, 58, 59, 60, 61, 62, 63, 71, 75, 77, 78, 79, 80, 81, 82, 83, 95, 97, 99, 100, 101, 102, 104, 118, 124, 135, 136, 138, 139, 140, 142, 143, 144, 154, 155, 156, 157, 158, 159, 160, 161, 162, 163, 164, 165, 166, 167, 176, 177, 178, 179, 182, 183]"
agent_c,L100,middle,74,39,35,1,0.5747,174,"[0, 1, 2, 3, 4, 5, 6, 9, 10, 13, 14, 15, 20, 21, 23, 24, 25, 26, 27, 28, 29, 30, 31, 32, 33, 36, 38, 40, 42, 48, 49, 50, 51, 55, 56, 57, 59, 61, 62, 71, 73, 74, 75, 76, 77, 79, 80, 82, 83, 84, 85, 99, 101, 104, 106, 122, 123, 124, 125, 126, 142, 143, 146, 154, 158, 159, 161, 162, 165, 166, 169, 170, 171, 172]"
agent_c,L100,middle,72,36,36,3,0.5814,172,"[0, 1, 3, 4, 6, 7, 8, 11, 14, 15, 16, 17, 18, 19, 20, 21, 22, 23, 27, 28, 29, 30, 31, 33, 34, 36, 37, 39, 40, 41, 44, 47, 50, 51, 52, 53, 55, 56, 57, 58, 59, 60, 62, 74, 77, 78, 79, 80, 81, 85, 99, 100, 101, 103, 105, 106, 120, 122, 123, 124, 125, 126, 143, 146, 155, 157, 158, 160, 162, 164, 166, 167]"
agent_c,L100,middle,79,34,45,1,0.5587,179,"[0, 1, 2, 4, 5, 6, 7, 8, 9, 10, 11, 12, 13, 16, 18, 20, 22, 23, 24, 25, 27, 28, 29, 30, 31, 32, 33, 35, 36, 37, 38, 39, 40, 45, 48, 49, 50, 51, 53, 54, 55, 56, 57, 60, 74, 75, 76, 77, 78, 79, 80, 94, 95, 96, 97, 98, 99, 101, 115, 118, 120, 121, 122, 139, 142, 152, 153, 154, 155, 157, 158, 160, 161, 162, 172, 173, 174, 175, 177]"
agent_c,L100,middle,81,36,45,3,0.5525,181,"[0, 2, 3, 4, 5, 6, 7, 8, 11, 12, 15, 18, 20, 21, 22, 23, 25, 27, 29, 30, 32, 33, 34, 35, 36, 37, 39, 45, 46, 47, 48, 49, 51, 52, 55, 56, 57, 59, 67, 68, 69, 70, 72, 73, 74, 75, 77, 80, 93, 95, 96, 98, 99, 100, 101, 102, 103, 104, 120, 122, 123, 125, 127, 141, 142, 143, 144, 145, 146, 158, 159, 160, 163, 164, 165, 167, 174, 175, 176, 178, 179]"
agent_c,L100,middle,73,37,36,6,0.578,173,"[1, 3, 4, 5, 6, 9, 10, 11, 12, 13, 15, 17, 18, 19, 20, 21, 24, 28, 29, 31, 34, 35, 37, 38, 39, 40, 41, 43, 44, 45, 47, 49, 50, 52, 55, 56, 57, 58, 60, 64, 74, 75, 78, 79, 80, 81, 82, 83, 95, 97, 98, 101, 102, 103, 115, 118, 119, 120, 121, 122, 123, 138, 139, 143, 152, 153, 154, 155, 156, 158, 160, 162, 164]"
agent_c,L100,middle,71,33,38,7,0.5848,171,"[1, 3, 4, 5, 7, 9, 10, 13, 14, 16, 18, 20, 23, 24, 26, 28, 29, 31, 32, 33, 34, 36, 37, 38, 39, 40, 42, 43, 44, 45, 46, 49, 50, 51, 52, 53, 54, 55, 56, 58, 59, 61, 73, 75, 76, 78, 79, 81, 94, 97, 98, 99, 100, 113, 114, 116, 117, 118, 119, 120, 135, 136, 137, 140, 142, 152, 154, 155, 157, 159, 164]"
agent_c,L100,middle,70,28,42,5,0.5882,170,"[2, 4, 7, 8, 9, 12, 13, 14, 15, 16, 18, 19, 21, 23, 25, 27, 28, 29, 31, 32, 34, 35, 36, 37, 38, 40, 41, 46, 47, 48, 52, 53, 54, 55, 56, 57, 62, 67, 68, 70, 72, 73, 74, 76, 78, 79, 83, 100, 104, 115, 116, 117, 119, 122, 123, 133, 136, 138, 140, 142, 143, 152, 158, 159, 160, 161, 162, 163, 166, 167]"
agent_c,L100,middle,78,32,46,3,0.5618,178,"[0, 3, 4, 5, 6, 8, 9, 11, 12, 13, 16, 17, 18, 19, 20, 21, 22, 24, 25, 26, 27, 28, 31, 32, 34, 35, 36, 38, 39, 41, 42, 49, 52, 53, 57, 58, 59, 60, 61, 63, 72, 75, 77, 78, 79, 80, 81, 82, 83, 84, 98, 99, 100, 101, 103, 104, 105, 120, 123, 125, 139, 141, 143, 144, 145, 146, 148, 151, 160, 161, 163, 164, 165, 166, 168, 169, 170, 171]"
agent_c,L100,middle,77,38,39,8,0.565,177,"[1, 3, 4, 5, 6, 9, 10, 11, 12, 16, 17, 18, 19, 20, 21, 24, 27, 28, 29, 31, 32, 33, 34, 35, 36, 38, 39, 40, 41, 43, 44, 46, 50, 51, 54, 55, 56, 58, 60, 61, 62, 63, 75, 77, 78, 80, 83, 86, 99, 100, 101, 102, 103, 104, 105, 118, 121, 122, 123, 124, 127, 141, 142, 143, 144, 145, 146, 156, 157, 158, 159, 160, 162, 163, 165, 166, 169]"
agent_c,L100,middle,74,35,39,9,0.5747,174,"[1, 2, 6, 8, 9, 10, 13, 14, 15, 16, 17, 18, 21, 22, 23, 24, 26, 28, 29, 33, 36, 38, 39, 41, 42, 43, 45, 46, 48, 49, 50, 52, 54, 55, 56, 57, 58, 60, 69, 70, 71, 73, 74, 77, 80, 93, 94, 95, 97, 99, 100, 102, 115, 116, 117, 118, 119, 121, 122, 123, 124, 129, 141, 142, 144, 145, 146, 157, 158, 159, 161, 163, 165, 166]"
agent_c,L100,middle,78,35,43,5,0.5618,178,"[0, 2, 3, 4, 6, 7, 8, 12, 14, 15, 16, 17, 18, 19, 20, 21, 22, 23, 24, 25, 26, 27, 29, 34, 36, 38, 39, 40, 45, 52, 53, 54, 56, 57, 58, 59, 61, 62, 63, 70, 72, 75, 79, 80, 81, 82, 85, 95, 96, 97, 99, 101, 102, 103, 104, 105, 119, 120, 121, 122, 123, 125, 139, 140, 141, 143, 145, 157, 158, 159, 161, 163, 164, 165, 167, 168, 174, 175]"
agent_c,L100,middle,73,36,37,8,0.578,173,"[1, 2, 3, 4, 5, 6, 8, 10, 12, 13, 14, 15, 16, 17, 21, 25, 26, 27, 28, 30, 31, 33, 36, 38, 40, 41, 43, 44, 45, 48, 49, 50, 51, 52, 54, 56, 57, 58, 60, 67, 77, 79, 82, 93, 94, 95, 96, 97, 100, 101, 103, 115, 116, 118, 120, 121, 123, 124, 137, 138, 139, 142, 143, 144, 155, 157, 159, 162, 163, 164, 165, 166, 167]"
agent_c,L100,middle,70,37,33,2,0.5882,170,"[3, 5, 8, 11, 12, 13, 16, 17, 19, 20, 21, 23, 24, 25, 28, 31, 32, 33, 35, 36, 37, 41, 43, 44, 45, 48, 49, 52, 54, 55, 59, 60, 61, 62, 69, 70, 71, 72, 73, 74, 76, 77, 79, 80, 81, 82, 83, 94, 95, 96, 98, 101, 102, 104, 117, 118, 119, 120, 121, 123, 140, 142, 143, 152, 154, 155, 156, 159, 160, 164]"
agent_c,L100,middle,76,40,36,3,0.5682,176,"[1, 2, 3, 4, 6, 7, 8, 9, 10, 11, 12, 13, 14, 15, 17, 19, 20, 24, 25, 26, 28, 29, 31, 32, 33, 34, 35, 37, 39, 40, 41, 44, 45, 46, 47, 48, 49, 50, 52, 55, 56, 58, 59, 60, 62, 75, 77, 80, 81, 82, 101, 102, 103, 104, 106, 119, 122, 123, 124, 125, 126, 140, 141, 143, 144, 145, 146, 148, 158, 160, 161, 163, 164, 165, 166, 167]"
agent_c,L100,middle,72,40,32,4,0.5814,172,"[1, 3, 8, 10, 12, 13, 14, 16, 17, 18, 21, 22, 27, 30, 35, 36, 37, 38, 39, 40, 43, 44, 45, 47, 48, 51, 52, 55, 56, 58, 61, 62, 63, 69, 70, 71, 72, 76, 77, 78, 79, 81, 82, 83, 92, 94, 95, 96, 98, 100, 104, 118, 121, 123, 132, 135, 136, 137, 138, 139, 142, 143, 155, 158, 159, 161, 162, 163, 167, 168, 169, 170]"
agent_c,L100,middle,74,48,26,2,0.5747,174,"[2, 3, 6, 7, 8, 10, 11, 12, 13, 14, 15, 16, 17, 18, 19, 20, 22, 23, 24, 25, 26, 28, 29, 30, 32, 37, 38, 40, 43, 45, 47, 48, 50, 51, 52, 55, 57, 58, 59, 60, 61, 62, 63, 64, 77, 78, 80, 81, 82, 83, 84, 99, 100, 102, 103, 105, 117, 120, 121, 125, 126, 141, 142, 143, 144, 145, 146, 147, 159, 162, 163, 164, 165, 167]"
agent_c,L100,middle,76,44,32,5,0.5682,176,"[3, 7, 8, 9, 10, 14, 15, 16, 17, 18, 20, 23, 24, 26, 29, 30, 31, 32, 34, 35, 38, 39, 40, 43, 45, 46, 47, 48, 49, 52, 53, 55, 56, 57, 58, 60, 67, 68, 69, 70, 71, 73, 74, 75, 76, 78, 82, 95, 96, 97, 98, 99, 100, 101, 116, 117, 118, 121, 122, 136, 138, 139, 140, 141, 142, 143, 154, 155, 156, 159, 162, 163, 169, 170, 172, 174]"
agent_c,L100,middle,81,30,51,2,0.5525,181,"[0, 3, 8, 9, 11, 12, 14, 15, 17, 18, 20, 21, 22, 23, 28, 29, 31, 32, 37, 38, 40, 41, 43, 45, 47, 50, 52, 54, 55, 56, 57, 58, 60, 63, 68, 69, 70, 71, 73, 74, 76, 77, 78, 79, 80, 81, 82, 84, 98, 99, 100, 103, 117, 118, 119, 120, 121, 122, 123, 124, 138, 139, 140, 141, 142, 144, 146, 157, 158, 159, 160, 162, 164, 166, 173, 174, 175, 176, 177, 178, 179]"
agent_c,L100,middle,78,13,65,2,0.5618,178,"[0, 4, 7, 9, 10, 12, 13, 14, 15, 17, 20, 21, 22, 25, 28, 29, 30, 31, 32, 33, 35, 36, 37, 38, 39, 40, 41, 42, 44, 45, 46, 50, 51, 52, 53, 57, 58, 59, 68, 70, 71, 72, 73, 76, 79, 91, 92, 93, 94, 95, 97, 98, 99, 112, 113, 114, 115, 116, 117, 118, 119, 134, 137, 140, 150, 151, 152, 153, 154, 155, 156, 157, 158, 159, 170, 171, 172, 176]"
agent_c,L100,middle,77,37,40,8,0.565,177,"[0, 1, 2, 3, 4, 10, 11, 12, 13, 15, 16, 17, 18, 19, 21, 22, 24, 26, 27, 28, 30, 31, 32, 34, 35, 37, 38, 40, 41, 43, 54, 56, 57, 61, 67, 70, 71, 72, 73, 74, 75, 76, 77, 78, 84, 96, 97, 98, 99, 102, 115, 116, 117, 118, 119, 120, 121, 122, 135, 137, 138, 139, 144, 152, 153, 154, 155, 157, 158, 159, 160, 162, 171, 172, 173, 174, 175]"
agent_c,L100,middle,80,24,56,4,0.5556,180,"[0, 1, 3, 4, 5, 6, 7, 9, 11, 12, 13, 19, 20, 21, 23, 24, 26, 27, 32, 33, 34, 35, 36, 37, 38, 39, 40, 42, 47, 48, 51, 52, 53, 55, 61, 65, 66, 67, 68, 70, 71, 75, 76, 79, 80, 81, 82, 83, 95, 96, 98, 100, 101, 104, 120, 121, 123, 135, 136, 137, 142, 143, 144, 145, 154, 155, 156, 157, 158, 159, 160, 161, 162, 163, 167, 174, 175, 176, 177, 178]"
agent_c,L100,middle,77,27,50,6,0.565,177,"[0, 1, 4, 5, 6, 8, 9, 10, 12, 13, 16, 17, 20, 23, 24, 26, 27, 28, 29, 30, 31, 32, 33, 34, 36, 38, 40, 43, 47, 49, 51, 55, 56, 58, 59, 60, 62, 63, 69, 70, 71, 75, 77, 78, 79, 80, 82, 83, 86, 97, 99, 102, 104, 119, 120, 121, 122, 123, 124, 125, 126, 140, 141, 143, 144, 146, 148, 158, 159, 160, 161, 163, 164, 165, 167, 169, 175]"
agent_c,L100,middle,75,28,47,5,0.5714,175,"[0, 1, 2, 5, 6, 7, 8, 9, 10, 11, 12, 14, 16, 18, 20, 21, 22, 23, 24, 25, 26, 29, 30, 31, 33, 35, 38, 42, 43, 47, 48, 49, 55, 56, 58, 59, 67, 69, 70, 72, 74, 75, 76, 77, 78, 79, 82, 93, 94, 95, 97, 99, 101, 113, 116, 117, 118, 119, 121, 122, 136, 138, 140, 142, 152, 153, 155, 156, 160, 161, 162, 170, 171, 172, 173]"
agent_c,L100,middle,76,39,37,7,0.5682,176,"[0, 4, 5, 6, 8, 9, 10, 11, 13, 14, 17, 19, 20, 21, 22, 23, 24, 25, 28, 29, 30, 31, 32, 35, 36, 38, 39, 43, 47, 51, 52, 53, 56, 57, 63, 69, 70, 72, 76, 77, 80, 89, 91, 92, 93, 95, 96, 97, 98, 99, 100, 113, 116, 119, 122, 134, 136, 137, 138, 139, 141, 150, 151, 152, 153, 155, 157, 158, 159, 160, 161, 162, 163, 170, 172, 174]"
agent_c,L100,middle,81,32,49,1,0.5525,181,"[0, 1, 2, 3, 4, 5, 6, 9, 10, 11, 12, 13, 14, 15, 16, 17, 18, 19, 20, 22, 23, 25, 26, 27, 29, 30, 31, 33, 37, 38, 39, 49, 50, 52, 53, 54, 55, 57, 58, 59, 66, 67, 69, 70, 71, 72, 73, 74, 75, 79, 93, 94, 95, 96, 97, 99, 114, 119, 132, 133, 135, 136, 137, 138, 140, 152, 153, 155, 156, 158, 159, 166, 168, 169, 170, 171, 173, 174, 175, 177, 179]"
agent_c,L100,middle,74,38,36,2,0.5747,174,"[0, 1, 2, 3, 5, 9, 11, 12, 13, 14, 17, 18, 19, 20, 21, 22, 24, 25, 26, 29, 31, 33, 34, 36, 37, 38, 40, 45, 49, 50, 51, 52, 54, 56, 57, 58, 59, 61, 68, 69, 71, 72, 74, 75, 76, 77, 78, 80, 81, 94, 95, 96, 97, 98, 100, 101, 102, 104, 120, 121, 122, 123, 125, 140, 142, 143, 145, 159, 161, 164, 168, 170, 171, 172]"
agent_c,L100,middle,73,34,39,3,0.578,173,"[0, 1, 2, 3, 8, 9, 10, 11, 14, 15, 16, 18, 19, 20, 22, 25, 27, 28, 29, 30, 32, 33, 36, 37, 39, 40, 42, 46, 47, 50, 51, 52, 53, 57, 60, 61, 62, 67, 68, 69, 71, 73, 75, 76, 78, 79, 80, 81, 83, 96, 97, 99, 101, 102, 116, 117, 118, 119, 120, 123, 137, 139, 140, 141, 144, 154, 155, 159, 160, 161, 162, 163, 165]"
agent_c,L100,middle,74,39,35,4,0.5747,174,"[0, 1, 2, 3, 5, 7, 8, 9, 11, 12, 15, 18, 21, 22, 23, 25, 26, 29, 35, 36, 38, 39, 40, 41, 43, 44, 45, 46, 47, 48, 49, 50, 52, 53, 54, 55, 57, 58, 60, 62, 70, 71, 72, 73, 74, 75, 76, 78, 79, 81, 94, 95, 96, 97, 98, 100, 101, 117, 119, 120, 121, 122, 136, 139, 140, 142, 143, 145, 157, 158, 163, 164, 170, 172]"
agent_c,L100,middle,77,37,40,7,0.565,177,"[0, 1, 2, 5, 7, 8, 10, 11, 14, 16, 17, 19, 21, 28, 29, 30, 32, 33, 34, 36, 37, 38, 39, 41, 42, 43, 44, 46, 47, 48, 51, 52, 53, 54, 56, 57, 58, 62, 69, 70, 72, 73, 74, 75, 76, 77, 80, 92, 94, 95, 96, 97, 99, 113, 115, 116, 117, 118, 121, 134, 135, 137, 138, 139, 141, 154, 156, 158, 159, 160, 162, 169, 170, 171, 172, 173, 175]"
agent_c,L100,middle,73,35,38,0,0.578,173,"[0, 1, 3, 4, 6, 9, 13, 14, 15, 16, 17, 18, 19, 20, 21, 25, 26, 27, 29, 30, 31, 32, 33, 34, 35, 36, 37, 38, 39, 40, 41, 44, 45, 46, 47, 48, 50, 51, 52, 53, 55, 57, 58, 59, 60, 77, 78, 79, 80, 95, 96, 98, 100, 113, 114, 115, 116, 117, 118, 119, 120, 122, 138, 139, 142, 154, 155, 156, 157, 159, 160, 162, 169]"
agent_c,L100,middle,70,32,38,1,0.5882,170,"[1, 5, 6, 9, 10, 11, 13, 14, 16, 17, 18, 19, 20, 21, 22, 23, 26, 27, 28, 29, 30, 31, 32, 33, 35, 37, 38, 39, 46, 48, 49, 50, 52, 54, 55, 56, 57, 58, 59, 65, 67, 71, 72, 74, 78, 79, 80, 92, 94, 98, 99, 100, 114, 115, 116, 118, 119, 121, 134, 136, 138, 139, 140, 151, 152, 154, 155, 157, 158, 160]"
agent_c,L100,middle,71,25,46,5,0.5848,171,"[0, 1, 3, 4, 5, 6, 7, 8, 9, 10, 11, 12, 13, 15, 17, 18, 19, 20, 21, 22, 23, 24, 27, 28, 30, 31, 33, 34, 35, 37, 38, 41, 50, 51, 52, 53, 54, 55, 56, 57, 58, 59, 60, 61, 71, 72, 73, 76, 78, 80, 81, 82, 84, 105, 119, 121, 122, 123, 135, 137, 138, 139, 140, 141, 142, 143, 156, 158, 161, 162, 163]"
agent_c,L100,middle,82,48,34,2,0.5495,182,"[1, 2, 5, 6, 7, 8, 10, 11, 13, 14, 15, 16, 18, 19, 20, 26, 27, 29, 30, 31, 32, 34, 35, 36, 37, 39, 44, 45, 47, 49, 51, 53, 55, 56, 60, 65, 66, 67, 69, 71, 72, 74, 75, 76, 77, 78, 79, 96, 99, 112, 120, 129, 130, 132, 133, 134, 135, 137, 139, 140, 149, 150, 151, 152, 153, 154, 156, 157, 158, 160, 166, 168, 169, 170, 171, 172, 173, 174, 175, 176, 177, 178]"
agent_c,L100,middle,73,55,18,4,0.578,173,"[0, 1, 2, 3, 6, 7, 9, 11, 13, 14, 15, 16, 17, 18, 19, 20, 21, 22, 24, 26, 28, 29, 31, 35, 36, 37, 38, 39, 46, 48, 50, 51, 52, 53, 54, 55, 56, 57, 58, 59, 61, 72, 73, 74, 75, 76, 78, 80, 92, 93, 95, 96, 97, 99, 102, 117, 118, 121, 123, 136, 137, 138, 143, 152, 153, 154, 158, 159, 160, 163, 167, 170, 171]"
agent_c,L100,middle,80,46,34,4,0.5556,180,"[0, 1, 2, 3, 4, 5, 6, 7, 9, 10, 11, 13, 14, 17, 18, 19, 23, 24, 29, 30, 31, 32, 33, 36, 37, 38, 40, 41, 42, 44, 45, 46, 47, 48, 49, 50, 56, 59, 61, 72, 73, 74, 76, 77, 78, 80, 92, 93, 95, 96, 97, 99, 100, 101, 103, 115, 117, 118, 119, 122, 137, 138, 139, 140, 141, 143, 154, 156, 157, 158, 159, 160, 161, 163, 171, 172, 173, 174, 175, 177]"
agent_c,L100,middle,83,35,48,9,0.5464,183,"[1, 3, 4, 5, 6, 7, 8, 9, 14, 15, 16, 17, 18, 19, 20, 21, 22, 23, 24, 25, 26, 27, 28, 30, 32, 33, 34, 35, 36, 37, 38, 39, 40, 51, 55, 56, 57, 58, 59, 63, 71, 72, 73, 74, 75, 77, 78, 79, 82, 95, 97, 98, 99, 100, 103, 118, 119, 121, 123, 136, 137, 138, 139, 140, 141, 142, 144, 155, 156, 157, 158, 160, 162, 166, 172, 173, 174, 175, 176, 177, 179, 180, 181]"
agent_c,L100,middle,74,36,38,1,0.5747,174,"[0, 1, 2, 3, 4, 7, 8, 9, 10, 13, 14, 16, 17, 19, 20, 21, 23, 24, 25, 26, 28, 29, 30, 31, 33, 36, 38, 40, 41, 43, 45, 46, 47, 50, 51, 52, 53, 54, 55, 56, 58, 59, 60, 73, 74, 75, 76, 78, 80, 92, 95, 97, 99, 101, 114, 115, 117, 119, 121, 135, 136, 137, 138, 139, 141, 151, 152, 153, 154, 155, 157, 158, 159, 163]"
agent_c,L100,middle,74,31,43,4,0.5747,174,"[0, 1, 5, 6, 7, 8, 10, 11, 12, 15, 16, 18, 19, 20, 21, 23, 24, 25, 26, 28, 31, 32, 34, 35, 38, 39, 40, 42, 46, 48, 50, 51, 52, 53, 54, 55, 56, 57, 60, 61, 62, 63, 75, 76, 77, 78, 80, 81, 83, 86, 100, 101, 103, 104, 105, 118, 120, 123, 125, 142, 143, 144, 145, 147, 154, 155, 156, 157, 159, 161, 162, 164, 166, 169]"
agent_c,L100,middle,77,32,45,4,0.565,177,"[0, 1, 2, 7, 9, 10, 11, 12, 14, 15, 17, 18, 21, 22, 24, 25, 26, 29, 30, 31, 33, 34, 35, 36, 37, 39, 40, 41, 46, 47, 48, 49, 50, 51, 53, 54, 55, 56, 57, 60, 62, 71, 72, 73, 74, 75, 78, 79, 81, 98, 99, 100, 101, 104, 119, 121, 123, 137, 140, 141, 142, 143, 144, 153, 155, 157, 158, 159, 160, 163, 165, 169, 171, 172, 173, 174, 175]"
agent_c,L100,middle,73,42,31,6,0.578,173,"[0, 1, 3, 4, 5, 7, 8, 10, 13, 14, 15, 18, 19, 20, 21, 23, 24, 25, 28, 29, 32, 35, 37, 39, 42, 43, 44, 46, 47, 48, 50, 51, 52, 53, 54, 56, 57, 58, 59, 61, 70, 72, 73, 74, 76, 77, 79, 81, 93, 94, 95, 96, 97, 98, 100, 115, 117, 119, 123, 136, 137, 138, 139, 140, 153, 154, 156, 157, 159, 161, 168, 169, 171]"
agent_c,L100,middle,78,38,40,1,0.5618,178,"[0, 1, 3, 4, 11, 12, 15, 16, 18, 19, 21, 22, 28, 29, 30, 33, 34, 36, 37, 38, 40, 41, 42, 43, 44, 45, 47, 48, 50, 51, 53, 54, 56, 57, 58, 60, 66, 67, 68, 69, 70, 71, 72, 74, 75, 76, 77, 78, 81, 94, 95, 96, 98, 100, 101, 118, 119, 120, 121, 134, 136, 139, 141, 151, 152, 153, 154, 155, 157, 158, 159, 160, 161, 162, 163, 165, 174, 175]"
agent_c,L100,middle,71,25,46,5,0.5848,171,"[0, 1, 2, 3, 4, 6, 7, 9, 10, 11, 12, 14, 15, 16, 17, 18, 19, 24, 27, 28, 29, 31, 34, 37, 38, 39, 45, 46, 50, 51, 52, 53, 57, 59, 64, 65, 67, 68, 69, 70, 72, 73, 74, 75, 76, 77, 78, 79, 95, 97, 100, 113, 114, 116, 117, 118, 119, 120, 132, 136, 137, 138, 139, 145, 155, 160, 164, 165, 166, 168, 169]"
agent_c,L100,middle,77,38,39,4,0.565,177,"[0, 1, 2, 4, 6, 7, 9, 12, 13, 14, 17, 19, 20, 21, 22, 23, 24, 26, 27, 28, 29, 30, 31, 33, 34, 35, 36, 37, 38, 39, 40, 41, 42, 43, 44, 45, 46, 47, 48, 50, 51, 53, 56, 57, 58, 59, 75, 76, 77, 78, 79, 83, 99, 101, 115, 116, 119, 120, 121, 135, 136, 139, 140, 141, 150, 152, 153, 155, 156, 157, 158, 159, 160, 162, 173, 174, 175]"
agent_c,L100,middle,76,37,39,0,0.5682,176,"[0, 2, 5, 6, 7, 8, 9, 10, 11, 12, 14, 15, 16, 17, 18, 19, 20, 21, 24, 25, 26, 27, 29, 30, 32, 33, 34, 35, 36, 37, 39, 40, 41, 52, 53, 54, 55, 56, 57, 58, 59, 61, 71, 72, 73, 74, 75, 76, 78, 79, 81, 95, 96, 98, 100, 101, 118, 119, 121, 134, 137, 139, 141, 151, 152, 153, 155, 158, 160, 162, 163, 169, 170, 172, 173, 174]"
agent_c,L100,middle,74,45,29,2,0.5747,174,"[0, 1, 4, 5, 7, 8, 9, 10, 11, 12, 14, 15, 16, 17, 18, 19, 23, 24, 25, 26, 28, 31, 32, 33, 35, 38, 39, 40, 41, 42, 44, 46, 47, 48, 49, 51, 52, 53, 54, 55, 56, 58, 60, 62, 75, 77, 81, 83, 95, 96, 98, 99, 100, 101, 102, 115, 116, 117, 118, 119, 121, 122, 138, 139, 140, 141, 143, 153, 157, 158, 159, 160, 164, 172]"
agent_c,L100,middle,71,35,36,5,0.5848,171,"[1, 2, 3, 5, 6, 8, 9, 10, 11, 13, 14, 16, 19, 20, 21, 22, 23, 25, 26, 27, 28, 29, 31, 33, 36, 37, 38, 39, 40, 43, 46, 47, 48, 50, 53, 55, 56, 57, 58, 59, 61, 72, 73, 75, 76, 78, 79, 82, 94, 95, 99, 100, 115, 117, 120, 125, 139, 140, 141, 142, 145, 151, 152, 154, 155, 156, 157, 158, 159, 160, 164]"
agent_c,L100,middle,75,33,42,5,0.5714,175,"[0, 1, 2, 4, 5, 7, 8, 9, 10, 11, 12, 13, 14, 15, 16, 17, 18, 19, 20, 32, 34, 35, 36, 38, 39, 41, 42, 43, 44, 47, 48, 49, 50, 53, 54, 55, 56, 57, 58, 59, 61, 74, 77, 78, 80, 91, 92, 93, 94, 95, 96, 97, 98, 100, 101, 105, 117, 120, 122, 136, 137, 138, 139, 140, 141, 142, 143, 144, 155, 156, 158, 160, 162, 164, 165]"
agent_c,L100,middle,78,40,38,6,0.5618,178,"[1, 2, 3, 4, 5, 6, 7, 8, 10, 12, 14, 15, 16, 17, 21, 22, 23, 27, 30, 31, 32, 33, 36, 37, 38, 39, 41, 42, 43, 45, 46, 50, 53, 56, 57, 58, 60, 69, 70, 71, 72, 73, 75, 77, 78, 81, 93, 95, 96, 97, 98, 99, 101, 115, 117, 120, 134, 137, 138, 139, 141, 149, 152, 153, 154, 155, 156, 157, 158, 159, 160, 162, 169, 171, 172, 174, 175, 176]"
agent_c,L100,middle,75,40,35,3,0.5714,175,"[0, 1, 2, 4, 7, 8, 9, 10, 11, 12, 13, 14, 15, 18, 19, 22, 28, 29, 31, 32, 33, 36, 37, 39, 40, 41, 42, 43, 45, 46, 47, 48, 49, 50, 51, 52, 53, 54, 55, 57, 58, 59, 72, 73, 74, 75, 76, 78, 80, 92, 93, 94, 95, 98, 99, 101, 103, 104, 119, 120, 122, 124, 126, 141, 142, 143, 145, 146, 160, 161, 162, 163, 164, 165, 167]"
agent_c,L100,middle,74,34,40,4,0.5747,174,"[0, 2, 4, 5, 7, 8, 9, 10, 12, 15, 17, 20, 23, 25, 26, 27, 28, 29, 30, 31, 34, 35, 36, 39, 41, 43, 44, 45, 46, 47, 49, 50, 51, 52, 53, 54, 55, 56, 58, 59, 60, 72, 74, 75, 76, 77, 78, 79, 80, 83, 99, 100, 102, 113, 115, 116, 117, 119, 120, 121, 122, 137, 138, 142, 143, 144, 145, 156, 158, 159, 160, 163, 164, 167]"
agent_c,L100,middle,78,39,39,4,0.5618,178,"[1, 2, 3, 4, 5, 6, 8, 9, 10, 11, 12, 13, 14, 15, 16, 18, 19, 24, 25, 26, 27, 28, 29, 30, 31, 32, 34, 35, 36, 37, 39, 40, 42, 45, 46, 47, 48, 50, 51, 53, 55, 57, 58, 59, 60, 75, 76, 77, 78, 81, 95, 98, 99, 102, 114, 116, 117, 118, 119, 120, 121, 122, 138, 140, 141, 143, 154, 155, 157, 160, 161, 162, 170, 171, 173, 174, 175, 176]"
agent_c,L100,middle,76,44,32,2,0.5682,176,"[0, 1, 2, 3, 4, 5, 6, 8, 10, 11, 13, 14, 16, 18, 19, 20, 24, 26, 27, 30, 31, 32, 33, 34, 35, 36, 39, 45, 48, 49, 50, 52, 53, 54, 55, 59, 61, 68, 70, 71, 73, 74, 75, 76, 77, 78, 80, 82, 83, 96, 97, 98, 99, 100, 101, 103, 119, 120, 121, 123, 137, 138, 139, 144, 153, 156, 157, 159, 160, 161, 162, 165, 171, 172, 173, 174]"
agent_c,L100,middle,71,28,43,3,0.5848,171,"[0, 1, 5, 6, 7, 8, 9, 10, 11, 13, 15, 16, 17, 18, 20, 22, 23, 24, 25, 26, 28, 30, 32, 34, 35, 36, 37, 38, 39, 40, 41, 42, 43, 44, 47, 49, 51, 52, 58, 59, 70, 71, 74, 76, 78, 81, 92, 95, 97, 99, 100, 103, 116, 118, 120, 121, 124, 138, 139, 142, 143, 144, 152, 153, 155, 157, 161, 163, 164, 165, 166]"
agent_c,L100,middle,73,15,58,5,0.578,173,"[2, 3, 4, 5, 6, 8, 9, 10, 11, 13, 15, 17, 18, 19, 21, 22, 23, 24, 27, 28, 29, 31, 32, 33, 34, 35, 36, 37, 41, 45, 48, 49, 50, 51, 52, 53, 55, 56, 57, 58, 59, 60, 61, 63, 77, 78, 80, 82, 85, 99, 101, 102, 104, 119, 121, 122, 123, 124, 137, 138, 140, 143, 144, 152, 154, 155, 156, 158, 159, 160, 161, 162, 164]"
agent_c,L100,middle,75,31,44,4,0.5714,175,"[1, 3, 5, 7, 10, 12, 13, 14, 15, 18, 19, 20, 21, 22, 23, 24, 25, 31, 34, 36, 37, 39, 41, 44, 45, 47, 49, 50, 51, 52, 54, 55, 57, 58, 59, 60, 68, 69, 71, 72, 74, 79, 81, 90, 91, 92, 96, 97, 98, 99, 101, 112, 114, 115, 116, 117, 118, 119, 120, 122, 136, 138, 143, 153, 155, 156, 157, 158, 159, 160, 161, 162, 169, 170, 173]"
agent_c,L100,middle,82,40,42,2,0.5495,182,"[2, 5, 6, 7, 8, 9, 15, 16, 18, 19, 21, 22, 23, 25, 26, 28, 29, 30, 31, 32, 33, 34, 36, 37, 39, 40, 45, 47, 49, 51, 52, 53, 55, 56, 58, 59, 60, 68, 69, 71, 73, 74, 77, 78, 80, 92, 93, 94, 95, 96, 97, 98, 99, 100, 115, 118, 119, 120, 132, 134, 135, 137, 138, 139, 141, 153, 154, 156, 157, 158, 159, 160, 167, 168, 169, 170, 173, 174, 175, 177, 178, 179]"
agent_c,L100,middle,76,33,43,3,0.5682,176,"[0, 2, 3, 4, 9, 10, 11, 13, 16, 17, 18, 19, 22, 23, 25, 26, 27, 28, 30, 31, 33, 36, 37, 40, 41, 42, 46, 47, 51, 54, 55, 56, 57, 59, 60, 62, 63, 64, 66, 75, 79, 80, 81, 82, 83, 84, 85, 97, 98, 99, 100, 101, 102, 103, 104, 105, 106, 120, 122, 126, 142, 143, 144, 147, 154, 158, 159, 160, 161, 162, 163, 165, 166, 167, 168, 169]"
agent_c,L100,middle,75,33,42,2,0.5714,175,"[0, 1, 8, 11, 14, 15, 16, 18, 19, 20, 21, 22, 23, 24, 25, 27, 28, 29, 30, 31, 32, 33, 34, 35, 36, 38, 39, 43, 47, 49, 50, 51, 52, 53, 55, 57, 60, 62, 63, 73, 74, 75, 76, 77, 78, 79, 80, 81, 84, 96, 101, 102, 103, 104, 105, 119, 120, 121, 123, 124, 125, 139, 141, 144, 146, 155, 156, 157, 158, 159, 161, 162, 163, 164, 165]"
agent_c,L100,middle,69,28,41,2,0.5917,169,"[1, 2, 3, 4, 6, 7, 8, 9, 11, 14, 16, 17, 18, 19, 20, 21, 22, 24, 25, 26, 29, 30, 31, 34, 36, 37, 38, 42, 48, 50, 51, 53, 54, 55, 56, 58, 59, 60, 61, 64, 73, 74, 76, 78, 80, 81, 82, 96, 97, 98, 99, 101, 102, 115, 116, 117, 120, 122, 136, 137, 138, 139, 141, 142, 152, 155, 157, 160, 162]"
agent_c,L100,middle,78,42,36,1,0.5618,178,"[1, 2, 4, 5, 7, 9, 11, 12, 15, 17, 18, 19, 20, 21, 22, 23, 24, 25, 26, 27, 28, 30, 31, 32, 37, 38, 39, 45, 48, 51, 52, 54, 55, 56, 57, 58, 59, 64, 65, 66, 67, 69, 74, 75, 76, 78, 81, 92, 93, 95, 96, 98, 99, 100, 102, 117, 118, 119, 121, 134, 135, 136, 137, 138, 140, 141, 153, 155, 156, 158, 159, 160, 161, 168, 171, 172, 175, 176]"
agent_c,L100,middle,86,37,49,3,0.5376,186,"[0, 2, 3, 4, 5, 6, 8, 12, 13, 15, 16, 17, 18, 19, 20, 21, 22, 23, 24, 25, 26, 28, 29, 31, 33, 34, 35, 36, 37, 38, 40, 50, 51, 52, 53, 54, 55, 56, 57, 58, 59, 60, 68, 70, 72, 73, 74, 77, 78, 79, 80, 95, 96, 98, 102, 117, 119, 121, 135, 136, 137, 138, 139, 140, 151, 152, 153, 154, 155, 156, 157, 158, 160, 168, 169, 170, 171, 172, 173, 175, 176, 177, 178, 180, 181, 182]"
agent_c,L100,middle,79,33,46,6,0.5587,179,"[0, 3, 4, 6, 7, 8, 10, 14, 18, 20, 21, 22, 24, 25, 28, 33, 35, 36, 37, 38, 39, 42, 44, 47, 48, 49, 50, 51, 52, 56, 57, 58, 59, 61, 68, 69, 71, 72, 73, 74, 76, 78, 79, 81, 91, 93, 94, 97, 100, 102, 113, 115, 116, 118, 120, 121, 133, 136, 137, 138, 141, 143, 151, 152, 153, 154, 155, 156, 157, 159, 161, 162, 169, 170, 172, 173, 174, 176, 177]"
agent_c,L100,middle,74,46,28,15,0.5747,174,"[0, 1, 2, 4, 5, 6, 9, 10, 11, 13, 15, 16, 17, 19, 20, 21, 22, 24, 25, 27, 28, 29, 30, 31, 33, 36, 38, 39, 41, 47, 48, 51, 53, 55, 56, 57, 59, 60, 62, 71, 72, 73, 74, 76, 77, 78, 79, 80, 81, 88, 100, 104, 119, 120, 130, 138, 139, 140, 141, 144, 145, 153, 155, 156, 157, 158, 159, 160, 161, 162, 164, 165, 168, 172]"
agent_c,L100,middle,77,41,36,3,0.565,177,"[0, 1, 2, 4, 5, 6, 7, 9, 10, 13, 14, 15, 19, 21, 22, 24, 26, 27, 28, 30, 31, 32, 38, 39, 41, 44, 45, 47, 48, 49, 50, 51, 54, 56, 57, 58, 60, 71, 72, 74, 76, 77, 78, 80, 90, 92, 93, 94, 95, 96, 97, 100, 120, 130, 131, 132, 136, 138, 140, 148, 149, 150, 151, 152, 153, 157, 159, 162, 166, 167, 168, 169, 170, 172, 173, 174, 175]"
agent_c,L100,middle,75,33,42,5,0.5714,175,"[2, 3, 4, 5, 6, 7, 8, 9, 10, 11, 12, 13, 14, 15, 16, 17, 18, 20, 21, 23, 24, 25, 29, 30, 33, 35, 36, 39, 40, 41, 48, 49, 53, 54, 55, 56, 57, 58, 59, 60, 61, 74, 75, 76, 77, 78, 80, 82, 95, 96, 97, 98, 99, 100, 104, 118, 119, 120, 123, 136, 137, 138, 140, 141, 142, 145, 146, 147, 148, 159, 162, 163, 164, 165, 168]"
agent_c,L100,middle,76,44,32,2,0.5682,176,"[1, 2, 4, 5, 9, 10, 11, 12, 14, 15, 16, 18, 21, 22, 23, 25, 26, 28, 29, 30, 31, 33, 34, 35, 36, 37, 38, 39, 47, 49, 50, 51, 52, 53, 54, 57, 58, 59, 65, 66, 67, 70, 71, 73, 76, 77, 78, 79, 80, 93, 94, 95, 96, 97, 100, 101, 118, 119, 120, 121, 123, 136, 138, 139, 141, 142, 143, 155, 156, 157, 158, 162, 163, 165, 173, 174]"
agent_c,L100,middle,73,31,42,6,0.578,173,"[0, 1, 2, 3, 6, 7, 8, 9, 11, 13, 14, 15, 18, 19, 20, 21, 23, 25, 26, 30, 31, 32, 35, 36, 37, 38, 39, 45, 47, 49, 53, 54, 55, 56, 58, 60, 66, 67, 69, 70, 73, 74, 76, 78, 80, 81, 83, 84, 97, 98, 101, 103, 104, 118, 120, 121, 123, 124, 125, 137, 139, 142, 143, 150, 157, 159, 160, 162, 163, 164, 165, 166, 170]"
agent_c,L100,middle,74,40,34,5,0.5747,174,"[0, 2, 3, 7, 8, 9, 13, 14, 15, 16, 17, 18, 19, 20, 21, 22, 23, 24, 26, 28, 31, 32, 33, 34, 36, 37, 38, 39, 40, 41, 42, 45, 47, 48, 51, 52, 53, 55, 56, 58, 59, 61, 64, 77, 79, 81, 82, 83, 84, 85, 86, 102, 104, 105, 106, 107, 122, 123, 124, 126, 129, 146, 148, 155, 156, 158, 159, 160, 161, 162, 163, 164, 166, 168]"
agent_c,L100,middle,74,28,46,3,0.5747,174,"[3, 4, 6, 8, 11, 13, 15, 16, 17, 18, 19, 21, 23, 24, 25, 27, 28, 29, 30, 31, 32, 33, 34, 36, 38, 39, 44, 45, 46, 47, 48, 49, 50, 52, 53, 54, 55, 56, 62, 69, 70, 71, 72, 74, 75, 77, 79, 80, 81, 94, 95, 96, 98, 101, 116, 117, 118, 119, 120, 121, 134, 136, 137, 138, 139, 141, 153, 154, 156, 159, 160, 161, 162, 164]"
agent_c,L100,middle,81,33,48,3,0.5525,181,"[1, 6, 7, 8, 9, 11, 12, 13, 14, 15, 18, 19, 21, 22, 24, 25, 29, 31, 33, 35, 36, 37, 39, 41, 42, 43, 45, 46, 48, 50, 51, 52, 53, 55, 56, 57, 58, 61, 68, 69, 70, 73, 74, 75, 78, 79, 80, 92, 93, 94, 96, 98, 100, 115, 117, 118, 120, 132, 134, 135, 136, 137, 140, 141, 143, 154, 156, 157, 158, 159, 160, 161, 162, 163, 172, 173, 174, 175, 177, 178, 179]"
agent_c,L100,middle,76,21,55,5,0.5682,176,"[0, 2, 3, 5, 6, 7, 8, 9, 10, 11, 12, 13, 14, 15, 17, 19, 21, 22, 24, 25, 26, 28, 29, 30, 33, 35, 36, 37, 39, 40, 42, 44, 51, 52, 54, 55, 57, 59, 60, 61, 63, 65, 77, 78, 79, 80, 81, 82, 83, 84, 97, 98, 99, 100, 101, 102, 103, 104, 120, 121, 122, 123, 125, 126, 128, 131, 147, 150, 160, 161, 162, 163, 165, 166, 169, 174]"
agent_c,L100,middle,74,28,46,6,0.5747,174,"[1, 2, 3, 5, 6, 7, 10, 11, 12, 13, 15, 17, 18, 19, 20, 21, 23, 24, 25, 26, 27, 28, 29, 30, 32, 36, 38, 39, 41, 46, 48, 49, 50, 51, 52, 54, 55, 57, 60, 61, 62, 63, 66, 78, 79, 80, 81, 82, 83, 84, 85, 87, 103, 104, 105, 106, 124, 126, 138, 140, 141, 143, 144, 145, 146, 156, 158, 159, 160, 161, 162, 164, 165, 167]"
agent_c,L100,middle,76,44,32,7,0.5682,176,"[4, 5, 7, 9, 11, 12, 14, 16, 17, 18, 22, 23, 24, 25, 27, 28, 29, 30, 32, 33, 34, 35, 37, 38, 43, 44, 46, 47, 48, 50, 51, 55, 56, 57, 58, 59, 60, 69, 70, 71, 73, 76, 78, 80, 90, 92, 96, 97, 99, 101, 111, 113, 114, 115, 116, 117, 120, 121, 122, 137, 138, 141, 142, 150, 151, 153, 154, 155, 157, 159, 161, 163, 171, 172, 173, 174]"
agent_c,L100,middle,84,52,32,2,0.5435,184,"[1, 2, 3, 6, 7, 9, 13, 16, 19, 20, 22, 27, 28, 29, 32, 33, 34, 35, 36, 37, 40, 41, 47, 48, 49, 50, 51, 52, 53, 54, 55, 57, 59, 66, 67, 69, 72, 75, 79, 87, 88, 90, 91, 92, 93, 94, 95, 96, 98, 99, 100, 114, 115, 118, 119, 120, 132, 133, 134, 137, 138, 139, 141, 151, 152, 153, 154, 155, 157, 158, 160, 161, 162, 169, 171, 172, 173, 174, 175, 177, 178, 179, 180, 182]"
agent_c,L100,middle,67,24,43,1,0.5988,167,"[0, 1, 2, 3, 5, 6, 7, 9, 10, 11, 12, 14, 15, 16, 17, 19, 21, 23, 24, 25, 26, 28, 31, 32, 33, 34, 35, 37, 39, 47, 48, 50, 53, 55, 56, 57, 59, 60, 68, 69, 71, 72, 73, 74, 75, 77, 78, 80, 94, 95, 96, 97, 99, 101, 117, 119, 120, 132, 136, 137, 138, 139, 140, 151, 157, 161, 165]"
agent_c,L100,middle,74,34,40,5,0.5747,174,"[0, 1, 2, 3, 4, 5, 6, 7, 8, 9, 10, 12, 14, 15, 16, 18, 19, 20, 21, 22, 23, 25, 28, 29, 31, 34, 36, 39, 40, 41, 48, 50, 51, 53, 54, 55, 56, 59, 60, 61, 62, 64, 75, 76, 77, 79, 80, 82, 84, 98, 99, 100, 102, 103, 104, 106, 121, 123, 124, 125, 127, 139, 141, 144, 147, 157, 158, 159, 162, 164, 165, 166, 168, 172]"
agent_c,L100,middle,79,38,41,2,0.5587,179,"[0, 1, 2, 4, 5, 6, 7, 8, 9, 10, 11, 12, 13, 15, 16, 17, 18, 19, 21, 22, 23, 24, 26, 29, 30, 31, 32, 34, 35, 36, 37, 38, 41, 44, 54, 55, 56, 57, 58, 60, 61, 62, 63, 65, 66, 67, 68, 81, 82, 83, 86, 87, 89, 102, 103, 104, 106, 108, 109, 125, 126, 127, 128, 129, 130, 143, 145, 146, 147, 148, 150, 163, 164, 165, 166, 167, 169, 170, 172]"
agent_c,L0,long,34,11,23,1,0.7463,134,"[18, 19, 20, 22, 23, 24, 28, 30, 38, 40, 41, 42, 43, 45, 46, 47, 49, 50, 51, 53, 55, 56, 58, 61, 86, 88, 89, 90, 91, 115, 118, 119, 121, 122]"
agent_c,L0,long,37,13,24,2,0.7299,137,"[18, 19, 20, 21, 22, 23, 25, 26, 27, 28, 30, 41, 43, 44, 45, 46, 47, 49, 52, 54, 55, 56, 57, 59, 60, 61, 86, 87, 88, 89, 90, 92, 94, 120, 122, 123, 135]"
agent_c,L0,long,37,22,15,1,0.7299,137,"[6, 14, 16, 18, 19, 20, 21, 22, 24, 25, 26, 28, 29, 30, 32, 52, 53, 54, 55, 58, 60, 61, 62, 64, 90, 95, 113, 115, 116, 117, 118, 119, 120, 121, 124, 125, 126]"
agent_c,L0,long,37,29,8,2,0.7299,137,"[6, 12, 13, 15, 16, 17, 18, 19, 21, 22, 23, 24, 27, 29, 49, 50, 52, 53, 54, 55, 56, 57, 58, 59, 62, 85, 86, 87, 88, 90, 112, 115, 116, 117, 118, 119, 120]"
agent_c,L0,long,38,27,11,0,0.7246,138,"[20, 22, 23, 24, 25, 26, 27, 28, 29, 30, 31, 42, 43, 45, 46, 47, 48, 52, 53, 54, 55, 60, 62, 83, 89, 90, 92, 93, 94, 118, 119, 120, 121, 122, 123, 124, 125, 127]"
agent_c,L0,long,36,9,27,2,0.7353,136,"[6, 12, 13, 14, 15, 18, 20, 21, 22, 23, 28, 29, 48, 49, 50, 53, 55, 56, 57, 59, 60, 61, 83, 88, 90, 92, 112, 113, 114, 115, 116, 117, 118, 119, 120, 122]"
agent_c,L0,long,36,18,18,1,0.7353,136,"[6, 13, 14, 15, 16, 20, 21, 22, 23, 24, 27, 29, 32, 50, 52, 54, 56, 57, 59, 61, 80, 81, 82, 83, 84, 86, 89, 91, 113, 115, 116, 117, 118, 119, 120, 121]"
agent_c,L0,long,33,17,16,3,0.7519,133,"[18, 20, 21, 22, 24, 25, 26, 28, 29, 38, 39, 40, 41, 43, 49, 51, 52, 54, 55, 57, 58, 59, 60, 83, 85, 86, 88, 90, 114, 116, 117, 119, 123]"
agent_c,L0,long,35,12,23,3,0.7407,135,"[6, 14, 16, 17, 18, 19, 20, 21, 23, 24, 25, 29, 30, 31, 32, 52, 54, 56, 59, 60, 61, 63, 83, 87, 90, 91, 94, 113, 116, 117, 118, 119, 122, 123, 124]"
agent_c,L0,long,35,9,26,1,0.7407,135,"[18, 19, 20, 22, 24, 27, 29, 30, 33, 43, 45, 46, 47, 48, 50, 53, 54, 56, 57, 59, 61, 62, 63, 64, 88, 91, 92, 93, 95, 119, 121, 122, 123, 124, 125]"
agent_c,L0,long,34,24,10,0,0.7463,134,"[18, 19, 20, 21, 23, 24, 25, 27, 28, 29, 41, 42, 44, 45, 46, 47, 48, 49, 50, 51, 52, 53, 55, 56, 57, 58, 59, 83, 88, 89, 118, 119, 120, 132]"
agent_c,L0,long,34,17,17,0,0.7463,134,"[18, 19, 20, 22, 23, 25, 26, 28, 29, 38, 40, 42, 43, 44, 47, 48, 49, 51, 52, 53, 54, 57, 58, 59, 84, 85, 86, 87, 88, 89, 116, 117, 118, 119]"
agent_c,L0,long,31,13,18,0,0.7634,131,"[6, 14, 17, 18, 19, 20, 22, 23, 24, 26, 28, 29, 48, 49, 51, 54, 55, 56, 57, 58, 59, 60, 82, 85, 87, 89, 90, 91, 115, 117, 121]"
agent_c,L0,long,29,9,20,1,0.7752,129,"[18, 19, 20, 21, 23, 24, 26, 27, 29, 40, 41, 42, 43, 48, 49, 50, 51, 59, 78, 83, 84, 87, 88, 90, 113, 114, 115, 118, 119]"
agent_c,L0,long,36,13,23,0,0.7353,136,"[6, 13, 15, 17, 18, 20, 21, 24, 26, 28, 29, 47, 48, 49, 52, 55, 56, 59, 62, 63, 86, 87, 88, 89, 90, 91, 92, 93, 94, 116, 118, 119, 121, 123, 125, 126]"
agent_c,L0,long,37,20,17,6,0.7299,137,"[6, 13, 14, 16, 17, 18, 19, 21, 22, 23, 24, 25, 26, 27, 28, 34, 55, 57, 58, 59, 61, 81, 82, 83, 84, 86, 87, 88, 92, 114, 115, 118, 119, 120, 121, 122, 123]"
agent_c,L0,long,34,18,16,0,0.7463,134,"[6, 13, 14, 15, 19, 20, 21, 22, 24, 25, 27, 29, 47, 50, 51, 53, 54, 56, 57, 58, 59, 81, 82, 83, 88, 89, 90, 112, 113, 114, 115, 117, 119, 120]"
agent_c,L0,long,34,21,13,7,0.7463,134,"[6, 12, 14, 17, 18, 19, 21, 22, 23, 25, 26, 27, 28, 34, 55, 56, 57, 59, 78, 79, 81, 82, 83, 84, 85, 87, 88, 91, 113, 114, 115, 116, 118, 119]"
agent_c,L0,long,36,14,22,1,0.7353,136,"[20, 21, 22, 23, 24, 27, 28, 29, 38, 39, 40, 41, 42, 43, 44, 45, 46, 49, 50, 51, 53, 55, 56, 58, 59, 82, 86, 87, 89, 116, 117, 118, 119, 120, 122, 134]"
agent_c,L0,long,32,16,16,0,0.7576,132,"[9, 15, 16, 17, 18, 19, 20, 22, 23, 24, 25, 26, 27, 29, 50, 51, 52, 55, 58, 59, 77, 81, 82, 83, 84, 85, 88, 89, 111, 113, 115, 119]"
agent_c,L0,long,33,19,14,3,0.7519,133,"[18, 19, 20, 23, 24, 25, 26, 28, 29, 38, 40, 42, 43, 45, 46, 47, 50, 51, 53, 54, 56, 57, 60, 62, 84, 89, 90, 91, 114, 117, 119, 120, 123]"
agent_c,L0,long,34,14,20,1,0.7463,134,"[6, 13, 17, 19, 21, 22, 23, 24, 26, 29, 48, 49, 50, 51, 53, 54, 55, 56, 57, 58, 59, 60, 82, 83, 85, 86, 90, 111, 114, 116, 117, 118, 119, 121]"
agent_c,L0,long,32,17,15,3,0.7576,132,"[19, 21, 23, 24, 29, 30, 37, 38, 40, 42, 43, 45, 46, 47, 48, 49, 50, 51, 53, 55, 56, 57, 59, 60, 61, 86, 87, 90, 93, 119, 120, 122]"
agent_c,L0,long,34,14,20,3,0.7463,134,"[18, 19, 21, 22, 23, 25, 26, 27, 28, 30, 40, 41, 42, 43, 45, 46, 47, 48, 50, 51, 52, 53, 55, 57, 59, 86, 88, 89, 91, 116, 118, 119, 121, 132]"
agent_c,L0,long,36,16,20,1,0.7353,136,"[18, 20, 21, 22, 24, 26, 27, 28, 29, 38, 39, 41, 43, 45, 47, 48, 51, 52, 53, 54, 55, 56, 57, 58, 61, 85, 87, 88, 89, 90, 116, 117, 118, 120, 121, 134]"
agent_c,L0,long,32,14,18,1,0.7576,132,"[8, 16, 17, 18, 19, 20, 21, 22, 25, 26, 28, 29, 47, 48, 49, 50, 51, 53, 55, 57, 60, 81, 82, 84, 85, 86, 87, 89, 91, 114, 116, 120]"
agent_c,L0,long,30,13,17,5,0.7692,130,"[7, 15, 18, 19, 20, 21, 24, 25, 26, 28, 29, 30, 31, 33, 52, 54, 56, 57, 58, 59, 61, 62, 64, 88, 91, 95, 113, 121, 123, 125]"
agent_c,L0,long,35,13,22,0,0.7407,135,"[18, 19, 20, 21, 22, 23, 25, 27, 28, 29, 40, 41, 42, 43, 44, 45, 46, 48, 50, 52, 53, 54, 55, 57, 59, 84, 86, 87, 88, 89, 90, 118, 119, 120, 132]"
agent_c,L0,long,38,20,18,2,0.7246,138,"[6, 12, 15, 19, 20, 21, 23, 24, 25, 26, 27, 29, 30, 31, 33, 53, 55, 56, 57, 58, 60, 61, 62, 84, 88, 89, 90, 91, 92, 114, 116, 117, 118, 119, 120, 122, 125, 128]"
agent_c,L0,long,36,13,23,1,0.7353,136,"[18, 20, 21, 22, 23, 24, 25, 26, 27, 28, 29, 30, 42, 43, 46, 47, 48, 49, 50, 51, 52, 54, 56, 57, 58, 59, 60, 84, 88, 90, 91, 93, 119, 121, 124, 125]"
agent_c,L0,long,35,16,19,2,0.7407,135,"[18, 19, 21, 23, 24, 26, 29, 31, 39, 40, 41, 42, 43, 44, 46, 47, 48, 50, 51, 53, 55, 56, 57, 58, 59, 61, 86, 87, 88, 90, 91, 118, 119, 120, 122]"
agent_c,L0,long,33,19,14,3,0.7519,133,"[6, 12, 13, 15, 16, 17, 18, 20, 22, 24, 26, 27, 30, 49, 50, 51, 53, 54, 55, 56, 58, 60, 83, 86, 87, 90, 111, 112, 113, 116, 117, 118, 119]"
agent_c,L0,long,34,19,15,0,0.7463,134,"[18, 22, 23, 24, 26, 28, 29, 30, 31, 40, 41, 42, 43, 44, 46, 47, 48, 51, 55, 56, 57, 60, 61, 62, 85, 89, 91, 92, 117, 118, 119, 120, 121, 122]"
agent_c,L0,long,35,17,18,1,0.7407,135,"[20, 23, 25, 26, 27, 28, 29, 37, 38, 39, 40, 42, 43, 45, 46, 47, 48, 49, 50, 52, 53, 56, 57, 59, 60, 85, 86, 88, 89, 91, 116, 118, 119, 121, 123]"
agent_c,L0,long,34,14,20,1,0.7463,134,"[6, 12, 13, 16, 18, 21, 23, 24, 26, 27, 28, 30, 49, 50, 51, 52, 53, 55, 56, 57, 58, 60, 82, 86, 87, 91, 111, 113, 114, 115, 117, 119, 120, 121]"
agent_c,L0,long,36,23,13,2,0.7353,136,"[6, 13, 14, 16, 17, 18, 19, 22, 23, 24, 26, 27, 30, 50, 51, 54, 55, 56, 58, 59, 80, 82, 83, 85, 87, 88, 89, 90, 92, 114, 115, 116, 117, 118, 119, 123]"
agent_c,L0,long,35,23,12,0,0.7407,135,"[6, 12, 14, 15, 16, 17, 19, 21, 22, 24, 26, 27, 28, 29, 49, 50, 51, 54, 55, 56, 57, 59, 79, 80, 84, 85, 87, 88, 89, 90, 113, 115, 116, 119, 120]"
agent_c,L0,long,34,13,21,2,0.7463,134,"[6, 12, 13, 14, 15, 17, 18, 20, 21, 23, 24, 27, 28, 29, 49, 50, 51, 52, 53, 55, 57, 60, 82, 83, 84, 88, 91, 114, 115, 116, 117, 118, 119, 120]"
agent_c,L0,long,35,14,21,0,0.7407,135,"[6, 12, 13, 14, 15, 17, 18, 19, 23, 26, 28, 29, 47, 48, 49, 51, 54, 56, 58, 59, 77, 82, 83, 85, 87, 88, 89, 110, 112, 114, 116, 117, 118, 121, 122]"
agent_c,L0,long,34,14,20,1,0.7463,134,"[18, 20, 21, 22, 24, 25, 28, 29, 39, 40, 41, 42, 43, 44, 46, 48, 49, 52, 53, 54, 55, 56, 59, 83, 84, 85, 86, 87, 89, 90, 117, 118, 119, 122]"
agent_c,L0,long,37,14,23,1,0.7299,137,"[18, 19, 20, 21, 22, 23, 24, 25, 27, 29, 31, 41, 42, 43, 45, 46, 47, 49, 50, 51, 52, 53, 55, 56, 57, 59, 60, 61, 85, 89, 91, 117, 119, 120, 121, 123, 135]"
agent_c,L0,long,37,19,18,0,0.7299,137,"[20, 22, 23, 25, 27, 29, 30, 37, 38, 41, 42, 43, 44, 45, 47, 48, 49, 51, 53, 54, 55, 58, 59, 60, 84, 85, 87, 89, 91, 92, 116, 118, 119, 120, 121, 122, 135]"
agent_c,L0,long,30,15,15,7,0.7692,130,"[6, 12, 15, 16, 17, 18, 21, 22, 24, 26, 28, 32, 50, 51, 52, 53, 54, 58, 60, 62, 80, 85, 87, 89, 94, 113, 114, 118, 120, 121]"
agent_c,L0,long,38,23,15,0,0.7246,138,"[6, 12, 13, 14, 15, 17, 18, 19, 20, 21, 23, 24, 25, 27, 29, 49, 50, 51, 53, 55, 56, 58, 59, 79, 81, 82, 83, 84, 85, 86, 87, 88, 89, 90, 117, 118, 119, 120]"
agent_c,L0,long,32,22,10,1,0.7576,132,"[7, 18, 21, 22, 23, 26, 27, 28, 29, 30, 49, 50, 52, 53, 54, 55, 56, 57, 58, 59, 61, 62, 63, 83, 85, 90, 91, 93, 114, 119, 122, 125]"
agent_c,L0,long,36,19,17,2,0.7353,136,"[8, 14, 16, 17, 18, 19, 20, 21, 22, 23, 25, 26, 27, 29, 51, 53, 54, 55, 56, 58, 60, 81, 82, 83, 84, 85, 86, 87, 88, 90, 112, 116, 117, 118, 119, 120]"
agent_c,L0,long,36,12,24,3,0.7353,136,"[6, 12, 13, 14, 19, 20, 24, 26, 27, 28, 29, 30, 50, 51, 52, 54, 55, 56, 57, 59, 60, 81, 82, 83, 84, 88, 90, 91, 113, 114, 115, 116, 118, 120, 121, 126]"
agent_c,L0,long,36,16,20,2,0.7353,136,"[18, 20, 21, 22, 24, 25, 26, 27, 28, 29, 39, 40, 41, 42, 43, 45, 46, 47, 48, 49, 50, 51, 52, 53, 55, 56, 57, 58, 61, 85, 90, 91, 118, 120, 122, 134]"
agent_c,L0,long,35,26,9,2,0.7407,135,"[6, 13, 14, 15, 16, 17, 19, 20, 21, 22, 23, 24, 25, 27, 29, 50, 52, 53, 54, 55, 56, 57, 58, 59, 81, 82, 86, 88, 89, 111, 113, 114, 115, 117, 121]"
agent_c,L0,long,41,17,24,0,0.7092,141,"[6, 13, 15, 17, 18, 19, 20, 21, 22, 23, 25, 26, 27, 28, 29, 49, 50, 51, 52, 53, 54, 56, 57, 59, 80, 81, 82, 87, 88, 89, 112, 114, 115, 117, 118, 119, 120, 121, 122, 123, 124]"
agent_c,L0,long,36,17,19,2,0.7353,136,"[7, 14, 19, 20, 21, 23, 25, 26, 27, 29, 31, 48, 50, 51, 52, 53, 55, 56, 57, 58, 59, 60, 82, 83, 84, 85, 86, 87, 88, 89, 91, 93, 117, 120, 121, 122]"
agent_c,L0,long,35,13,22,2,0.7407,135,"[6, 14, 15, 16, 18, 20, 21, 22, 25, 27, 28, 29, 49, 51, 52, 54, 55, 56, 57, 58, 59, 78, 83, 84, 88, 90, 111, 112, 114, 116, 117, 118, 119, 120, 122]"
agent_c,L0,long,33,23,10,4,0.7519,133,"[20, 21, 22, 24, 25, 26, 27, 28, 29, 30, 31, 32, 43, 44, 45, 46, 51, 54, 55, 56, 58, 59, 63, 84, 89, 90, 91, 94, 119, 120, 122, 123, 125]"
agent_c,L0,long,33,14,19,2,0.7519,133,"[7, 14, 16, 18, 19, 20, 22, 23, 24, 25, 27, 28, 31, 50, 51, 53, 54, 56, 57, 58, 59, 78, 79, 84, 86, 88, 89, 110, 113, 114, 117, 118, 119]"
agent_c,L0,long,37,26,11,0,0.7299,137,"[6, 13, 14, 15, 16, 17, 18, 19, 20, 21, 24, 26, 28, 29, 51, 52, 54, 55, 56, 57, 58, 59, 79, 80, 81, 82, 83, 84, 85, 89, 113, 114, 116, 117, 118, 119, 120]"
agent_c,L0,long,35,19,16,2,0.7407,135,"[18, 19, 21, 22, 23, 25, 28, 29, 31, 41, 42, 43, 45, 46, 47, 48, 50, 51, 53, 55, 56, 57, 58, 59, 61, 85, 89, 90, 91, 115, 118, 119, 120, 121, 133]"
agent_c,L0,long,33,20,13,1,0.7519,133,"[18, 19, 20, 22, 23, 24, 26, 27, 29, 30, 31, 32, 44, 45, 46, 47, 51, 52, 56, 57, 61, 63, 86, 87, 88, 89, 92, 116, 117, 118, 119, 120, 122]"
agent_c,L0,long,33,20,13,1,0.7519,133,"[18, 19, 20, 24, 25, 26, 27, 28, 29, 38, 39, 40, 41, 44, 45, 46, 47, 49, 50, 53, 55, 56, 58, 59, 81, 85, 87, 88, 89, 91, 116, 120, 122]"
agent_c,L0,long,34,15,19,2,0.7463,134,"[6, 14, 15, 18, 19, 20, 21, 23, 24, 27, 28, 29, 50, 51, 54, 56, 59, 60, 82, 83, 84, 85, 86, 87, 88, 90, 112, 113, 114, 115, 116, 117, 119, 122]"
agent_c,L0,long,34,16,18,1,0.7463,134,"[18, 19, 20, 22, 23, 24, 25, 27, 28, 29, 40, 42, 49, 50, 51, 52, 54, 55, 56, 58, 59, 60, 82, 84, 85, 86, 87, 90, 92, 116, 118, 119, 121, 132]"
agent_c,L0,long,38,27,11,1,0.7246,138,"[6, 12, 13, 14, 16, 17, 19, 21, 23, 24, 25, 26, 27, 29, 30, 31, 52, 53, 54, 55, 57, 58, 59, 60, 61, 62, 63, 87, 92, 93, 94, 96, 118, 121, 122, 124, 125, 126]"
agent_c,L0,long,34,18,16,3,0.7463,134,"[6, 12, 13, 15, 17, 19, 20, 21, 22, 27, 28, 30, 48, 49, 51, 55, 56, 57, 58, 61, 80, 81, 82, 84, 85, 86, 88, 89, 91, 113, 115, 118, 119, 122]"
agent_c,L0,long,31,12,19,1,0.7634,131,"[7, 17, 19, 20, 21, 23, 24, 25, 26, 27, 28, 30, 49, 51, 52, 58, 59, 79, 82, 83, 84, 87, 89, 90, 91, 113, 115, 116, 119, 120, 122]"
agent_c,L0,long,32,20,12,7,0.7576,132,"[6, 13, 14, 16, 17, 19, 21, 22, 24, 25, 27, 31, 50, 52, 53, 54, 56, 57, 62, 83, 84, 85, 86, 87, 90, 112, 113, 114, 116, 117, 118, 120]"
agent_c,L0,long,33,16,17,4,0.7519,133,"[8, 15, 16, 17, 19, 22, 24, 25, 26, 27, 28, 32, 50, 51, 52, 53, 54, 56, 61, 79, 80, 81, 82, 83, 88, 89, 90, 111, 113, 114, 115, 118, 121]"
agent_c,L0,long,34,24,10,0,0.7463,134,"[6, 14, 15, 16, 17, 18, 19, 21, 22, 26, 27, 28, 29, 48, 51, 52, 53, 54, 55, 58, 59, 78, 82, 83, 85, 86, 87, 88, 89, 111, 113, 114, 117, 119]"
agent_c,L0,long,38,11,27,1,0.7246,138,"[18, 20, 21, 22, 23, 24, 25, 27, 29, 38, 39, 40, 42, 46, 47, 48, 50, 51, 52, 54, 55, 57, 58, 60, 86, 87, 88, 89, 114, 115, 116, 117, 118, 119, 120, 121, 122, 135]"
agent_c,L0,long,36,14,22,0,0.7353,136,"[18, 19, 20, 21, 22, 25, 27, 28, 29, 38, 39, 41, 43, 44, 45, 46, 47, 48, 49, 50, 51, 52, 53, 54, 56, 58, 59, 60, 61, 85, 90, 91, 118, 120, 121, 122]"
agent_c,L0,long,32,15,17,2,0.7576,132,"[18, 19, 20, 21, 22, 24, 25, 26, 27, 31, 41, 42, 44, 45, 48, 51, 52, 53, 54, 55, 56, 57, 58, 59, 81, 85, 89, 113, 115, 117, 119, 130]"
agent_c,L0,long,36,23,13,1,0.7353,136,"[6, 12, 14, 15, 16, 17, 18, 19, 22, 24, 25, 27, 28, 31, 50, 52, 54, 56, 57, 58, 60, 61, 82, 86, 87, 89, 90, 91, 92, 93, 115, 117, 120, 121, 122, 123]"
agent_c,L0,long,35,18,17,0,0.7407,135,"[6, 13, 15, 16, 17, 18, 19, 20, 21, 22, 23, 24, 26, 29, 49, 50, 51, 52, 53, 56, 58, 59, 79, 80, 87, 89, 90, 111, 114, 115, 116, 117, 118, 119, 120]"
agent_c,L0,long,31,14,17,2,0.7634,131,"[18, 19, 22, 24, 26, 27, 28, 29, 39, 42, 43, 45, 47, 48, 49, 50, 51, 52, 54, 55, 57, 58, 59, 60, 84, 85, 86, 92, 118, 119, 120]"
agent_c,L0,long,38,11,27,3,0.7246,138,"[19, 20, 21, 22, 23, 24, 25, 28, 32, 42, 43, 45, 46, 47, 48, 49, 51, 52, 53, 54, 55, 56, 57, 59, 60, 86, 87, 88, 89, 90, 116, 117, 118, 119, 120, 121, 122, 123]"
agent_c,L0,long,32,21,11,1,0.7576,132,"[7, 18, 21, 24, 25, 27, 29, 45, 46, 49, 50, 51, 52, 54, 55, 56, 57, 58, 59, 61, 80, 85, 86, 90, 109, 112, 114, 115, 116, 118, 120, 121]"
agent_c,L0,long,31,5,26,1,0.7634,131,"[18, 19, 20, 22, 23, 24, 25, 26, 27, 28, 29, 42, 43, 44, 45, 46, 47, 48, 49, 51, 52, 53, 54, 58, 59, 84, 86, 89, 114, 119, 121]"
agent_c,L0,long,31,20,11,0,0.7634,131,"[19, 21, 23, 25, 27, 29, 30, 38, 39, 41, 42, 43, 45, 46, 50, 52, 53, 54, 55, 56, 57, 61, 82, 87, 88, 91, 117, 118, 119, 120, 121]"
agent_c,L0,long,32,16,16,0,0.7576,132,"[19, 20, 21, 28, 30, 38, 41, 42, 43, 44, 45, 46, 47, 48, 51, 52, 53, 56, 57, 58, 60, 81, 87, 88, 90, 114, 115, 116, 117, 118, 119, 120]"
agent_c,L0,long,33,16,17,0,0.7519,133,"[7, 15, 17, 19, 20, 22, 23, 24, 25, 26, 29, 47, 48, 51, 52, 53, 54, 55, 56, 58, 59, 60, 82, 84, 87, 89, 90, 112, 114, 115, 116, 119, 120]"
agent_c,L0,long,33,17,16,6,0.7519,133,"[20, 22, 23, 24, 25, 28, 30, 38, 39, 40, 42, 43, 47, 48, 49, 50, 51, 52, 53, 55, 56, 57, 58, 59, 81, 86, 87, 89, 114, 115, 116, 118, 124]"
agent_c,L0,long,38,20,18,0,0.7246,138,"[6, 14, 15, 17, 19, 20, 22, 25, 26, 27, 30, 31, 32, 33, 34, 54, 55, 57, 58, 59, 60, 61, 62, 63, 64, 91, 92, 94, 95, 96, 116, 118, 119, 121, 123, 124, 125, 127]"
agent_c,L0,long,33,11,22,1,0.7519,133,"[6, 12, 14, 16, 17, 19, 20, 21, 22, 23, 25, 26, 27, 28, 29, 49, 51, 53, 54, 56, 60, 81, 86, 87, 89, 111, 112, 113, 114, 115, 117, 118, 119]"
agent_c,L0,long,35,12,23,1,0.7407,135,"[18, 19, 20, 21, 22, 23, 24, 26, 29, 30, 43, 44, 45, 47, 48, 49, 50, 51, 52, 53, 54, 55, 57, 60, 84, 85, 86, 87, 88, 90, 92, 118, 119, 120, 121]"
agent_c,L0,long,38,22,16,2,0.7246,138,"[6, 13, 15, 16, 20, 21, 22, 23, 24, 25, 26, 28, 29, 30, 31, 32, 54, 55, 56, 57, 59, 60, 62, 63, 65, 89, 91, 92, 93, 95, 116, 118, 119, 120, 121, 122, 123, 124]"
agent_c,L0,long,31,12,19,5,0.7634,131,"[8, 14, 15, 16, 17, 18, 19, 21, 22, 23, 24, 26, 27, 28, 29, 32, 54, 55, 57, 58, 59, 64, 87, 88, 89, 90, 92, 114, 119, 120, 121]"
agent_c,L0,long,35,29,6,3,0.7407,135,"[6, 12, 16, 20, 23, 25, 26, 27, 29, 45, 46, 47, 48, 49, 50, 51, 53, 54, 55, 56, 58, 59, 79, 80, 81, 85, 87, 88, 92, 114, 115, 116, 117, 118, 119]"
agent_c,L0,long,33,14,19,4,0.7519,133,"[7, 15, 16, 17, 18, 19, 20, 22, 24, 25, 26, 28, 31, 50, 51, 53, 54, 58, 60, 80, 81, 82, 83, 84, 86, 87, 89, 90, 111, 115, 116, 119, 121]"
agent_c,L0,long,30,12,18,5,0.7692,130,"[6, 12, 13, 14, 15, 17, 18, 19, 21, 24, 25, 26, 27, 28, 29, 49, 50, 51, 54, 55, 56, 57, 59, 79, 80, 87, 93, 113, 115, 121]"
agent_c,L0,long,37,11,26,0,0.7299,137,"[20, 21, 22, 24, 26, 27, 28, 29, 38, 39, 41, 42, 46, 48, 49, 50, 51, 52, 53, 54, 55, 56, 57, 59, 81, 85, 86, 87, 88, 89, 117, 118, 119, 120, 132, 134, 135]"
agent_c,L0,long,35,23,12,0,0.7407,135,"[6, 12, 13, 15, 16, 17, 18, 20, 21, 22, 23, 24, 28, 29, 30, 50, 52, 53, 55, 56, 57, 59, 63, 83, 85, 89, 90, 94, 114, 116, 117, 118, 119, 122, 124]"
agent_c,L0,long,32,22,10,6,0.7576,132,"[18, 20, 21, 22, 23, 25, 26, 28, 29, 38, 39, 40, 41, 43, 45, 46, 48, 49, 50, 51, 52, 53, 54, 55, 57, 62, 86, 92, 117, 118, 120, 121]"
agent_c,L0,long,33,8,25,2,0.7519,133,"[18, 20, 21, 22, 27, 28, 29, 39, 40, 42, 43, 44, 45, 46, 48, 49, 50, 51, 52, 53, 54, 55, 56, 57, 58, 60, 61, 88, 90, 92, 117, 118, 123]"
agent_c,L0,long,35,18,17,1,0.7407,135,"[6, 12, 13, 14, 17, 18, 19, 20, 22, 23, 25, 26, 27, 28, 30, 50, 51, 52, 53, 54, 55, 56, 59, 79, 81, 86, 87, 88, 89, 113, 114, 116, 117, 118, 119]"
agent_c,L0,long,34,20,14,2,0.7463,134,"[6, 13, 18, 20, 21, 22, 23, 24, 26, 27, 28, 29, 30, 31, 50, 52, 53, 54, 59, 60, 61, 84, 86, 87, 88, 89, 90, 93, 114, 115, 117, 120, 122, 124]"
agent_c,L0,long,30,10,20,3,0.7692,130,"[18, 20, 21, 23, 24, 25, 26, 28, 30, 39, 40, 41, 43, 45, 46, 48, 50, 52, 53, 54, 55, 56, 57, 62, 84, 90, 116, 118, 119, 120]"
agent_c,L0,long,35,21,14,1,0.7407,135,"[19, 22, 23, 25, 27, 29, 30, 31, 39, 40, 43, 44, 45, 46, 47, 48, 49, 51, 53, 55, 57, 58, 60, 62, 84, 89, 91, 93, 94, 120, 121, 123, 124, 125, 129]"
agent_c,L0,long,33,14,19,3,0.7519,133,"[6, 12, 13, 14, 16, 17, 18, 19, 21, 23, 24, 25, 27, 28, 30, 50, 51, 52, 53, 54, 56, 58, 59, 60, 64, 86, 91, 113, 114, 118, 120, 121, 122]"
agent_c,L0,long,37,27,10,1,0.7299,137,"[8, 14, 15, 16, 17, 18, 19, 20, 22, 23, 24, 26, 29, 48, 50, 51, 56, 57, 58, 59, 60, 82, 83, 84, 85, 86, 87, 88, 89, 91, 93, 116, 117, 119, 120, 121, 124]"
agent_c,L0,long,31,9,22,3,0.7634,131,"[18, 22, 23, 25, 26, 27, 28, 30, 38, 39, 40, 41, 42, 43, 44, 45, 48, 50, 51, 53, 54, 55, 56, 57, 58, 59, 82, 88, 91, 118, 123]"
agent_c,L0,long,34,24,10,6,0.7463,134,"[6, 13, 14, 15, 16, 17, 19, 20, 21, 22, 24, 27, 28, 30, 49, 50, 53, 54, 55, 56, 57, 59, 79, 83, 84, 85, 86, 88, 93, 115, 116, 117, 118, 120]"
agent_c,L0,long,36,12,24,3,0.7353,136,"[9, 16, 19, 21, 22, 23, 24, 26, 32, 48, 49, 50, 52, 54, 55, 56, 57, 58, 60, 62, 80, 85, 88, 89, 90, 91, 111, 113, 115, 116, 117, 118, 119, 120, 121, 122]"
agent_c,L50,long,31,23,8,2,0.7634,131,"[14, 24, 25, 26, 29, 48, 50, 51, 52, 54, 55, 56, 57, 58, 60, 80, 81, 82, 83, 84, 89, 90, 111, 112, 113, 114, 115, 116, 118, 119, 123]"
agent_c,L50,long,29,14,15,2,0.7752,129,"[14, 24, 27, 28, 29, 48, 50, 52, 53, 54, 56, 57, 58, 60, 61, 84, 85, 87, 88, 89, 93, 113, 114, 116, 117, 120, 121, 122, 123]"
agent_c,L50,long,33,11,22,0,0.7519,133,"[14, 24, 26, 27, 29, 46, 47, 48, 49, 50, 52, 53, 54, 55, 56, 57, 59, 82, 83, 84, 87, 88, 89, 109, 110, 111, 112, 113, 114, 115, 116, 117, 119]"
agent_c,L50,long,27,10,17,0,0.7874,127,"[22, 23, 25, 28, 30, 45, 46, 48, 49, 51, 53, 54, 55, 57, 59, 60, 82, 84, 87, 89, 90, 111, 113, 115, 118, 119, 120]"
agent_c,L50,long,29,10,19,1,0.7752,129,"[14, 24, 25, 27, 28, 29, 30, 51, 54, 56, 57, 58, 60, 81, 84, 85, 87, 88, 89, 91, 109, 111, 112, 113, 114, 115, 117, 118, 120]"
agent_c,L50,long,31,12,19,0,0.7634,131,"[21, 22, 23, 25, 26, 28, 29, 44, 47, 48, 49, 51, 52, 54, 57, 58, 60, 83, 84, 86, 88, 89, 91, 113, 114, 115, 117, 118, 119, 120, 122]"
agent_c,L50,long,33,14,19,1,0.7519,133,"[21, 22, 23, 25, 26, 27, 28, 30, 31, 49, 50, 51, 52, 54, 56, 57, 58, 59, 60, 61, 86, 87, 88, 89, 92, 114, 115, 116, 117, 118, 120, 121, 122]"
agent_c,L50,long,34,24,10,1,0.7463,134,"[14, 24, 25, 27, 28, 29, 30, 32, 52, 54, 55, 56, 57, 59, 61, 83, 84, 85, 87, 88, 89, 90, 91, 92, 112, 113, 114, 115, 116, 119, 120, 121, 122, 123]"
agent_c,L50,long,32,20,12,1,0.7576,132,"[21, 22, 23, 26, 27, 28, 29, 44, 45, 46, 47, 48, 49, 50, 51, 52, 53, 54, 55, 56, 57, 59, 60, 85, 86, 87, 88, 89, 91, 117, 118, 120]"
agent_c,L50,long,32,13,19,1,0.7576,132,"[21, 22, 24, 25, 29, 30, 32, 47, 48, 50, 52, 53, 54, 55, 56, 59, 60, 61, 87, 88, 89, 91, 112, 113, 114, 115, 116, 117, 118, 119, 120, 122]"
agent_c,L50,long,30,20,10,2,0.7692,130,"[14, 29, 32, 48, 49, 53, 54, 56, 59, 60, 82, 83, 84, 85, 86, 87, 88, 89, 90, 107, 108, 109, 110, 112, 114, 115, 116, 117, 119, 120]"
agent_c,L50,long,34,20,14,0,0.7463,134,"[17, 27, 28, 29, 45, 47, 48, 50, 51, 53, 54, 55, 56, 57, 58, 59, 60, 81, 83, 84, 85, 88, 90, 91, 111, 112, 113, 114, 115, 116, 118, 119, 120, 121]"
agent_c,L50,long,28,16,12,1,0.7812,128,"[16, 27, 30, 47, 50, 51, 54, 56, 59, 81, 83, 86, 87, 88, 89, 90, 106, 107, 109, 111, 112, 113, 114, 115, 116, 117, 118, 120]"
agent_c,L50,long,31,15,16,2,0.7634,131,"[14, 24, 25, 26, 28, 30, 50, 55, 58, 60, 78, 79, 81, 82, 83, 84, 86, 87, 88, 89, 90, 108, 110, 111, 113, 114, 115, 117, 118, 119, 120]"
agent_c,L50,long,34,25,9,1,0.7463,134,"[21, 22, 23, 24, 25, 26, 27, 29, 45, 46, 48, 49, 51, 53, 54, 55, 56, 57, 59, 84, 85, 86, 88, 90, 113, 114, 115, 116, 117, 118, 119, 130, 131, 132]"
agent_c,L50,long,30,11,19,6,0.7692,130,"[23, 24, 26, 27, 28, 29, 45, 46, 47, 48, 49, 50, 51, 52, 56, 58, 59, 82, 83, 84, 85, 88, 89, 91, 113, 115, 117, 118, 119, 125]"
agent_c,L50,long,27,13,14,4,0.7874,127,"[22, 24, 25, 26, 28, 29, 46, 47, 50, 53, 54, 55, 58, 60, 81, 82, 83, 84, 85, 86, 88, 92, 114, 115, 116, 117, 119]"
agent_c,L50,long,32,21,11,0,0.7576,132,"[14, 26, 27, 28, 29, 46, 47, 49, 50, 51, 52, 55, 56, 58, 59, 61, 84, 85, 87, 89, 90, 91, 110, 111, 112, 113, 114, 116, 117, 118, 120, 121]"
agent_c,L50,long,30,8,22,2,0.7692,130,"[14, 24, 25, 26, 27, 28, 29, 50, 53, 55, 56, 57, 58, 59, 82, 83, 84, 88, 90, 91, 109, 110, 113, 114, 115, 116, 117, 118, 119, 124]"
agent_c,L50,long,29,16,13,1,0.7752,129,"[21, 22, 23, 25, 26, 27, 28, 29, 45, 47, 48, 51, 53, 55, 56, 60, 82, 85, 87, 88, 89, 90, 111, 113, 114, 115, 118, 119, 120]"
agent_c,L50,long,28,18,10,2,0.7812,128,"[14, 26, 28, 30, 48, 49, 51, 52, 53, 54, 56, 57, 60, 84, 85, 88, 89, 90, 106, 107, 108, 110, 111, 112, 113, 116, 117, 122]"
agent_c,L50,long,31,11,20,1,0.7634,131,"[21, 22, 26, 29, 43, 44, 45, 47, 50, 51, 52, 54, 56, 57, 58, 59, 82, 83, 84, 86, 87, 89, 90, 92, 114, 116, 117, 118, 119, 120, 121]"
agent_c,L50,long,32,14,18,2,0.7576,132,"[14, 24, 25, 26, 29, 46, 47, 48, 50, 51, 52, 54, 56, 58, 60, 80, 84, 85, 86, 87, 88, 89, 108, 109, 110, 112, 113, 114, 115, 116, 117, 120]"
agent_c,L50,long,28,19,9,8,0.7812,128,"[21, 22, 27, 28, 33, 49, 50, 51, 52, 53, 54, 55, 56, 57, 58, 60, 82, 83, 84, 86, 87, 88, 92, 113, 115, 117, 118, 119]"
agent_c,L50,long,34,24,10,3,0.7463,134,"[14, 29, 30, 47, 48, 49, 50, 51, 52, 53, 54, 56, 58, 59, 60, 61, 63, 64, 66, 88, 92, 96, 112, 113, 116, 117, 118, 119, 120, 121, 122, 123, 124, 126]"
agent_c,L50,long,27,16,11,4,0.7874,127,"[17, 28, 29, 47, 48, 50, 51, 53, 54, 55, 56, 58, 61, 81, 82, 86, 87, 90, 106, 107, 108, 110, 112, 116, 117, 118, 120]"
agent_c,L50,long,31,22,9,2,0.7634,131,"[14, 24, 25, 26, 28, 30, 50, 51, 52, 53, 55, 56, 57, 59, 78, 79, 80, 82, 83, 84, 85, 86, 87, 90, 110, 111, 112, 115, 117, 118, 119]"
agent_c,L50,long,31,24,7,0,0.7634,131,"[14, 26, 27, 28, 30, 50, 51, 52, 55, 57, 58, 59, 60, 61, 63, 84, 85, 86, 87, 88, 90, 92, 93, 115, 116, 117, 119, 120, 121, 122, 125]"
agent_c,L50,long,31,17,14,6,0.7634,131,"[14, 26, 27, 28, 29, 33, 51, 53, 54, 55, 58, 59, 61, 81, 83, 84, 86, 87, 88, 89, 91, 92, 94, 113, 114, 115, 118, 120, 121, 122, 124]"
agent_c,L50,long,30,12,18,1,0.7692,130,"[14, 24, 25, 26, 27, 28, 29, 30, 51, 52, 54, 56, 57, 58, 59, 60, 81, 86, 87, 89, 90, 91, 92, 94, 116, 118, 119, 122, 123, 124]"
agent_c,L50,long,30,19,11,2,0.7692,130,"[21, 24, 26, 27, 28, 29, 44, 46, 47, 49, 50, 51, 53, 54, 55, 56, 58, 59, 81, 82, 83, 84, 85, 87, 88, 89, 91, 119, 120, 125]"
agent_c,L50,long,28,14,14,1,0.7812,128,"[21, 25, 26, 27, 29, 44, 48, 50, 51, 52, 53, 56, 57, 58, 59, 61, 86, 87, 91, 93, 113, 115, 117, 118, 119, 121, 123, 124]"
agent_c,L50,long,32,14,18,1,0.7576,132,"[23, 24, 25, 27, 28, 29, 45, 48, 50, 51, 52, 55, 56, 57, 58, 59, 61, 83, 84, 87, 89, 90, 91, 113, 114, 115, 117, 118, 119, 120, 121, 122]"
agent_c,L50,long,29,17,12,1,0.7752,129,"[21, 23, 26, 27, 28, 29, 30, 46, 50, 51, 53, 54, 55, 58, 59, 60, 61, 83, 84, 85, 88, 89, 90, 92, 114, 115, 118, 119, 121]"
agent_c,L50,long,31,23,8,2,0.7634,131,"[14, 27, 30, 31, 48, 49, 50, 51, 52, 53, 54, 55, 56, 57, 58, 59, 62, 85, 89, 90, 91, 109, 110, 111, 112, 113, 114, 116, 119, 120, 122]"
agent_c,L50,long,31,18,13,3,0.7634,131,"[15, 27, 28, 30, 32, 49, 51, 52, 53, 55, 56, 59, 61, 63, 82, 83, 85, 86, 89, 90, 91, 93, 111, 112, 113, 114, 116, 117, 118, 121, 122]"
agent_c,L50,long,29,7,22,2,0.7752,129,"[22, 23, 24, 25, 27, 29, 30, 46, 48, 49, 51, 54, 55, 56, 57, 58, 59, 60, 84, 85, 87, 89, 90, 93, 118, 119, 120, 121, 122]"
agent_c,L50,long,29,17,12,2,0.7752,129,"[14, 24, 26, 28, 29, 48, 49, 52, 53, 54, 55, 56, 58, 59, 61, 83, 85, 86, 87, 88, 89, 91, 112, 113, 115, 117, 118, 119, 123]"
agent_c,L50,long,28,9,19,2,0.7812,128,"[16, 29, 31, 47, 48, 50, 52, 53, 54, 55, 56, 57, 58, 59, 61, 83, 88, 90, 92, 110, 111, 112, 113, 114, 119, 120, 125, 126]"
agent_c,L50,long,29,17,12,6,0.7752,129,"[15, 27, 28, 30, 48, 49, 50, 51, 52, 54, 55, 56, 58, 60, 79, 80, 84, 85, 87, 89, 107, 108, 109, 111, 112, 113, 115, 117, 123]"
agent_c,L50,long,28,9,19,2,0.7812,128,"[14, 27, 28, 29, 48, 49, 50, 53, 54, 55, 56, 57, 58, 59, 83, 85, 86, 87, 88, 91, 111, 112, 113, 114, 116, 117, 118, 119]"
agent_c,L50,long,31,19,12,1,0.7634,131,"[14, 26, 28, 29, 31, 49, 50, 51, 55, 57, 60, 62, 81, 85, 86, 87, 89, 90, 91, 108, 109, 110, 111, 112, 113, 115, 116, 117, 119, 120, 123]"
agent_c,L50,long,29,13,16,4,0.7752,129,"[22, 23, 24, 29, 32, 48, 51, 52, 53, 54, 56, 57, 59, 61, 82, 85, 86, 87, 88, 89, 92, 112, 113, 115, 116, 117, 119, 120, 122]"
agent_c,L50,long,26,15,11,4,0.7937,126,"[21, 22, 23, 25, 26, 29, 44, 46, 47, 48, 49, 51, 52, 54, 55, 56, 58, 60, 88, 92, 112, 113, 114, 115, 117, 119]"
agent_c,L50,long,30,14,16,1,0.7692,130,"[22, 24, 27, 28, 29, 30, 46, 47, 48, 49, 51, 53, 55, 56, 57, 58, 59, 60, 62, 86, 89, 90, 91, 93, 117, 119, 120, 121, 122, 124]"
agent_c,L50,long,31,9,22,1,0.7634,131,"[21, 23, 24, 25, 26, 27, 30, 46, 47, 49, 50, 53, 54, 55, 56, 57, 59, 60, 61, 62, 87, 88, 89, 90, 91, 92, 115, 116, 117, 121, 123]"
agent_c,L50,long,27,16,11,4,0.7874,127,"[24, 25, 32, 44, 48, 50, 51, 52, 53, 55, 57, 58, 60, 80, 81, 84, 85, 86, 88, 89, 110, 111, 112, 115, 116, 117, 119]"
agent_c,L50,long,28,12,16,2,0.7812,128,"[14, 27, 28, 29, 50, 51, 52, 53, 54, 55, 56, 58, 61, 81, 83, 84, 85, 86, 87, 88, 89, 108, 109, 112, 113, 115, 116, 119]"
agent_c,L50,long,34,22,12,4,0.7463,134,"[24, 25, 26, 28, 29, 30, 31, 33, 37, 54, 55, 59, 60, 62, 63, 64, 65, 67, 68, 92, 93, 94, 95, 96, 97, 99, 121, 122, 123, 124, 125, 126, 127, 128]"
agent_c,L50,long,30,20,10,7,0.7692,130,"[15, 28, 34, 52, 53, 57, 58, 59, 61, 77, 78, 79, 81, 85, 86, 87, 88, 89, 91, 93, 110, 111, 112, 114, 117, 118, 120, 121, 122, 125]"
agent_c,L50,long,27,14,13,4,0.7874,127,"[22, 23, 25, 26, 27, 29, 44, 45, 47, 50, 51, 52, 53, 54, 56, 57, 60, 85, 86, 87, 88, 94, 115, 116, 118, 120, 121]"
agent_c,L50,long,29,21,8,2,0.7752,129,"[14, 24, 25, 26, 28, 29, 30, 51, 52, 53, 54, 55, 57, 58, 59, 60, 63, 86, 87, 91, 92, 110, 111, 112, 115, 118, 120, 122, 124]"
agent_c,L50,long,31,10,21,2,0.7634,131,"[16, 27, 28, 30, 48, 50, 52, 53, 54, 55, 56, 57, 58, 59, 61, 84, 87, 88, 89, 90, 91, 109, 110, 111, 112, 114, 115, 117, 118, 120, 121]"
agent_c,L50,long,34,18,16,1,0.7463,134,"[14, 24, 26, 27, 28, 30, 51, 52, 53, 54, 55, 56, 57, 59, 78, 79, 80, 82, 83, 84, 85, 87, 89, 90, 110, 111, 112, 113, 115, 116, 117, 118, 119, 120]"
agent_c,L50,long,31,16,15,0,0.7634,131,"[22, 23, 24, 25, 26, 27, 28, 29, 31, 49, 51, 52, 53, 55, 59, 61, 83, 85, 86, 88, 89, 91, 113, 114, 117, 118, 119, 120, 121, 122, 123]"
agent_c,L50,long,31,16,15,4,0.7634,131,"[15, 27, 28, 31, 48, 49, 51, 52, 53, 54, 55, 56, 57, 60, 62, 87, 88, 89, 91, 109, 110, 111, 112, 114, 115, 116, 117, 118, 119, 120, 122]"
agent_c,L50,long,29,13,16,1,0.7752,129,"[14, 24, 25, 26, 27, 29, 47, 48, 50, 51, 52, 53, 54, 55, 56, 58, 59, 82, 86, 87, 89, 110, 111, 112, 113, 114, 116, 118, 120]"
agent_c,L50,long,32,15,17,0,0.7576,132,"[21, 23, 24, 25, 26, 29, 30, 31, 32, 33, 50, 51, 53, 55, 56, 58, 59, 61, 62, 63, 87, 88, 89, 90, 92, 93, 116, 118, 119, 120, 121, 123]"
agent_c,L50,long,32,10,22,0,0.7576,132,"[22, 23, 24, 26, 27, 29, 44, 45, 46, 47, 48, 49, 51, 55, 56, 57, 58, 59, 81, 83, 85, 87, 88, 89, 112, 113, 114, 115, 117, 118, 119, 130]"
agent_c,L50,long,33,17,16,2,0.7519,133,"[21, 23, 24, 25, 26, 27, 29, 44, 45, 48, 49, 51, 52, 54, 55, 57, 58, 60, 84, 85, 87, 88, 90, 112, 113, 114, 115, 116, 117, 118, 119, 120, 131]"
agent_c,L50,long,30,19,11,8,0.7692,130,"[21, 22, 24, 25, 26, 28, 29, 33, 49, 50, 51, 52, 54, 56, 58, 59, 61, 65, 89, 92, 111, 112, 114, 115, 116, 117, 118, 119, 120, 126]"
agent_c,L50,long,31,15,16,2,0.7634,131,"[21, 22, 23, 24, 25, 27, 29, 45, 47, 50, 52, 54, 55, 56, 58, 59, 84, 85, 86, 87, 88, 89, 90, 93, 115, 116, 117, 118, 119, 120, 121]"
agent_c,L50,long,28,14,14,0,0.7812,128,"[21, 23, 24, 25, 26, 27, 28, 29, 45, 48, 49, 50, 51, 52, 53, 54, 56, 57, 59, 60, 85, 89, 90, 112, 116, 117, 118, 120]"
agent_c,L50,long,26,17,9,3,0.7937,126,"[14, 27, 28, 30, 48, 49, 50, 52, 53, 54, 59, 79, 81, 83, 85, 88, 90, 106, 107, 110, 112, 113, 115, 116, 118, 121]"
agent_c,L50,long,29,18,11,1,0.7752,129,"[23, 24, 25, 28, 29, 30, 46, 48, 51, 53, 54, 55, 56, 57, 58, 59, 60, 83, 84, 85, 86, 89, 90, 112, 113, 115, 116, 118, 121]"
agent_c,L50,long,31,4,27,0,0.7634,131,"[21, 23, 24, 25, 26, 27, 28, 29, 30, 51, 52, 53, 55, 56, 57, 58, 60, 83, 84, 85, 87, 88, 89, 92, 93, 119, 121, 122, 123, 124, 125]"
agent_c,L50,long,30,18,12,1,0.7692,130,"[16, 27, 28, 29, 45, 47, 48, 49, 50, 52, 53, 55, 56, 57, 58, 60, 81, 86, 87, 88, 89, 110, 111, 112, 113, 114, 115, 117, 119, 120]"
agent_c,L50,long,31,7,24,3,0.7634,131,"[21, 22, 23, 25, 27, 28, 29, 45, 46, 47, 48, 49, 50, 51, 52, 53, 54, 55, 56, 57, 58, 63, 88, 89, 90, 113, 114, 115, 116, 119, 120]"
agent_c,L50,long,29,23,6,1,0.7752,129,"[21, 22, 23, 24, 25, 26, 27, 29, 48, 50, 51, 52, 54, 57, 58, 59, 60, 61, 62, 64, 89, 90, 92, 93, 116, 120, 121, 123, 125]"
agent_c,L50,long,33,9,24,2,0.7519,133,"[21, 22, 23, 27, 28, 29, 44, 45, 46, 47, 48, 49, 50, 52, 53, 56, 59, 60, 61, 62, 63, 88, 89, 90, 91, 92, 94, 117, 119, 120, 121, 122, 124]"
agent_c,L50,long,32,22,10,2,0.7576,132,"[14, 24, 25, 26, 28, 29, 31, 51, 52, 53, 54, 55, 57, 59, 60, 80, 81, 82, 86, 87, 89, 90, 92, 112, 113, 114, 115, 117, 118, 120, 122, 124]"
agent_c,L50,long,31,20,11,3,0.7634,131,"[14, 24, 25, 26, 27, 30, 50, 51, 52, 53, 54, 55, 56, 58, 59, 79, 80, 82, 83, 84, 85, 86, 87, 88, 91, 112, 113, 114, 115, 116, 119]"
agent_c,L50,long,29,17,12,6,0.7752,129,"[15, 27, 28, 29, 32, 49, 50, 54, 56, 57, 58, 59, 62, 81, 86, 87, 88, 89, 90, 91, 94, 112, 113, 114, 116, 117, 119, 121, 123]"
agent_c,L50,long,31,7,24,2,0.7634,131,"[15, 27, 28, 30, 49, 51, 52, 54, 55, 56, 59, 60, 61, 82, 88, 89, 90, 92, 108, 109, 110, 111, 112, 113, 115, 116, 117, 118, 119, 121, 122]"
agent_c,L50,long,29,25,4,4,0.7752,129,"[21, 22, 23, 24, 25, 26, 27, 28, 31, 49, 52, 54, 56, 58, 59, 60, 85, 86, 87, 88, 89, 90, 93, 116, 117, 118, 119, 120, 121]"
agent_c,L50,long,29,20,9,1,0.7752,129,"[21, 23, 25, 29, 43, 45, 46, 48, 49, 50, 53, 58, 60, 81, 82, 83, 85, 86, 88, 90, 111, 113, 114, 115, 116, 117, 118, 119, 120]"
agent_c,L50,long,33,9,24,0,0.7519,133,"[22, 23, 26, 28, 29, 44, 45, 46, 47, 48, 49, 52, 54, 55, 56, 57, 58, 59, 61, 85, 87, 88, 89, 91, 113, 114, 115, 116, 118, 119, 120, 121, 122]"
agent_c,L50,long,30,18,12,5,0.7692,130,"[15, 27, 28, 29, 31, 50, 53, 54, 55, 56, 58, 59, 60, 81, 83, 84, 86, 89, 91, 108, 109, 110, 111, 113, 115, 117, 118, 119, 120, 125]"
agent_c,L50,long,30,22,8,0,0.7692,130,"[21, 22, 23, 25, 28, 29, 44, 47, 48, 50, 51, 52, 53, 55, 56, 59, 82, 83, 85, 88, 89, 110, 111, 112, 113, 114, 115, 116, 117, 119]"
agent_c,L50,long,30,13,17,0,0.7692,130,"[14, 24, 25, 29, 45, 47, 48, 49, 52, 53, 54, 55, 56, 58, 59, 85, 86, 88, 89, 91, 109, 110, 112, 114, 115, 116, 117, 118, 121, 122]"
agent_c,L50,long,28,19,9,1,0.7812,128,"[15, 27, 28, 29, 45, 46, 48, 51, 52, 55, 57, 59, 80, 81, 82, 83, 84, 86, 87, 88, 91, 111, 115, 116, 117, 118, 119, 120]"
agent_c,L50,long,34,14,20,2,0.7463,134,"[15, 27, 28, 29, 45, 46, 48, 49, 50, 51, 52, 54, 55, 56, 57, 58, 59, 81, 83, 84, 85, 86, 87, 88, 89, 91, 112, 115, 116, 118, 119, 121, 122, 124]"
agent_c,L50,long,31,18,13,2,0.7634,131,"[21, 22, 23, 25, 26, 27, 29, 30, 31, 51, 52, 53, 54, 55, 58, 59, 60, 61, 63, 86, 90, 94, 114, 115, 116, 117, 118, 119, 120, 121, 123]"
agent_c,L50,long,32,20,12,0,0.7576,132,"[14, 24, 25, 26, 27, 29, 47, 48, 49, 50, 51, 54, 55, 58, 59, 80, 81, 82, 83, 87, 88, 89, 108, 110, 111, 112, 113, 115, 116, 117, 119, 120]"
agent_c,L50,long,31,18,13,2,0.7634,131,"[21, 23, 28, 29, 47, 48, 49, 50, 51, 53, 54, 56, 57, 58, 59, 82, 84, 85, 86, 87, 89, 90, 94, 114, 115, 117, 118, 119, 121, 123, 124]"
agent_c,L50,long,31,18,13,0,0.7634,131,"[17, 27, 28, 29, 49, 51, 52, 53, 54, 57, 58, 59, 77, 78, 79, 80, 84, 86, 87, 90, 107, 108, 109, 110, 112, 113, 114, 115, 116, 118, 120]"
agent_c,L50,long,29,20,9,0,0.7752,129,"[15, 27, 28, 29, 48, 50, 51, 52, 53, 56, 57, 59, 77, 78, 82, 83, 84, 85, 86, 88, 89, 90, 110, 111, 112, 114, 117, 118, 122]"
agent_c,L50,long,32,22,10,2,0.7576,132,"[15, 29, 30, 31, 33, 35, 54, 55, 56, 57, 59, 61, 62, 63, 64, 84, 88, 89, 90, 92, 94, 95, 96, 97, 116, 121, 122, 123, 124, 125, 126, 128]"
agent_c,L50,long,33,20,13,2,0.7519,133,"[22, 23, 24, 25, 26, 27, 31, 47, 48, 49, 50, 51, 53, 54, 55, 56, 57, 59, 81, 82, 83, 84, 85, 88, 89, 113, 114, 115, 116, 117, 118, 119, 131]"
agent_c,L50,long,32,10,22,2,0.7576,132,"[22, 23, 24, 25, 27, 29, 30, 46, 47, 48, 49, 50, 51, 52, 53, 54, 55, 56, 57, 58, 60, 84, 85, 88, 89, 91, 114, 115, 116, 118, 119, 121]"
agent_c,L50,long,30,13,17,3,0.7692,130,"[21, 22, 23, 24, 25, 27, 28, 29, 31, 49, 50, 52, 53, 54, 55, 57, 58, 59, 60, 85, 86, 87, 88, 89, 90, 93, 117, 118, 119, 121]"
agent_c,L50,long,33,23,10,0,0.7519,133,"[21, 22, 24, 25, 26, 27, 28, 33, 52, 53, 54, 55, 57, 58, 59, 61, 64, 65, 88, 90, 91, 94, 95, 96, 97, 118, 119, 120, 124, 125, 126, 127, 128]"
agent_c,L50,long,26,11,15,1,0.7937,126,"[21, 22, 24, 26, 28, 29, 45, 46, 47, 50, 52, 53, 54, 55, 57, 59, 83, 85, 87, 90, 111, 113, 115, 116, 118, 119]"
agent_c,L50,long,30,9,21,0,0.7692,130,"[21, 22, 23, 25, 26, 28, 29, 46, 47, 48, 50, 51, 53, 55, 56, 57, 58, 59, 81, 82, 84, 85, 88, 89, 90, 116, 117, 118, 119, 121]"
agent_c,L50,long,30,18,12,2,0.7692,130,"[21, 22, 23, 24, 25, 26, 30, 47, 48, 49, 52, 54, 57, 58, 61, 82, 84, 86, 87, 88, 89, 91, 112, 114, 115, 116, 117, 118, 119, 121]"
agent_c,L50,long,26,9,17,4,0.7937,126,"[21, 22, 23, 24, 28, 29, 45, 46, 47, 48, 50, 51, 55, 56, 57, 62, 85, 87, 89, 109, 110, 111, 113, 114, 118, 120]"
agent_c,L50,long,29,9,20,0,0.7752,129,"[22, 24, 26, 27, 28, 29, 44, 45, 46, 47, 49, 52, 54, 55, 56, 57, 58, 59, 60, 85, 86, 88, 89, 91, 114, 116, 118, 119, 121]"
agent_c,L50,long,33,24,9,0,0.7519,133,"[15, 27, 30, 31, 32, 33, 51, 52, 53, 55, 58, 59, 62, 63, 82, 83, 84, 85, 86, 87, 88, 89, 90, 91, 92, 94, 116, 117, 118, 120, 122, 123, 124]"
agent_c,L50,long,34,18,16,0,0.7463,134,"[21, 22, 23, 24, 25, 27, 28, 29, 45, 46, 47, 48, 50, 52, 53, 54, 56, 58, 59, 82, 83, 84, 85, 86, 87, 88, 89, 115, 116, 117, 118, 119, 120, 132]"
agent_c,L50,long,33,23,10,2,0.7519,133,"[14, 24, 27, 28, 29, 46, 47, 48, 50, 51, 53, 54, 55, 57, 58, 59, 80, 81, 82, 83, 84, 85, 86, 87, 89, 111, 113, 115, 116, 117, 118, 119, 122]"
agent_c,L100,long,29,13,16,1,0.7752,129,"[19, 20, 22, 26, 29, 31, 48, 49, 51, 52, 53, 54, 55, 56, 57, 59, 60, 83, 86, 88, 89, 90, 111, 112, 114, 115, 118, 119, 120]"
agent_c,L100,long,31,18,13,1,0.7634,131,"[18, 19, 21, 22, 23, 24, 26, 27, 28, 30, 48, 49, 51, 52, 53, 55, 56, 58, 59, 60, 61, 62, 63, 90, 91, 94, 118, 119, 120, 121, 123]"
agent_c,L100,long,33,12,21,0,0.7519,133,"[13, 23, 25, 26, 29, 48, 49, 50, 51, 52, 53, 54, 55, 56, 57, 58, 59, 85, 87, 89, 90, 107, 109, 110, 111, 114, 115, 116, 117, 118, 119, 120, 121]"
agent_c,L100,long,28,12,16,2,0.7812,128,"[18, 19, 20, 22, 23, 24, 25, 27, 28, 29, 30, 50, 58, 59, 61, 82, 83, 85, 87, 92, 94, 113, 115, 117, 120, 121, 122, 125]"
agent_c,L100,long,28,12,16,3,0.7812,128,"[13, 24, 26, 28, 29, 48, 50, 53, 54, 55, 56, 60, 82, 83, 85, 87, 89, 90, 92, 110, 111, 112, 113, 114, 120, 121, 123, 126]"
agent_c,L100,long,34,25,9,3,0.7463,134,"[17, 28, 30, 47, 48, 49, 50, 52, 53, 54, 56, 57, 58, 59, 83, 86, 88, 89, 92, 107, 108, 109, 110, 112, 113, 114, 115, 116, 117, 118, 119, 120, 122, 124]"
agent_c,L100,long,30,17,13,3,0.7692,130,"[13, 23, 24, 27, 33, 52, 54, 56, 57, 58, 59, 61, 84, 85, 86, 88, 89, 90, 91, 106, 108, 112, 113, 114, 115, 116, 117, 118, 119, 121]"
agent_c,L100,long,27,16,11,1,0.7874,127,"[19, 20, 22, 23, 24, 25, 27, 28, 29, 47, 48, 50, 51, 52, 54, 55, 56, 59, 83, 84, 87, 88, 91, 115, 116, 117, 121]"
agent_c,L100,long,31,20,11,3,0.7634,131,"[13, 23, 25, 26, 27, 29, 31, 51, 52, 53, 54, 56, 57, 59, 61, 85, 88, 89, 90, 93, 110, 111, 112, 115, 116, 117, 118, 119, 120, 121, 123]"
agent_c,L100,long,27,3,24,2,0.7874,127,"[13, 24, 25, 26, 27, 28, 29, 49, 51, 52, 53, 56, 58, 59, 60, 86, 87, 89, 92, 109, 110, 112, 113, 114, 115, 116, 120]"
agent_c,L100,long,30,12,18,2,0.7692,130,"[13, 25, 26, 27, 28, 29, 48, 50, 51, 53, 54, 55, 57, 58, 60, 86, 87, 88, 89, 106, 107, 108, 109, 110, 111, 112, 113, 114, 117, 120]"
agent_c,L100,long,29,14,15,1,0.7752,129,"[18, 21, 22, 23, 24, 25, 26, 27, 28, 29, 48, 50, 51, 52, 53, 54, 55, 56, 57, 58, 61, 86, 90, 114, 115, 116, 117, 119, 120]"
agent_c,L100,long,32,11,21,2,0.7576,132,"[18, 20, 21, 22, 23, 24, 26, 29, 46, 47, 48, 49, 50, 52, 53, 54, 55, 56, 57, 58, 59, 85, 86, 87, 88, 91, 115, 116, 117, 118, 119, 120]"
agent_c,L100,long,35,14,21,0,0.7407,135,"[19, 20, 22, 24, 25, 27, 29, 45, 46, 48, 49, 50, 51, 52, 53, 54, 55, 59, 60, 84, 85, 86, 89, 90, 112, 113, 115, 116, 117, 118, 119, 120, 131, 132, 133]"
agent_c,L100,long,29,10,19,1,0.7752,129,"[13, 23, 24, 25, 26, 28, 29, 30, 53, 54, 55, 56, 57, 59, 60, 85, 86, 89, 91, 106, 108, 110, 112, 113, 114, 115, 116, 117, 122]"
agent_c,L100,long,34,22,12,0,0.7463,134,"[18, 19, 20, 22, 24, 25, 26, 27, 29, 47, 48, 50, 52, 54, 55, 57, 58, 60, 83, 84, 85, 86, 87, 88, 89, 90, 114, 115, 116, 118, 119, 120, 131, 132]"
agent_c,L100,long,30,17,13,0,0.7692,130,"[19, 21, 23, 25, 26, 27, 28, 29, 46, 48, 51, 52, 57, 58, 59, 60, 61, 83, 85, 87, 88, 89, 90, 91, 113, 116, 117, 118, 120, 121]"
agent_c,L100,long,33,13,20,1,0.7519,133,"[19, 20, 21, 23, 24, 25, 26, 27, 28, 29, 30, 49, 50, 51, 57, 58, 59, 61, 84, 85, 86, 88, 89, 90, 92, 114, 115, 116, 118, 119, 120, 121, 123]"
agent_c,L100,long,31,18,13,1,0.7634,131,"[19, 20, 21, 22, 23, 24, 25, 26, 27, 28, 30, 49, 53, 54, 58, 59, 81, 82, 83, 84, 85, 86, 87, 88, 89, 114, 115, 116, 117, 119, 129]"
agent_c,L100,long,30,15,15,1,0.7692,130,"[14, 24, 25, 26, 27, 28, 31, 52, 53, 54, 55, 59, 60, 84, 86, 87, 88, 89, 90, 106, 107, 108, 109, 110, 111, 112, 114, 115, 116, 120]"
agent_c,L100,long,27,13,14,4,0.7874,127,"[18, 20, 21, 22, 23, 24, 26, 28, 29, 51, 54, 56, 57, 58, 59, 60, 62, 85, 87, 88, 90, 94, 113, 114, 115, 116, 121]"
agent_c,L100,long,29,18,11,4,0.7752,129,"[13, 23, 24, 25, 29, 48, 49, 50, 52, 54, 56, 57, 58, 62, 86, 88, 89, 91, 106, 107, 111, 113, 114, 115, 116, 117, 118, 119, 121]"
agent_c,L100,long,32,14,18,0,0.7576,132,"[19, 20, 21, 22, 23, 24, 25, 26, 27, 28, 30, 49, 51, 53, 54, 55, 56, 57, 58, 59, 60, 86, 87, 90, 113, 114, 115, 118, 119, 120, 129, 130]"
agent_c,L100,long,27,8,19,2,0.7874,127,"[18, 19, 20, 22, 23, 25, 28, 30, 47, 54, 55, 58, 59, 60, 62, 83, 84, 85, 86, 89, 90, 91, 116, 117, 118, 120, 121]"
agent_c,L100,long,30,11,19,3,0.7692,130,"[22, 24, 27, 30, 46, 47, 48, 49, 50, 51, 53, 55, 56, 57, 58, 59, 60, 83, 84, 85, 87, 89, 91, 113, 115, 116, 117, 119, 121, 123]"
agent_c,L100,long,33,10,23,2,0.7519,133,"[18, 20, 23, 25, 26, 27, 28, 29, 46, 47, 48, 49, 50, 51, 54, 55, 58, 59, 62, 86, 87, 88, 89, 90, 91, 114, 116, 118, 120, 121, 122, 123, 124]"
agent_c,L100,long,30,8,22,2,0.7692,130,"[18, 19, 20, 21, 22, 23, 25, 26, 27, 28, 29, 50, 51, 54, 57, 60, 85, 87, 88, 89, 91, 111, 112, 113, 115, 117, 118, 119, 120, 122]"
agent_c,L100,long,30,5,25,0,0.7692,130,"[18, 19, 20, 21, 22, 23, 24, 25, 26, 28, 29, 49, 51, 53, 56, 57, 58, 59, 83, 85, 86, 89, 90, 112, 114, 115, 116, 117, 118, 120]"
agent_c,L100,long,26,15,11,3,0.7937,126,"[17, 27, 29, 31, 48, 49, 50, 51, 53, 54, 57, 58, 60, 62, 85, 86, 89, 92, 110, 111, 113, 115, 116, 117, 118, 122]"
agent_c,L100,long,33,17,16,1,0.7519,133,"[13, 23, 25, 29, 47, 48, 49, 50, 51, 52, 53, 54, 55, 56, 59, 60, 85, 86, 90, 92, 93, 94, 111, 112, 113, 114, 115, 117, 118, 120, 122, 123, 125]"
agent_c,L100,long,30,16,14,0,0.7692,130,"[18, 22, 26, 27, 28, 29, 30, 31, 51, 53, 54, 55, 56, 58, 59, 60, 61, 62, 85, 86, 90, 92, 116, 117, 118, 119, 120, 121, 122, 123]"
agent_c,L100,long,29,20,9,1,0.7752,129,"[14, 25, 26, 27, 28, 30, 49, 51, 53, 54, 55, 56, 57, 59, 83, 84, 87, 89, 107, 108, 109, 110, 111, 112, 115, 116, 117, 118, 119]"
agent_c,L100,long,29,10,19,0,0.7752,129,"[14, 24, 27, 29, 30, 31, 51, 52, 55, 56, 57, 58, 59, 61, 85, 87, 90, 91, 106, 107, 109, 110, 112, 113, 114, 115, 116, 120, 122]"
agent_c,L100,long,30,16,14,1,0.7692,130,"[13, 24, 25, 28, 30, 32, 51, 52, 55, 56, 58, 59, 61, 63, 64, 88, 90, 91, 92, 93, 94, 111, 114, 116, 117, 118, 119, 123, 124, 125]"
agent_c,L100,long,29,14,15,2,0.7752,129,"[18, 20, 21, 23, 24, 25, 26, 28, 29, 48, 49, 51, 53, 54, 55, 56, 57, 58, 60, 62, 86, 87, 88, 89, 91, 93, 116, 121, 123]"
agent_c,L100,long,30,23,7,5,0.7692,130,"[13, 24, 25, 27, 28, 29, 30, 31, 52, 53, 54, 56, 57, 58, 59, 60, 66, 91, 106, 108, 111, 113, 114, 115, 116, 117, 118, 120, 122, 123]"
agent_c,L100,long,29,18,11,4,0.7752,129,"[13, 25, 26, 30, 48, 50, 52, 53, 54, 58, 61, 82, 84, 85, 86, 87, 88, 89, 90, 107, 108, 110, 111, 113, 114, 116, 117, 118, 121]"
agent_c,L100,long,29,17,12,2,0.7752,129,"[19, 21, 24, 25, 26, 28, 30, 48, 55, 57, 58, 62, 80, 81, 82, 83, 84, 86, 87, 88, 89, 90, 111, 113, 114, 116, 117, 118, 120]"
agent_c,L100,long,30,16,14,0,0.7692,130,"[13, 23, 24, 26, 27, 28, 29, 30, 53, 54, 55, 56, 57, 58, 59, 60, 85, 86, 87, 88, 89, 90, 108, 109, 110, 112, 113, 117, 118, 122]"
agent_c,L100,long,30,8,22,3,0.7692,130,"[18, 19, 20, 21, 23, 25, 27, 28, 31, 53, 54, 55, 57, 60, 81, 82, 83, 84, 85, 86, 87, 88, 89, 90, 91, 115, 116, 118, 120, 124]"
agent_c,L100,long,30,14,16,2,0.7692,130,"[13, 23, 25, 27, 29, 48, 49, 50, 52, 57, 58, 60, 82, 83, 85, 86, 87, 88, 89, 106, 108, 109, 110, 112, 113, 115, 116, 118, 120, 122]"
agent_c,L100,long,32,4,28,3,0.7576,132,"[14, 23, 24, 25, 26, 28, 29, 31, 54, 55, 56, 57, 58, 59, 60, 62, 87, 88, 89, 90, 91, 108, 109, 112, 113, 114, 116, 117, 118, 119, 120, 122]"
agent_c,L100,long,28,15,13,2,0.7812,128,"[15, 26, 27, 28, 30, 51, 52, 53, 54, 55, 57, 59, 61, 85, 86, 87, 88, 89, 90, 107, 109, 112, 113, 114, 115, 116, 118, 120]"
agent_c,L100,long,27,13,14,2,0.7874,127,"[19, 20, 22, 23, 24, 26, 27, 29, 47, 48, 49, 50, 52, 53, 55, 56, 59, 83, 85, 86, 87, 88, 90, 112, 113, 114, 120]"
agent_c,L100,long,31,10,21,4,0.7634,131,"[18, 19, 20, 23, 25, 26, 27, 28, 29, 32, 52, 54, 55, 59, 60, 81, 82, 83, 84, 85, 87, 90, 92, 113, 114, 116, 117, 119, 121, 122, 125]"
agent_c,L100,long,32,8,24,2,0.7576,132,"[18, 19, 20, 21, 22, 23, 24, 25, 26, 27, 28, 29, 30, 31, 54, 55, 56, 57, 58, 61, 86, 87, 91, 112, 114, 115, 116, 117, 118, 119, 120, 123]"
agent_c,L100,long,33,19,14,1,0.7519,133,"[18, 20, 22, 24, 27, 29, 45, 47, 49, 52, 53, 54, 55, 57, 59, 61, 83, 84, 86, 88, 89, 90, 91, 92, 113, 114, 115, 116, 117, 118, 121, 122, 123]"
agent_c,L100,long,26,22,4,1,0.7937,126,"[15, 24, 26, 27, 28, 30, 49, 52, 53, 54, 55, 56, 57, 58, 59, 87, 89, 105, 107, 108, 109, 113, 114, 115, 116, 119]"
agent_c,L100,long,30,25,5,1,0.7692,130,"[13, 23, 25, 27, 28, 29, 50, 51, 53, 54, 55, 56, 57, 58, 59, 84, 86, 90, 106, 107, 108, 109, 110, 111, 112, 113, 115, 116, 118, 119]"
agent_c,L100,long,35,27,8,2,0.7407,135,"[18, 19, 20, 21, 23, 25, 27, 28, 29, 49, 50, 51, 53, 54, 55, 58, 59, 82, 83, 84, 85, 86, 87, 88, 89, 92, 115, 116, 117, 118, 119, 120, 121, 122, 123]"
agent_c,L100,long,45,16,29,3,0.6897,145,"[18, 19, 22, 23, 24, 26, 27, 28, 29, 47, 48, 50, 51, 52, 55, 56, 58, 59, 83, 84, 85, 86, 87, 88, 93, 115, 116, 117, 118, 119, 120, 130, 131, 132, 133, 134, 135, 136, 137, 138, 139, 140, 141, 142, 143]"
agent_c,L100,long,37,15,22,2,0.7299,137,"[19, 22, 23, 24, 28, 29, 44, 45, 46, 47, 48, 49, 50, 51, 52, 53, 55, 56, 59, 62, 86, 87, 89, 90, 113, 114, 115, 116, 117, 118, 119, 120, 121, 132, 133, 134, 135]"
agent_c,L100,long,30,12,18,1,0.7692,130,"[13, 23, 24, 25, 30, 49, 50, 51, 52, 53, 55, 57, 58, 59, 61, 85, 88, 92, 106, 108, 110, 111, 112, 114, 117, 118, 121, 122, 123, 124]"
agent_c,L100,long,35,18,17,0,0.7407,135,"[18, 22, 26, 27, 28, 29, 45, 46, 47, 48, 49, 50, 51, 52, 53, 54, 56, 57, 58, 59, 84, 85, 87, 88, 89, 90, 114, 115, 116, 119, 120, 130, 131, 132, 133]"
agent_c,L100,long,29,16,13,0,0.7752,129,"[19, 22, 23, 24, 29, 30, 45, 46, 47, 48, 49, 52, 53, 54, 55, 56, 58, 59, 60, 84, 85, 87, 88, 89, 90, 113, 114, 119, 120]"
agent_c,L100,long,29,14,15,3,0.7752,129,"[18, 20, 21, 23, 24, 27, 32, 49, 50, 51, 52, 53, 55, 56, 57, 58, 60, 62, 87, 88, 89, 90, 91, 92, 113, 114, 118, 121, 124]"
agent_c,L100,long,29,8,21,1,0.7752,129,"[13, 23, 24, 25, 28, 29, 49, 50, 54, 55, 56, 60, 82, 84, 88, 89, 91, 93, 107, 108, 109, 112, 113, 118, 119, 120, 121, 122, 123]"
agent_c,L100,long,30,15,15,3,0.7692,130,"[18, 19, 20, 22, 23, 26, 27, 30, 49, 50, 51, 52, 53, 55, 56, 57, 58, 59, 61, 87, 89, 90, 92, 115, 117, 118, 119, 120, 122, 124]"
agent_c,L100,long,29,17,12,0,0.7752,129,"[13, 24, 25, 26, 28, 29, 50, 52, 54, 56, 58, 59, 60, 61, 84, 85, 87, 88, 89, 90, 91, 109, 111, 112, 113, 117, 118, 120, 121]"
agent_c,L100,long,27,11,16,3,0.7874,127,"[19, 20, 21, 23, 24, 25, 28, 30, 49, 50, 52, 57, 58, 59, 80, 81, 82, 83, 85, 87, 88, 90, 111, 114, 116, 118, 120]"
agent_c,L100,long,30,18,12,2,0.7692,130,"[14, 25, 27, 28, 30, 49, 53, 54, 56, 57, 58, 59, 60, 61, 85, 86, 88, 89, 90, 91, 107, 108, 110, 113, 114, 115, 117, 119, 120, 122]"
agent_c,L100,long,31,8,23,5,0.7634,131,"[13, 23, 24, 25, 26, 28, 34, 54, 57, 58, 59, 81, 82, 83, 84, 85, 86, 87, 88, 89, 90, 107, 110, 111, 113, 116, 117, 118, 119, 120, 124]"
agent_c,L100,long,30,11,19,2,0.7692,130,"[18, 19, 20, 21, 22, 23, 26, 27, 28, 29, 48, 50, 51, 52, 53, 54, 55, 57, 58, 59, 84, 85, 91, 113, 114, 115, 116, 117, 118, 121]"
agent_c,L100,long,29,12,17,1,0.7752,129,"[13, 23, 24, 25, 26, 27, 29, 49, 50, 52, 54, 55, 57, 58, 59, 84, 86, 87, 89, 105, 108, 110, 111, 112, 114, 115, 117, 118, 121]"
agent_c,L100,long,25,9,16,5,0.8,125,"[13, 23, 24, 25, 26, 30, 49, 51, 55, 56, 59, 81, 82, 85, 89, 91, 95, 107, 109, 110, 112, 113, 117, 118, 121]"
agent_c,L100,long,31,14,17,2,0.7634,131,"[18, 19, 20, 21, 22, 23, 24, 25, 26, 27, 29, 31, 51, 54, 55, 56, 57, 58, 60, 84, 85, 86, 87, 88, 90, 91, 115, 117, 119, 121, 123]"
agent_c,L100,long,32,12,20,0,0.7576,132,"[19, 20, 22, 23, 24, 25, 27, 28, 30, 49, 50, 51, 52, 53, 56, 57, 59, 60, 61, 86, 88, 92, 112, 113, 114, 115, 116, 117, 119, 120, 121, 122]"
agent_c,L100,long,28,21,7,2,0.7812,128,"[14, 23, 24, 27, 28, 30, 49, 52, 53, 54, 55, 56, 57, 58, 59, 60, 85, 86, 88, 92, 110, 113, 115, 116, 117, 118, 120, 123]"
agent_c,L100,long,29,16,13,1,0.7752,129,"[19, 20, 21, 22, 23, 24, 25, 26, 28, 29, 50, 52, 53, 54, 55, 56, 58, 59, 83, 84, 85, 88, 89, 111, 113, 114, 115, 117, 120]"
agent_c,L100,long,35,18,17,0,0.7407,135,"[18, 19, 20, 21, 22, 23, 24, 26, 28, 29, 48, 51, 54, 55, 57, 58, 59, 62, 63, 86, 87, 89, 91, 92, 93, 94, 95, 96, 119, 121, 122, 124, 125, 126, 127]"
agent_c,L100,long,34,7,27,2,0.7463,134,"[18, 19, 20, 21, 23, 24, 25, 26, 27, 28, 29, 31, 51, 52, 53, 54, 58, 59, 61, 85, 86, 87, 89, 90, 112, 113, 114, 115, 117, 118, 120, 130, 131, 132]"
agent_c,L100,long,40,12,28,0,0.7143,140,"[18, 19, 20, 21, 23, 24, 25, 26, 29, 47, 48, 49, 50, 52, 53, 54, 55, 57, 59, 60, 85, 86, 87, 89, 90, 113, 114, 115, 117, 118, 120, 130, 131, 132, 133, 134, 135, 136, 137, 138]"
agent_c,L100,long,36,24,12,5,0.7353,136,"[13, 23, 24, 27, 31, 50, 53, 54, 55, 56, 57, 58, 59, 82, 84, 86, 88, 89, 90, 91, 92, 109, 111, 112, 113, 117, 118, 120, 121, 122, 123, 124, 125, 126, 127, 131]"
agent_c,L100,long,30,8,22,2,0.7692,130,"[18, 19, 20, 21, 23, 24, 25, 28, 30, 31, 32, 53, 55, 56, 57, 58, 59, 61, 62, 66, 69, 93, 95, 96, 97, 119, 121, 122, 123, 127]"
agent_c,L100,long,31,17,14,7,0.7634,131,"[14, 23, 24, 25, 26, 27, 28, 35, 55, 58, 59, 60, 61, 62, 63, 88, 89, 90, 91, 92, 94, 110, 113, 114, 115, 116, 118, 119, 120, 121, 125]"
agent_c,L100,long,33,6,27,2,0.7519,133,"[15, 24, 25, 26, 27, 32, 53, 54, 56, 58, 59, 61, 62, 86, 88, 89, 90, 91, 93, 108, 109, 111, 112, 113, 114, 115, 116, 117, 118, 119, 121, 122, 123]"
agent_c,L100,long,32,19,13,2,0.7576,132,"[23, 24, 25, 28, 30, 46, 48, 49, 50, 52, 55, 56, 57, 58, 59, 82, 83, 85, 86, 87, 88, 90, 91, 92, 113, 114, 116, 117, 121, 122, 123, 125]"
agent_c,L100,long,28,6,22,2,0.7812,128,"[18, 19, 20, 21, 22, 23, 24, 25, 28, 29, 48, 49, 50, 51, 52, 53, 54, 56, 57, 58, 60, 88, 90, 112, 114, 115, 117, 119]"
agent_c,L100,long,30,7,23,3,0.7692,130,"[18, 19, 20, 21, 22, 23, 24, 25, 26, 28, 31, 52, 54, 55, 56, 59, 81, 83, 85, 86, 87, 91, 111, 114, 115, 116, 117, 118, 120, 122]"
agent_c,L100,long,30,12,18,4,0.7692,130,"[13, 27, 28, 29, 31, 49, 53, 54, 55, 56, 59, 61, 83, 84, 85, 86, 87, 89, 90, 91, 107, 108, 109, 111, 113, 114, 115, 119, 121, 124]"
agent_c,L100,long,30,13,17,5,0.7692,130,"[18, 19, 21, 22, 23, 24, 25, 26, 27, 28, 30, 49, 50, 52, 54, 55, 56, 58, 59, 60, 63, 88, 93, 114, 117, 118, 119, 120, 121, 122]"
agent_c,L100,long,33,25,8,1,0.7519,133,"[18, 19, 20, 21, 25, 26, 27, 29, 49, 53, 54, 55, 56, 57, 59, 60, 61, 62, 85, 87, 88, 89, 91, 92, 94, 116, 118, 119, 120, 121, 122, 123, 125]"
agent_c,L100,long,33,21,12,0,0.7519,133,"[14, 23, 24, 27, 28, 29, 31, 32, 52, 55, 57, 58, 59, 60, 62, 87, 88, 89, 90, 91, 93, 109, 110, 111, 112, 113, 114, 115, 116, 119, 121, 122, 123]"
agent_c,L100,long,28,8,20,2,0.7812,128,"[18, 19, 20, 21, 23, 24, 26, 28, 29, 30, 48, 49, 50, 51, 52, 53, 55, 56, 57, 58, 59, 61, 87, 89, 90, 117, 119, 121]"
agent_c,L100,long,34,14,20,3,0.7463,134,"[14, 23, 24, 25, 26, 29, 52, 53, 54, 55, 56, 57, 58, 59, 61, 86, 89, 90, 92, 107, 108, 109, 111, 112, 113, 114, 115, 116, 117, 119, 120, 121, 122, 125]"
agent_c,L100,long,27,9,18,2,0.7874,127,"[13, 24, 25, 26, 27, 30, 50, 53, 54, 55, 56, 57, 58, 59, 85, 87, 88, 89, 105, 109, 110, 111, 113, 115, 116, 118, 120]"
agent_c,L100,long,32,21,11,1,0.7576,132,"[14, 24, 25, 26, 27, 28, 30, 51, 52, 53, 54, 55, 56, 58, 59, 61, 87, 88, 91, 106, 108, 109, 110, 111, 113, 114, 115, 116, 117, 118, 119, 121]"
agent_c,L100,long,32,16,16,0,0.7576,132,"[19, 20, 22, 23, 24, 25, 26, 29, 31, 51, 52, 54, 55, 56, 58, 59, 60, 61, 84, 85, 88, 89, 90, 91, 92, 114, 115, 117, 119, 120, 121, 122]"
agent_c,L100,long,32,12,20,1,0.7576,132,"[19, 20, 21, 25, 26, 27, 28, 29, 30, 31, 32, 53, 54, 56, 58, 59, 60, 61, 62, 63, 65, 91, 92, 93, 95, 117, 119, 120, 121, 122, 124, 125]"
agent_c,L100,long,29,16,13,2,0.7752,129,"[18, 19, 20, 22, 24, 26, 27, 28, 29, 48, 49, 50, 51, 53, 54, 55, 56, 57, 58, 61, 86, 89, 90, 112, 114, 115, 117, 119, 121]"
agent_c,L100,long,33,11,22,0,0.7519,133,"[18, 19, 20, 22, 23, 24, 25, 26, 27, 29, 48, 49, 50, 51, 52, 53, 54, 55, 57, 58, 59, 85, 86, 87, 88, 89, 90, 91, 117, 119, 121, 123, 124]"
agent_c,L100,long,32,5,27,3,0.7576,132,"[13, 23, 24, 25, 27, 28, 29, 49, 50, 51, 52, 53, 54, 55, 56, 57, 62, 88, 89, 107, 109, 110, 111, 113, 114, 115, 116, 117, 118, 119, 120, 121]"
agent_c,L100,long,30,9,21,0,0.7692,130,"[18, 19, 20, 21, 22, 24, 25, 26, 27, 28, 31, 53, 55, 56, 61, 82, 83, 85, 87, 88, 89, 90, 91, 112, 114, 116, 117, 118, 119, 121]"
agent_c,L100,long,31,6,25,0,0.7634,131,"[13, 24, 25, 26, 27, 28, 29, 30, 51, 52, 55, 56, 57, 58, 60, 61, 86, 87, 88, 89, 91, 108, 109, 111, 115, 116, 117, 118, 119, 120, 121]"
agent_c,L100,long,30,5,25,5,0.7692,130,"[18, 19, 20, 21, 22, 24, 26, 27, 29, 48, 49, 50, 51, 52, 53, 54, 55, 56, 57, 58, 61, 87, 88, 89, 90, 114, 117, 118, 119, 124]"
agent_c,L100,long,32,9,23,0,0.7576,132,"[13, 23, 24, 26, 27, 29, 48, 50, 52, 54, 55, 56, 58, 61, 84, 85, 86, 87, 88, 89, 90, 91, 109, 110, 111, 114, 115, 117, 118, 119, 120, 121]"
agent_c,L100,long,31,9,22,1,0.7634,131,"[15, 26, 27, 28, 29, 48, 49, 50, 51, 52, 53, 54, 55, 56, 57, 58, 59, 61, 88, 89, 90, 92, 109, 113, 114, 116, 117, 119, 120, 121, 122]"
agent_c,L100,long,29,20,9,2,0.7752,129,"[19, 20, 21, 23, 24, 25, 26, 27, 28, 29, 50, 51, 52, 53, 54, 57, 58, 60, 83, 84, 85, 87, 88, 89, 112, 114, 115, 116, 120]"
agent_c,L100,long,30,10,20,2,0.7692,130,"[14, 23, 28, 29, 30, 49, 52, 53, 54, 55, 56, 57, 62, 86, 87, 88, 89, 91, 92, 107, 108, 110, 111, 113, 115, 117, 121, 122, 123, 124]"
agent_c,L100,long,32,12,20,3,0.7576,132,"[13, 23, 25, 26, 27, 28, 29, 30, 31, 53, 55, 56, 57, 58, 60, 62, 87, 88, 89, 90, 93, 109, 111, 113, 114, 115, 117, 118, 120, 122, 123, 125]"
