agent_name,layout,event_update_level,num_attention_switches,num_attention_switches_margins,num_attention_switches_middle,inform_loss,reading_speed,total_steps,attention_switches_time_steps_list
agent_a,L0,short,14,7,7,18,0.8772,114,"[10, 17, 20, 29, 39, 41, 50, 59, 61, 70, 75, 85, 94, 108]"
agent_a,L0,short,20,13,7,1,0.8333,120,"[4, 9, 12, 21, 30, 31, 42, 52, 61, 62, 63, 64, 75, 84, 85, 95, 104, 105, 106, 116]"
agent_a,L0,short,16,11,5,12,0.8621,116,"[4, 9, 18, 20, 32, 41, 50, 59, 68, 71, 80, 89, 90, 98, 102, 113]"
agent_a,L0,short,19,13,6,3,0.8403,119,"[4, 9, 18, 20, 30, 40, 50, 51, 60, 61, 62, 71, 73, 83, 94, 97, 105, 107, 117]"
agent_a,L0,short,16,5,11,10,0.8621,116,"[9, 16, 19, 20, 29, 31, 41, 42, 51, 54, 64, 73, 82, 84, 96, 106]"
agent_a,L0,short,18,10,8,16,0.8475,118,"[4, 9, 11, 20, 22, 31, 34, 43, 47, 58, 67, 76, 85, 95, 96, 105, 106, 108]"
agent_a,L0,short,16,8,8,6,0.8621,116,"[4, 11, 20, 30, 39, 41, 51, 60, 61, 70, 72, 81, 90, 92, 102, 111]"
agent_a,L0,short,19,10,9,6,0.8403,119,"[4, 9, 11, 20, 30, 32, 41, 53, 62, 71, 74, 83, 84, 85, 94, 96, 98, 107, 117]"
agent_a,L0,short,16,6,10,11,0.8621,116,"[6, 13, 24, 33, 35, 44, 45, 55, 57, 66, 68, 78, 87, 89, 98, 109]"
agent_a,L0,short,15,13,2,18,0.8696,115,"[9, 18, 19, 29, 39, 49, 50, 51, 60, 62, 71, 80, 85, 94, 107]"
agent_a,L0,short,15,10,5,17,0.8696,115,"[5, 13, 22, 32, 41, 42, 43, 46, 57, 66, 76, 85, 86, 97, 108]"
agent_a,L0,short,18,10,8,2,0.8475,118,"[4, 9, 18, 20, 30, 40, 41, 51, 52, 61, 62, 71, 74, 83, 93, 102, 103, 113]"
agent_a,L0,short,17,9,8,8,0.8547,117,"[9, 11, 14, 22, 25, 34, 45, 54, 56, 65, 67, 76, 85, 87, 96, 97, 107]"
agent_a,L0,short,19,14,5,16,0.8403,119,"[4, 9, 11, 24, 34, 44, 54, 65, 74, 83, 91, 92, 93, 101, 102, 103, 112, 113, 115]"
agent_a,L0,short,20,9,11,5,0.8333,120,"[5, 12, 21, 30, 31, 32, 34, 43, 45, 55, 64, 66, 76, 77, 81, 90, 91, 101, 111, 112]"
agent_a,L0,short,14,6,8,6,0.8772,114,"[10, 17, 20, 29, 31, 43, 52, 54, 64, 66, 75, 85, 97, 106]"
agent_a,L0,short,17,12,5,8,0.8547,117,"[4, 9, 18, 20, 30, 41, 50, 59, 60, 61, 71, 80, 82, 91, 93, 103, 114]"
agent_a,L0,short,18,12,6,12,0.8475,118,"[4, 9, 19, 20, 33, 42, 52, 53, 55, 56, 65, 67, 68, 70, 81, 91, 105, 113]"
agent_a,L0,short,20,12,8,4,0.8333,120,"[9, 11, 21, 30, 31, 41, 50, 51, 52, 53, 55, 66, 75, 76, 86, 95, 97, 106, 108, 116]"
agent_a,L0,short,18,15,3,10,0.8475,118,"[9, 18, 20, 23, 32, 35, 46, 56, 65, 74, 76, 87, 96, 105, 106, 107, 109, 110]"
agent_a,L0,short,15,8,7,16,0.8696,115,"[7, 14, 23, 32, 41, 51, 60, 70, 72, 80, 82, 91, 92, 103, 113]"
agent_a,L0,short,18,15,3,12,0.8475,118,"[5, 12, 22, 31, 33, 42, 51, 54, 63, 73, 74, 75, 76, 78, 87, 96, 100, 110]"
agent_a,L0,short,20,13,7,16,0.8333,120,"[5, 12, 21, 23, 33, 36, 47, 56, 65, 67, 68, 78, 79, 89, 90, 91, 93, 102, 106, 116]"
agent_a,L0,short,18,9,9,3,0.8475,118,"[9, 11, 19, 21, 30, 32, 43, 52, 61, 63, 72, 82, 91, 92, 102, 104, 112, 114]"
agent_a,L0,short,16,9,7,15,0.8621,116,"[5, 12, 21, 30, 39, 41, 50, 52, 61, 64, 73, 75, 85, 94, 102, 106]"
agent_a,L0,short,20,14,6,4,0.8333,120,"[4, 9, 19, 28, 30, 31, 33, 42, 52, 54, 64, 74, 76, 85, 95, 103, 105, 106, 115, 116]"
agent_a,L0,short,18,9,9,4,0.8475,118,"[10, 17, 20, 30, 40, 41, 51, 52, 61, 63, 72, 73, 83, 92, 95, 104, 112, 115]"
agent_a,L0,short,15,12,3,12,0.8696,115,"[5, 16, 26, 36, 46, 56, 59, 68, 77, 86, 87, 95, 97, 105, 107]"
agent_a,L0,short,16,9,7,11,0.8621,116,"[9, 16, 18, 19, 21, 30, 32, 33, 34, 44, 55, 67, 76, 85, 96, 106]"
agent_a,L0,short,19,12,7,5,0.8403,119,"[9, 16, 18, 19, 30, 40, 41, 42, 51, 53, 63, 64, 73, 75, 86, 95, 104, 105, 115]"
agent_a,L0,short,16,11,5,12,0.8621,116,"[9, 16, 19, 28, 32, 42, 51, 60, 63, 71, 73, 82, 93, 102, 111, 112]"
agent_a,L0,short,18,11,7,6,0.8475,118,"[4, 9, 18, 20, 31, 40, 51, 62, 71, 73, 82, 91, 93, 95, 103, 104, 106, 116]"
agent_a,L0,short,17,12,5,7,0.8547,117,"[4, 9, 18, 20, 31, 40, 50, 60, 69, 72, 81, 91, 100, 101, 102, 111, 114]"
agent_a,L0,short,15,10,5,16,0.8696,115,"[9, 11, 20, 22, 33, 34, 46, 55, 64, 72, 75, 84, 85, 100, 110]"
agent_a,L0,short,18,9,9,9,0.8475,118,"[4, 9, 18, 20, 30, 39, 42, 52, 62, 71, 80, 89, 90, 99, 100, 103, 112, 114]"
agent_a,L0,short,12,7,5,12,0.8929,112,"[10, 18, 20, 29, 32, 46, 55, 64, 74, 86, 94, 105]"
agent_a,L0,short,16,5,11,14,0.8621,116,"[5, 12, 21, 30, 39, 40, 41, 51, 60, 62, 73, 82, 91, 95, 103, 114]"
agent_a,L0,short,16,8,8,7,0.8621,116,"[10, 17, 20, 29, 32, 42, 51, 53, 55, 64, 67, 76, 85, 94, 96, 106]"
agent_a,L0,short,20,9,11,2,0.8333,120,"[4, 9, 19, 28, 30, 31, 40, 42, 43, 54, 63, 72, 74, 83, 93, 102, 103, 104, 114, 115]"
agent_a,L0,short,13,10,3,33,0.885,113,"[6, 13, 23, 34, 44, 54, 62, 71, 80, 89, 91, 99, 103]"
agent_a,L0,short,15,8,7,10,0.8696,115,"[4, 9, 11, 23, 33, 43, 44, 56, 65, 76, 84, 93, 94, 96, 106]"
agent_a,L0,short,16,14,2,15,0.8621,116,"[4, 10, 19, 21, 32, 42, 51, 55, 65, 74, 84, 92, 100, 105, 106, 107]"
agent_a,L0,short,20,14,6,1,0.8333,120,"[4, 9, 19, 29, 31, 32, 42, 52, 53, 63, 73, 82, 84, 93, 94, 95, 96, 106, 115, 116]"
agent_a,L0,short,21,14,7,5,0.8264,121,"[9, 16, 18, 19, 28, 30, 40, 49, 58, 60, 69, 79, 80, 81, 82, 91, 93, 102, 105, 116, 117]"
agent_a,L0,short,17,8,9,12,0.8547,117,"[4, 9, 11, 20, 24, 35, 44, 56, 65, 74, 77, 86, 95, 104, 105, 106, 107]"
agent_a,L0,short,18,14,4,6,0.8475,118,"[4, 9, 18, 20, 30, 39, 50, 59, 60, 61, 70, 72, 81, 83, 93, 103, 105, 114]"
agent_a,L0,short,16,7,9,14,0.8621,116,"[9, 16, 19, 21, 30, 32, 42, 46, 55, 64, 69, 78, 89, 97, 99, 108]"
agent_a,L0,short,15,9,6,6,0.8696,115,"[9, 11, 19, 21, 32, 42, 43, 53, 64, 73, 82, 85, 94, 95, 107]"
agent_a,L0,short,17,12,5,7,0.8547,117,"[4, 9, 18, 20, 30, 39, 43, 52, 61, 70, 72, 81, 90, 94, 102, 111, 112]"
agent_a,L0,short,13,5,8,15,0.885,113,"[9, 18, 20, 30, 40, 51, 60, 61, 62, 76, 85, 95, 104]"
agent_a,L0,short,20,12,8,7,0.8333,120,"[4, 9, 18, 21, 30, 31, 32, 41, 45, 55, 65, 75, 84, 86, 95, 104, 105, 106, 115, 117]"
agent_a,L0,short,18,9,9,3,0.8475,118,"[9, 16, 18, 20, 29, 39, 41, 50, 61, 71, 72, 81, 83, 93, 95, 104, 105, 115]"
agent_a,L0,short,18,6,12,16,0.8475,118,"[4, 9, 19, 22, 31, 33, 37, 49, 59, 69, 79, 89, 98, 100, 109, 110, 111, 112]"
agent_a,L0,short,19,14,5,0,0.8403,119,"[9, 16, 18, 19, 29, 39, 49, 59, 68, 69, 70, 80, 81, 90, 91, 100, 102, 104, 114]"
agent_a,L0,short,17,12,5,6,0.8547,117,"[4, 9, 18, 21, 31, 40, 50, 60, 69, 71, 80, 91, 100, 101, 103, 112, 113]"
agent_a,L0,short,19,7,12,5,0.8403,119,"[4, 9, 19, 28, 30, 42, 52, 63, 74, 75, 84, 85, 86, 87, 88, 89, 99, 100, 110]"
agent_a,L0,short,17,7,10,10,0.8547,117,"[6, 13, 14, 23, 26, 36, 45, 47, 56, 59, 71, 80, 90, 100, 101, 110, 111]"
agent_a,L0,short,17,10,7,10,0.8547,117,"[9, 16, 18, 20, 29, 32, 42, 51, 53, 62, 71, 72, 74, 84, 93, 94, 106]"
agent_a,L0,short,15,7,8,6,0.8696,115,"[4, 10, 19, 21, 30, 32, 42, 51, 53, 63, 75, 85, 94, 96, 105]"
agent_a,L0,short,16,10,6,12,0.8621,116,"[9, 11, 20, 30, 31, 41, 50, 52, 61, 63, 72, 76, 85, 94, 98, 107]"
agent_a,L0,short,18,6,12,5,0.8475,118,"[12, 20, 29, 39, 50, 59, 68, 70, 71, 80, 81, 90, 91, 92, 103, 104, 113, 114]"
agent_a,L0,short,19,8,11,5,0.8403,119,"[9, 16, 18, 22, 31, 44, 53, 54, 63, 65, 74, 76, 85, 86, 88, 97, 98, 99, 110]"
agent_a,L0,short,21,17,4,5,0.8264,121,"[9, 16, 18, 19, 31, 42, 51, 52, 53, 64, 74, 83, 92, 93, 94, 104, 105, 106, 107, 108, 118]"
agent_a,L0,short,13,5,8,40,0.885,113,"[9, 12, 20, 21, 22, 32, 43, 62, 71, 81, 90, 101, 109]"
agent_a,L0,short,21,15,6,8,0.8264,121,"[9, 13, 21, 31, 40, 42, 51, 52, 53, 55, 65, 74, 76, 85, 94, 95, 104, 105, 106, 109, 119]"
agent_a,L0,short,18,10,8,7,0.8475,118,"[4, 9, 18, 20, 30, 40, 41, 44, 55, 64, 66, 75, 84, 86, 95, 105, 115, 116]"
agent_a,L0,short,18,12,6,14,0.8475,118,"[4, 10, 20, 21, 30, 31, 40, 43, 53, 65, 74, 83, 92, 93, 94, 104, 113, 116]"
agent_a,L0,short,16,12,4,10,0.8621,116,"[4, 9, 19, 28, 30, 41, 52, 62, 72, 80, 90, 91, 100, 101, 110, 112]"
agent_a,L0,short,18,14,4,7,0.8475,118,"[9, 16, 22, 31, 40, 52, 62, 70, 72, 73, 74, 75, 76, 77, 86, 88, 97, 108]"
agent_a,L0,short,15,10,5,12,0.8696,115,"[4, 9, 18, 20, 23, 32, 42, 51, 53, 62, 71, 73, 86, 96, 106]"
agent_a,L0,short,15,10,5,6,0.8696,115,"[4, 9, 18, 20, 21, 31, 40, 43, 54, 57, 66, 75, 85, 96, 105]"
agent_a,L0,short,17,7,10,6,0.8547,117,"[9, 17, 20, 29, 39, 48, 51, 61, 70, 79, 80, 90, 100, 102, 110, 111, 114]"
agent_a,L0,short,20,12,8,5,0.8333,120,"[4, 9, 11, 20, 23, 32, 41, 43, 53, 62, 63, 74, 75, 76, 77, 79, 89, 98, 100, 111]"
agent_a,L0,short,13,3,10,10,0.885,113,"[14, 24, 33, 42, 44, 54, 64, 74, 83, 84, 93, 94, 104]"
agent_a,L0,short,15,6,9,15,0.8696,115,"[4, 9, 19, 28, 30, 39, 41, 53, 63, 72, 81, 90, 92, 93, 105]"
agent_a,L0,short,18,12,6,8,0.8475,118,"[4, 9, 11, 20, 30, 34, 43, 52, 54, 63, 65, 75, 84, 94, 95, 96, 99, 108]"
agent_a,L0,short,17,7,10,14,0.8547,117,"[6, 14, 23, 32, 41, 50, 52, 62, 71, 79, 81, 82, 91, 95, 103, 112, 114]"
agent_a,L0,short,20,10,10,15,0.8333,120,"[6, 15, 24, 33, 43, 53, 62, 63, 65, 74, 84, 93, 94, 95, 103, 104, 105, 106, 115, 117]"
agent_a,L0,short,19,10,9,7,0.8403,119,"[9, 17, 19, 20, 29, 31, 32, 34, 44, 53, 56, 66, 75, 77, 86, 89, 98, 99, 111]"
agent_a,L0,short,14,6,8,4,0.8772,114,"[7, 13, 22, 24, 34, 43, 52, 54, 63, 73, 82, 83, 95, 104]"
agent_a,L0,short,17,13,4,11,0.8547,117,"[9, 16, 18, 20, 31, 41, 50, 59, 68, 69, 79, 80, 89, 92, 102, 111, 114]"
agent_a,L0,short,16,9,7,5,0.8621,116,"[10, 17, 20, 29, 32, 42, 51, 52, 62, 71, 72, 83, 92, 101, 102, 113]"
agent_a,L0,short,16,8,8,7,0.8621,116,"[9, 16, 19, 20, 30, 41, 50, 51, 60, 63, 72, 74, 83, 85, 96, 106]"
agent_a,L0,short,19,13,6,4,0.8403,119,"[4, 9, 18, 20, 21, 23, 26, 36, 45, 55, 56, 65, 67, 77, 89, 100, 101, 109, 111]"
agent_a,L0,short,16,7,9,8,0.8621,116,"[5, 12, 21, 30, 40, 41, 51, 60, 62, 72, 81, 90, 91, 101, 103, 113]"
agent_a,L0,short,15,8,7,7,0.8696,115,"[4, 9, 11, 20, 30, 39, 44, 56, 65, 74, 76, 85, 95, 104, 106]"
agent_a,L0,short,22,12,10,6,0.8197,122,"[12, 20, 21, 30, 32, 42, 53, 62, 64, 65, 75, 77, 79, 88, 90, 99, 108, 109, 111, 112, 114, 115]"
agent_a,L0,short,20,11,9,7,0.8333,120,"[9, 11, 19, 21, 35, 45, 54, 55, 56, 57, 58, 60, 70, 79, 89, 98, 99, 100, 110, 111]"
agent_a,L0,short,13,9,4,25,0.885,113,"[4, 11, 20, 29, 34, 45, 54, 64, 73, 82, 87, 96, 104]"
agent_a,L0,short,15,9,6,10,0.8696,115,"[10, 18, 20, 29, 31, 41, 50, 59, 62, 72, 82, 92, 101, 109, 111]"
agent_a,L0,short,16,12,4,5,0.8621,116,"[4, 9, 19, 28, 30, 39, 49, 59, 68, 70, 79, 88, 89, 92, 102, 112]"
agent_a,L0,short,14,2,12,10,0.8772,114,"[9, 15, 24, 33, 34, 47, 56, 65, 74, 84, 92, 94, 103, 105]"
agent_a,L0,short,17,11,6,4,0.8547,117,"[9, 17, 19, 28, 30, 41, 50, 51, 53, 62, 72, 81, 83, 93, 95, 105, 107]"
agent_a,L0,short,17,5,12,8,0.8547,117,"[9, 11, 19, 21, 30, 33, 43, 45, 54, 56, 67, 69, 78, 87, 89, 98, 110]"
agent_a,L0,short,14,12,2,12,0.8772,114,"[13, 21, 32, 42, 52, 54, 67, 76, 84, 94, 95, 103, 104, 105]"
agent_a,L0,short,17,9,8,10,0.8547,117,"[5, 12, 21, 30, 40, 49, 51, 52, 62, 71, 73, 82, 91, 94, 102, 111, 112]"
agent_a,L0,short,17,6,11,8,0.8547,117,"[10, 19, 28, 29, 30, 40, 49, 51, 60, 70, 73, 82, 93, 102, 104, 112, 115]"
agent_a,L0,short,19,9,10,6,0.8403,119,"[10, 18, 21, 30, 31, 41, 43, 52, 53, 62, 66, 75, 86, 87, 88, 89, 98, 99, 110]"
agent_a,L0,short,18,10,8,8,0.8475,118,"[9, 18, 20, 31, 40, 42, 52, 54, 63, 66, 75, 77, 78, 87, 89, 99, 108, 110]"
agent_a,L0,short,15,14,1,14,0.8696,115,"[4, 10, 20, 31, 40, 49, 58, 60, 69, 73, 83, 92, 100, 110, 111]"
agent_a,L50,short,17,8,9,4,0.8547,117,"[10, 19, 29, 40, 49, 50, 61, 71, 80, 81, 89, 90, 91, 92, 94, 104, 114]"
agent_a,L50,short,20,8,12,3,0.8333,120,"[10, 19, 20, 30, 31, 41, 50, 52, 61, 63, 72, 73, 83, 84, 85, 87, 96, 106, 115, 117]"
agent_a,L50,short,13,6,7,5,0.885,113,"[5, 11, 20, 30, 39, 41, 51, 61, 72, 82, 93, 102, 104]"
agent_a,L50,short,22,9,13,4,0.8197,122,"[4, 10, 21, 22, 23, 24, 34, 43, 45, 55, 64, 65, 66, 76, 78, 80, 82, 91, 101, 102, 112, 114]"
agent_a,L50,short,20,12,8,10,0.8333,120,"[5, 12, 21, 30, 39, 49, 51, 61, 70, 71, 72, 75, 76, 77, 79, 88, 92, 101, 110, 112]"
agent_a,L50,short,16,4,12,17,0.8621,116,"[5, 11, 20, 31, 33, 43, 52, 53, 54, 63, 64, 68, 78, 88, 101, 110]"
agent_a,L50,short,15,7,8,5,0.8696,115,"[10, 19, 21, 23, 32, 42, 44, 45, 56, 66, 76, 86, 88, 98, 108]"
agent_a,L50,short,16,7,9,10,0.8621,116,"[4, 10, 20, 29, 33, 43, 52, 61, 70, 71, 82, 91, 92, 102, 104, 114]"
agent_a,L50,short,16,10,6,6,0.8621,116,"[6, 12, 21, 31, 40, 43, 53, 55, 65, 66, 68, 79, 88, 97, 106, 108]"
agent_a,L50,short,17,7,10,8,0.8547,117,"[6, 12, 21, 30, 32, 41, 43, 54, 55, 56, 57, 67, 77, 86, 88, 98, 109]"
agent_a,L50,short,12,5,7,12,0.8929,112,"[4, 11, 21, 30, 39, 41, 53, 62, 73, 82, 92, 103]"
agent_a,L50,short,13,8,5,13,0.885,113,"[5, 12, 21, 31, 40, 49, 58, 61, 74, 84, 94, 103, 104]"
agent_a,L50,short,14,9,5,17,0.8772,114,"[4, 13, 22, 24, 35, 46, 56, 65, 74, 84, 94, 103, 104, 106]"
agent_a,L50,short,18,7,11,11,0.8475,118,"[12, 19, 28, 29, 39, 40, 41, 42, 43, 45, 55, 66, 75, 86, 95, 104, 105, 116]"
agent_a,L50,short,20,12,8,6,0.8333,120,"[6, 12, 22, 32, 41, 50, 52, 53, 62, 63, 72, 73, 76, 85, 94, 95, 105, 106, 115, 116]"
agent_a,L50,short,20,10,10,19,0.8333,120,"[4, 12, 21, 30, 34, 46, 56, 65, 74, 76, 77, 79, 88, 89, 98, 99, 100, 101, 110, 113]"
agent_a,L50,short,19,6,13,4,0.8403,119,"[10, 19, 28, 29, 30, 31, 32, 33, 43, 54, 63, 73, 74, 84, 94, 103, 104, 113, 116]"
agent_a,L50,short,19,13,6,6,0.8403,119,"[4, 11, 21, 30, 32, 41, 51, 60, 61, 62, 71, 74, 83, 85, 94, 95, 105, 106, 108]"
agent_a,L50,short,17,8,9,14,0.8547,117,"[4, 14, 24, 33, 43, 52, 60, 62, 71, 80, 81, 91, 101, 109, 110, 111, 112]"
agent_a,L50,short,21,11,10,5,0.8264,121,"[4, 10, 21, 22, 23, 33, 42, 46, 55, 57, 66, 68, 77, 79, 88, 98, 99, 100, 102, 111, 113]"
agent_a,L50,short,21,11,10,2,0.8264,121,"[5, 11, 20, 29, 30, 31, 42, 43, 53, 62, 63, 65, 66, 76, 85, 86, 97, 106, 115, 116, 117]"
agent_a,L50,short,12,7,5,40,0.8929,112,"[14, 25, 37, 48, 56, 65, 74, 83, 91, 92, 102, 109]"
agent_a,L50,short,16,4,12,5,0.8621,116,"[5, 11, 21, 33, 43, 45, 54, 57, 66, 75, 76, 85, 86, 96, 105, 107]"
agent_a,L50,short,15,4,11,3,0.8696,115,"[11, 19, 28, 29, 40, 51, 52, 61, 62, 71, 73, 84, 93, 95, 106]"
agent_a,L50,short,14,9,5,5,0.8772,114,"[10, 19, 28, 30, 40, 50, 59, 69, 80, 89, 99, 100, 109, 110]"
agent_a,L50,short,13,5,8,10,0.885,113,"[11, 19, 20, 21, 30, 33, 43, 52, 64, 74, 84, 93, 103]"
agent_a,L50,short,16,9,7,10,0.8621,116,"[12, 19, 21, 30, 40, 49, 50, 52, 61, 64, 73, 84, 93, 103, 105, 107]"
agent_a,L50,short,19,14,5,3,0.8403,119,"[10, 20, 29, 39, 48, 49, 58, 59, 60, 69, 71, 80, 89, 90, 93, 94, 104, 113, 114]"
agent_a,L50,short,12,8,4,14,0.8929,112,"[10, 21, 30, 41, 55, 64, 75, 84, 92, 101, 102, 103]"
agent_a,L50,short,14,10,4,5,0.8772,114,"[10, 21, 31, 42, 52, 61, 62, 63, 72, 73, 83, 92, 94, 104]"
agent_a,L50,short,15,8,7,14,0.8696,115,"[4, 11, 20, 30, 33, 42, 51, 55, 65, 74, 83, 93, 102, 103, 113]"
agent_a,L50,short,17,12,5,13,0.8547,117,"[10, 19, 20, 31, 44, 53, 63, 71, 80, 81, 82, 90, 91, 93, 102, 111, 112]"
agent_a,L50,short,17,6,11,6,0.8547,117,"[10, 19, 23, 32, 42, 52, 61, 62, 71, 72, 73, 75, 85, 94, 95, 106, 107]"
agent_a,L50,short,20,7,13,5,0.8333,120,"[4, 10, 12, 21, 23, 33, 43, 45, 55, 64, 73, 74, 83, 84, 85, 86, 96, 105, 107, 117]"
agent_a,L50,short,21,13,8,6,0.8264,121,"[10, 19, 20, 22, 31, 42, 51, 52, 55, 64, 66, 75, 84, 85, 86, 96, 97, 98, 99, 101, 112]"
agent_a,L50,short,16,9,7,14,0.8621,116,"[4, 10, 20, 21, 23, 24, 35, 36, 47, 57, 67, 76, 82, 91, 102, 112]"
agent_a,L50,short,17,8,9,4,0.8547,117,"[10, 12, 20, 23, 32, 42, 52, 53, 63, 72, 74, 83, 84, 93, 95, 106, 107]"
agent_a,L50,short,17,9,8,8,0.8547,117,"[4, 11, 20, 29, 30, 41, 51, 60, 61, 63, 72, 74, 76, 85, 88, 99, 109]"
agent_a,L50,short,20,17,3,11,0.8333,120,"[4, 10, 21, 31, 40, 49, 58, 59, 68, 69, 70, 71, 80, 83, 93, 103, 105, 114, 115, 116]"
agent_a,L50,short,19,16,3,8,0.8403,119,"[4, 10, 20, 29, 38, 41, 51, 60, 61, 62, 71, 75, 84, 93, 102, 103, 112, 113, 115]"
agent_a,L50,short,16,12,4,6,0.8621,116,"[4, 10, 20, 29, 30, 40, 42, 52, 64, 73, 82, 83, 85, 94, 95, 107]"
agent_a,L50,short,20,6,14,5,0.8333,120,"[12, 19, 28, 29, 39, 43, 52, 54, 55, 56, 65, 67, 68, 77, 80, 91, 102, 103, 113, 115]"
agent_a,L50,short,20,14,6,6,0.8333,120,"[11, 20, 29, 30, 40, 41, 50, 51, 52, 53, 62, 64, 65, 66, 67, 79, 90, 100, 111, 112]"
agent_a,L50,short,15,6,9,3,0.8696,115,"[4, 10, 23, 34, 44, 46, 55, 57, 67, 79, 88, 89, 99, 108, 109]"
agent_a,L50,short,19,11,8,20,0.8403,119,"[4, 15, 25, 34, 44, 53, 61, 62, 63, 64, 74, 83, 84, 85, 86, 96, 97, 106, 108]"
agent_a,L50,short,18,6,12,7,0.8475,118,"[10, 19, 20, 29, 31, 32, 33, 35, 45, 47, 57, 59, 69, 79, 90, 99, 102, 112]"
agent_a,L50,short,17,9,8,5,0.8547,117,"[11, 13, 21, 22, 23, 33, 34, 35, 45, 48, 59, 68, 78, 88, 89, 100, 109]"
agent_a,L50,short,19,14,5,5,0.8403,119,"[10, 19, 28, 29, 39, 41, 50, 59, 60, 61, 63, 72, 84, 93, 94, 103, 104, 113, 114]"
agent_a,L50,short,19,16,3,6,0.8403,119,"[4, 10, 20, 30, 39, 41, 51, 52, 61, 62, 63, 72, 76, 85, 94, 103, 104, 105, 115]"
agent_a,L50,short,19,9,10,9,0.8403,119,"[4, 10, 20, 29, 30, 40, 41, 52, 61, 64, 73, 74, 75, 77, 86, 88, 97, 100, 110]"
agent_a,L50,short,17,6,11,17,0.8547,117,"[11, 19, 20, 21, 22, 23, 26, 36, 46, 48, 58, 62, 72, 82, 91, 101, 110]"
agent_a,L50,short,14,9,5,13,0.8772,114,"[10, 21, 32, 42, 52, 61, 70, 71, 72, 73, 82, 83, 94, 104]"
agent_a,L50,short,19,12,7,8,0.8403,119,"[10, 21, 24, 33, 43, 52, 54, 63, 64, 65, 75, 76, 79, 90, 99, 100, 101, 110, 112]"
agent_a,L50,short,17,13,4,5,0.8547,117,"[4, 10, 20, 30, 33, 42, 51, 53, 62, 73, 82, 91, 92, 101, 102, 111, 112]"
agent_a,L50,short,18,11,7,9,0.8475,118,"[4, 10, 21, 30, 32, 41, 53, 62, 63, 65, 74, 83, 84, 93, 94, 96, 98, 111]"
agent_a,L50,short,13,4,9,20,0.885,113,"[4, 10, 21, 30, 39, 41, 51, 61, 71, 80, 84, 98, 107]"
agent_a,L50,short,18,8,10,13,0.8475,118,"[14, 26, 34, 43, 45, 55, 56, 57, 58, 59, 69, 78, 80, 89, 91, 101, 102, 113]"
agent_a,L50,short,16,10,6,2,0.8621,116,"[4, 11, 20, 29, 30, 40, 50, 60, 70, 81, 90, 91, 93, 102, 111, 112]"
agent_a,L50,short,19,8,11,6,0.8403,119,"[10, 19, 29, 30, 40, 41, 42, 43, 44, 45, 55, 65, 74, 75, 88, 97, 107, 108, 110]"
agent_a,L50,short,18,11,7,4,0.8475,118,"[11, 19, 30, 31, 43, 52, 53, 54, 56, 65, 68, 79, 88, 98, 99, 108, 109, 110]"
agent_a,L50,short,16,13,3,8,0.8621,116,"[5, 12, 22, 32, 41, 51, 61, 71, 80, 81, 91, 100, 101, 102, 110, 112]"
agent_a,L50,short,20,8,12,4,0.8333,120,"[10, 19, 28, 29, 31, 41, 50, 51, 60, 63, 64, 73, 75, 86, 87, 88, 89, 91, 100, 110]"
agent_a,L50,short,16,9,7,9,0.8621,116,"[5, 11, 20, 29, 39, 49, 58, 59, 69, 70, 72, 81, 83, 93, 102, 107]"
agent_a,L50,short,16,6,10,7,0.8621,116,"[10, 20, 29, 30, 40, 41, 45, 54, 56, 59, 68, 77, 87, 97, 106, 107]"
agent_a,L50,short,15,10,5,9,0.8696,115,"[5, 11, 21, 23, 33, 36, 46, 55, 57, 66, 75, 77, 86, 98, 107]"
agent_a,L50,short,17,8,9,8,0.8547,117,"[4, 11, 20, 30, 39, 41, 52, 61, 70, 72, 81, 83, 92, 93, 102, 104, 113]"
agent_a,L50,short,19,9,10,2,0.8403,119,"[10, 19, 20, 30, 31, 41, 51, 61, 62, 63, 72, 73, 84, 93, 94, 103, 105, 114, 115]"
agent_a,L50,short,12,4,8,12,0.8929,112,"[11, 19, 20, 32, 42, 51, 60, 62, 73, 83, 94, 104]"
agent_a,L50,short,17,9,8,10,0.8547,117,"[10, 19, 22, 31, 33, 43, 52, 54, 66, 75, 87, 96, 104, 105, 106, 107, 111]"
agent_a,L50,short,16,12,4,16,0.8621,116,"[4, 10, 21, 30, 34, 45, 54, 63, 73, 82, 83, 84, 93, 94, 103, 105]"
agent_a,L50,short,17,8,9,21,0.8547,117,"[11, 19, 22, 23, 24, 25, 34, 39, 49, 59, 68, 77, 78, 88, 97, 101, 112]"
agent_a,L50,short,18,12,6,9,0.8475,118,"[4, 10, 20, 29, 33, 42, 51, 53, 54, 55, 65, 75, 84, 85, 86, 95, 100, 109]"
agent_a,L50,short,16,4,12,19,0.8621,116,"[5, 11, 20, 29, 31, 42, 52, 54, 55, 64, 65, 69, 79, 89, 98, 109]"
agent_a,L50,short,16,7,9,6,0.8621,116,"[4, 10, 20, 29, 30, 31, 42, 52, 61, 63, 73, 74, 83, 86, 95, 105]"
agent_a,L50,short,12,7,5,18,0.8929,112,"[14, 23, 32, 43, 52, 61, 71, 80, 81, 90, 92, 102]"
agent_a,L50,short,11,7,4,15,0.9009,111,"[10, 22, 32, 42, 52, 62, 70, 74, 85, 94, 103]"
agent_a,L50,short,18,14,4,22,0.8475,118,"[5, 12, 22, 33, 44, 53, 61, 71, 81, 82, 83, 92, 93, 94, 103, 104, 113, 115]"
agent_a,L50,short,17,6,11,6,0.8547,117,"[10, 11, 12, 21, 22, 25, 34, 45, 55, 64, 73, 75, 85, 94, 96, 106, 109]"
agent_a,L50,short,17,2,15,6,0.8547,117,"[11, 19, 20, 32, 42, 51, 60, 68, 70, 80, 88, 89, 90, 100, 109, 110, 111]"
agent_a,L50,short,18,9,9,4,0.8475,118,"[10, 19, 21, 31, 33, 43, 52, 54, 63, 65, 74, 84, 86, 87, 98, 107, 108, 110]"
agent_a,L50,short,15,11,4,7,0.8696,115,"[10, 21, 30, 40, 49, 58, 60, 69, 71, 81, 90, 99, 100, 109, 110]"
agent_a,L50,short,17,3,14,2,0.8547,117,"[10, 19, 20, 30, 40, 51, 52, 54, 63, 72, 74, 84, 86, 95, 96, 106, 107]"
agent_a,L50,short,15,1,14,6,0.8696,115,"[10, 19, 28, 29, 39, 40, 50, 53, 62, 75, 85, 93, 94, 95, 105]"
agent_a,L50,short,15,11,4,11,0.8696,115,"[10, 20, 23, 34, 45, 54, 63, 64, 73, 74, 83, 88, 97, 98, 108]"
agent_a,L50,short,18,11,7,4,0.8475,118,"[4, 11, 20, 29, 30, 40, 50, 60, 71, 81, 82, 91, 92, 102, 110, 111, 113, 115]"
agent_a,L50,short,20,10,10,2,0.8333,120,"[4, 10, 20, 29, 32, 33, 42, 44, 54, 57, 66, 67, 69, 79, 88, 89, 99, 108, 109, 110]"
agent_a,L50,short,13,7,6,19,0.885,113,"[4, 10, 12, 21, 26, 36, 47, 57, 67, 78, 87, 96, 109]"
agent_a,L50,short,18,13,5,1,0.8475,118,"[4, 12, 21, 31, 40, 41, 51, 55, 65, 66, 77, 86, 87, 97, 98, 107, 108, 109]"
agent_a,L50,short,17,4,13,3,0.8547,117,"[10, 12, 20, 21, 22, 32, 33, 44, 53, 55, 64, 74, 77, 87, 96, 98, 108]"
agent_a,L50,short,17,7,10,10,0.8547,117,"[11, 12, 20, 21, 23, 24, 34, 36, 38, 48, 58, 67, 71, 80, 90, 100, 109]"
agent_a,L50,short,20,4,16,4,0.8333,120,"[10, 19, 28, 29, 39, 48, 50, 53, 63, 64, 65, 67, 76, 87, 96, 97, 99, 100, 101, 111]"
agent_a,L50,short,14,6,8,14,0.8772,114,"[12, 19, 28, 29, 39, 48, 51, 60, 69, 78, 79, 81, 90, 104]"
agent_a,L50,short,16,5,11,4,0.8621,116,"[5, 11, 12, 21, 22, 33, 44, 55, 66, 75, 84, 94, 95, 104, 106, 108]"
agent_a,L50,short,13,6,7,25,0.885,113,"[4, 15, 24, 33, 43, 52, 60, 64, 73, 82, 84, 96, 105]"
agent_a,L50,short,18,8,10,6,0.8475,118,"[4, 11, 20, 21, 22, 32, 33, 34, 44, 45, 56, 67, 76, 86, 95, 96, 106, 107]"
agent_a,L50,short,18,11,7,6,0.8475,118,"[4, 12, 21, 22, 23, 24, 35, 45, 56, 65, 74, 83, 84, 93, 94, 104, 113, 115]"
agent_a,L50,short,18,9,9,4,0.8475,118,"[10, 11, 22, 31, 42, 52, 61, 62, 63, 72, 73, 75, 85, 86, 90, 99, 108, 109]"
agent_a,L50,short,16,5,11,4,0.8621,116,"[10, 19, 20, 23, 32, 42, 51, 60, 62, 71, 72, 82, 91, 92, 104, 114]"
agent_a,L50,short,20,10,10,6,0.8333,120,"[10, 21, 31, 41, 50, 51, 52, 61, 62, 71, 72, 82, 84, 93, 102, 103, 104, 105, 106, 116]"
agent_a,L50,short,15,6,9,12,0.8696,115,"[4, 11, 20, 23, 33, 42, 52, 61, 70, 71, 80, 82, 93, 102, 112]"
agent_a,L100,short,13,11,2,41,0.885,113,"[4, 9, 13, 27, 36, 46, 59, 68, 77, 86, 94, 102, 104]"
agent_a,L100,short,20,13,7,5,0.8333,120,"[4, 9, 19, 20, 21, 31, 43, 52, 54, 55, 64, 66, 75, 84, 86, 95, 96, 105, 107, 116]"
agent_a,L100,short,26,22,4,11,0.7937,126,"[10, 13, 21, 32, 41, 50, 51, 60, 61, 62, 63, 64, 65, 74, 75, 76, 77, 78, 79, 80, 82, 93, 102, 104, 107, 118]"
agent_a,L100,short,18,9,9,2,0.8475,118,"[4, 9, 10, 11, 21, 23, 33, 43, 53, 63, 72, 73, 83, 84, 94, 104, 114, 116]"
agent_a,L100,short,20,10,10,2,0.8333,120,"[10, 18, 20, 30, 31, 32, 42, 51, 52, 53, 62, 64, 73, 74, 85, 86, 95, 96, 106, 117]"
agent_a,L100,short,17,8,9,11,0.8547,117,"[4, 9, 11, 21, 23, 34, 43, 52, 61, 62, 64, 73, 74, 83, 84, 97, 106]"
agent_a,L100,short,20,8,12,12,0.8333,120,"[10, 19, 28, 30, 41, 51, 61, 69, 70, 74, 83, 91, 93, 94, 95, 104, 106, 115, 116, 117]"
agent_a,L100,short,13,9,4,21,0.885,113,"[4, 10, 21, 31, 43, 53, 62, 71, 79, 89, 90, 100, 103]"
agent_a,L100,short,22,11,11,6,0.8197,122,"[10, 18, 20, 30, 40, 49, 50, 53, 64, 73, 76, 85, 86, 94, 95, 96, 97, 106, 108, 109, 110, 120]"
agent_a,L100,short,11,5,6,43,0.9009,111,"[6, 12, 25, 35, 46, 56, 66, 76, 84, 97, 105]"
agent_a,L100,short,15,10,5,4,0.8696,115,"[11, 20, 21, 22, 32, 43, 54, 63, 64, 73, 74, 84, 92, 94, 106]"
agent_a,L100,short,16,10,6,9,0.8621,116,"[5, 10, 21, 31, 40, 49, 50, 61, 70, 71, 80, 81, 92, 101, 110, 112]"
agent_a,L100,short,16,3,13,7,0.8621,116,"[10, 19, 21, 32, 42, 51, 60, 68, 69, 71, 80, 90, 99, 100, 108, 110]"
agent_a,L100,short,16,11,5,16,0.8621,116,"[4, 11, 20, 33, 41, 50, 51, 52, 61, 63, 73, 83, 92, 93, 102, 107]"
agent_a,L100,short,15,9,6,9,0.8696,115,"[4, 9, 20, 30, 31, 32, 43, 53, 56, 65, 74, 76, 87, 97, 106]"
agent_a,L100,short,18,8,10,9,0.8475,118,"[6, 12, 22, 31, 40, 50, 60, 69, 71, 80, 81, 82, 83, 92, 94, 103, 112, 113]"
agent_a,L100,short,16,10,6,7,0.8621,116,"[4, 11, 20, 30, 32, 41, 42, 43, 53, 64, 74, 84, 87, 96, 106, 107]"
agent_a,L100,short,19,7,12,3,0.8403,119,"[10, 19, 21, 32, 41, 50, 51, 53, 62, 63, 64, 73, 74, 76, 86, 96, 106, 114, 116]"
agent_a,L100,short,20,12,8,5,0.8333,120,"[10, 18, 22, 31, 32, 43, 52, 61, 64, 73, 74, 84, 86, 94, 95, 96, 105, 107, 116, 117]"
agent_a,L100,short,13,6,7,16,0.885,113,"[10, 18, 21, 32, 41, 43, 53, 63, 71, 75, 86, 95, 106]"
agent_a,L100,short,20,7,13,1,0.8333,120,"[4, 9, 19, 29, 39, 48, 49, 58, 59, 68, 71, 80, 81, 90, 92, 101, 102, 111, 112, 113]"
agent_a,L100,short,15,9,6,9,0.8696,115,"[10, 18, 20, 31, 40, 44, 55, 64, 73, 76, 86, 96, 97, 107, 108]"
agent_a,L100,short,16,7,9,25,0.8621,116,"[4, 9, 10, 20, 22, 32, 42, 46, 55, 57, 60, 71, 83, 96, 105, 114]"
agent_a,L100,short,17,9,8,8,0.8547,117,"[10, 18, 20, 30, 40, 49, 50, 59, 60, 69, 70, 73, 83, 92, 101, 110, 112]"
agent_a,L100,short,17,12,5,8,0.8547,117,"[4, 10, 20, 30, 40, 49, 58, 60, 69, 78, 79, 82, 92, 101, 103, 113, 114]"
agent_a,L100,short,15,4,11,6,0.8696,115,"[11, 19, 20, 22, 32, 43, 53, 62, 64, 73, 76, 85, 94, 95, 107]"
agent_a,L100,short,18,13,5,10,0.8475,118,"[10, 18, 20, 21, 32, 42, 54, 63, 72, 73, 82, 83, 92, 94, 103, 105, 113, 115]"
agent_a,L100,short,17,12,5,10,0.8547,117,"[4, 9, 19, 20, 30, 31, 35, 44, 54, 63, 67, 78, 88, 98, 106, 107, 108]"
agent_a,L100,short,20,13,7,5,0.8333,120,"[4, 9, 10, 12, 22, 32, 42, 43, 53, 63, 64, 74, 84, 85, 86, 95, 97, 106, 108, 118]"
agent_a,L100,short,17,16,1,14,0.8547,117,"[12, 21, 34, 43, 53, 62, 70, 71, 72, 81, 82, 91, 92, 101, 102, 110, 113]"
agent_a,L100,short,18,14,4,9,0.8475,118,"[11, 19, 28, 31, 40, 49, 51, 60, 73, 82, 83, 84, 92, 93, 95, 104, 105, 115]"
agent_a,L100,short,20,11,9,4,0.8333,120,"[11, 19, 20, 21, 22, 32, 42, 43, 44, 53, 55, 64, 73, 74, 84, 94, 95, 105, 107, 116]"
agent_a,L100,short,12,7,5,15,0.8929,112,"[11, 19, 28, 30, 35, 45, 54, 63, 76, 85, 95, 103]"
agent_a,L100,short,21,10,11,5,0.8264,121,"[4, 9, 10, 21, 34, 43, 52, 53, 62, 63, 72, 73, 83, 84, 94, 95, 104, 105, 106, 115, 116]"
agent_a,L100,short,20,14,6,10,0.8333,120,"[11, 19, 20, 21, 31, 41, 50, 51, 52, 61, 63, 74, 85, 94, 103, 104, 105, 106, 107, 108]"
agent_a,L100,short,17,5,12,4,0.8547,117,"[10, 20, 29, 31, 40, 43, 52, 53, 62, 64, 73, 83, 93, 94, 97, 106, 107]"
agent_a,L100,short,17,9,8,2,0.8547,117,"[4, 9, 19, 30, 41, 50, 51, 61, 70, 71, 80, 83, 94, 102, 103, 105, 115]"
agent_a,L100,short,19,9,10,5,0.8403,119,"[10, 18, 21, 31, 32, 34, 44, 53, 54, 57, 67, 77, 86, 87, 96, 98, 100, 110, 111]"
agent_a,L100,short,16,9,7,5,0.8621,116,"[10, 18, 20, 21, 22, 33, 43, 52, 63, 73, 82, 93, 102, 110, 111, 112]"
agent_a,L100,short,19,4,15,3,0.8403,119,"[11, 19, 20, 21, 31, 44, 53, 54, 63, 64, 65, 74, 75, 76, 86, 88, 97, 106, 108]"
agent_a,L100,short,17,9,8,9,0.8547,117,"[10, 18, 22, 31, 40, 49, 58, 60, 69, 78, 80, 89, 90, 100, 108, 109, 110]"
agent_a,L100,short,15,11,4,7,0.8696,115,"[4, 9, 19, 29, 42, 52, 62, 71, 79, 81, 90, 91, 100, 101, 111]"
agent_a,L100,short,15,11,4,5,0.8696,115,"[4, 9, 19, 29, 31, 41, 51, 60, 71, 80, 90, 99, 100, 109, 111]"
agent_a,L100,short,15,10,5,12,0.8696,115,"[10, 18, 20, 30, 40, 49, 50, 51, 60, 64, 74, 84, 93, 95, 107]"
agent_a,L100,short,22,9,13,4,0.8197,122,"[10, 19, 29, 39, 40, 41, 42, 51, 54, 63, 64, 65, 74, 75, 76, 86, 95, 97, 98, 107, 109, 119]"
agent_a,L100,short,16,12,4,7,0.8621,116,"[4, 9, 10, 11, 21, 30, 35, 44, 53, 64, 74, 85, 94, 102, 103, 105]"
agent_a,L100,short,19,12,7,6,0.8403,119,"[10, 18, 20, 31, 40, 49, 50, 59, 61, 70, 72, 73, 74, 85, 96, 105, 113, 114, 115]"
agent_a,L100,short,18,12,6,22,0.8475,118,"[11, 19, 28, 31, 40, 49, 58, 59, 65, 75, 84, 92, 101, 102, 103, 105, 113, 114]"
agent_a,L100,short,19,5,14,9,0.8403,119,"[6, 12, 21, 32, 40, 50, 52, 61, 62, 71, 72, 81, 82, 92, 93, 102, 103, 113, 115]"
agent_a,L100,short,14,6,8,12,0.8772,114,"[12, 20, 29, 39, 48, 49, 60, 62, 71, 73, 82, 86, 95, 104]"
agent_a,L100,short,18,9,9,3,0.8475,118,"[4, 9, 19, 29, 30, 40, 42, 51, 62, 71, 72, 82, 91, 93, 102, 104, 113, 115]"
agent_a,L100,short,14,5,9,7,0.8772,114,"[4, 9, 20, 30, 39, 40, 50, 51, 62, 72, 81, 90, 93, 104]"
agent_a,L100,short,18,12,6,5,0.8475,118,"[10, 19, 20, 30, 40, 49, 50, 59, 60, 62, 63, 72, 73, 82, 84, 93, 105, 114]"
agent_a,L100,short,16,12,4,14,0.8621,116,"[4, 9, 19, 28, 31, 42, 53, 62, 72, 81, 90, 91, 92, 101, 103, 114]"
agent_a,L100,short,24,14,10,4,0.8065,124,"[10, 21, 22, 31, 32, 34, 44, 53, 54, 55, 56, 65, 66, 75, 77, 87, 96, 97, 106, 107, 108, 109, 118, 119]"
agent_a,L100,short,15,8,7,12,0.8696,115,"[4, 9, 10, 12, 22, 33, 42, 51, 54, 64, 73, 84, 86, 95, 108]"
agent_a,L100,short,13,4,9,9,0.885,113,"[11, 19, 20, 30, 40, 49, 52, 62, 71, 81, 90, 102, 111]"
agent_a,L100,short,14,10,4,12,0.8772,114,"[5, 10, 20, 30, 31, 42, 53, 63, 72, 73, 83, 91, 97, 106]"
agent_a,L100,short,13,9,4,33,0.885,113,"[4, 9, 19, 20, 29, 32, 44, 53, 64, 74, 87, 95, 103]"
agent_a,L100,short,15,9,6,12,0.8696,115,"[14, 24, 34, 43, 52, 53, 62, 64, 73, 82, 83, 86, 95, 104, 113]"
agent_a,L100,short,17,6,11,2,0.8547,117,"[10, 19, 29, 40, 49, 58, 59, 68, 69, 79, 88, 89, 98, 99, 100, 109, 110]"
agent_a,L100,short,19,12,7,12,0.8403,119,"[4, 9, 19, 28, 33, 43, 52, 61, 71, 72, 81, 84, 93, 94, 103, 104, 105, 114, 116]"
agent_a,L100,short,18,5,13,6,0.8475,118,"[5, 10, 20, 22, 33, 43, 52, 61, 71, 74, 83, 85, 94, 95, 96, 105, 106, 116]"
agent_a,L100,short,22,19,3,0,0.8197,122,"[4, 9, 19, 20, 30, 40, 53, 63, 64, 65, 74, 75, 76, 85, 86, 95, 96, 97, 106, 107, 116, 117]"
agent_a,L100,short,16,5,11,7,0.8621,116,"[4, 10, 20, 30, 31, 33, 44, 53, 62, 64, 73, 84, 94, 102, 104, 114]"
agent_a,L100,short,21,9,12,2,0.8264,121,"[12, 20, 21, 22, 23, 24, 34, 35, 45, 46, 47, 49, 50, 60, 71, 81, 91, 92, 102, 111, 114]"
agent_a,L100,short,19,6,13,7,0.8403,119,"[10, 12, 20, 21, 24, 34, 44, 53, 54, 55, 56, 65, 67, 76, 86, 89, 92, 102, 111]"
agent_a,L100,short,21,13,8,9,0.8264,121,"[6, 13, 22, 31, 33, 42, 43, 45, 46, 55, 57, 66, 67, 78, 87, 88, 89, 98, 99, 102, 113]"
agent_a,L100,short,16,3,13,11,0.8621,116,"[10, 11, 13, 21, 23, 34, 44, 54, 56, 67, 76, 77, 79, 89, 100, 109]"
agent_a,L100,short,12,5,7,46,0.8929,112,"[8, 15, 24, 34, 47, 55, 63, 69, 78, 89, 99, 107]"
agent_a,L100,short,18,8,10,2,0.8475,118,"[10, 19, 29, 39, 48, 50, 59, 69, 70, 71, 81, 90, 91, 101, 102, 103, 111, 113]"
agent_a,L100,short,16,4,12,12,0.8621,116,"[4, 9, 12, 21, 31, 32, 47, 58, 67, 76, 85, 94, 95, 104, 105, 108]"
agent_a,L100,short,17,10,7,14,0.8547,117,"[10, 11, 13, 22, 35, 45, 54, 64, 74, 83, 91, 92, 101, 102, 103, 111, 113]"
agent_a,L100,short,22,7,15,0,0.8197,122,"[4, 9, 19, 20, 30, 40, 41, 42, 51, 52, 61, 62, 64, 73, 76, 86, 87, 97, 108, 109, 111, 112]"
agent_a,L100,short,17,9,8,4,0.8547,117,"[4, 10, 20, 30, 39, 49, 50, 60, 69, 70, 80, 81, 90, 92, 101, 104, 113]"
agent_a,L100,short,15,4,11,10,0.8696,115,"[11, 20, 30, 40, 49, 51, 60, 61, 70, 71, 72, 82, 91, 92, 106]"
agent_a,L100,short,16,10,6,16,0.8621,116,"[4, 9, 14, 23, 32, 43, 52, 61, 70, 71, 80, 83, 93, 101, 102, 112]"
agent_a,L100,short,17,7,10,1,0.8547,117,"[5, 11, 14, 25, 35, 36, 46, 55, 56, 67, 77, 78, 79, 88, 89, 99, 109]"
agent_a,L100,short,18,10,8,13,0.8475,118,"[10, 12, 20, 21, 35, 45, 54, 63, 71, 73, 74, 83, 85, 93, 95, 104, 106, 116]"
agent_a,L100,short,17,10,7,5,0.8547,117,"[10, 18, 20, 30, 40, 49, 59, 60, 61, 62, 71, 72, 81, 83, 92, 93, 106]"
agent_a,L100,short,14,10,4,13,0.8772,114,"[10, 18, 21, 31, 40, 50, 59, 60, 69, 72, 81, 91, 100, 106]"
agent_a,L100,short,20,12,8,3,0.8333,120,"[10, 19, 20, 21, 22, 23, 34, 35, 46, 58, 67, 68, 77, 80, 90, 91, 100, 101, 111, 112]"
agent_a,L100,short,19,18,1,4,0.8403,119,"[4, 9, 19, 28, 30, 41, 50, 51, 52, 61, 62, 72, 73, 82, 83, 92, 93, 106, 115]"
agent_a,L100,short,15,11,4,9,0.8696,115,"[4, 9, 21, 31, 40, 49, 50, 51, 61, 70, 72, 81, 85, 96, 106]"
agent_a,L100,short,21,16,5,3,0.8264,121,"[4, 9, 19, 20, 29, 32, 42, 51, 53, 62, 63, 72, 73, 75, 84, 85, 95, 97, 107, 116, 117]"
agent_a,L100,short,18,14,4,20,0.8475,118,"[7, 13, 22, 31, 40, 52, 62, 71, 79, 80, 82, 92, 100, 101, 102, 104, 113, 114]"
agent_a,L100,short,20,10,10,5,0.8333,120,"[4, 11, 21, 31, 33, 35, 45, 54, 55, 64, 65, 74, 76, 85, 94, 95, 97, 106, 115, 117]"
agent_a,L100,short,18,13,5,7,0.8475,118,"[10, 18, 21, 31, 40, 50, 59, 60, 69, 71, 72, 73, 84, 93, 103, 104, 113, 114]"
agent_a,L100,short,19,6,13,5,0.8403,119,"[5, 10, 12, 21, 23, 24, 25, 26, 37, 46, 56, 65, 66, 76, 85, 87, 97, 107, 117]"
agent_a,L100,short,19,12,7,2,0.8403,119,"[10, 18, 20, 30, 40, 41, 50, 53, 63, 64, 73, 75, 84, 93, 94, 103, 104, 105, 115]"
agent_a,L100,short,16,7,9,12,0.8621,116,"[10, 20, 29, 32, 41, 43, 55, 64, 74, 83, 91, 92, 101, 104, 113, 114]"
agent_a,L100,short,22,15,7,4,0.8197,122,"[4, 9, 11, 21, 31, 32, 33, 43, 55, 65, 74, 75, 76, 77, 86, 88, 97, 98, 107, 108, 110, 112]"
agent_a,L100,short,20,6,14,4,0.8333,120,"[10, 11, 12, 20, 23, 34, 44, 53, 54, 55, 65, 74, 76, 85, 96, 105, 106, 114, 115, 118]"
agent_a,L100,short,22,9,13,5,0.8197,122,"[4, 9, 20, 30, 31, 41, 51, 61, 62, 63, 64, 73, 75, 84, 86, 87, 88, 89, 100, 109, 110, 114]"
agent_a,L100,short,16,8,8,3,0.8621,116,"[10, 18, 20, 31, 40, 49, 50, 61, 70, 79, 81, 82, 91, 93, 102, 112]"
agent_a,L100,short,17,12,5,6,0.8547,117,"[11, 19, 28, 30, 41, 52, 62, 72, 81, 82, 90, 92, 101, 102, 110, 111, 113]"
agent_a,L100,short,18,6,12,8,0.8475,118,"[10, 11, 20, 22, 32, 42, 51, 52, 61, 63, 72, 82, 91, 92, 101, 102, 105, 115]"
agent_a,L100,short,18,8,10,2,0.8475,118,"[4, 9, 19, 28, 31, 32, 42, 43, 53, 63, 64, 73, 74, 83, 84, 94, 96, 107]"
agent_a,L100,short,16,9,7,7,0.8621,116,"[5, 11, 20, 30, 40, 49, 50, 59, 60, 70, 79, 81, 90, 100, 109, 111]"
agent_a,L100,short,23,15,8,2,0.813,123,"[4, 10, 20, 31, 32, 41, 42, 43, 53, 62, 65, 74, 75, 84, 85, 86, 97, 98, 99, 108, 109, 118, 120]"
agent_a,L0,middle,7,4,3,13,0.9346,107,"[8, 21, 38, 44, 63, 80, 100]"
agent_a,L0,middle,7,5,2,4,0.9346,107,"[20, 37, 41, 59, 77, 80, 99]"
agent_a,L0,middle,9,6,3,9,0.9174,109,"[8, 21, 38, 43, 62, 79, 97, 99, 100]"
agent_a,L0,middle,9,4,5,6,0.9174,109,"[19, 21, 38, 41, 59, 64, 82, 99, 102]"
agent_a,L0,middle,11,7,4,1,0.9009,111,"[19, 37, 38, 39, 57, 60, 61, 64, 83, 102, 103]"
agent_a,L0,middle,12,9,3,4,0.8929,112,"[8, 21, 39, 41, 42, 45, 63, 66, 84, 102, 103, 104]"
agent_a,L0,middle,14,9,5,0,0.8772,114,"[19, 22, 39, 42, 43, 62, 63, 64, 65, 84, 87, 89, 108, 109]"
agent_a,L0,middle,13,8,5,0,0.885,113,"[19, 37, 38, 39, 40, 42, 61, 63, 82, 84, 85, 103, 105]"
agent_a,L0,middle,12,8,4,1,0.8929,112,"[20, 40, 42, 43, 61, 64, 83, 84, 85, 87, 105, 107]"
agent_a,L0,middle,8,6,2,9,0.9259,108,"[9, 21, 38, 42, 61, 78, 81, 99]"
agent_a,L0,middle,8,4,4,3,0.9259,108,"[19, 38, 40, 58, 60, 80, 98, 100]"
agent_a,L0,middle,11,10,1,4,0.9009,111,"[9, 21, 38, 41, 60, 61, 63, 80, 84, 102, 103]"
agent_a,L0,middle,10,7,3,4,0.9091,110,"[8, 21, 38, 41, 61, 78, 81, 99, 101, 103]"
agent_a,L0,middle,9,4,5,3,0.9174,109,"[19, 21, 38, 41, 59, 61, 81, 99, 102]"
agent_a,L0,middle,9,7,2,7,0.9174,109,"[8, 21, 38, 42, 60, 77, 83, 100, 103]"
agent_a,L0,middle,9,7,2,4,0.9174,109,"[19, 37, 38, 39, 56, 61, 80, 83, 101]"
agent_a,L0,middle,9,6,3,1,0.9174,109,"[19, 37, 38, 39, 56, 60, 79, 96, 99]"
agent_a,L0,middle,9,4,5,2,0.9174,109,"[19, 38, 39, 41, 59, 61, 80, 100, 102]"
agent_a,L0,middle,7,4,3,1,0.9346,107,"[19, 38, 39, 57, 60, 79, 99]"
agent_a,L0,middle,11,10,1,8,0.9009,111,"[8, 21, 38, 43, 61, 78, 81, 83, 101, 102, 103]"
agent_a,L0,middle,10,7,3,4,0.9091,110,"[20, 22, 39, 42, 44, 61, 65, 84, 101, 104]"
agent_a,L0,middle,8,5,3,7,0.9259,108,"[8, 21, 40, 58, 61, 78, 81, 99]"
agent_a,L0,middle,7,4,3,6,0.9346,107,"[19, 37, 39, 57, 62, 82, 99]"
agent_a,L0,middle,20,17,3,2,0.8333,120,"[19, 21, 22, 23, 24, 25, 27, 46, 65, 67, 86, 103, 105, 106, 107, 108, 109, 110, 111, 112]"
agent_a,L0,middle,11,5,6,2,0.9009,111,"[19, 21, 39, 41, 42, 60, 62, 81, 85, 102, 105]"
agent_a,L0,middle,10,8,2,4,0.9091,110,"[20, 38, 41, 59, 62, 81, 98, 100, 101, 102]"
agent_a,L0,middle,8,7,1,10,0.9259,108,"[8, 21, 38, 43, 61, 78, 81, 99]"
agent_a,L0,middle,8,6,2,15,0.9259,108,"[12, 25, 42, 60, 77, 83, 101, 104]"
agent_a,L0,middle,9,6,3,1,0.9174,109,"[19, 38, 39, 41, 59, 61, 82, 100, 105]"
agent_a,L0,middle,12,4,8,6,0.8929,112,"[22, 40, 42, 61, 63, 81, 84, 85, 86, 104, 106, 108]"
agent_a,L0,middle,14,10,4,1,0.8772,114,"[8, 21, 23, 24, 43, 44, 63, 65, 84, 85, 86, 104, 105, 107]"
agent_a,L0,middle,9,7,2,3,0.9174,109,"[9, 21, 38, 42, 60, 77, 80, 99, 100]"
agent_a,L0,middle,9,6,3,6,0.9174,109,"[19, 21, 38, 41, 43, 65, 83, 100, 104]"
agent_a,L0,middle,8,6,2,6,0.9259,108,"[9, 21, 39, 57, 60, 77, 81, 100]"
agent_a,L0,middle,9,6,3,7,0.9174,109,"[20, 26, 43, 60, 63, 81, 83, 101, 103]"
agent_a,L0,middle,9,7,2,4,0.9174,109,"[8, 21, 39, 41, 61, 78, 81, 99, 100]"
agent_a,L0,middle,9,7,2,3,0.9174,109,"[8, 21, 39, 59, 60, 77, 80, 99, 102]"
agent_a,L0,middle,7,5,2,5,0.9346,107,"[20, 38, 42, 62, 80, 97, 101]"
agent_a,L0,middle,6,4,2,26,0.9434,106,"[15, 29, 46, 64, 82, 101]"
agent_a,L0,middle,12,7,5,3,0.8929,112,"[20, 37, 40, 43, 46, 65, 66, 67, 68, 87, 89, 110]"
agent_a,L0,middle,10,5,5,1,0.9091,110,"[19, 38, 39, 41, 59, 61, 80, 82, 100, 101]"
agent_a,L0,middle,8,5,3,8,0.9259,108,"[8, 22, 40, 59, 62, 79, 82, 100]"
agent_a,L0,middle,10,8,2,5,0.9091,110,"[9, 22, 40, 43, 61, 64, 82, 99, 101, 102]"
agent_a,L0,middle,11,8,3,3,0.9009,111,"[21, 38, 41, 59, 61, 80, 82, 83, 100, 102, 104]"
agent_a,L0,middle,10,5,5,1,0.9091,110,"[19, 38, 39, 56, 59, 60, 79, 81, 99, 101]"
agent_a,L0,middle,11,7,4,1,0.9009,111,"[20, 38, 40, 42, 60, 62, 63, 82, 84, 101, 104]"
agent_a,L0,middle,12,4,8,1,0.8929,112,"[8, 21, 38, 41, 42, 43, 63, 81, 83, 103, 104, 105]"
agent_a,L0,middle,8,5,3,3,0.9259,108,"[19, 37, 38, 39, 57, 60, 81, 99]"
agent_a,L0,middle,9,8,1,6,0.9174,109,"[8, 21, 38, 42, 60, 78, 82, 99, 101]"
agent_a,L0,middle,9,4,5,8,0.9174,109,"[19, 37, 38, 41, 59, 78, 80, 98, 104]"
agent_a,L0,middle,10,5,5,0,0.9091,110,"[20, 39, 40, 58, 60, 79, 81, 99, 100, 101]"
agent_a,L0,middle,7,4,3,1,0.9346,107,"[19, 37, 39, 56, 59, 80, 99]"
agent_a,L0,middle,9,6,3,6,0.9174,109,"[8, 21, 38, 41, 60, 64, 83, 100, 103]"
agent_a,L0,middle,9,5,4,6,0.9174,109,"[20, 21, 38, 41, 45, 62, 84, 101, 103]"
agent_a,L0,middle,7,2,5,2,0.9346,107,"[19, 38, 41, 59, 78, 80, 100]"
agent_a,L0,middle,13,7,6,1,0.885,113,"[19, 22, 40, 42, 60, 62, 81, 83, 85, 86, 104, 106, 108]"
agent_a,L0,middle,9,5,4,4,0.9174,109,"[9, 21, 38, 42, 60, 77, 80, 81, 102]"
agent_a,L0,middle,8,6,2,13,0.9259,108,"[12, 25, 42, 60, 77, 80, 98, 101]"
agent_a,L0,middle,8,6,2,7,0.9259,108,"[19, 22, 39, 43, 61, 81, 98, 101]"
agent_a,L0,middle,9,6,3,5,0.9174,109,"[20, 38, 40, 59, 61, 80, 83, 100, 102]"
agent_a,L0,middle,9,5,4,5,0.9174,109,"[8, 22, 40, 58, 60, 77, 80, 99, 103]"
agent_a,L0,middle,11,9,2,4,0.9009,111,"[8, 21, 38, 42, 60, 77, 81, 99, 100, 101, 102]"
agent_a,L0,middle,14,6,8,3,0.8772,114,"[19, 37, 38, 41, 42, 43, 44, 62, 66, 85, 102, 104, 105, 107]"
agent_a,L0,middle,9,6,3,4,0.9174,109,"[9, 21, 38, 41, 60, 77, 81, 99, 103]"
agent_a,L0,middle,9,4,5,6,0.9174,109,"[19, 21, 39, 41, 42, 60, 64, 83, 105]"
agent_a,L0,middle,10,5,5,1,0.9091,110,"[19, 38, 39, 56, 59, 60, 61, 82, 100, 101]"
agent_a,L0,middle,9,5,4,1,0.9174,109,"[19, 37, 39, 56, 59, 62, 81, 100, 102]"
agent_a,L0,middle,15,13,2,5,0.8696,115,"[19, 21, 38, 43, 60, 63, 82, 99, 101, 102, 103, 104, 105, 106, 107]"
agent_a,L0,middle,11,7,4,4,0.9009,111,"[9, 22, 39, 42, 43, 61, 63, 80, 83, 102, 104]"
agent_a,L0,middle,9,6,3,2,0.9174,109,"[19, 37, 38, 40, 57, 61, 80, 98, 100]"
agent_a,L0,middle,13,4,9,0,0.885,113,"[19, 39, 57, 59, 60, 63, 83, 100, 102, 103, 105, 106, 107]"
agent_a,L0,middle,7,5,2,15,0.9346,107,"[8, 24, 42, 60, 65, 82, 105]"
agent_a,L0,middle,6,4,2,11,0.9434,106,"[12, 26, 45, 63, 84, 103]"
agent_a,L0,middle,11,9,2,4,0.9009,111,"[8, 21, 38, 43, 62, 79, 82, 99, 101, 102, 103]"
agent_a,L0,middle,8,6,2,1,0.9259,108,"[19, 37, 38, 39, 61, 80, 98, 100]"
agent_a,L0,middle,8,5,3,5,0.9259,108,"[19, 37, 40, 58, 61, 81, 98, 100]"
agent_a,L0,middle,13,4,9,0,0.885,113,"[22, 23, 41, 43, 60, 63, 83, 100, 102, 103, 104, 105, 106]"
agent_a,L0,middle,10,7,3,2,0.9091,110,"[19, 22, 39, 42, 60, 63, 82, 99, 101, 102]"
agent_a,L0,middle,11,7,4,4,0.9009,111,"[19, 22, 39, 42, 60, 62, 81, 83, 101, 102, 105]"
agent_a,L0,middle,10,8,2,4,0.9091,110,"[8, 22, 39, 42, 60, 62, 79, 82, 100, 101]"
agent_a,L0,middle,9,6,3,7,0.9174,109,"[8, 22, 41, 59, 63, 80, 83, 100, 104]"
agent_a,L0,middle,9,3,6,7,0.9174,109,"[19, 21, 38, 41, 59, 61, 81, 85, 103]"
agent_a,L0,middle,8,4,4,1,0.9259,108,"[8, 21, 38, 42, 63, 83, 101, 103]"
agent_a,L0,middle,12,9,3,3,0.8929,112,"[8, 21, 38, 41, 60, 61, 63, 81, 83, 85, 103, 104]"
agent_a,L0,middle,10,6,4,1,0.9091,110,"[20, 21, 38, 41, 59, 61, 62, 63, 83, 104]"
agent_a,L0,middle,7,4,3,14,0.9346,107,"[9, 25, 43, 62, 79, 98, 100]"
agent_a,L0,middle,12,8,4,1,0.8929,112,"[19, 37, 38, 39, 40, 41, 60, 63, 82, 84, 102, 104]"
agent_a,L0,middle,11,6,5,3,0.9009,111,"[19, 37, 38, 39, 42, 60, 62, 63, 82, 85, 105]"
agent_a,L0,middle,9,3,6,4,0.9174,109,"[20, 38, 40, 58, 60, 79, 84, 101, 103]"
agent_a,L0,middle,9,6,3,8,0.9174,109,"[8, 22, 39, 42, 61, 79, 81, 100, 104]"
agent_a,L0,middle,11,9,2,1,0.9009,111,"[19, 37, 38, 40, 57, 61, 62, 63, 84, 101, 105]"
agent_a,L0,middle,11,9,2,3,0.9009,111,"[19, 37, 38, 39, 41, 58, 62, 81, 84, 101, 103]"
agent_a,L0,middle,10,7,3,1,0.9091,110,"[20, 38, 41, 60, 61, 81, 98, 100, 102, 104]"
agent_a,L0,middle,9,8,1,12,0.9174,109,"[9, 21, 38, 43, 61, 68, 86, 103, 105]"
agent_a,L0,middle,10,7,3,3,0.9091,110,"[20, 37, 40, 42, 60, 63, 82, 84, 101, 106]"
agent_a,L0,middle,15,12,3,5,0.8696,115,"[8, 21, 22, 23, 27, 44, 47, 66, 84, 86, 87, 88, 89, 90, 110]"
agent_a,L0,middle,6,1,5,9,0.9434,106,"[23, 43, 61, 81, 97, 100]"
agent_a,L0,middle,10,6,4,1,0.9091,110,"[19, 38, 40, 59, 60, 79, 81, 99, 100, 101]"
agent_a,L0,middle,9,6,3,10,0.9174,109,"[9, 21, 38, 41, 61, 78, 81, 99, 103]"
agent_a,L0,middle,10,6,4,5,0.9091,110,"[19, 23, 41, 60, 61, 62, 81, 83, 100, 102]"
agent_a,L50,middle,9,6,3,6,0.9174,109,"[20, 38, 40, 58, 60, 62, 83, 100, 102]"
agent_a,L50,middle,8,4,4,6,0.9259,108,"[8, 19, 38, 39, 58, 61, 81, 101]"
agent_a,L50,middle,7,2,5,11,0.9346,107,"[19, 36, 39, 58, 64, 84, 101]"
agent_a,L50,middle,8,5,3,6,0.9259,108,"[8, 20, 38, 40, 62, 80, 98, 99]"
agent_a,L50,middle,10,4,6,6,0.9091,110,"[10, 20, 25, 43, 61, 78, 81, 99, 103, 104]"
agent_a,L50,middle,10,5,5,7,0.9091,110,"[19, 20, 23, 41, 43, 61, 65, 83, 100, 102]"
agent_a,L50,middle,8,4,4,6,0.9259,108,"[19, 20, 38, 41, 60, 78, 83, 102]"
agent_a,L50,middle,10,7,3,5,0.9091,110,"[8, 21, 41, 59, 76, 80, 81, 99, 100, 102]"
agent_a,L50,middle,11,7,4,4,0.9009,111,"[8, 20, 38, 40, 59, 62, 80, 82, 100, 101, 103]"
agent_a,L50,middle,10,4,6,0,0.9091,110,"[8, 20, 42, 60, 62, 63, 64, 82, 84, 104]"
agent_a,L50,middle,9,6,3,6,0.9174,109,"[8, 21, 39, 43, 61, 80, 81, 99, 103]"
agent_a,L50,middle,7,7,0,16,0.9346,107,"[8, 21, 38, 44, 65, 82, 99]"
agent_a,L50,middle,10,3,7,5,0.9091,110,"[8, 19, 20, 22, 40, 44, 64, 82, 100, 103]"
agent_a,L50,middle,8,8,0,12,0.9259,108,"[8, 21, 38, 44, 64, 81, 98, 100]"
agent_a,L50,middle,8,5,3,6,0.9259,108,"[21, 42, 61, 79, 81, 98, 100, 101]"
agent_a,L50,middle,8,6,2,5,0.9259,108,"[19, 21, 43, 62, 64, 86, 102, 104]"
agent_a,L50,middle,10,4,6,3,0.9091,110,"[8, 20, 38, 40, 59, 63, 81, 100, 102, 103]"
agent_a,L50,middle,8,4,4,4,0.9259,108,"[20, 21, 40, 41, 62, 81, 84, 103]"
agent_a,L50,middle,10,6,4,0,0.9091,110,"[19, 20, 37, 41, 60, 62, 82, 99, 101, 102]"
agent_a,L50,middle,9,4,5,3,0.9174,109,"[19, 36, 40, 58, 60, 78, 81, 99, 100]"
agent_a,L50,middle,9,6,3,17,0.9174,109,"[11, 24, 43, 63, 80, 97, 98, 99, 103]"
agent_a,L50,middle,10,7,3,3,0.9091,110,"[8, 19, 38, 41, 60, 61, 79, 82, 100, 101]"
agent_a,L50,middle,8,2,6,8,0.9259,108,"[19, 20, 38, 40, 59, 64, 84, 101]"
agent_a,L50,middle,11,7,4,1,0.9009,111,"[8, 19, 40, 59, 76, 79, 81, 100, 101, 102, 103]"
agent_a,L50,middle,9,4,5,3,0.9174,109,"[19, 36, 39, 58, 59, 77, 79, 82, 101]"
agent_a,L50,middle,8,4,4,4,0.9259,108,"[22, 40, 59, 80, 81, 98, 101, 102]"
agent_a,L50,middle,14,10,4,2,0.8772,114,"[9, 20, 38, 40, 41, 43, 63, 64, 65, 83, 86, 104, 105, 107]"
agent_a,L50,middle,7,3,4,2,0.9346,107,"[19, 36, 40, 59, 77, 80, 99]"
agent_a,L50,middle,9,6,3,6,0.9174,109,"[9, 19, 37, 41, 61, 78, 82, 99, 101]"
agent_a,L50,middle,8,3,5,3,0.9259,108,"[8, 19, 37, 39, 59, 77, 80, 101]"
agent_a,L50,middle,10,6,4,3,0.9091,110,"[19, 20, 22, 40, 42, 62, 82, 99, 101, 103]"
agent_a,L50,middle,8,2,6,3,0.9259,108,"[19, 20, 37, 41, 60, 78, 81, 101]"
agent_a,L50,middle,9,4,5,11,0.9174,109,"[23, 42, 59, 62, 82, 98, 101, 102, 105]"
agent_a,L50,middle,12,7,5,2,0.8929,112,"[8, 19, 20, 21, 40, 41, 43, 62, 80, 83, 102, 103]"
agent_a,L50,middle,9,6,3,4,0.9174,109,"[8, 20, 38, 42, 61, 78, 81, 99, 101]"
agent_a,L50,middle,6,3,3,13,0.9434,106,"[12, 23, 42, 62, 81, 100]"
agent_a,L50,middle,8,5,3,1,0.9259,108,"[19, 36, 39, 59, 61, 82, 99, 101]"
agent_a,L50,middle,11,8,3,1,0.9009,111,"[8, 19, 38, 39, 57, 60, 78, 80, 81, 83, 103]"
agent_a,L50,middle,10,5,5,3,0.9091,110,"[19, 36, 39, 41, 60, 61, 79, 82, 100, 103]"
agent_a,L50,middle,10,5,5,1,0.9091,110,"[20, 40, 58, 61, 81, 82, 99, 101, 102, 104]"
agent_a,L50,middle,10,4,6,8,0.9091,110,"[8, 19, 37, 39, 58, 60, 62, 81, 86, 106]"
agent_a,L50,middle,9,6,3,1,0.9174,109,"[19, 21, 39, 41, 60, 62, 63, 83, 103]"
agent_a,L50,middle,8,4,4,3,0.9259,108,"[19, 36, 39, 58, 59, 77, 82, 99]"
agent_a,L50,middle,9,6,3,7,0.9174,109,"[8, 21, 38, 45, 64, 65, 84, 85, 105]"
agent_a,L50,middle,10,5,5,1,0.9091,110,"[8, 19, 37, 40, 59, 77, 79, 81, 82, 102]"
agent_a,L50,middle,9,7,2,10,0.9174,109,"[11, 25, 42, 60, 64, 81, 99, 100, 103]"
agent_a,L50,middle,9,7,2,6,0.9174,109,"[8, 21, 39, 42, 61, 78, 81, 99, 100]"
agent_a,L50,middle,7,4,3,4,0.9346,107,"[19, 36, 39, 60, 81, 98, 100]"
agent_a,L50,middle,8,5,3,5,0.9259,108,"[20, 38, 41, 59, 61, 83, 99, 102]"
agent_a,L50,middle,12,7,5,3,0.8929,112,"[20, 38, 40, 58, 60, 80, 81, 82, 100, 101, 103, 107]"
agent_a,L50,middle,9,3,6,2,0.9174,109,"[8, 19, 21, 39, 42, 62, 81, 101, 102]"
agent_a,L50,middle,8,5,3,2,0.9259,108,"[8, 19, 38, 40, 59, 62, 80, 100]"
agent_a,L50,middle,12,5,7,1,0.8929,112,"[10, 20, 38, 40, 59, 62, 80, 82, 83, 102, 103, 105]"
agent_a,L50,middle,8,3,5,2,0.9259,108,"[19, 36, 39, 58, 59, 77, 81, 99]"
agent_a,L50,middle,10,5,5,3,0.9091,110,"[9, 20, 38, 40, 59, 79, 80, 99, 101, 103]"
agent_a,L50,middle,12,5,7,3,0.8929,112,"[19, 20, 37, 41, 61, 81, 82, 83, 100, 103, 104, 106]"
agent_a,L50,middle,9,7,2,5,0.9174,109,"[8, 21, 38, 42, 60, 78, 81, 99, 100]"
agent_a,L50,middle,9,3,6,2,0.9174,109,"[19, 36, 39, 58, 59, 77, 80, 99, 102]"
agent_a,L50,middle,11,6,5,3,0.9009,111,"[9, 19, 20, 42, 60, 62, 80, 82, 101, 102, 103]"
agent_a,L50,middle,10,6,4,2,0.9091,110,"[9, 19, 38, 39, 57, 60, 78, 80, 99, 100]"
agent_a,L50,middle,11,6,5,7,0.9009,111,"[8, 19, 21, 24, 43, 45, 63, 66, 84, 88, 106]"
agent_a,L50,middle,10,8,2,2,0.9091,110,"[19, 20, 38, 40, 41, 61, 63, 83, 100, 102]"
agent_a,L50,middle,10,6,4,1,0.9091,110,"[19, 36, 40, 59, 60, 78, 81, 99, 101, 102]"
agent_a,L50,middle,9,8,1,9,0.9174,109,"[10, 22, 39, 43, 61, 78, 82, 99, 101]"
agent_a,L50,middle,10,6,4,7,0.9091,110,"[9, 19, 24, 42, 45, 65, 83, 86, 104, 106]"
agent_a,L50,middle,12,9,3,1,0.8929,112,"[21, 39, 42, 43, 61, 63, 64, 83, 84, 101, 103, 104]"
agent_a,L50,middle,8,4,4,0,0.9259,108,"[19, 36, 41, 59, 61, 81, 98, 101]"
agent_a,L50,middle,8,3,5,7,0.9259,108,"[19, 36, 40, 58, 60, 78, 82, 101]"
agent_a,L50,middle,14,7,7,4,0.8772,114,"[8, 19, 37, 39, 42, 43, 45, 63, 66, 84, 102, 103, 104, 106]"
agent_a,L50,middle,10,7,3,4,0.9091,110,"[8, 19, 20, 39, 40, 58, 62, 80, 83, 101]"
agent_a,L50,middle,10,6,4,6,0.9091,110,"[9, 19, 23, 40, 59, 62, 80, 99, 101, 103]"
agent_a,L50,middle,9,5,4,4,0.9174,109,"[8, 19, 37, 40, 60, 77, 80, 99, 103]"
agent_a,L50,middle,6,3,3,17,0.9434,106,"[10, 23, 43, 63, 82, 101]"
agent_a,L50,middle,9,3,6,5,0.9174,109,"[19, 20, 21, 38, 42, 62, 82, 99, 103]"
agent_a,L50,middle,9,8,1,3,0.9174,109,"[19, 37, 39, 40, 60, 78, 82, 99, 101]"
agent_a,L50,middle,12,11,1,0,0.8929,112,"[9, 19, 38, 39, 41, 62, 63, 64, 84, 101, 103, 104]"
agent_a,L50,middle,9,8,1,6,0.9174,109,"[8, 21, 39, 43, 62, 81, 98, 100, 101]"
agent_a,L50,middle,10,6,4,3,0.9091,110,"[19, 20, 37, 40, 60, 63, 82, 99, 101, 102]"
agent_a,L50,middle,9,3,6,9,0.9174,109,"[19, 20, 21, 22, 40, 43, 66, 86, 104]"
agent_a,L50,middle,10,7,3,2,0.9091,110,"[9, 20, 38, 40, 43, 61, 79, 81, 100, 101]"
agent_a,L50,middle,9,5,4,4,0.9174,109,"[19, 36, 39, 40, 59, 62, 82, 99, 102]"
agent_a,L50,middle,11,7,4,1,0.9009,111,"[19, 36, 39, 41, 60, 61, 79, 82, 100, 101, 102]"
agent_a,L50,middle,11,4,7,5,0.9009,111,"[22, 40, 42, 60, 62, 63, 64, 65, 84, 87, 107]"
agent_a,L50,middle,9,4,5,7,0.9174,109,"[10, 20, 38, 40, 59, 61, 79, 82, 102]"
agent_a,L50,middle,10,3,7,1,0.9091,110,"[19, 36, 39, 41, 43, 63, 82, 83, 102, 103]"
agent_a,L50,middle,10,4,6,1,0.9091,110,"[10, 20, 39, 58, 60, 61, 79, 81, 102, 103]"
agent_a,L50,middle,9,7,2,1,0.9174,109,"[9, 19, 38, 39, 57, 60, 78, 80, 101]"
agent_a,L50,middle,10,6,4,4,0.9091,110,"[21, 39, 41, 59, 61, 81, 98, 101, 102, 105]"
agent_a,L50,middle,7,3,4,8,0.9346,107,"[19, 36, 40, 59, 63, 85, 102]"
agent_a,L50,middle,11,6,5,7,0.9009,111,"[9, 19, 24, 42, 60, 62, 80, 83, 100, 102, 104]"
agent_a,L50,middle,7,5,2,3,0.9346,107,"[19, 36, 39, 59, 77, 82, 99]"
agent_a,L50,middle,9,4,5,1,0.9174,109,"[20, 39, 40, 41, 61, 81, 99, 101, 102]"
agent_a,L50,middle,8,5,3,8,0.9259,108,"[22, 42, 61, 80, 96, 98, 99, 102]"
agent_a,L50,middle,8,3,5,5,0.9259,108,"[10, 22, 40, 59, 79, 98, 100, 102]"
agent_a,L50,middle,9,4,5,10,0.9174,109,"[19, 23, 41, 46, 64, 82, 99, 101, 105]"
agent_a,L50,middle,9,6,3,7,0.9174,109,"[10, 20, 39, 43, 63, 81, 98, 100, 101]"
agent_a,L50,middle,12,4,8,2,0.8929,112,"[8, 19, 20, 21, 22, 41, 44, 64, 83, 102, 105, 106]"
agent_a,L50,middle,10,7,3,3,0.9091,110,"[8, 19, 37, 40, 60, 77, 80, 99, 100, 101]"
agent_a,L50,middle,9,3,6,2,0.9174,109,"[19, 39, 40, 41, 42, 61, 62, 85, 105]"
agent_a,L50,middle,9,4,5,5,0.9174,109,"[8, 19, 37, 42, 62, 80, 98, 99, 100]"
agent_a,L100,middle,11,7,4,2,0.9009,111,"[19, 21, 39, 41, 61, 62, 81, 83, 84, 101, 105]"
agent_a,L100,middle,11,7,4,1,0.9009,111,"[8, 20, 38, 40, 42, 61, 62, 80, 83, 102, 104]"
agent_a,L100,middle,11,9,2,1,0.9009,111,"[8, 21, 39, 40, 60, 78, 80, 98, 100, 101, 102]"
agent_a,L100,middle,10,6,4,3,0.9091,110,"[19, 21, 39, 41, 60, 62, 81, 83, 100, 103]"
agent_a,L100,middle,10,7,3,2,0.9091,110,"[20, 38, 42, 60, 79, 80, 81, 99, 100, 101]"
agent_a,L100,middle,12,7,5,2,0.8929,112,"[8, 20, 39, 40, 41, 60, 61, 79, 81, 100, 101, 103]"
agent_a,L100,middle,9,4,5,4,0.9174,109,"[9, 19, 21, 41, 60, 63, 81, 100, 101]"
agent_a,L100,middle,9,6,3,1,0.9174,109,"[21, 38, 41, 59, 61, 63, 82, 100, 102]"
agent_a,L100,middle,12,6,6,3,0.8929,112,"[19, 21, 40, 42, 60, 62, 64, 65, 69, 88, 106, 108]"
agent_a,L100,middle,9,5,4,7,0.9174,109,"[19, 21, 39, 42, 60, 63, 82, 99, 102]"
agent_a,L100,middle,13,5,8,1,0.885,113,"[19, 37, 40, 41, 42, 43, 62, 64, 85, 102, 105, 106, 107]"
agent_a,L100,middle,8,4,4,6,0.9259,108,"[21, 38, 41, 59, 61, 83, 100, 102]"
agent_a,L100,middle,8,6,2,1,0.9259,108,"[19, 38, 39, 40, 60, 78, 81, 100]"
agent_a,L100,middle,10,6,4,5,0.9091,110,"[8, 19, 21, 39, 41, 42, 64, 83, 101, 103]"
agent_a,L100,middle,10,7,3,1,0.9091,110,"[8, 19, 39, 41, 60, 62, 80, 83, 101, 102]"
agent_a,L100,middle,10,5,5,5,0.9091,110,"[19, 21, 39, 41, 60, 63, 82, 86, 103, 105]"
agent_a,L100,middle,10,5,5,0,0.9091,110,"[8, 20, 40, 42, 60, 62, 80, 82, 100, 102]"
agent_a,L100,middle,12,8,4,1,0.8929,112,"[20, 38, 41, 42, 43, 62, 63, 82, 84, 101, 103, 104]"
agent_a,L100,middle,10,5,5,8,0.9091,110,"[8, 19, 20, 24, 43, 62, 80, 82, 100, 102]"
agent_a,L100,middle,13,10,3,1,0.885,113,"[19, 37, 39, 59, 60, 61, 80, 83, 84, 85, 87, 104, 106]"
agent_a,L100,middle,13,8,5,2,0.885,113,"[19, 22, 23, 25, 44, 46, 64, 66, 84, 86, 88, 107, 109]"
agent_a,L100,middle,9,6,3,4,0.9174,109,"[19, 37, 39, 41, 61, 81, 98, 99, 102]"
agent_a,L100,middle,10,8,2,3,0.9091,110,"[20, 38, 41, 59, 61, 62, 82, 83, 100, 103]"
agent_a,L100,middle,12,8,4,2,0.8929,112,"[19, 21, 39, 41, 62, 81, 98, 99, 100, 101, 102, 105]"
agent_a,L100,middle,9,5,4,4,0.9174,109,"[21, 38, 41, 60, 79, 80, 99, 100, 102]"
agent_a,L100,middle,8,5,3,2,0.9259,108,"[20, 37, 40, 59, 77, 79, 97, 99]"
agent_a,L100,middle,11,7,4,1,0.9009,111,"[19, 36, 41, 60, 61, 62, 81, 83, 100, 102, 103]"
agent_a,L100,middle,10,6,4,0,0.9091,110,"[8, 19, 40, 41, 60, 61, 81, 100, 101, 102]"
agent_a,L100,middle,10,6,4,4,0.9091,110,"[19, 36, 39, 40, 59, 60, 63, 83, 100, 106]"
agent_a,L100,middle,11,7,4,5,0.9009,111,"[8, 20, 21, 39, 40, 44, 62, 80, 82, 101, 102]"
agent_a,L100,middle,11,8,3,1,0.9009,111,"[8, 20, 38, 39, 57, 59, 60, 79, 80, 101, 102]"
agent_a,L100,middle,9,4,5,2,0.9174,109,"[9, 20, 21, 41, 61, 80, 82, 99, 102]"
agent_a,L100,middle,8,7,1,3,0.9259,108,"[20, 38, 40, 59, 77, 81, 99, 100]"
agent_a,L100,middle,11,7,4,0,0.9009,111,"[8, 19, 38, 39, 40, 58, 60, 61, 79, 81, 102]"
agent_a,L100,middle,12,7,5,5,0.8929,112,"[8, 20, 38, 39, 40, 41, 42, 61, 63, 82, 100, 105]"
agent_a,L100,middle,12,8,4,1,0.8929,112,"[8, 20, 22, 39, 41, 60, 61, 79, 81, 82, 101, 103]"
agent_a,L100,middle,9,5,4,4,0.9174,109,"[9, 19, 41, 59, 62, 80, 82, 99, 101]"
agent_a,L100,middle,10,7,3,2,0.9091,110,"[8, 19, 38, 39, 57, 60, 78, 82, 100, 102]"
agent_a,L100,middle,10,3,7,5,0.9091,110,"[23, 27, 45, 47, 65, 67, 69, 87, 90, 108]"
agent_a,L100,middle,9,5,4,3,0.9174,109,"[10, 20, 38, 40, 59, 77, 79, 97, 100]"
agent_a,L100,middle,11,6,5,2,0.9009,111,"[19, 37, 41, 59, 77, 79, 98, 99, 100, 103, 104]"
agent_a,L100,middle,13,5,8,0,0.885,113,"[9, 19, 38, 39, 57, 59, 77, 79, 98, 99, 100, 101, 102]"
agent_a,L100,middle,8,5,3,4,0.9259,108,"[23, 41, 44, 64, 84, 101, 103, 105]"
agent_a,L100,middle,10,7,3,2,0.9091,110,"[9, 21, 40, 58, 60, 61, 79, 81, 100, 101]"
agent_a,L100,middle,10,7,3,1,0.9091,110,"[8, 19, 20, 40, 60, 61, 79, 82, 100, 102]"
agent_a,L100,middle,6,2,4,14,0.9434,106,"[8, 19, 44, 62, 81, 103]"
agent_a,L100,middle,10,2,8,1,0.9091,110,"[19, 36, 40, 58, 60, 79, 80, 81, 99, 101]"
agent_a,L100,middle,11,4,7,9,0.9009,111,"[8, 19, 21, 23, 42, 43, 45, 63, 68, 87, 105]"
agent_a,L100,middle,10,6,4,1,0.9091,110,"[8, 19, 38, 39, 57, 60, 81, 82, 100, 102]"
agent_a,L100,middle,9,1,8,1,0.9174,109,"[19, 36, 39, 58, 59, 60, 61, 82, 102]"
agent_a,L100,middle,11,7,4,1,0.9009,111,"[9, 20, 38, 39, 40, 41, 61, 81, 82, 101, 102]"
agent_a,L100,middle,10,5,5,7,0.9091,110,"[19, 36, 39, 41, 60, 61, 65, 83, 87, 106]"
agent_a,L100,middle,10,6,4,2,0.9091,110,"[8, 19, 38, 40, 59, 61, 79, 81, 99, 101]"
agent_a,L100,middle,15,12,3,4,0.8696,115,"[21, 38, 41, 59, 61, 80, 81, 99, 100, 101, 102, 103, 104, 105, 107]"
agent_a,L100,middle,9,6,3,6,0.9174,109,"[10, 22, 39, 42, 60, 78, 81, 99, 100]"
agent_a,L100,middle,9,6,3,2,0.9174,109,"[20, 37, 40, 58, 61, 80, 98, 99, 100]"
agent_a,L100,middle,8,4,4,6,0.9259,108,"[20, 37, 42, 60, 79, 80, 84, 101]"
agent_a,L100,middle,9,3,6,5,0.9174,109,"[19, 22, 40, 58, 60, 61, 80, 82, 103]"
agent_a,L100,middle,8,2,6,2,0.9259,108,"[19, 39, 57, 59, 77, 79, 97, 102]"
agent_a,L100,middle,12,6,6,0,0.8929,112,"[19, 36, 39, 40, 41, 61, 79, 81, 82, 102, 104, 105]"
agent_a,L100,middle,7,3,4,6,0.9346,107,"[8, 19, 39, 57, 60, 83, 101]"
agent_a,L100,middle,11,7,4,6,0.9009,111,"[20, 37, 40, 41, 61, 62, 66, 84, 102, 104, 106]"
agent_a,L100,middle,15,7,8,4,0.8696,115,"[19, 36, 39, 40, 59, 60, 61, 63, 82, 86, 88, 107, 108, 109, 113]"
agent_a,L100,middle,13,8,5,3,0.885,113,"[8, 19, 39, 41, 60, 61, 63, 81, 85, 86, 105, 106, 108]"
agent_a,L100,middle,11,6,5,3,0.9009,111,"[19, 21, 22, 40, 43, 61, 63, 82, 85, 103, 104]"
agent_a,L100,middle,11,7,4,5,0.9009,111,"[8, 20, 38, 39, 41, 60, 62, 80, 82, 100, 102]"
agent_a,L100,middle,12,7,5,1,0.8929,112,"[8, 19, 38, 39, 40, 41, 59, 62, 81, 84, 104, 105]"
agent_a,L100,middle,13,9,4,7,0.885,113,"[19, 21, 39, 43, 61, 63, 64, 68, 88, 105, 107, 108, 110]"
agent_a,L100,middle,11,6,5,1,0.9009,111,"[8, 19, 38, 39, 57, 59, 60, 79, 81, 99, 101]"
agent_a,L100,middle,10,6,4,7,0.9091,110,"[23, 41, 59, 61, 80, 97, 99, 100, 103, 104]"
agent_a,L100,middle,9,6,3,5,0.9174,109,"[8, 20, 39, 40, 59, 60, 78, 83, 101]"
agent_a,L100,middle,13,7,6,1,0.885,113,"[8, 19, 20, 39, 40, 41, 43, 62, 81, 82, 100, 102, 103]"
agent_a,L100,middle,9,4,5,1,0.9174,109,"[8, 19, 39, 57, 59, 77, 80, 99, 102]"
agent_a,L100,middle,11,7,4,5,0.9009,111,"[21, 39, 43, 61, 63, 82, 83, 100, 101, 102, 104]"
agent_a,L100,middle,12,8,4,2,0.8929,112,"[19, 21, 22, 41, 42, 43, 62, 63, 81, 85, 103, 104]"
agent_a,L100,middle,11,7,4,2,0.9009,111,"[8, 20, 38, 39, 40, 42, 61, 63, 82, 100, 102]"
agent_a,L100,middle,11,7,4,3,0.9009,111,"[19, 37, 39, 40, 61, 80, 81, 99, 100, 101, 104]"
agent_a,L100,middle,10,2,8,5,0.9091,110,"[19, 23, 41, 45, 63, 81, 83, 101, 102, 103]"
agent_a,L100,middle,12,7,5,0,0.8929,112,"[8, 19, 38, 39, 40, 58, 60, 78, 80, 81, 101, 102]"
agent_a,L100,middle,10,5,5,2,0.9091,110,"[20, 37, 40, 41, 42, 61, 62, 81, 83, 102]"
agent_a,L100,middle,11,8,3,5,0.9009,111,"[8, 19, 38, 40, 61, 80, 82, 100, 101, 102, 105]"
agent_a,L100,middle,9,5,4,4,0.9174,109,"[19, 22, 40, 42, 62, 81, 99, 100, 101]"
agent_a,L100,middle,9,6,3,2,0.9174,109,"[19, 36, 39, 58, 60, 78, 82, 99, 100]"
agent_a,L100,middle,13,9,4,6,0.885,113,"[8, 19, 20, 39, 40, 41, 42, 60, 65, 83, 86, 104, 106]"
agent_a,L100,middle,11,8,3,1,0.9009,111,"[8, 19, 38, 41, 60, 61, 62, 64, 84, 102, 104]"
agent_a,L100,middle,13,6,7,1,0.885,113,"[19, 21, 39, 41, 42, 43, 63, 66, 68, 87, 89, 107, 108]"
agent_a,L100,middle,10,3,7,1,0.9091,110,"[19, 36, 40, 58, 60, 78, 81, 82, 101, 103]"
agent_a,L100,middle,10,6,4,1,0.9091,110,"[8, 19, 20, 21, 40, 42, 63, 82, 101, 102]"
agent_a,L100,middle,8,5,3,5,0.9259,108,"[20, 37, 40, 58, 60, 78, 81, 99]"
agent_a,L100,middle,8,2,6,2,0.9259,108,"[19, 36, 40, 58, 60, 79, 97, 99]"
agent_a,L100,middle,13,9,4,1,0.885,113,"[8, 19, 38, 39, 58, 59, 79, 80, 81, 82, 83, 102, 104]"
agent_a,L100,middle,10,5,5,1,0.9091,110,"[8, 19, 39, 57, 59, 61, 79, 82, 100, 103]"
agent_a,L100,middle,11,5,6,1,0.9009,111,"[19, 36, 40, 43, 61, 63, 82, 84, 101, 103, 105]"
agent_a,L100,middle,9,8,1,7,0.9174,109,"[21, 38, 42, 62, 80, 82, 99, 100, 101]"
agent_a,L100,middle,11,5,6,5,0.9009,111,"[8, 19, 38, 39, 41, 60, 61, 79, 82, 100, 105]"
agent_a,L100,middle,9,6,3,6,0.9174,109,"[20, 38, 41, 59, 61, 80, 81, 100, 104]"
agent_a,L100,middle,11,3,8,9,0.9009,111,"[8, 19, 20, 21, 22, 27, 47, 66, 87, 106, 109]"
agent_a,L100,middle,13,9,4,10,0.885,113,"[8, 19, 38, 39, 40, 41, 42, 43, 45, 64, 69, 89, 108]"
agent_a,L100,middle,9,6,3,6,0.9174,109,"[20, 37, 41, 59, 62, 81, 98, 99, 103]"
agent_a,L100,middle,12,8,4,5,0.8929,112,"[19, 38, 39, 58, 59, 77, 79, 80, 81, 82, 100, 107]"
agent_a,L0,long,7,6,1,2,0.9346,107,"[28, 29, 55, 60, 85, 90, 93]"
agent_a,L0,long,8,3,5,1,0.9259,108,"[28, 29, 57, 60, 62, 91, 92, 93]"
agent_a,L0,long,5,4,1,6,0.9524,105,"[12, 29, 35, 65, 92]"
agent_a,L0,long,4,2,2,4,0.9615,104,"[28, 31, 63, 90]"
agent_a,L0,long,6,4,2,1,0.9434,106,"[30, 57, 59, 84, 89, 91]"
agent_a,L0,long,6,6,0,8,0.9434,106,"[12, 29, 34, 59, 64, 93]"
agent_a,L0,long,6,4,2,5,0.9434,106,"[28, 30, 58, 62, 88, 92]"
agent_a,L0,long,9,8,1,1,0.9174,109,"[28, 29, 30, 56, 60, 63, 90, 92, 93]"
agent_a,L0,long,5,3,2,10,0.9524,105,"[13, 29, 35, 65, 94]"
agent_a,L0,long,6,5,1,0,0.9434,106,"[12, 29, 55, 59, 87, 89]"
agent_a,L0,long,6,5,1,2,0.9434,106,"[28, 29, 30, 56, 61, 91]"
agent_a,L0,long,8,6,2,3,0.9259,108,"[12, 30, 55, 59, 60, 88, 90, 93]"
agent_a,L0,long,5,4,1,1,0.9524,105,"[28, 30, 59, 84, 90]"
agent_a,L0,long,6,4,2,3,0.9434,106,"[12, 30, 55, 59, 87, 91]"
agent_a,L0,long,6,5,1,1,0.9434,106,"[28, 30, 58, 60, 85, 91]"
agent_a,L0,long,5,2,3,3,0.9524,105,"[31, 57, 61, 88, 91]"
agent_a,L0,long,8,8,0,1,0.9259,108,"[12, 30, 55, 59, 61, 89, 90, 92]"
agent_a,L0,long,5,4,1,5,0.9524,105,"[12, 29, 34, 60, 91]"
agent_a,L0,long,8,4,4,1,0.9259,108,"[28, 30, 32, 33, 60, 64, 91, 94]"
agent_a,L0,long,6,6,0,0,0.9434,106,"[28, 29, 55, 59, 85, 90]"
agent_a,L0,long,7,6,1,0,0.9346,107,"[12, 29, 54, 59, 87, 89, 91]"
agent_a,L0,long,8,8,0,0,0.9259,108,"[12, 29, 55, 59, 60, 89, 90, 91]"
agent_a,L0,long,7,5,2,2,0.9346,107,"[28, 29, 30, 56, 61, 88, 92]"
agent_a,L0,long,6,6,0,0,0.9434,106,"[12, 29, 54, 59, 88, 89]"
agent_a,L0,long,6,5,1,2,0.9434,106,"[12, 30, 55, 60, 89, 91]"
agent_a,L0,long,7,5,2,6,0.9346,107,"[28, 29, 32, 60, 63, 90, 94]"
agent_a,L0,long,4,4,0,11,0.9615,104,"[13, 37, 62, 91]"
agent_a,L0,long,5,3,2,2,0.9524,105,"[28, 29, 57, 61, 89]"
agent_a,L0,long,7,6,1,2,0.9346,107,"[12, 30, 55, 59, 60, 88, 91]"
agent_a,L0,long,6,3,3,4,0.9434,106,"[28, 30, 31, 61, 90, 95]"
agent_a,L0,long,7,7,0,1,0.9346,107,"[13, 30, 55, 60, 89, 90, 91]"
agent_a,L0,long,6,3,3,5,0.9434,106,"[28, 31, 59, 62, 88, 92]"
agent_a,L0,long,7,4,3,9,0.9346,107,"[13, 29, 34, 61, 64, 92, 97]"
agent_a,L0,long,8,7,1,2,0.9259,108,"[28, 29, 55, 59, 61, 88, 90, 92]"
agent_a,L0,long,6,5,1,0,0.9434,106,"[12, 29, 54, 59, 87, 89]"
agent_a,L0,long,5,5,0,7,0.9524,105,"[16, 34, 59, 63, 92]"
agent_a,L0,long,7,7,0,0,0.9346,107,"[28, 29, 55, 59, 60, 86, 90]"
agent_a,L0,long,6,5,1,0,0.9434,106,"[28, 29, 55, 60, 85, 91]"
agent_a,L0,long,6,5,1,3,0.9434,106,"[12, 29, 54, 59, 88, 92]"
agent_a,L0,long,7,6,1,2,0.9346,107,"[28, 29, 55, 59, 60, 86, 92]"
agent_a,L0,long,9,9,0,0,0.9174,109,"[28, 29, 30, 31, 57, 61, 63, 92, 93]"
agent_a,L0,long,9,7,2,3,0.9174,109,"[30, 57, 59, 60, 61, 63, 91, 92, 96]"
agent_a,L0,long,7,7,0,4,0.9346,107,"[28, 29, 55, 59, 60, 86, 94]"
agent_a,L0,long,7,7,0,8,0.9346,107,"[12, 29, 34, 59, 64, 93, 94]"
agent_a,L0,long,5,4,1,11,0.9524,105,"[12, 33, 58, 64, 91]"
agent_a,L0,long,8,5,3,2,0.9259,108,"[28, 31, 58, 60, 61, 88, 90, 93]"
agent_a,L0,long,7,7,0,0,0.9346,107,"[28, 29, 55, 59, 84, 89, 90]"
agent_a,L0,long,6,6,0,0,0.9434,106,"[28, 29, 55, 59, 85, 89]"
agent_a,L0,long,5,5,0,7,0.9524,105,"[12, 33, 58, 63, 92]"
agent_a,L0,long,5,4,1,14,0.9524,105,"[12, 33, 58, 65, 93]"
agent_a,L0,long,6,5,1,1,0.9434,106,"[12, 29, 54, 59, 87, 90]"
agent_a,L0,long,8,7,1,0,0.9259,108,"[28, 29, 57, 59, 60, 61, 87, 91]"
agent_a,L0,long,6,5,1,5,0.9434,106,"[28, 31, 58, 63, 89, 93]"
agent_a,L0,long,5,4,1,8,0.9524,105,"[17, 34, 59, 63, 91]"
agent_a,L0,long,5,5,0,6,0.9524,105,"[32, 58, 62, 88, 92]"
agent_a,L0,long,6,5,1,0,0.9434,106,"[13, 29, 56, 59, 88, 89]"
agent_a,L0,long,6,4,2,3,0.9434,106,"[28, 29, 55, 59, 62, 92]"
agent_a,L0,long,7,4,3,5,0.9346,107,"[12, 29, 35, 60, 90, 91, 92]"
agent_a,L0,long,6,3,3,8,0.9434,106,"[28, 31, 58, 62, 88, 92]"
agent_a,L0,long,5,3,2,1,0.9524,105,"[29, 57, 59, 86, 90]"
agent_a,L0,long,6,5,1,3,0.9434,106,"[12, 33, 58, 63, 91, 93]"
agent_a,L0,long,6,6,0,8,0.9434,106,"[12, 29, 34, 59, 65, 93]"
agent_a,L0,long,6,5,1,2,0.9434,106,"[12, 30, 55, 59, 61, 91]"
agent_a,L0,long,5,5,0,11,0.9524,105,"[12, 33, 58, 63, 92]"
agent_a,L0,long,9,9,0,1,0.9174,109,"[28, 29, 30, 31, 57, 62, 90, 91, 92]"
agent_a,L0,long,8,3,5,0,0.9259,108,"[29, 31, 32, 59, 63, 64, 91, 94]"
agent_a,L0,long,6,6,0,0,0.9434,106,"[12, 29, 55, 59, 88, 89]"
agent_a,L0,long,6,5,1,4,0.9434,106,"[28, 32, 58, 64, 89, 94]"
agent_a,L0,long,8,7,1,2,0.9259,108,"[29, 57, 58, 60, 88, 89, 90, 93]"
agent_a,L0,long,6,5,1,2,0.9434,106,"[12, 29, 54, 61, 89, 90]"
agent_a,L0,long,7,6,1,2,0.9346,107,"[12, 30, 57, 60, 88, 89, 91]"
agent_a,L0,long,6,6,0,11,0.9434,106,"[12, 29, 34, 59, 64, 93]"
agent_a,L0,long,7,6,1,0,0.9346,107,"[12, 29, 56, 60, 61, 90, 91]"
agent_a,L0,long,7,7,0,0,0.9346,107,"[29, 30, 58, 60, 85, 90, 91]"
agent_a,L0,long,6,5,1,7,0.9434,106,"[28, 30, 58, 62, 88, 93]"
agent_a,L0,long,10,10,0,1,0.9091,110,"[13, 29, 34, 59, 64, 65, 66, 95, 96, 97]"
agent_a,L0,long,8,8,0,0,0.9259,108,"[28, 29, 55, 59, 84, 89, 90, 91]"
agent_a,L0,long,6,6,0,0,0.9434,106,"[28, 29, 55, 59, 84, 89]"
agent_a,L0,long,7,7,0,0,0.9346,107,"[12, 29, 54, 59, 88, 89, 90]"
agent_a,L0,long,7,4,3,1,0.9346,107,"[30, 57, 59, 60, 87, 90, 92]"
agent_a,L0,long,11,10,1,0,0.9009,111,"[12, 29, 55, 59, 60, 61, 62, 63, 91, 93, 94]"
agent_a,L0,long,6,5,1,5,0.9434,106,"[16, 34, 59, 63, 91, 93]"
agent_a,L0,long,7,6,1,0,0.9346,107,"[28, 29, 57, 59, 60, 86, 90]"
agent_a,L0,long,6,3,3,2,0.9434,106,"[28, 31, 58, 62, 88, 92]"
agent_a,L0,long,5,3,2,5,0.9524,105,"[28, 31, 58, 62, 89]"
agent_a,L0,long,5,4,1,8,0.9524,105,"[12, 33, 58, 63, 94]"
agent_a,L0,long,6,5,1,5,0.9434,106,"[12, 30, 34, 60, 64, 92]"
agent_a,L0,long,8,8,0,0,0.9259,108,"[12, 29, 54, 60, 61, 89, 90, 92]"
agent_a,L0,long,5,3,2,3,0.9524,105,"[31, 58, 62, 87, 91]"
agent_a,L0,long,10,6,4,1,0.9091,110,"[12, 30, 57, 59, 60, 62, 90, 93, 94, 95]"
agent_a,L0,long,5,5,0,3,0.9524,105,"[29, 58, 59, 84, 92]"
agent_a,L0,long,7,7,0,0,0.9346,107,"[28, 29, 55, 59, 60, 86, 90]"
agent_a,L0,long,7,5,2,4,0.9346,107,"[28, 30, 58, 60, 62, 90, 93]"
agent_a,L0,long,6,4,2,4,0.9434,106,"[28, 30, 58, 62, 89, 92]"
agent_a,L0,long,6,6,0,1,0.9434,106,"[29, 57, 58, 60, 85, 89]"
agent_a,L0,long,6,6,0,1,0.9434,106,"[29, 57, 58, 60, 85, 89]"
agent_a,L0,long,5,4,1,6,0.9524,105,"[12, 34, 59, 63, 91]"
agent_a,L0,long,7,7,0,4,0.9346,107,"[28, 30, 58, 60, 85, 89, 95]"
agent_a,L0,long,6,5,1,4,0.9434,106,"[13, 30, 55, 61, 88, 90]"
agent_a,L0,long,8,8,0,1,0.9259,108,"[13, 30, 58, 59, 61, 89, 90, 91]"
agent_a,L50,long,9,9,0,0,0.9174,109,"[28, 29, 30, 31, 32, 61, 62, 88, 92]"
agent_a,L50,long,7,5,2,2,0.9346,107,"[28, 31, 59, 86, 88, 89, 90]"
agent_a,L50,long,6,5,1,8,0.9434,106,"[13, 29, 34, 60, 64, 92]"
agent_a,L50,long,5,4,1,2,0.9524,105,"[12, 29, 55, 60, 90]"
agent_a,L50,long,6,6,0,1,0.9434,106,"[12, 29, 58, 59, 88, 90]"
agent_a,L50,long,9,5,4,2,0.9174,109,"[12, 29, 32, 33, 62, 65, 93, 96, 97]"
agent_a,L50,long,6,5,1,3,0.9434,106,"[13, 29, 58, 60, 88, 91]"
agent_a,L50,long,6,4,2,5,0.9434,106,"[13, 31, 60, 87, 89, 94]"
agent_a,L50,long,8,7,1,2,0.9259,108,"[12, 29, 31, 59, 61, 62, 91, 93]"
agent_a,L50,long,8,7,1,0,0.9259,108,"[13, 29, 55, 59, 61, 89, 91, 93]"
agent_a,L50,long,6,5,1,5,0.9434,106,"[13, 29, 34, 62, 89, 93]"
agent_a,L50,long,8,6,2,3,0.9259,108,"[12, 29, 32, 60, 61, 89, 91, 93]"
agent_a,L50,long,6,6,0,0,0.9434,106,"[13, 29, 55, 59, 88, 90]"
agent_a,L50,long,7,2,5,1,0.9346,107,"[29, 31, 60, 61, 88, 91, 93]"
agent_a,L50,long,11,8,3,4,0.9009,111,"[28, 29, 30, 31, 59, 61, 62, 63, 66, 93, 96]"
agent_a,L50,long,6,5,1,3,0.9434,106,"[12, 29, 55, 59, 61, 92]"
agent_a,L50,long,7,5,2,4,0.9346,107,"[28, 29, 55, 59, 62, 89, 92]"
agent_a,L50,long,6,4,2,4,0.9434,106,"[13, 31, 58, 60, 88, 92]"
agent_a,L50,long,12,12,0,0,0.8929,112,"[12, 30, 58, 59, 60, 61, 62, 63, 92, 93, 94, 95]"
agent_a,L50,long,7,7,0,4,0.9346,107,"[13, 30, 34, 63, 92, 93, 95]"
agent_a,L50,long,6,6,0,1,0.9434,106,"[12, 29, 31, 59, 60, 90]"
agent_a,L50,long,5,3,2,8,0.9524,105,"[15, 33, 59, 63, 91]"
agent_a,L50,long,6,5,1,1,0.9434,106,"[28, 29, 55, 59, 85, 91]"
agent_a,L50,long,5,5,0,2,0.9524,105,"[13, 29, 55, 59, 92]"
agent_a,L50,long,7,6,1,0,0.9346,107,"[28, 29, 31, 60, 61, 89, 92]"
agent_a,L50,long,7,5,2,1,0.9346,107,"[29, 30, 59, 60, 62, 89, 93]"
agent_a,L50,long,6,5,1,0,0.9434,106,"[29, 30, 58, 60, 87, 90]"
agent_a,L50,long,7,4,3,2,0.9346,107,"[12, 31, 58, 60, 62, 90, 92]"
agent_a,L50,long,6,5,1,1,0.9434,106,"[28, 29, 55, 60, 87, 90]"
agent_a,L50,long,6,4,2,1,0.9434,106,"[28, 29, 57, 59, 60, 92]"
agent_a,L50,long,7,5,2,4,0.9346,107,"[14, 33, 59, 87, 88, 89, 92]"
agent_a,L50,long,7,7,0,0,0.9346,107,"[12, 29, 58, 60, 61, 89, 91]"
agent_a,L50,long,6,3,3,4,0.9434,106,"[31, 58, 61, 87, 90, 93]"
agent_a,L50,long,6,2,4,1,0.9434,106,"[12, 29, 33, 62, 91, 92]"
agent_a,L50,long,7,3,4,5,0.9346,107,"[28, 35, 62, 89, 91, 92, 94]"
agent_a,L50,long,6,6,0,0,0.9434,106,"[13, 29, 55, 60, 88, 90]"
agent_a,L50,long,7,5,2,5,0.9346,107,"[12, 29, 33, 60, 64, 92, 94]"
agent_a,L50,long,5,3,2,8,0.9524,105,"[15, 33, 59, 63, 91]"
agent_a,L50,long,7,7,0,0,0.9346,107,"[28, 30, 58, 60, 88, 90, 91]"
agent_a,L50,long,9,9,0,0,0.9174,109,"[29, 57, 58, 59, 60, 61, 90, 91, 93]"
agent_a,L50,long,6,5,1,3,0.9434,106,"[12, 30, 58, 59, 60, 92]"
agent_a,L50,long,6,5,1,2,0.9434,106,"[28, 29, 57, 60, 88, 90]"
agent_a,L50,long,6,5,1,1,0.9434,106,"[28, 29, 55, 59, 85, 92]"
agent_a,L50,long,8,5,3,4,0.9259,108,"[12, 29, 31, 34, 60, 64, 91, 94]"
agent_a,L50,long,5,3,2,6,0.9524,105,"[15, 34, 64, 91, 93]"
agent_a,L50,long,4,2,2,5,0.9615,104,"[12, 33, 60, 89]"
agent_a,L50,long,7,7,0,1,0.9346,107,"[12, 29, 31, 59, 60, 89, 90]"
agent_a,L50,long,6,4,2,3,0.9434,106,"[28, 29, 31, 61, 88, 91]"
agent_a,L50,long,6,5,1,0,0.9434,106,"[29, 30, 31, 62, 88, 93]"
agent_a,L50,long,4,3,1,4,0.9615,104,"[28, 30, 64, 91]"
agent_a,L50,long,5,3,2,2,0.9524,105,"[28, 29, 57, 61, 89]"
agent_a,L50,long,8,8,0,1,0.9259,108,"[12, 29, 55, 59, 60, 61, 90, 92]"
agent_a,L50,long,7,2,5,4,0.9346,107,"[28, 31, 60, 90, 91, 92, 94]"
agent_a,L50,long,9,9,0,0,0.9174,109,"[12, 30, 58, 59, 61, 62, 63, 92, 93]"
agent_a,L50,long,6,6,0,2,0.9434,106,"[28, 29, 55, 60, 88, 90]"
agent_a,L50,long,6,4,2,4,0.9434,106,"[13, 31, 58, 60, 88, 91]"
agent_a,L50,long,5,4,1,1,0.9524,105,"[12, 29, 55, 59, 90]"
agent_a,L50,long,6,5,1,2,0.9434,106,"[12, 29, 32, 60, 89, 90]"
agent_a,L50,long,8,6,2,1,0.9259,108,"[28, 29, 57, 60, 87, 90, 91, 92]"
agent_a,L50,long,7,4,3,0,0.9346,107,"[28, 30, 58, 60, 87, 91, 92]"
agent_a,L50,long,9,8,1,1,0.9174,109,"[13, 29, 57, 59, 60, 61, 90, 91, 93]"
agent_a,L50,long,6,5,1,4,0.9434,106,"[29, 58, 59, 63, 89, 92]"
agent_a,L50,long,6,5,1,4,0.9434,106,"[28, 31, 58, 60, 88, 90]"
agent_a,L50,long,5,4,1,0,0.9524,105,"[13, 29, 57, 59, 89]"
agent_a,L50,long,7,6,1,1,0.9346,107,"[28, 29, 30, 58, 60, 62, 91]"
agent_a,L50,long,9,8,1,2,0.9174,109,"[28, 29, 30, 31, 32, 61, 62, 88, 94]"
agent_a,L50,long,9,9,0,0,0.9174,109,"[12, 29, 31, 59, 60, 61, 90, 92, 93]"
agent_a,L50,long,8,5,3,2,0.9259,108,"[28, 29, 30, 58, 60, 61, 89, 93]"
agent_a,L50,long,5,4,1,5,0.9524,105,"[29, 57, 58, 63, 90]"
agent_a,L50,long,5,4,1,2,0.9524,105,"[28, 30, 60, 87, 89]"
agent_a,L50,long,6,4,2,4,0.9434,106,"[28, 31, 59, 61, 89, 93]"
agent_a,L50,long,10,10,0,1,0.9091,110,"[12, 30, 31, 59, 60, 61, 90, 91, 92, 94]"
agent_a,L50,long,8,8,0,0,0.9259,108,"[28, 29, 30, 31, 61, 62, 90, 92]"
agent_a,L50,long,6,4,2,1,0.9434,106,"[29, 32, 59, 62, 88, 93]"
agent_a,L50,long,7,5,2,8,0.9346,107,"[12, 30, 59, 60, 63, 90, 96]"
agent_a,L50,long,6,6,0,0,0.9434,106,"[28, 29, 55, 59, 85, 89]"
agent_a,L50,long,5,2,3,5,0.9524,105,"[14, 34, 61, 88, 91]"
agent_a,L50,long,7,6,1,3,0.9346,107,"[12, 31, 59, 60, 61, 89, 94]"
agent_a,L50,long,5,4,1,1,0.9524,105,"[12, 29, 60, 87, 89]"
agent_a,L50,long,7,5,2,4,0.9346,107,"[12, 30, 31, 59, 63, 90, 93]"
agent_a,L50,long,6,6,0,1,0.9434,106,"[12, 29, 55, 59, 88, 90]"
agent_a,L50,long,5,2,3,4,0.9524,105,"[12, 29, 32, 62, 91]"
agent_a,L50,long,9,8,1,0,0.9174,109,"[29, 57, 58, 59, 60, 61, 89, 91, 92]"
agent_a,L50,long,8,7,1,3,0.9259,108,"[13, 29, 55, 60, 88, 90, 91, 94]"
agent_a,L50,long,7,6,1,1,0.9346,107,"[29, 58, 59, 60, 61, 89, 92]"
agent_a,L50,long,6,3,3,3,0.9434,106,"[28, 29, 57, 60, 87, 91]"
agent_a,L50,long,6,6,0,2,0.9434,106,"[12, 29, 55, 60, 88, 90]"
agent_a,L50,long,11,10,1,1,0.9009,111,"[12, 29, 55, 59, 60, 61, 62, 63, 65, 94, 96]"
agent_a,L50,long,9,8,1,1,0.9174,109,"[28, 29, 30, 58, 60, 86, 90, 91, 93]"
agent_a,L50,long,4,4,0,7,0.9615,104,"[32, 61, 87, 91]"
agent_a,L50,long,6,6,0,0,0.9434,106,"[28, 29, 55, 59, 85, 89]"
agent_a,L50,long,8,6,2,2,0.9259,108,"[28, 30, 59, 60, 63, 64, 90, 95]"
agent_a,L50,long,5,3,2,4,0.9524,105,"[29, 57, 61, 87, 91]"
agent_a,L50,long,6,5,1,8,0.9434,106,"[28, 30, 58, 62, 88, 93]"
agent_a,L50,long,7,7,0,0,0.9346,107,"[28, 30, 58, 60, 61, 89, 91]"
agent_a,L50,long,6,4,2,3,0.9434,106,"[28, 29, 55, 60, 87, 91]"
agent_a,L50,long,11,9,2,4,0.9009,111,"[28, 29, 30, 31, 32, 33, 63, 64, 67, 94, 97]"
agent_a,L50,long,8,8,0,0,0.9259,108,"[12, 29, 55, 59, 60, 61, 62, 92]"
agent_a,L50,long,7,7,0,0,0.9346,107,"[12, 29, 55, 59, 60, 89, 90]"
agent_a,L50,long,6,2,4,5,0.9434,106,"[31, 58, 62, 90, 91, 92]"
agent_a,L100,long,5,4,1,1,0.9524,105,"[12, 29, 55, 60, 91]"
agent_a,L100,long,5,3,2,1,0.9524,105,"[29, 58, 59, 86, 90]"
agent_a,L100,long,7,6,1,0,0.9346,107,"[28, 29, 31, 60, 61, 88, 91]"
agent_a,L100,long,6,4,2,6,0.9434,106,"[13, 29, 33, 59, 63, 90]"
agent_a,L100,long,8,4,4,2,0.9259,108,"[28, 29, 31, 60, 63, 91, 92, 93]"
agent_a,L100,long,5,4,1,3,0.9524,105,"[29, 57, 59, 62, 93]"
agent_a,L100,long,6,6,0,0,0.9434,106,"[12, 29, 55, 60, 89, 90]"
agent_a,L100,long,6,5,1,4,0.9434,106,"[12, 29, 55, 60, 88, 92]"
agent_a,L100,long,6,4,2,3,0.9434,106,"[13, 29, 55, 59, 87, 92]"
agent_a,L100,long,7,6,1,2,0.9346,107,"[12, 29, 55, 59, 61, 89, 92]"
agent_a,L100,long,7,5,2,4,0.9346,107,"[12, 29, 30, 56, 62, 89, 92]"
agent_a,L100,long,7,6,1,0,0.9346,107,"[13, 30, 58, 59, 60, 88, 90]"
agent_a,L100,long,7,4,3,0,0.9346,107,"[28, 30, 58, 60, 62, 91, 92]"
agent_a,L100,long,6,6,0,1,0.9434,106,"[13, 29, 55, 60, 88, 90]"
agent_a,L100,long,5,3,2,5,0.9524,105,"[13, 32, 60, 63, 93]"
agent_a,L100,long,7,6,1,2,0.9346,107,"[28, 29, 30, 59, 61, 88, 91]"
agent_a,L100,long,9,9,0,3,0.9174,109,"[12, 29, 30, 32, 60, 61, 63, 91, 93]"
agent_a,L100,long,7,2,5,2,0.9346,107,"[28, 30, 60, 89, 90, 91, 93]"
agent_a,L100,long,10,4,6,1,0.9091,110,"[13, 30, 33, 34, 35, 36, 63, 67, 95, 96]"
agent_a,L100,long,4,3,1,9,0.9615,104,"[28, 33, 64, 92]"
agent_a,L100,long,6,4,2,0,0.9434,106,"[12, 29, 57, 59, 87, 89]"
agent_a,L100,long,4,1,3,5,0.9615,104,"[31, 58, 61, 90]"
agent_a,L100,long,8,4,4,5,0.9259,108,"[28, 29, 32, 59, 62, 90, 92, 94]"
agent_a,L100,long,5,3,2,5,0.9524,105,"[29, 32, 59, 64, 91]"
agent_a,L100,long,7,6,1,0,0.9346,107,"[28, 29, 59, 86, 88, 89, 90]"
agent_a,L100,long,8,8,0,0,0.9259,108,"[28, 29, 58, 60, 61, 62, 90, 92]"
agent_a,L100,long,7,3,4,1,0.9346,107,"[28, 29, 32, 59, 63, 92, 93]"
agent_a,L100,long,6,5,1,1,0.9434,106,"[13, 29, 55, 59, 87, 90]"
agent_a,L100,long,9,2,7,0,0.9174,109,"[30, 31, 58, 61, 62, 63, 91, 93, 94]"
agent_a,L100,long,9,8,1,0,0.9174,109,"[28, 29, 58, 60, 61, 62, 89, 92, 93]"
agent_a,L100,long,6,5,1,1,0.9434,106,"[12, 30, 59, 60, 88, 91]"
agent_a,L100,long,4,3,1,3,0.9615,104,"[28, 29, 60, 92]"
agent_a,L100,long,6,5,1,0,0.9434,106,"[12, 30, 31, 59, 61, 91]"
agent_a,L100,long,5,3,2,9,0.9524,105,"[12, 32, 58, 63, 91]"
agent_a,L100,long,6,5,1,1,0.9434,106,"[28, 30, 59, 60, 87, 90]"
agent_a,L100,long,5,4,1,6,0.9524,105,"[13, 31, 59, 88, 93]"
agent_a,L100,long,6,6,0,9,0.9434,106,"[13, 29, 34, 60, 65, 93]"
agent_a,L100,long,8,7,1,1,0.9259,108,"[28, 29, 30, 59, 60, 87, 90, 92]"
agent_a,L100,long,5,3,2,0,0.9524,105,"[13, 29, 57, 60, 90]"
agent_a,L100,long,5,4,1,1,0.9524,105,"[29, 57, 60, 88, 89]"
agent_a,L100,long,7,4,3,2,0.9346,107,"[29, 30, 58, 60, 63, 91, 92]"
agent_a,L100,long,6,5,1,2,0.9434,106,"[28, 29, 58, 60, 87, 90]"
agent_a,L100,long,7,7,0,1,0.9346,107,"[29, 57, 59, 87, 88, 89, 91]"
agent_a,L100,long,5,2,3,3,0.9524,105,"[28, 31, 58, 62, 90]"
agent_a,L100,long,6,4,2,3,0.9434,106,"[28, 30, 58, 61, 89, 91]"
agent_a,L100,long,6,5,1,2,0.9434,106,"[12, 30, 58, 60, 88, 91]"
agent_a,L100,long,7,6,1,3,0.9346,107,"[12, 33, 61, 63, 65, 93, 95]"
agent_a,L100,long,6,5,1,1,0.9434,106,"[12, 29, 55, 59, 61, 92]"
agent_a,L100,long,5,5,0,2,0.9524,105,"[12, 30, 58, 60, 89]"
agent_a,L100,long,5,4,1,4,0.9524,105,"[29, 58, 60, 88, 92]"
agent_a,L100,long,7,7,0,0,0.9346,107,"[13, 29, 55, 59, 60, 89, 90]"
agent_a,L100,long,8,6,2,0,0.9259,108,"[12, 31, 32, 59, 61, 62, 90, 92]"
agent_a,L100,long,4,2,2,3,0.9615,104,"[28, 29, 61, 90]"
agent_a,L100,long,9,4,5,5,0.9174,109,"[28, 29, 30, 34, 63, 64, 65, 93, 97]"
agent_a,L100,long,6,4,2,2,0.9434,106,"[28, 30, 58, 60, 87, 92]"
agent_a,L100,long,10,9,1,0,0.9091,110,"[28, 29, 30, 59, 60, 61, 62, 63, 91, 93]"
agent_a,L100,long,7,5,2,0,0.9346,107,"[12, 29, 55, 59, 62, 89, 92]"
agent_a,L100,long,6,5,1,0,0.9434,106,"[28, 29, 59, 60, 87, 90]"
agent_a,L100,long,6,4,2,6,0.9434,106,"[14, 30, 35, 63, 91, 93]"
agent_a,L100,long,11,9,2,0,0.9009,111,"[28, 29, 30, 59, 60, 61, 62, 64, 92, 96, 97]"
agent_a,L100,long,7,6,1,0,0.9346,107,"[28, 30, 31, 59, 61, 88, 91]"
agent_a,L100,long,6,3,3,3,0.9434,106,"[28, 31, 58, 61, 89, 92]"
agent_a,L100,long,7,5,2,1,0.9346,107,"[14, 30, 58, 59, 60, 88, 91]"
agent_a,L100,long,6,4,2,4,0.9434,106,"[13, 29, 33, 60, 88, 91]"
agent_a,L100,long,6,5,1,1,0.9434,106,"[12, 30, 58, 59, 87, 89]"
agent_a,L100,long,5,2,3,6,0.9524,105,"[14, 32, 58, 62, 89]"
agent_a,L100,long,7,2,5,4,0.9346,107,"[28, 32, 59, 62, 90, 91, 92]"
agent_a,L100,long,6,5,1,1,0.9434,106,"[29, 57, 60, 88, 89, 90]"
agent_a,L100,long,6,4,2,3,0.9434,106,"[29, 30, 59, 61, 89, 92]"
agent_a,L100,long,4,2,2,6,0.9615,104,"[12, 33, 61, 89]"
agent_a,L100,long,8,7,1,0,0.9259,108,"[29, 30, 58, 60, 61, 88, 91, 92]"
agent_a,L100,long,6,4,2,1,0.9434,106,"[28, 29, 30, 31, 62, 91]"
agent_a,L100,long,6,6,0,1,0.9434,106,"[28, 29, 31, 60, 88, 90]"
agent_a,L100,long,6,4,2,6,0.9434,106,"[12, 29, 30, 58, 63, 93]"
agent_a,L100,long,7,4,3,0,0.9346,107,"[28, 29, 58, 59, 86, 88, 89]"
agent_a,L100,long,7,6,1,1,0.9346,107,"[28, 29, 59, 60, 88, 90, 92]"
agent_a,L100,long,7,6,1,0,0.9346,107,"[29, 30, 59, 60, 87, 90, 91]"
agent_a,L100,long,10,5,5,2,0.9091,110,"[12, 30, 33, 59, 64, 92, 93, 94, 95, 97]"
agent_a,L100,long,5,1,4,0,0.9524,105,"[30, 31, 58, 61, 91]"
agent_a,L100,long,5,3,2,2,0.9524,105,"[12, 29, 57, 60, 90]"
agent_a,L100,long,9,8,1,1,0.9174,109,"[12, 30, 58, 59, 60, 88, 90, 91, 92]"
agent_a,L100,long,9,9,0,1,0.9174,109,"[12, 30, 31, 59, 60, 61, 62, 91, 93]"
agent_a,L100,long,5,3,2,19,0.9524,105,"[13, 29, 36, 68, 95]"
agent_a,L100,long,6,5,1,0,0.9434,106,"[12, 29, 55, 59, 87, 89]"
agent_a,L100,long,7,2,5,3,0.9346,107,"[30, 57, 60, 61, 64, 91, 93]"
agent_a,L100,long,7,5,2,1,0.9346,107,"[14, 30, 58, 59, 87, 89, 90]"
agent_a,L100,long,6,2,4,5,0.9434,106,"[28, 29, 33, 62, 90, 92]"
agent_a,L100,long,6,3,3,1,0.9434,106,"[29, 30, 59, 61, 90, 91]"
agent_a,L100,long,6,6,0,2,0.9434,106,"[12, 29, 55, 60, 88, 90]"
agent_a,L100,long,6,5,1,1,0.9434,106,"[13, 29, 55, 60, 88, 91]"
agent_a,L100,long,8,2,6,0,0.9259,108,"[29, 31, 59, 61, 62, 64, 93, 94]"
agent_a,L100,long,5,2,3,5,0.9524,105,"[30, 57, 62, 89, 91]"
agent_a,L100,long,6,5,1,4,0.9434,106,"[12, 31, 58, 60, 88, 90]"
agent_a,L100,long,6,1,5,0,0.9434,106,"[29, 59, 60, 61, 90, 91]"
agent_a,L100,long,7,5,2,1,0.9346,107,"[29, 57, 59, 61, 62, 90, 94]"
agent_a,L100,long,6,5,1,2,0.9434,106,"[13, 29, 55, 61, 88, 93]"
agent_a,L100,long,8,1,7,0,0.9259,108,"[30, 31, 58, 61, 63, 92, 93, 94]"
agent_a,L100,long,7,5,2,2,0.9346,107,"[12, 30, 58, 59, 62, 89, 92]"
agent_a,L100,long,6,2,4,4,0.9434,106,"[14, 32, 59, 62, 89, 91]"
agent_a,L100,long,6,5,1,0,0.9434,106,"[12, 29, 55, 59, 87, 89]"
