agent_name,layout,event_update_level,num_attention_switches,num_attention_switches_margins,num_attention_switches_middle,inform_loss,reading_speed,total_steps,attention_switches_time_steps_list
agent_b,L0,short,51,29,22,3,0.6623,151,"[8, 10, 12, 14, 16, 19, 25, 26, 27, 28, 29, 35, 36, 37, 39, 46, 47, 48, 49, 51, 60, 62, 67, 68, 70, 71, 81, 82, 91, 92, 93, 99, 100, 101, 102, 104, 105, 107, 113, 114, 116, 117, 126, 127, 133, 134, 135, 136, 137, 146, 147]"
agent_b,L0,short,51,26,25,8,0.6623,151,"[3, 9, 17, 19, 21, 24, 25, 26, 27, 28, 30, 37, 38, 40, 43, 51, 52, 57, 59, 60, 61, 62, 70, 72, 73, 78, 79, 82, 83, 86, 93, 97, 101, 103, 104, 105, 111, 113, 114, 117, 123, 124, 126, 135, 136, 142, 143, 145, 146, 147, 148]"
agent_b,L0,short,54,21,33,2,0.6494,154,"[7, 8, 9, 10, 11, 12, 18, 19, 20, 22, 23, 33, 41, 42, 44, 52, 53, 54, 65, 70, 71, 72, 73, 74, 75, 83, 84, 85, 91, 92, 93, 94, 95, 101, 102, 103, 105, 106, 107, 114, 117, 124, 125, 126, 127, 129, 136, 137, 138, 139, 140, 148, 149, 150]"
agent_b,L0,short,49,23,26,5,0.6711,149,"[7, 8, 9, 15, 16, 17, 18, 19, 27, 30, 35, 37, 38, 39, 40, 49, 50, 53, 59, 60, 61, 63, 70, 71, 73, 75, 84, 85, 86, 89, 94, 95, 96, 97, 103, 105, 106, 108, 109, 115, 116, 119, 121, 122, 126, 136, 142, 145, 146]"
agent_b,L0,short,48,18,30,12,0.6757,148,"[7, 8, 10, 13, 14, 15, 16, 17, 18, 20, 29, 30, 31, 32, 33, 34, 43, 44, 51, 52, 53, 56, 65, 71, 72, 73, 74, 83, 84, 89, 94, 96, 103, 104, 105, 108, 113, 114, 116, 118, 120, 127, 128, 129, 131, 138, 140, 141]"
agent_b,L0,short,50,28,22,3,0.6667,150,"[7, 8, 9, 10, 11, 16, 17, 18, 19, 21, 29, 30, 32, 33, 41, 42, 43, 49, 50, 51, 52, 53, 62, 64, 73, 78, 79, 80, 81, 82, 83, 91, 92, 93, 94, 102, 103, 105, 112, 114, 116, 126, 132, 134, 135, 136, 143, 144, 145, 146]"
agent_b,L0,short,49,27,22,11,0.6711,149,"[2, 6, 7, 8, 10, 19, 23, 24, 25, 27, 29, 30, 38, 39, 45, 51, 52, 54, 61, 62, 64, 69, 70, 72, 74, 80, 81, 82, 85, 94, 99, 101, 103, 108, 109, 111, 113, 118, 119, 120, 121, 122, 123, 131, 132, 133, 140, 141, 143]"
agent_b,L0,short,52,27,25,3,0.6579,152,"[7, 8, 9, 10, 14, 16, 17, 18, 19, 20, 29, 30, 31, 38, 39, 40, 41, 42, 50, 51, 53, 61, 63, 65, 72, 76, 82, 83, 85, 90, 91, 92, 93, 95, 102, 104, 105, 106, 112, 113, 114, 115, 117, 125, 126, 127, 135, 136, 137, 138, 139, 149]"
agent_b,L0,short,47,28,19,5,0.6803,147,"[7, 8, 9, 13, 16, 17, 18, 19, 27, 28, 29, 35, 37, 38, 39, 48, 49, 56, 57, 58, 59, 65, 68, 69, 77, 79, 80, 84, 89, 90, 91, 92, 100, 101, 102, 108, 109, 110, 111, 113, 122, 128, 129, 131, 133, 141, 142]"
agent_b,L0,short,47,21,26,10,0.6803,147,"[7, 8, 10, 13, 16, 17, 18, 19, 27, 28, 31, 38, 39, 41, 46, 51, 59, 62, 67, 69, 70, 73, 79, 82, 84, 88, 89, 90, 91, 93, 94, 100, 101, 103, 104, 110, 114, 115, 124, 125, 126, 132, 133, 135, 136, 137, 141]"
agent_b,L0,short,45,16,29,11,0.6897,145,"[2, 6, 8, 10, 17, 18, 19, 25, 30, 32, 37, 38, 39, 40, 41, 42, 51, 52, 58, 60, 61, 63, 71, 72, 77, 79, 80, 86, 87, 89, 94, 96, 99, 104, 105, 106, 107, 108, 114, 116, 118, 120, 128, 129, 140]"
agent_b,L0,short,51,26,25,8,0.6623,151,"[7, 8, 9, 11, 15, 17, 19, 21, 29, 30, 32, 38, 40, 42, 49, 50, 51, 60, 61, 66, 67, 68, 69, 70, 71, 77, 78, 79, 80, 82, 89, 91, 97, 103, 104, 106, 112, 113, 114, 115, 122, 125, 127, 134, 135, 138, 139, 140, 141, 142, 143]"
agent_b,L0,short,50,27,23,6,0.6667,150,"[7, 8, 9, 14, 15, 16, 17, 18, 19, 27, 28, 30, 38, 41, 46, 47, 49, 53, 59, 60, 61, 62, 63, 70, 71, 72, 73, 80, 81, 82, 83, 91, 93, 100, 102, 103, 108, 110, 111, 112, 114, 121, 122, 123, 126, 133, 134, 142, 143, 144]"
agent_b,L0,short,50,32,18,8,0.6667,150,"[7, 8, 11, 15, 17, 18, 19, 20, 27, 30, 35, 36, 38, 39, 44, 51, 53, 59, 61, 64, 68, 71, 74, 79, 80, 81, 82, 83, 88, 89, 90, 91, 92, 93, 94, 105, 111, 112, 113, 114, 116, 117, 118, 119, 128, 129, 136, 137, 139, 148]"
agent_b,L0,short,47,20,27,10,0.6803,147,"[2, 7, 8, 10, 18, 20, 24, 25, 26, 27, 28, 30, 37, 39, 43, 50, 58, 59, 60, 61, 68, 69, 70, 71, 77, 78, 83, 88, 89, 90, 92, 96, 97, 98, 99, 101, 108, 110, 111, 117, 118, 120, 121, 130, 133, 139, 141]"
agent_b,L0,short,54,25,29,5,0.6494,154,"[7, 10, 12, 13, 15, 19, 25, 26, 28, 29, 35, 36, 38, 40, 41, 42, 45, 52, 53, 54, 55, 56, 65, 66, 68, 74, 75, 76, 77, 85, 87, 94, 95, 96, 97, 103, 104, 105, 106, 107, 114, 115, 116, 117, 125, 126, 128, 135, 136, 137, 140, 148, 149, 151]"
agent_b,L0,short,51,26,25,6,0.6623,151,"[7, 8, 10, 16, 17, 18, 19, 20, 27, 28, 29, 32, 33, 41, 44, 50, 52, 54, 62, 63, 64, 71, 72, 73, 75, 82, 83, 84, 85, 87, 93, 94, 95, 97, 103, 104, 105, 106, 107, 108, 115, 116, 117, 118, 126, 127, 130, 137, 139, 140, 149]"
agent_b,L0,short,46,18,28,4,0.6849,146,"[7, 8, 9, 10, 14, 16, 18, 19, 20, 28, 29, 30, 38, 40, 48, 49, 51, 53, 60, 61, 63, 73, 78, 79, 82, 83, 87, 88, 89, 91, 92, 93, 94, 101, 102, 105, 111, 112, 113, 116, 123, 125, 131, 135, 141, 142]"
agent_b,L0,short,50,28,22,11,0.6667,150,"[2, 6, 7, 8, 9, 20, 24, 25, 26, 27, 30, 32, 40, 42, 48, 49, 50, 53, 59, 60, 61, 62, 63, 72, 73, 74, 75, 82, 84, 87, 94, 97, 101, 102, 105, 106, 113, 114, 115, 116, 122, 123, 124, 125, 128, 136, 137, 139, 146, 147]"
agent_b,L0,short,47,26,21,9,0.6803,147,"[7, 8, 9, 13, 14, 15, 17, 20, 27, 29, 30, 36, 37, 38, 39, 41, 48, 49, 51, 53, 54, 55, 63, 64, 66, 74, 75, 76, 86, 87, 93, 94, 95, 100, 106, 107, 112, 113, 114, 115, 118, 125, 126, 127, 130, 137, 139]"
agent_b,L0,short,51,30,21,7,0.6623,151,"[7, 8, 9, 12, 14, 19, 21, 22, 24, 33, 34, 36, 38, 44, 45, 46, 47, 53, 54, 55, 56, 57, 66, 67, 70, 77, 79, 88, 92, 93, 94, 99, 104, 106, 108, 112, 114, 116, 117, 119, 125, 126, 127, 128, 129, 136, 138, 139, 147, 148, 149]"
agent_b,L0,short,47,22,25,9,0.6803,147,"[4, 7, 8, 9, 16, 17, 18, 19, 27, 28, 29, 37, 38, 41, 47, 48, 49, 51, 58, 59, 60, 61, 71, 77, 80, 85, 90, 91, 95, 96, 97, 99, 103, 112, 116, 117, 120, 121, 126, 129, 130, 131, 136, 137, 138, 140, 141]"
agent_b,L0,short,46,26,20,10,0.6849,146,"[2, 7, 8, 9, 16, 17, 18, 20, 26, 27, 28, 30, 37, 39, 46, 47, 48, 49, 55, 56, 57, 59, 62, 71, 76, 77, 78, 79, 80, 82, 83, 96, 101, 103, 104, 107, 114, 115, 120, 121, 122, 124, 126, 134, 136, 144]"
agent_b,L0,short,45,27,18,14,0.6897,145,"[7, 9, 11, 12, 13, 14, 15, 18, 23, 31, 37, 42, 43, 44, 45, 46, 48, 55, 57, 63, 64, 65, 66, 67, 69, 76, 78, 84, 87, 90, 94, 95, 97, 98, 107, 108, 113, 114, 115, 117, 120, 127, 128, 135, 138]"
agent_b,L0,short,53,31,22,9,0.6536,153,"[3, 7, 8, 12, 23, 26, 27, 29, 30, 31, 37, 38, 40, 42, 43, 44, 45, 54, 56, 57, 64, 65, 66, 67, 73, 75, 79, 84, 85, 86, 87, 90, 96, 97, 98, 99, 106, 107, 108, 109, 110, 117, 118, 119, 120, 122, 129, 130, 131, 133, 142, 143, 146]"
agent_b,L0,short,51,25,26,10,0.6623,151,"[2, 6, 7, 8, 9, 10, 18, 20, 22, 23, 29, 30, 31, 32, 33, 42, 44, 46, 54, 55, 61, 66, 71, 72, 73, 75, 81, 82, 83, 84, 87, 96, 98, 107, 109, 114, 115, 116, 119, 124, 126, 128, 130, 136, 137, 138, 139, 141, 147, 148, 149]"
agent_b,L0,short,47,21,26,8,0.6803,147,"[7, 8, 9, 14, 15, 17, 18, 19, 20, 30, 31, 37, 38, 39, 40, 41, 42, 49, 50, 54, 62, 68, 69, 70, 71, 73, 79, 81, 82, 90, 91, 92, 93, 100, 101, 105, 111, 113, 119, 120, 122, 124, 130, 131, 133, 142, 145]"
agent_b,L0,short,52,33,19,8,0.6579,152,"[7, 8, 11, 14, 15, 20, 26, 27, 28, 29, 30, 31, 32, 33, 41, 43, 49, 50, 56, 63, 64, 69, 72, 74, 80, 81, 82, 84, 85, 90, 91, 93, 94, 95, 96, 97, 105, 106, 107, 114, 115, 117, 124, 127, 133, 134, 135, 136, 137, 139, 147, 149]"
agent_b,L0,short,51,23,28,5,0.6623,151,"[2, 7, 8, 9, 10, 18, 21, 25, 27, 29, 30, 37, 38, 39, 40, 41, 42, 45, 54, 59, 60, 62, 63, 72, 73, 74, 75, 82, 84, 85, 91, 96, 100, 102, 104, 105, 107, 114, 116, 117, 118, 125, 127, 128, 135, 136, 137, 138, 146, 147, 148]"
agent_b,L0,short,48,27,21,5,0.6757,148,"[7, 8, 9, 11, 15, 16, 17, 19, 23, 30, 31, 33, 40, 41, 45, 52, 54, 61, 63, 64, 70, 71, 72, 73, 74, 81, 82, 84, 85, 87, 88, 96, 97, 98, 106, 108, 117, 119, 120, 123, 124, 131, 132, 135, 141, 142, 143, 144]"
agent_b,L0,short,45,30,15,26,0.6897,145,"[2, 8, 11, 18, 19, 24, 26, 27, 28, 29, 30, 34, 40, 44, 50, 53, 57, 58, 59, 60, 61, 63, 64, 71, 72, 73, 74, 78, 85, 88, 94, 96, 100, 101, 102, 106, 112, 113, 114, 115, 116, 117, 125, 136, 143]"
agent_b,L0,short,47,24,23,4,0.6803,147,"[7, 10, 12, 13, 14, 16, 18, 20, 28, 29, 31, 32, 39, 40, 41, 42, 49, 52, 58, 60, 62, 69, 70, 71, 72, 80, 83, 92, 97, 99, 100, 102, 105, 106, 107, 110, 111, 113, 114, 117, 124, 126, 136, 142, 143, 144, 145]"
agent_b,L0,short,52,31,21,3,0.6579,152,"[7, 9, 12, 14, 15, 16, 17, 18, 19, 20, 30, 31, 38, 39, 40, 42, 48, 50, 52, 59, 60, 61, 68, 69, 72, 78, 79, 80, 82, 90, 91, 94, 100, 101, 102, 103, 104, 109, 110, 111, 113, 115, 122, 125, 126, 133, 134, 135, 136, 145, 147, 148]"
agent_b,L0,short,49,23,26,10,0.6711,149,"[7, 8, 10, 15, 16, 19, 20, 24, 30, 31, 32, 33, 34, 37, 45, 46, 47, 53, 54, 55, 56, 57, 67, 68, 75, 76, 77, 78, 86, 87, 89, 95, 96, 98, 107, 109, 114, 116, 118, 120, 127, 128, 129, 135, 136, 137, 138, 139, 143]"
agent_b,L0,short,50,35,15,11,0.6667,150,"[7, 9, 12, 15, 16, 17, 18, 19, 21, 29, 30, 37, 38, 39, 40, 47, 48, 49, 52, 59, 60, 62, 67, 68, 69, 70, 73, 85, 92, 97, 98, 99, 101, 102, 104, 106, 112, 113, 114, 115, 116, 125, 126, 134, 135, 136, 143, 144, 145, 147]"
agent_b,L0,short,50,28,22,8,0.6667,150,"[8, 10, 12, 14, 15, 16, 17, 18, 20, 21, 29, 31, 39, 40, 41, 45, 51, 52, 53, 54, 56, 65, 70, 71, 72, 73, 74, 76, 84, 85, 87, 96, 102, 104, 105, 106, 107, 108, 109, 115, 116, 117, 118, 120, 128, 129, 130, 139, 140, 142]"
agent_b,L0,short,50,25,25,11,0.6667,150,"[2, 6, 7, 8, 9, 10, 18, 19, 20, 27, 28, 29, 30, 32, 40, 41, 49, 50, 51, 54, 60, 61, 65, 71, 72, 73, 74, 80, 82, 83, 84, 91, 95, 101, 103, 104, 108, 114, 117, 122, 123, 124, 125, 126, 134, 136, 137, 140, 147, 148]"
agent_b,L0,short,48,21,27,9,0.6757,148,"[2, 9, 15, 16, 18, 19, 20, 21, 26, 28, 29, 31, 38, 41, 43, 45, 52, 53, 54, 59, 60, 62, 63, 67, 73, 75, 82, 84, 91, 92, 93, 94, 102, 103, 104, 106, 112, 113, 116, 122, 123, 125, 132, 133, 137, 143, 144, 145]"
agent_b,L0,short,51,24,27,8,0.6623,151,"[2, 7, 9, 16, 18, 21, 24, 26, 27, 28, 29, 36, 37, 38, 39, 47, 48, 49, 55, 56, 58, 59, 66, 67, 69, 73, 79, 80, 82, 83, 84, 91, 93, 94, 101, 102, 103, 104, 108, 116, 122, 123, 124, 126, 127, 135, 136, 137, 144, 145, 147]"
agent_b,L0,short,52,27,25,3,0.6579,152,"[7, 8, 9, 13, 14, 16, 17, 18, 19, 27, 30, 36, 39, 46, 49, 50, 56, 59, 61, 62, 63, 69, 70, 71, 72, 73, 79, 80, 81, 84, 90, 91, 93, 101, 102, 103, 111, 113, 119, 120, 121, 122, 123, 129, 130, 131, 132, 133, 141, 142, 143, 146]"
agent_b,L0,short,53,32,21,6,0.6536,153,"[3, 7, 8, 9, 16, 17, 20, 25, 26, 27, 29, 36, 37, 38, 39, 40, 41, 42, 51, 53, 61, 62, 63, 64, 66, 69, 78, 83, 84, 85, 88, 89, 96, 98, 99, 104, 105, 106, 107, 108, 109, 111, 119, 120, 127, 128, 130, 138, 139, 141, 148, 149, 150]"
agent_b,L0,short,50,27,23,3,0.6667,150,"[7, 9, 13, 14, 15, 16, 17, 18, 19, 27, 28, 29, 30, 37, 39, 41, 48, 49, 50, 51, 60, 61, 62, 64, 73, 74, 76, 84, 87, 88, 94, 95, 97, 98, 105, 107, 109, 114, 116, 117, 118, 120, 127, 128, 130, 137, 138, 139, 140, 148]"
agent_b,L0,short,51,27,24,9,0.6623,151,"[4, 8, 9, 10, 12, 20, 22, 24, 26, 31, 32, 33, 34, 35, 36, 44, 48, 57, 58, 64, 65, 66, 69, 78, 81, 85, 86, 87, 88, 89, 90, 91, 92, 93, 94, 96, 104, 105, 112, 113, 114, 117, 124, 125, 129, 136, 137, 138, 139, 147, 149]"
agent_b,L0,short,49,26,23,6,0.6711,149,"[7, 8, 10, 13, 14, 17, 20, 27, 29, 30, 31, 33, 40, 42, 48, 50, 51, 53, 60, 62, 68, 69, 70, 71, 72, 78, 81, 82, 88, 91, 94, 100, 102, 103, 105, 110, 111, 112, 113, 115, 121, 126, 132, 134, 140, 141, 143, 144, 145]"
agent_b,L0,short,51,24,27,4,0.6623,151,"[5, 8, 10, 17, 19, 20, 24, 26, 27, 28, 29, 30, 37, 38, 39, 40, 49, 50, 53, 59, 61, 62, 63, 71, 72, 73, 79, 81, 82, 83, 91, 93, 94, 100, 101, 103, 104, 111, 113, 114, 121, 122, 124, 126, 133, 134, 135, 138, 146, 147, 148]"
agent_b,L0,short,51,25,26,5,0.6623,151,"[7, 8, 9, 10, 14, 16, 17, 22, 30, 35, 36, 37, 38, 39, 40, 48, 52, 58, 59, 60, 61, 66, 67, 68, 70, 71, 72, 74, 81, 82, 83, 84, 85, 95, 103, 104, 105, 113, 114, 115, 116, 123, 124, 125, 126, 133, 134, 137, 145, 146, 148]"
agent_b,L0,short,52,20,32,3,0.6579,152,"[2, 7, 8, 10, 17, 18, 20, 21, 26, 28, 30, 31, 38, 39, 41, 48, 50, 51, 59, 60, 62, 69, 72, 76, 77, 79, 80, 82, 88, 89, 93, 98, 101, 102, 109, 110, 111, 113, 121, 122, 123, 131, 132, 133, 134, 135, 137, 144, 145, 146, 147, 148]"
agent_b,L0,short,51,31,20,5,0.6623,151,"[2, 6, 7, 9, 16, 20, 24, 25, 26, 29, 36, 38, 40, 46, 48, 49, 55, 57, 58, 59, 60, 62, 70, 71, 76, 77, 78, 80, 82, 89, 91, 98, 99, 100, 102, 103, 111, 112, 113, 114, 120, 122, 123, 124, 133, 134, 141, 143, 144, 145, 147]"
agent_b,L0,short,48,26,22,13,0.6757,148,"[7, 8, 9, 13, 14, 15, 16, 17, 19, 22, 30, 34, 40, 41, 42, 48, 49, 51, 52, 59, 60, 61, 63, 70, 71, 74, 83, 84, 87, 94, 95, 100, 101, 102, 103, 105, 106, 112, 113, 114, 115, 118, 126, 127, 133, 134, 136, 139]"
agent_b,L0,short,50,25,25,3,0.6667,150,"[7, 9, 12, 13, 16, 17, 18, 20, 27, 28, 29, 37, 39, 40, 43, 48, 50, 51, 52, 53, 54, 63, 64, 71, 72, 73, 74, 83, 84, 89, 90, 91, 93, 94, 103, 104, 109, 111, 112, 113, 115, 116, 125, 126, 133, 135, 136, 143, 145, 146]"
agent_b,L0,short,53,31,22,4,0.6536,153,"[7, 8, 10, 13, 14, 15, 19, 21, 23, 30, 31, 32, 39, 40, 41, 42, 43, 49, 50, 51, 52, 54, 63, 70, 71, 73, 79, 82, 84, 89, 90, 92, 93, 94, 103, 105, 111, 114, 115, 122, 123, 124, 125, 126, 132, 134, 135, 136, 137, 138, 146, 147, 148]"
agent_b,L0,short,50,26,24,8,0.6667,150,"[9, 11, 15, 16, 17, 18, 21, 22, 29, 31, 32, 38, 40, 41, 42, 49, 50, 51, 52, 59, 62, 69, 71, 72, 77, 78, 79, 81, 82, 84, 90, 91, 93, 95, 103, 104, 105, 106, 107, 114, 116, 118, 125, 126, 127, 128, 129, 130, 134, 143]"
agent_b,L0,short,52,37,15,9,0.6579,152,"[7, 8, 10, 15, 16, 17, 18, 19, 27, 28, 29, 35, 37, 41, 46, 48, 49, 51, 58, 61, 63, 69, 70, 71, 72, 74, 83, 84, 89, 91, 92, 94, 100, 101, 103, 105, 111, 112, 114, 120, 121, 122, 125, 131, 132, 133, 134, 135, 136, 138, 146, 147]"
agent_b,L0,short,50,25,25,6,0.6667,150,"[7, 9, 10, 11, 14, 15, 16, 17, 19, 20, 23, 32, 39, 40, 41, 42, 45, 53, 59, 61, 62, 64, 70, 71, 73, 74, 83, 85, 91, 93, 95, 100, 101, 102, 103, 104, 105, 112, 113, 114, 116, 124, 125, 126, 128, 129, 136, 137, 138, 141]"
agent_b,L0,short,51,22,29,3,0.6623,151,"[2, 7, 8, 10, 11, 12, 20, 21, 22, 23, 29, 32, 36, 43, 44, 51, 53, 54, 59, 60, 61, 62, 66, 67, 73, 74, 75, 77, 87, 94, 97, 104, 105, 106, 107, 112, 114, 115, 116, 118, 119, 125, 128, 129, 131, 138, 140, 146, 147, 148, 149]"
agent_b,L0,short,51,34,17,6,0.6623,151,"[7, 9, 14, 16, 17, 18, 20, 27, 29, 30, 35, 37, 38, 39, 40, 47, 48, 50, 51, 52, 53, 54, 63, 64, 73, 76, 82, 83, 85, 90, 93, 95, 100, 101, 102, 104, 105, 111, 113, 114, 115, 116, 117, 118, 119, 121, 122, 124, 134, 142, 143]"
agent_b,L0,short,52,23,29,5,0.6579,152,"[2, 7, 8, 10, 17, 18, 19, 24, 25, 27, 30, 38, 39, 41, 48, 49, 50, 57, 59, 60, 67, 70, 74, 75, 78, 79, 82, 87, 88, 89, 90, 97, 98, 101, 107, 108, 109, 112, 119, 121, 122, 123, 124, 133, 134, 135, 136, 142, 143, 144, 145, 146]"
agent_b,L0,short,55,33,22,6,0.6452,155,"[10, 12, 14, 15, 17, 18, 19, 27, 28, 30, 35, 36, 37, 40, 46, 48, 50, 51, 58, 59, 60, 62, 67, 71, 73, 78, 79, 80, 84, 89, 92, 93, 94, 102, 103, 104, 105, 106, 107, 114, 115, 116, 117, 118, 119, 127, 129, 136, 137, 140, 141, 142, 151, 152, 153]"
agent_b,L0,short,45,28,17,6,0.6897,145,"[8, 10, 12, 13, 16, 17, 20, 21, 32, 37, 38, 40, 41, 46, 47, 48, 49, 50, 52, 59, 62, 68, 71, 72, 74, 83, 84, 88, 89, 91, 92, 94, 100, 101, 102, 104, 110, 113, 114, 123, 127, 132, 134, 135, 138]"
agent_b,L0,short,50,24,26,7,0.6667,150,"[9, 11, 12, 14, 16, 17, 18, 21, 28, 29, 30, 34, 40, 41, 46, 48, 49, 50, 52, 59, 62, 68, 72, 76, 79, 80, 81, 87, 90, 91, 97, 98, 99, 101, 109, 110, 111, 117, 118, 119, 120, 121, 127, 131, 138, 140, 141, 142, 143, 144]"
agent_b,L0,short,50,26,24,5,0.6667,150,"[7, 9, 13, 15, 16, 17, 18, 19, 27, 28, 29, 35, 37, 39, 45, 46, 48, 49, 57, 58, 59, 65, 67, 69, 77, 80, 85, 86, 87, 88, 89, 95, 98, 99, 100, 106, 107, 109, 110, 116, 117, 118, 119, 120, 123, 130, 131, 132, 140, 146]"
agent_b,L0,short,52,26,26,5,0.6579,152,"[7, 8, 9, 13, 15, 17, 18, 19, 28, 29, 35, 36, 38, 39, 45, 47, 48, 49, 57, 58, 62, 68, 69, 70, 76, 77, 78, 79, 80, 86, 89, 90, 96, 97, 99, 100, 105, 111, 117, 119, 121, 128, 129, 130, 131, 138, 139, 140, 142, 148, 149, 150]"
agent_b,L0,short,48,14,34,8,0.6757,148,"[7, 8, 9, 11, 14, 15, 17, 18, 19, 20, 21, 22, 31, 32, 41, 42, 49, 51, 55, 62, 68, 69, 70, 71, 72, 81, 82, 83, 88, 91, 92, 94, 96, 103, 104, 105, 111, 112, 113, 114, 115, 116, 124, 125, 130, 137, 144, 145]"
agent_b,L0,short,48,25,23,4,0.6757,148,"[7, 10, 12, 14, 15, 16, 17, 18, 22, 32, 38, 39, 41, 42, 49, 50, 51, 52, 55, 62, 63, 69, 71, 72, 73, 74, 76, 84, 85, 86, 91, 95, 97, 104, 107, 111, 113, 114, 115, 117, 119, 121, 128, 129, 130, 137, 139, 141]"
agent_b,L0,short,50,21,29,10,0.6667,150,"[2, 6, 7, 8, 9, 17, 19, 20, 26, 28, 29, 33, 39, 40, 41, 44, 52, 58, 60, 61, 64, 69, 70, 74, 81, 84, 93, 94, 96, 99, 101, 102, 103, 104, 105, 107, 108, 116, 118, 125, 126, 127, 128, 130, 137, 138, 139, 145, 147, 148]"
agent_b,L0,short,52,25,27,6,0.6579,152,"[3, 8, 10, 17, 18, 20, 26, 27, 28, 29, 36, 37, 38, 41, 47, 48, 50, 51, 58, 62, 68, 69, 72, 78, 79, 80, 83, 84, 89, 90, 91, 92, 94, 100, 101, 102, 103, 105, 112, 113, 114, 115, 121, 122, 124, 125, 126, 127, 136, 137, 145, 148]"
agent_b,L0,short,50,42,8,5,0.6667,150,"[8, 9, 14, 15, 16, 18, 19, 26, 27, 28, 30, 36, 37, 38, 39, 41, 42, 49, 50, 51, 52, 62, 67, 71, 73, 78, 79, 80, 81, 82, 84, 91, 92, 93, 94, 102, 104, 105, 111, 112, 113, 114, 118, 126, 132, 134, 135, 143, 144, 145]"
agent_b,L0,short,49,22,27,0,0.6711,149,"[2, 6, 7, 8, 10, 19, 20, 25, 27, 30, 38, 40, 46, 51, 52, 53, 54, 60, 61, 62, 63, 64, 71, 75, 81, 82, 83, 85, 86, 94, 96, 100, 104, 106, 108, 110, 115, 117, 119, 120, 125, 126, 127, 129, 130, 131, 139, 141, 147]"
agent_b,L0,short,51,29,22,9,0.6623,151,"[2, 6, 7, 8, 9, 11, 19, 23, 28, 30, 31, 37, 38, 39, 40, 41, 43, 44, 47, 58, 64, 66, 68, 76, 77, 78, 80, 81, 88, 89, 91, 96, 101, 102, 103, 105, 106, 112, 114, 115, 116, 123, 124, 128, 134, 135, 136, 137, 145, 146, 147]"
agent_b,L0,short,51,32,19,6,0.6623,151,"[7, 11, 12, 14, 18, 21, 23, 24, 30, 31, 32, 34, 41, 42, 43, 44, 45, 46, 47, 55, 57, 65, 66, 67, 73, 74, 75, 76, 77, 85, 86, 88, 95, 96, 97, 104, 105, 106, 108, 115, 116, 118, 125, 127, 129, 136, 138, 146, 147, 148, 149]"
agent_b,L0,short,51,33,18,6,0.6623,151,"[2, 6, 8, 9, 17, 18, 19, 20, 21, 22, 23, 24, 31, 33, 34, 35, 43, 45, 46, 55, 56, 62, 64, 65, 66, 68, 75, 76, 77, 85, 86, 87, 96, 100, 106, 107, 114, 115, 116, 117, 119, 125, 126, 127, 129, 137, 138, 144, 146, 147, 148]"
agent_b,L0,short,51,25,26,3,0.6623,151,"[8, 9, 12, 13, 15, 16, 17, 18, 20, 28, 30, 36, 37, 38, 39, 46, 48, 49, 57, 59, 64, 67, 68, 70, 76, 77, 79, 81, 82, 83, 90, 91, 93, 100, 101, 102, 103, 109, 111, 112, 113, 121, 122, 123, 130, 131, 132, 134, 135, 147, 148]"
agent_b,L0,short,53,18,35,4,0.6536,153,"[3, 7, 9, 10, 17, 19, 20, 23, 28, 29, 31, 32, 39, 40, 41, 42, 49, 52, 59, 60, 62, 63, 64, 65, 67, 75, 77, 83, 86, 87, 95, 97, 101, 102, 104, 105, 107, 108, 115, 117, 118, 119, 120, 126, 128, 129, 130, 138, 139, 142, 148, 149, 150]"
agent_b,L0,short,49,32,17,5,0.6711,149,"[9, 11, 14, 15, 17, 19, 25, 28, 29, 30, 35, 36, 38, 40, 47, 49, 52, 58, 61, 63, 69, 70, 71, 73, 81, 82, 83, 88, 89, 90, 92, 94, 95, 101, 102, 103, 107, 114, 115, 123, 124, 125, 126, 133, 134, 135, 137, 144, 146]"
agent_b,L0,short,50,27,23,7,0.6667,150,"[8, 10, 12, 14, 16, 21, 27, 28, 31, 36, 37, 38, 39, 40, 41, 47, 48, 49, 50, 52, 62, 69, 71, 79, 80, 83, 88, 89, 91, 92, 93, 99, 100, 101, 102, 103, 104, 109, 110, 111, 112, 115, 117, 125, 126, 128, 129, 131, 138, 142]"
agent_b,L0,short,50,27,23,6,0.6667,150,"[2, 6, 7, 10, 17, 18, 20, 22, 27, 28, 29, 30, 31, 39, 42, 52, 56, 59, 62, 69, 70, 71, 72, 74, 80, 81, 83, 88, 89, 90, 91, 92, 93, 98, 99, 101, 102, 103, 112, 113, 119, 121, 122, 124, 126, 134, 135, 136, 144, 146]"
agent_b,L0,short,52,26,26,4,0.6579,152,"[2, 6, 7, 8, 9, 10, 19, 20, 26, 27, 28, 29, 30, 38, 39, 40, 49, 50, 57, 59, 61, 69, 71, 73, 79, 81, 82, 87, 90, 91, 92, 93, 99, 100, 101, 102, 104, 112, 113, 114, 116, 123, 124, 127, 134, 135, 136, 138, 145, 146, 147, 148]"
agent_b,L0,short,51,36,15,11,0.6623,151,"[7, 8, 9, 12, 15, 17, 19, 22, 29, 30, 31, 33, 40, 42, 47, 48, 49, 53, 59, 60, 62, 68, 70, 72, 77, 78, 79, 80, 81, 84, 90, 91, 93, 100, 101, 104, 109, 110, 111, 112, 113, 120, 123, 124, 125, 126, 128, 135, 136, 139, 148]"
agent_b,L0,short,48,29,19,7,0.6757,148,"[7, 8, 9, 13, 15, 16, 17, 20, 27, 28, 29, 30, 39, 40, 41, 47, 48, 49, 50, 51, 52, 63, 64, 65, 72, 73, 74, 75, 85, 90, 91, 92, 94, 97, 98, 103, 109, 113, 118, 119, 120, 128, 130, 136, 137, 138, 139, 140]"
agent_b,L0,short,54,25,29,8,0.6494,154,"[2, 7, 10, 12, 19, 20, 21, 25, 27, 30, 31, 38, 39, 40, 43, 50, 52, 57, 58, 59, 60, 61, 69, 70, 72, 77, 79, 80, 81, 90, 92, 96, 97, 98, 99, 100, 102, 109, 111, 117, 118, 120, 121, 122, 123, 132, 133, 134, 135, 137, 144, 145, 146, 148]"
agent_b,L0,short,49,37,12,7,0.6711,149,"[7, 8, 9, 14, 15, 17, 18, 19, 28, 29, 30, 37, 41, 46, 47, 48, 51, 57, 58, 60, 65, 70, 71, 72, 77, 78, 79, 80, 82, 89, 90, 92, 99, 100, 102, 107, 108, 110, 112, 115, 124, 130, 131, 132, 133, 135, 142, 143, 144]"
agent_b,L0,short,51,31,20,11,0.6623,151,"[7, 9, 12, 13, 14, 15, 16, 17, 19, 29, 36, 39, 45, 46, 47, 52, 58, 59, 63, 64, 65, 68, 69, 70, 71, 77, 79, 80, 81, 88, 89, 90, 91, 98, 99, 100, 104, 109, 110, 111, 112, 113, 114, 123, 124, 129, 136, 143, 144, 145, 147]"
agent_b,L0,short,53,21,32,5,0.6536,153,"[8, 9, 12, 13, 15, 19, 20, 22, 24, 31, 33, 34, 40, 43, 44, 51, 52, 53, 54, 61, 62, 63, 64, 68, 75, 76, 77, 78, 85, 86, 87, 88, 89, 96, 97, 98, 99, 106, 107, 109, 110, 111, 112, 114, 121, 122, 123, 125, 134, 135, 143, 144, 147]"
agent_b,L0,short,47,34,13,6,0.6803,147,"[9, 13, 17, 19, 24, 25, 28, 29, 33, 34, 35, 36, 39, 45, 46, 48, 49, 56, 58, 59, 60, 61, 67, 68, 69, 70, 72, 80, 81, 89, 92, 99, 100, 103, 107, 108, 111, 112, 118, 119, 120, 122, 128, 129, 130, 134, 142]"
agent_b,L0,short,53,17,36,2,0.6536,153,"[4, 7, 8, 10, 17, 18, 20, 21, 27, 28, 29, 31, 32, 39, 40, 42, 43, 53, 60, 62, 63, 65, 73, 74, 82, 84, 90, 93, 95, 96, 101, 102, 103, 104, 106, 107, 114, 115, 116, 118, 125, 126, 127, 129, 130, 137, 138, 139, 141, 147, 148, 149, 150]"
agent_b,L0,short,52,29,23,4,0.6579,152,"[2, 8, 9, 17, 19, 23, 24, 27, 29, 31, 38, 39, 42, 48, 49, 50, 56, 57, 58, 59, 61, 69, 70, 72, 73, 74, 77, 84, 85, 86, 93, 94, 95, 97, 102, 103, 104, 105, 106, 107, 116, 117, 124, 125, 127, 128, 136, 137, 138, 145, 146, 148]"
agent_b,L0,short,51,24,27,4,0.6623,151,"[2, 6, 7, 8, 10, 18, 21, 25, 27, 28, 29, 30, 37, 38, 39, 41, 50, 51, 60, 61, 64, 70, 71, 72, 78, 79, 80, 81, 82, 89, 90, 91, 92, 93, 100, 102, 103, 110, 112, 113, 115, 121, 122, 123, 126, 134, 135, 136, 143, 144, 146]"
agent_b,L0,short,47,17,30,13,0.6803,147,"[10, 12, 13, 14, 15, 16, 17, 18, 19, 21, 29, 30, 31, 35, 42, 43, 50, 51, 54, 61, 62, 63, 70, 71, 72, 74, 82, 83, 88, 89, 90, 92, 94, 101, 102, 104, 106, 112, 113, 114, 115, 116, 117, 121, 131, 139, 140]"
agent_b,L0,short,48,31,17,8,0.6757,148,"[7, 8, 10, 12, 15, 16, 18, 19, 20, 23, 33, 41, 43, 49, 50, 51, 52, 58, 59, 62, 63, 69, 70, 71, 72, 73, 82, 83, 88, 89, 91, 95, 100, 101, 102, 105, 113, 114, 115, 121, 122, 123, 125, 126, 132, 133, 136, 139]"
agent_b,L0,short,47,22,25,7,0.6803,147,"[2, 6, 8, 9, 16, 17, 18, 19, 21, 28, 30, 31, 38, 39, 41, 48, 50, 53, 58, 60, 63, 69, 72, 77, 80, 81, 82, 87, 88, 89, 91, 92, 98, 99, 100, 101, 102, 107, 115, 117, 123, 124, 125, 126, 134, 135, 136]"
agent_b,L0,short,45,19,26,8,0.6897,145,"[2, 6, 8, 10, 20, 24, 25, 26, 27, 30, 36, 38, 39, 40, 41, 43, 51, 52, 53, 59, 61, 62, 64, 71, 72, 73, 74, 80, 82, 84, 87, 97, 101, 102, 104, 105, 106, 107, 114, 118, 126, 128, 134, 135, 140]"
agent_b,L0,short,52,18,34,5,0.6579,152,"[2, 7, 8, 9, 17, 18, 20, 25, 26, 27, 28, 29, 30, 33, 41, 42, 43, 44, 53, 54, 60, 61, 62, 66, 75, 76, 77, 79, 85, 86, 87, 89, 98, 99, 102, 107, 108, 110, 111, 120, 121, 127, 128, 129, 130, 131, 139, 141, 142, 148, 149, 150]"
agent_b,L0,short,48,26,22,5,0.6757,148,"[7, 10, 12, 14, 15, 19, 20, 27, 28, 29, 31, 37, 42, 47, 51, 52, 57, 58, 59, 60, 62, 63, 64, 65, 72, 73, 75, 85, 86, 92, 93, 94, 96, 99, 106, 107, 108, 109, 110, 111, 113, 123, 130, 131, 132, 140, 141, 144]"
agent_b,L0,short,47,30,17,8,0.6803,147,"[9, 10, 11, 12, 13, 18, 20, 22, 23, 25, 32, 35, 41, 42, 45, 51, 54, 55, 56, 63, 64, 66, 72, 73, 74, 78, 83, 84, 86, 88, 95, 96, 97, 100, 110, 114, 116, 117, 118, 119, 125, 126, 127, 128, 130, 137, 140]"
agent_b,L0,short,52,30,22,5,0.6579,152,"[4, 7, 8, 9, 18, 20, 24, 25, 26, 28, 29, 36, 39, 45, 47, 49, 53, 58, 59, 60, 61, 62, 70, 71, 72, 77, 78, 79, 82, 89, 90, 91, 92, 97, 98, 99, 100, 101, 103, 112, 114, 120, 122, 123, 134, 140, 141, 142, 143, 144, 145, 148]"
agent_b,L0,short,48,26,22,8,0.6757,148,"[7, 9, 12, 16, 17, 18, 19, 26, 29, 34, 37, 38, 39, 45, 47, 48, 50, 57, 58, 62, 69, 71, 75, 76, 77, 79, 80, 86, 88, 89, 90, 97, 98, 99, 101, 107, 109, 110, 112, 119, 120, 122, 128, 129, 132, 139, 140, 141]"
agent_b,L0,short,50,26,24,5,0.6667,150,"[2, 6, 7, 8, 9, 17, 21, 26, 27, 32, 37, 38, 39, 40, 41, 43, 51, 52, 58, 59, 60, 61, 63, 71, 73, 74, 81, 83, 84, 93, 95, 100, 101, 102, 103, 104, 110, 112, 113, 115, 122, 123, 125, 132, 134, 135, 141, 142, 143, 145]"
agent_b,L0,short,52,36,16,3,0.6579,152,"[8, 9, 14, 15, 16, 17, 18, 19, 27, 28, 29, 36, 37, 38, 39, 40, 41, 42, 43, 45, 53, 54, 63, 64, 73, 74, 82, 83, 84, 89, 91, 92, 93, 95, 102, 103, 104, 105, 113, 116, 123, 124, 125, 126, 134, 135, 136, 143, 145, 147, 148, 149]"
agent_b,L0,short,53,28,25,7,0.6536,153,"[9, 11, 13, 14, 16, 18, 21, 28, 29, 31, 37, 38, 40, 45, 47, 48, 49, 50, 58, 59, 61, 68, 69, 70, 76, 80, 81, 87, 88, 90, 91, 92, 94, 101, 102, 103, 105, 110, 113, 114, 121, 122, 124, 130, 131, 132, 133, 134, 135, 136, 137, 138, 149]"
agent_b,L0,short,50,32,18,7,0.6667,150,"[4, 7, 9, 10, 17, 20, 22, 27, 28, 29, 32, 39, 41, 49, 51, 52, 56, 58, 61, 62, 65, 70, 72, 74, 80, 81, 82, 83, 84, 93, 94, 96, 101, 102, 103, 105, 107, 113, 114, 115, 116, 123, 126, 133, 134, 135, 137, 138, 145, 148]"
agent_b,L50,short,48,29,19,10,0.6757,148,"[4, 10, 19, 27, 30, 35, 36, 37, 38, 39, 46, 49, 50, 51, 56, 59, 60, 62, 70, 71, 72, 73, 74, 80, 81, 82, 83, 85, 86, 93, 95, 96, 97, 104, 105, 106, 107, 113, 114, 115, 116, 117, 124, 126, 127, 129, 135, 143]"
agent_b,L50,short,54,36,18,8,0.6494,154,"[9, 13, 14, 15, 22, 28, 29, 30, 37, 38, 39, 40, 43, 49, 50, 51, 54, 61, 62, 63, 69, 70, 72, 73, 80, 82, 83, 84, 90, 91, 92, 93, 94, 102, 105, 106, 112, 113, 116, 124, 125, 127, 133, 135, 136, 137, 142, 143, 144, 145, 146, 147, 148, 149]"
agent_b,L50,short,52,31,21,5,0.6579,152,"[8, 11, 15, 16, 17, 19, 20, 28, 31, 37, 38, 40, 46, 49, 50, 51, 59, 60, 61, 69, 71, 72, 78, 80, 83, 89, 91, 92, 97, 98, 99, 101, 102, 108, 109, 110, 112, 113, 114, 120, 121, 123, 125, 133, 135, 141, 142, 144, 145, 146, 147, 148]"
agent_b,L50,short,48,28,20,6,0.6757,148,"[4, 9, 18, 20, 25, 26, 27, 29, 36, 37, 39, 40, 47, 48, 49, 50, 56, 57, 58, 59, 61, 70, 77, 78, 79, 81, 88, 89, 90, 91, 96, 98, 100, 101, 102, 108, 110, 113, 119, 120, 121, 123, 130, 133, 134, 137, 145, 146]"
agent_b,L50,short,52,33,19,7,0.6579,152,"[5, 9, 11, 19, 20, 25, 27, 31, 37, 38, 39, 40, 47, 48, 49, 50, 56, 58, 59, 60, 68, 69, 72, 79, 80, 81, 82, 89, 90, 94, 101, 102, 108, 109, 110, 111, 114, 119, 121, 122, 123, 124, 125, 132, 133, 134, 137, 144, 145, 146, 148, 149]"
agent_b,L50,short,48,26,22,8,0.6757,148,"[5, 9, 17, 18, 20, 26, 27, 32, 38, 41, 46, 47, 48, 49, 50, 57, 59, 61, 67, 68, 71, 77, 78, 80, 86, 87, 88, 89, 90, 95, 97, 99, 100, 106, 107, 108, 110, 115, 116, 118, 119, 121, 129, 130, 131, 138, 139, 141]"
agent_b,L50,short,47,29,18,9,0.6803,147,"[8, 9, 15, 16, 17, 20, 21, 28, 29, 30, 33, 40, 41, 43, 49, 50, 51, 52, 54, 56, 65, 66, 67, 74, 75, 76, 77, 79, 87, 89, 95, 96, 97, 99, 100, 107, 108, 110, 111, 118, 125, 126, 128, 135, 137, 138, 141]"
agent_b,L50,short,50,35,15,7,0.6667,150,"[8, 12, 18, 21, 25, 26, 27, 29, 35, 36, 38, 39, 45, 46, 47, 50, 59, 60, 67, 68, 69, 70, 78, 79, 81, 87, 89, 90, 92, 97, 98, 99, 100, 101, 102, 104, 111, 112, 114, 124, 126, 134, 135, 136, 141, 142, 143, 144, 145, 147]"
agent_b,L50,short,47,35,12,10,0.6803,147,"[8, 9, 14, 15, 18, 19, 26, 28, 31, 37, 38, 41, 48, 50, 52, 59, 60, 62, 70, 71, 72, 78, 79, 81, 84, 89, 90, 91, 93, 98, 101, 102, 108, 109, 110, 111, 112, 118, 119, 121, 122, 124, 130, 132, 134, 142, 143]"
agent_b,L50,short,51,23,28,9,0.6623,151,"[8, 9, 15, 17, 22, 28, 29, 31, 38, 43, 49, 51, 52, 57, 60, 61, 62, 67, 68, 70, 71, 73, 80, 81, 82, 85, 91, 92, 93, 94, 99, 100, 102, 104, 109, 110, 111, 112, 113, 114, 115, 121, 122, 123, 124, 126, 135, 143, 144, 147, 149]"
agent_b,L50,short,51,26,25,9,0.6623,151,"[10, 13, 19, 20, 22, 27, 28, 29, 31, 37, 39, 40, 41, 49, 50, 51, 52, 53, 54, 55, 62, 66, 67, 76, 78, 84, 85, 86, 87, 88, 89, 93, 101, 102, 103, 109, 110, 112, 113, 114, 116, 124, 125, 127, 135, 138, 143, 144, 145, 147, 148]"
agent_b,L50,short,50,29,21,9,0.6667,150,"[5, 9, 19, 23, 25, 26, 27, 28, 29, 36, 38, 39, 42, 49, 50, 51, 52, 59, 60, 61, 66, 74, 80, 82, 87, 88, 89, 90, 93, 94, 95, 102, 103, 104, 105, 106, 112, 113, 115, 116, 122, 123, 124, 127, 129, 137, 138, 139, 141, 148]"
agent_b,L50,short,51,23,28,5,0.6623,151,"[8, 10, 14, 15, 16, 17, 18, 20, 28, 30, 37, 38, 39, 47, 49, 56, 57, 58, 60, 66, 67, 68, 71, 78, 79, 80, 81, 88, 89, 91, 92, 99, 101, 103, 108, 109, 110, 111, 113, 114, 115, 121, 122, 123, 124, 125, 132, 133, 134, 135, 145]"
agent_b,L50,short,47,30,17,5,0.6803,147,"[8, 10, 15, 16, 17, 19, 26, 27, 28, 31, 38, 42, 47, 50, 51, 58, 59, 63, 73, 78, 79, 80, 83, 87, 88, 90, 91, 94, 102, 104, 106, 107, 111, 113, 115, 116, 117, 121, 122, 124, 126, 128, 134, 136, 137, 138, 143]"
agent_b,L50,short,54,27,27,4,0.6494,154,"[5, 9, 10, 18, 19, 20, 22, 28, 29, 30, 32, 39, 40, 41, 42, 51, 52, 53, 61, 62, 63, 71, 72, 73, 75, 83, 84, 90, 91, 92, 95, 102, 103, 104, 111, 112, 113, 114, 115, 121, 122, 125, 130, 131, 132, 133, 134, 135, 142, 143, 144, 145, 146, 147]"
agent_b,L50,short,49,36,13,7,0.6711,149,"[8, 9, 14, 15, 17, 18, 21, 28, 29, 30, 39, 40, 48, 50, 51, 59, 61, 67, 70, 71, 77, 78, 79, 80, 82, 87, 88, 89, 90, 91, 93, 99, 100, 101, 102, 109, 110, 111, 113, 119, 120, 121, 126, 132, 133, 141, 142, 143, 144]"
agent_b,L50,short,51,26,25,6,0.6623,151,"[8, 9, 11, 15, 16, 18, 19, 20, 21, 23, 32, 34, 42, 43, 44, 46, 54, 57, 65, 72, 74, 75, 83, 86, 90, 91, 92, 95, 101, 102, 103, 104, 105, 106, 107, 113, 114, 115, 116, 117, 124, 126, 127, 133, 135, 136, 137, 143, 144, 145, 149]"
agent_b,L50,short,48,27,21,5,0.6757,148,"[8, 9, 10, 15, 17, 18, 20, 29, 30, 37, 38, 40, 47, 48, 51, 58, 60, 63, 69, 72, 73, 79, 80, 81, 82, 83, 88, 89, 91, 93, 99, 100, 102, 105, 111, 112, 113, 118, 119, 120, 121, 124, 130, 133, 134, 141, 143, 145]"
agent_b,L50,short,48,27,21,9,0.6757,148,"[10, 15, 16, 17, 18, 19, 21, 28, 29, 30, 32, 34, 41, 42, 43, 50, 51, 55, 62, 63, 64, 66, 75, 76, 77, 85, 86, 87, 95, 96, 97, 103, 104, 105, 107, 108, 114, 116, 117, 118, 122, 129, 130, 136, 137, 138, 140, 143]"
agent_b,L50,short,46,22,24,7,0.6849,146,"[8, 10, 14, 16, 18, 20, 22, 29, 30, 31, 39, 40, 43, 49, 50, 51, 54, 63, 71, 72, 79, 80, 81, 82, 83, 91, 93, 98, 101, 103, 105, 109, 110, 113, 114, 116, 123, 124, 126, 131, 132, 133, 134, 136, 143, 144]"
agent_b,L50,short,55,36,19,5,0.6452,155,"[6, 9, 17, 18, 19, 24, 26, 27, 28, 29, 37, 38, 40, 48, 51, 57, 58, 60, 61, 68, 69, 70, 71, 74, 82, 89, 91, 93, 98, 100, 102, 103, 105, 110, 111, 112, 113, 114, 115, 121, 122, 125, 126, 127, 133, 134, 135, 136, 137, 138, 139, 148, 149, 150, 151]"
agent_b,L50,short,51,27,24,5,0.6623,151,"[11, 15, 16, 18, 19, 20, 27, 29, 30, 37, 38, 40, 41, 42, 50, 51, 52, 60, 62, 68, 69, 70, 72, 80, 85, 91, 92, 93, 97, 99, 100, 102, 103, 107, 110, 111, 113, 118, 119, 123, 126, 127, 133, 134, 137, 138, 143, 144, 145, 147, 149]"
agent_b,L50,short,50,29,21,5,0.6667,150,"[10, 14, 15, 16, 17, 18, 19, 20, 28, 31, 39, 40, 42, 50, 51, 52, 59, 60, 63, 69, 70, 71, 72, 79, 80, 81, 82, 83, 93, 95, 101, 102, 104, 108, 109, 110, 113, 114, 115, 122, 123, 124, 125, 126, 133, 134, 135, 137, 144, 146]"
agent_b,L50,short,46,28,18,10,0.6849,146,"[4, 9, 14, 22, 26, 30, 31, 36, 37, 39, 40, 42, 49, 50, 51, 53, 59, 62, 64, 71, 72, 73, 79, 80, 82, 83, 86, 93, 94, 95, 101, 103, 104, 105, 106, 111, 113, 114, 115, 117, 123, 124, 128, 136, 137, 138]"
agent_b,L50,short,51,26,25,9,0.6623,151,"[4, 9, 10, 11, 19, 21, 25, 30, 31, 32, 34, 42, 44, 50, 51, 52, 54, 60, 61, 62, 63, 64, 73, 74, 80, 81, 82, 83, 84, 86, 93, 95, 102, 103, 106, 111, 112, 113, 115, 121, 122, 123, 124, 127, 133, 134, 135, 137, 139, 147, 148]"
agent_b,L50,short,49,29,20,7,0.6711,149,"[4, 9, 17, 18, 23, 27, 28, 29, 30, 39, 40, 47, 49, 50, 55, 60, 65, 66, 67, 68, 69, 70, 71, 78, 80, 81, 84, 91, 92, 93, 94, 101, 102, 104, 106, 111, 114, 115, 122, 123, 124, 127, 134, 136, 141, 142, 144, 145, 146]"
agent_b,L50,short,48,33,15,2,0.6757,148,"[4, 9, 10, 11, 19, 20, 21, 33, 39, 41, 43, 48, 49, 50, 51, 52, 58, 59, 60, 61, 62, 63, 71, 72, 73, 81, 82, 84, 92, 94, 96, 103, 105, 106, 110, 111, 113, 114, 115, 116, 124, 125, 126, 127, 135, 136, 137, 144]"
agent_b,L50,short,49,21,28,4,0.6711,149,"[5, 9, 10, 18, 19, 20, 25, 26, 27, 28, 29, 31, 39, 40, 49, 50, 56, 57, 58, 60, 68, 70, 76, 77, 78, 79, 80, 87, 89, 90, 92, 93, 99, 100, 101, 102, 105, 115, 120, 121, 122, 124, 130, 132, 133, 134, 142, 143, 144]"
agent_b,L50,short,55,37,18,5,0.6452,155,"[8, 9, 10, 15, 18, 19, 21, 28, 29, 30, 39, 40, 46, 50, 57, 59, 60, 64, 70, 71, 72, 78, 80, 83, 84, 89, 91, 93, 94, 95, 101, 102, 103, 104, 105, 110, 112, 113, 115, 122, 124, 126, 127, 136, 137, 138, 139, 144, 145, 146, 147, 148, 149, 150, 152]"
agent_b,L50,short,50,33,17,14,0.6667,150,"[5, 10, 11, 19, 21, 23, 28, 29, 30, 31, 38, 44, 51, 56, 63, 70, 73, 75, 78, 79, 82, 86, 90, 91, 93, 95, 98, 99, 100, 101, 102, 103, 105, 106, 110, 111, 112, 114, 115, 116, 122, 123, 124, 125, 126, 134, 137, 144, 145, 146]"
agent_b,L50,short,49,32,17,9,0.6711,149,"[4, 9, 11, 19, 20, 22, 27, 35, 41, 44, 50, 53, 57, 58, 59, 60, 61, 62, 63, 70, 71, 72, 73, 80, 81, 82, 84, 92, 94, 95, 100, 103, 105, 109, 110, 111, 114, 115, 117, 122, 124, 125, 126, 128, 136, 137, 144, 146, 147]"
agent_b,L50,short,48,26,22,3,0.6757,148,"[4, 10, 17, 18, 19, 20, 28, 29, 30, 37, 38, 39, 40, 50, 55, 56, 60, 66, 67, 68, 69, 70, 76, 77, 81, 82, 84, 85, 93, 94, 96, 101, 102, 103, 104, 105, 107, 113, 115, 116, 117, 123, 125, 127, 128, 134, 137, 138]"
agent_b,L50,short,46,24,22,9,0.6849,146,"[4, 9, 17, 21, 26, 27, 28, 30, 36, 38, 39, 40, 48, 50, 51, 57, 58, 60, 61, 68, 70, 71, 78, 80, 81, 82, 89, 91, 92, 97, 98, 99, 100, 101, 104, 110, 111, 112, 119, 124, 131, 132, 133, 135, 142, 143]"
agent_b,L50,short,49,28,21,4,0.6711,149,"[8, 9, 14, 18, 21, 27, 30, 31, 37, 39, 41, 47, 48, 49, 51, 58, 59, 60, 62, 68, 69, 70, 71, 78, 79, 80, 81, 88, 89, 91, 92, 100, 102, 103, 109, 111, 112, 115, 121, 122, 123, 125, 133, 135, 140, 141, 142, 144, 145]"
agent_b,L50,short,47,26,21,5,0.6803,147,"[4, 9, 17, 19, 25, 26, 28, 29, 35, 36, 37, 38, 39, 46, 47, 48, 49, 55, 57, 59, 60, 71, 77, 78, 79, 80, 87, 88, 89, 92, 102, 107, 108, 109, 111, 112, 118, 119, 120, 123, 125, 126, 127, 135, 136, 139, 145]"
agent_b,L50,short,52,25,27,4,0.6579,152,"[6, 9, 17, 18, 19, 20, 25, 26, 27, 28, 29, 30, 40, 41, 50, 53, 59, 61, 67, 68, 69, 70, 73, 79, 80, 82, 83, 90, 91, 92, 94, 95, 96, 97, 104, 105, 106, 107, 109, 115, 116, 118, 119, 126, 128, 129, 138, 139, 146, 147, 148, 149]"
agent_b,L50,short,48,21,27,1,0.6757,148,"[8, 9, 16, 18, 19, 20, 27, 28, 31, 37, 39, 40, 41, 47, 48, 49, 50, 51, 60, 62, 63, 70, 74, 77, 79, 86, 87, 88, 89, 95, 96, 97, 99, 100, 106, 110, 115, 116, 117, 118, 120, 126, 127, 130, 136, 137, 138, 141]"
agent_b,L50,short,47,20,27,9,0.6803,147,"[4, 9, 17, 18, 21, 27, 28, 29, 30, 37, 38, 40, 41, 42, 50, 51, 58, 64, 66, 72, 73, 74, 77, 82, 83, 84, 87, 94, 95, 97, 98, 102, 103, 104, 105, 106, 107, 108, 109, 115, 119, 121, 128, 129, 131, 139, 142]"
agent_b,L50,short,49,27,22,7,0.6711,149,"[5, 9, 10, 14, 21, 26, 27, 29, 31, 32, 39, 40, 41, 42, 52, 57, 58, 59, 61, 63, 70, 71, 72, 75, 82, 83, 90, 92, 93, 98, 103, 105, 109, 110, 111, 112, 113, 114, 116, 121, 123, 125, 126, 134, 136, 138, 144, 146, 147]"
agent_b,L50,short,47,24,23,10,0.6803,147,"[4, 9, 12, 20, 24, 27, 29, 31, 37, 38, 39, 40, 41, 42, 51, 53, 64, 70, 71, 72, 78, 79, 80, 81, 82, 88, 89, 91, 92, 96, 97, 98, 99, 100, 102, 109, 110, 111, 112, 116, 122, 123, 130, 135, 141, 142, 145]"
agent_b,L50,short,45,25,20,7,0.6897,145,"[4, 9, 11, 19, 20, 25, 26, 28, 29, 30, 38, 39, 41, 50, 51, 57, 58, 59, 61, 62, 69, 70, 73, 81, 82, 83, 89, 90, 92, 93, 100, 101, 103, 104, 110, 111, 112, 115, 119, 124, 127, 135, 136, 137, 141]"
agent_b,L50,short,47,23,24,5,0.6803,147,"[4, 9, 20, 24, 27, 28, 29, 31, 37, 39, 41, 47, 48, 49, 51, 57, 59, 60, 61, 69, 70, 71, 77, 79, 80, 81, 90, 91, 96, 98, 100, 101, 102, 109, 111, 113, 118, 120, 122, 127, 131, 132, 138, 139, 140, 143, 144]"
agent_b,L50,short,48,36,12,3,0.6757,148,"[8, 9, 10, 15, 17, 18, 21, 28, 29, 30, 37, 38, 39, 40, 43, 44, 45, 53, 55, 63, 64, 66, 74, 75, 76, 77, 78, 80, 88, 89, 97, 99, 104, 106, 109, 110, 115, 118, 119, 120, 121, 129, 130, 131, 133, 139, 140, 142]"
agent_b,L50,short,49,38,11,6,0.6711,149,"[8, 9, 14, 16, 17, 19, 26, 27, 28, 29, 36, 38, 39, 41, 49, 51, 59, 60, 66, 67, 68, 72, 78, 79, 80, 86, 87, 91, 96, 97, 98, 99, 100, 106, 107, 108, 110, 111, 118, 119, 120, 121, 127, 128, 132, 138, 139, 140, 142]"
agent_b,L50,short,51,38,13,7,0.6623,151,"[8, 9, 14, 18, 19, 20, 21, 28, 29, 30, 31, 39, 41, 49, 50, 51, 52, 53, 63, 64, 68, 74, 75, 76, 84, 85, 86, 95, 97, 101, 102, 103, 104, 105, 106, 107, 115, 116, 117, 124, 125, 127, 133, 137, 138, 142, 143, 144, 145, 147, 148]"
agent_b,L50,short,50,30,20,9,0.6667,150,"[4, 9, 11, 19, 21, 26, 30, 31, 32, 38, 40, 41, 42, 49, 50, 51, 52, 53, 56, 66, 74, 76, 77, 83, 87, 92, 93, 94, 96, 97, 101, 102, 105, 110, 114, 115, 116, 118, 123, 124, 126, 128, 134, 135, 136, 138, 144, 145, 146, 148]"
agent_b,L50,short,47,17,30,5,0.6803,147,"[8, 9, 14, 15, 16, 20, 27, 29, 30, 36, 37, 38, 39, 40, 47, 48, 49, 50, 53, 62, 63, 71, 72, 74, 81, 83, 85, 87, 94, 95, 96, 97, 105, 106, 109, 114, 115, 116, 117, 124, 125, 127, 128, 134, 135, 136, 139]"
agent_b,L50,short,51,25,26,7,0.6623,151,"[4, 9, 19, 23, 24, 26, 28, 29, 35, 36, 37, 38, 39, 41, 49, 50, 51, 58, 59, 61, 62, 66, 74, 80, 81, 82, 83, 84, 91, 92, 93, 94, 101, 103, 105, 112, 113, 115, 120, 121, 122, 123, 124, 125, 132, 133, 136, 143, 144, 145, 146]"
agent_b,L50,short,48,31,17,7,0.6757,148,"[8, 9, 14, 15, 16, 17, 18, 20, 28, 30, 37, 38, 39, 46, 47, 48, 50, 53, 62, 69, 72, 81, 85, 86, 88, 92, 93, 99, 101, 102, 103, 108, 110, 111, 112, 113, 114, 120, 122, 123, 125, 130, 131, 133, 134, 142, 143, 144]"
agent_b,L50,short,47,21,26,4,0.6803,147,"[4, 9, 17, 19, 23, 25, 26, 27, 28, 29, 37, 38, 39, 47, 48, 50, 56, 57, 58, 60, 68, 71, 77, 78, 80, 81, 89, 90, 91, 92, 97, 98, 99, 103, 110, 111, 113, 115, 123, 124, 131, 132, 133, 136, 142, 143, 144]"
agent_b,L50,short,50,19,31,6,0.6667,150,"[9, 13, 16, 17, 18, 19, 26, 27, 28, 30, 37, 38, 39, 46, 49, 50, 57, 58, 59, 61, 67, 68, 70, 71, 74, 82, 84, 90, 91, 92, 96, 102, 103, 105, 106, 107, 108, 109, 111, 117, 118, 119, 121, 122, 131, 132, 140, 142, 143, 144]"
agent_b,L50,short,48,28,20,6,0.6757,148,"[8, 10, 15, 16, 18, 19, 20, 22, 32, 38, 39, 42, 48, 49, 51, 52, 54, 61, 65, 71, 73, 74, 75, 82, 83, 84, 86, 93, 97, 101, 103, 104, 106, 111, 112, 114, 116, 121, 122, 123, 124, 125, 127, 133, 134, 135, 137, 146]"
agent_b,L50,short,47,28,19,6,0.6803,147,"[8, 9, 14, 15, 19, 26, 27, 28, 29, 32, 42, 44, 49, 50, 53, 55, 61, 64, 65, 66, 74, 76, 77, 87, 88, 91, 92, 93, 94, 95, 96, 99, 105, 106, 107, 108, 110, 115, 117, 119, 120, 126, 127, 130, 136, 138, 142]"
agent_b,L50,short,47,30,17,14,0.6803,147,"[8, 10, 14, 15, 17, 19, 27, 29, 30, 32, 39, 40, 43, 49, 50, 51, 54, 61, 65, 71, 72, 76, 82, 83, 88, 89, 90, 91, 92, 93, 99, 103, 106, 112, 113, 116, 120, 123, 124, 129, 132, 133, 134, 140, 142, 143, 145]"
agent_b,L50,short,49,37,12,8,0.6711,149,"[9, 10, 14, 15, 16, 17, 18, 19, 20, 29, 31, 38, 39, 42, 49, 50, 57, 58, 59, 60, 68, 69, 70, 71, 74, 83, 91, 92, 97, 98, 99, 100, 101, 102, 108, 109, 110, 112, 118, 119, 120, 121, 122, 123, 130, 131, 134, 140, 144]"
agent_b,L50,short,53,25,28,1,0.6536,153,"[6, 9, 11, 19, 21, 22, 23, 24, 30, 32, 33, 34, 42, 43, 44, 51, 52, 54, 55, 62, 63, 64, 65, 73, 74, 75, 82, 83, 84, 85, 92, 93, 95, 96, 104, 105, 107, 113, 114, 116, 122, 123, 124, 126, 127, 134, 135, 136, 139, 146, 147, 148, 149]"
agent_b,L50,short,49,33,16,5,0.6711,149,"[8, 9, 11, 15, 16, 18, 19, 20, 21, 30, 32, 39, 40, 42, 49, 50, 53, 61, 62, 68, 70, 71, 72, 79, 80, 83, 88, 89, 91, 92, 99, 100, 101, 102, 103, 109, 110, 112, 113, 119, 121, 122, 124, 131, 133, 141, 143, 144, 145]"
agent_b,L50,short,50,28,22,7,0.6667,150,"[8, 9, 11, 17, 19, 21, 32, 38, 40, 41, 42, 48, 49, 50, 52, 60, 61, 62, 68, 70, 71, 72, 74, 76, 83, 84, 85, 86, 92, 94, 95, 96, 100, 105, 106, 110, 115, 116, 117, 123, 125, 128, 134, 136, 137, 142, 144, 145, 146, 147]"
agent_b,L50,short,49,29,20,7,0.6711,149,"[4, 10, 18, 21, 25, 26, 27, 28, 29, 30, 31, 39, 40, 41, 43, 44, 53, 54, 60, 61, 63, 64, 65, 66, 67, 76, 77, 84, 85, 86, 87, 88, 96, 99, 100, 106, 107, 108, 111, 118, 119, 120, 126, 127, 128, 129, 133, 140, 147]"
agent_b,L50,short,52,25,27,8,0.6579,152,"[4, 9, 10, 14, 22, 23, 28, 29, 33, 34, 36, 37, 45, 46, 48, 49, 56, 58, 60, 66, 68, 70, 77, 78, 81, 86, 87, 88, 89, 91, 97, 98, 99, 100, 105, 106, 107, 108, 111, 118, 120, 121, 127, 129, 131, 137, 138, 139, 140, 141, 148, 150]"
agent_b,L50,short,46,29,17,3,0.6849,146,"[8, 9, 14, 15, 16, 20, 27, 28, 30, 38, 39, 40, 47, 48, 49, 50, 57, 60, 68, 69, 70, 71, 79, 80, 81, 86, 87, 88, 89, 91, 97, 100, 101, 104, 109, 110, 111, 113, 122, 124, 132, 133, 135, 139, 140, 142]"
agent_b,L50,short,51,20,31,13,0.6623,151,"[8, 12, 16, 17, 18, 21, 28, 30, 39, 40, 45, 47, 49, 53, 58, 60, 65, 66, 67, 73, 78, 79, 80, 81, 86, 87, 89, 91, 98, 101, 102, 103, 107, 108, 109, 110, 111, 112, 114, 120, 121, 122, 124, 126, 127, 128, 136, 137, 140, 146, 148]"
agent_b,L50,short,45,25,20,5,0.6897,145,"[4, 10, 18, 20, 24, 27, 28, 29, 31, 33, 34, 44, 45, 46, 54, 56, 62, 63, 66, 72, 73, 74, 76, 81, 82, 84, 85, 87, 93, 94, 95, 96, 102, 103, 105, 108, 114, 115, 117, 118, 121, 128, 130, 139, 142]"
agent_b,L50,short,44,19,25,15,0.6944,144,"[10, 13, 14, 16, 23, 29, 34, 37, 38, 39, 44, 45, 55, 62, 66, 67, 68, 70, 74, 75, 76, 77, 79, 80, 86, 87, 88, 89, 90, 96, 97, 98, 99, 100, 105, 106, 108, 111, 120, 126, 127, 128, 131, 140]"
agent_b,L50,short,47,28,19,13,0.6803,147,"[10, 13, 14, 16, 17, 18, 20, 28, 30, 36, 38, 39, 43, 49, 50, 53, 60, 63, 65, 71, 72, 73, 76, 82, 83, 84, 86, 87, 90, 95, 96, 97, 98, 100, 106, 108, 112, 117, 118, 119, 121, 122, 130, 131, 132, 139, 143]"
agent_b,L50,short,47,19,28,12,0.6803,147,"[8, 9, 10, 11, 16, 18, 20, 21, 30, 31, 38, 39, 40, 43, 49, 50, 52, 61, 62, 64, 70, 71, 72, 74, 81, 82, 85, 90, 91, 93, 99, 100, 103, 107, 112, 113, 114, 120, 121, 122, 123, 127, 133, 134, 141, 143, 144]"
agent_b,L50,short,53,27,26,3,0.6536,153,"[5, 9, 18, 19, 23, 24, 26, 28, 29, 36, 37, 39, 40, 41, 43, 51, 52, 59, 60, 61, 63, 71, 72, 78, 79, 81, 82, 89, 91, 92, 93, 94, 99, 100, 101, 103, 104, 110, 112, 114, 121, 122, 123, 124, 125, 135, 136, 143, 144, 145, 147, 149, 151]"
agent_b,L50,short,53,25,28,5,0.6536,153,"[5, 9, 19, 21, 25, 26, 27, 30, 31, 32, 40, 41, 42, 49, 50, 52, 59, 60, 62, 69, 70, 73, 74, 82, 83, 85, 86, 92, 93, 94, 96, 101, 105, 106, 110, 112, 115, 116, 121, 122, 124, 131, 135, 136, 137, 143, 144, 145, 146, 147, 148, 149, 150]"
agent_b,L50,short,49,26,23,12,0.6711,149,"[4, 9, 17, 18, 19, 21, 26, 27, 28, 29, 30, 31, 33, 41, 43, 51, 52, 55, 61, 62, 63, 67, 75, 82, 83, 84, 85, 93, 94, 95, 100, 107, 113, 114, 115, 116, 120, 124, 125, 126, 127, 128, 130, 135, 137, 138, 139, 145, 146]"
agent_b,L50,short,51,24,27,4,0.6623,151,"[9, 14, 17, 18, 21, 30, 31, 36, 38, 41, 42, 47, 48, 51, 54, 60, 62, 64, 70, 71, 72, 74, 80, 82, 83, 84, 89, 90, 91, 94, 101, 102, 104, 106, 111, 112, 113, 116, 122, 126, 131, 132, 133, 134, 135, 136, 142, 145, 146, 147, 148]"
agent_b,L50,short,51,22,29,5,0.6623,151,"[4, 9, 17, 19, 24, 28, 31, 37, 39, 48, 49, 53, 57, 59, 61, 63, 70, 71, 72, 76, 77, 78, 80, 81, 82, 88, 89, 90, 91, 92, 99, 100, 101, 102, 108, 109, 110, 111, 112, 118, 119, 120, 122, 123, 132, 135, 142, 143, 144, 145, 146]"
agent_b,L50,short,52,30,22,2,0.6579,152,"[8, 9, 14, 15, 16, 21, 29, 31, 32, 38, 39, 40, 41, 42, 50, 52, 59, 60, 61, 62, 63, 66, 74, 75, 82, 83, 84, 85, 92, 93, 94, 95, 105, 106, 111, 113, 115, 116, 123, 124, 125, 126, 132, 133, 134, 136, 137, 138, 139, 146, 148, 149]"
agent_b,L50,short,51,21,30,7,0.6623,151,"[4, 9, 11, 12, 15, 25, 31, 32, 33, 34, 35, 42, 43, 44, 45, 47, 55, 58, 64, 66, 72, 76, 77, 82, 83, 86, 87, 88, 89, 95, 96, 98, 99, 104, 105, 106, 107, 108, 109, 110, 122, 128, 129, 130, 131, 137, 138, 139, 141, 148, 149]"
agent_b,L50,short,45,25,20,6,0.6897,145,"[8, 10, 14, 16, 17, 18, 19, 27, 28, 29, 37, 38, 39, 41, 49, 51, 59, 60, 61, 63, 72, 78, 79, 80, 82, 87, 91, 92, 98, 100, 101, 102, 106, 108, 109, 110, 111, 113, 119, 124, 129, 130, 134, 141, 142]"
agent_b,L50,short,47,24,23,8,0.6803,147,"[8, 9, 10, 11, 17, 19, 21, 28, 30, 32, 39, 41, 47, 49, 50, 51, 66, 71, 75, 77, 78, 79, 80, 81, 83, 91, 92, 95, 101, 102, 103, 104, 109, 110, 111, 114, 120, 121, 122, 123, 126, 127, 133, 134, 135, 136, 139]"
agent_b,L50,short,46,27,19,8,0.6849,146,"[9, 13, 15, 16, 18, 20, 21, 29, 32, 38, 41, 46, 49, 50, 52, 59, 60, 62, 68, 69, 70, 71, 79, 80, 81, 86, 87, 88, 91, 98, 99, 102, 106, 107, 108, 109, 112, 117, 118, 119, 120, 121, 128, 130, 133, 142]"
agent_b,L50,short,50,29,21,5,0.6667,150,"[9, 16, 17, 21, 26, 27, 30, 35, 36, 37, 38, 40, 48, 49, 51, 58, 60, 62, 68, 69, 70, 72, 78, 79, 81, 83, 89, 90, 91, 92, 98, 99, 100, 102, 109, 110, 112, 113, 114, 115, 123, 124, 125, 131, 132, 133, 136, 143, 144, 145]"
agent_b,L50,short,50,24,26,6,0.6667,150,"[9, 14, 15, 17, 19, 26, 28, 30, 38, 40, 41, 46, 48, 49, 50, 54, 60, 62, 68, 70, 73, 79, 80, 81, 82, 87, 89, 90, 92, 93, 94, 100, 101, 103, 105, 106, 111, 113, 114, 115, 116, 124, 125, 126, 133, 134, 137, 143, 144, 146]"
agent_b,L50,short,53,34,19,5,0.6536,153,"[6, 10, 17, 18, 19, 20, 25, 27, 28, 29, 30, 38, 39, 40, 43, 51, 52, 53, 60, 61, 62, 63, 71, 72, 73, 81, 82, 83, 84, 85, 92, 94, 95, 102, 103, 104, 106, 113, 114, 115, 116, 118, 125, 126, 128, 134, 135, 136, 137, 138, 146, 147, 148]"
agent_b,L50,short,48,29,19,5,0.6757,148,"[4, 10, 11, 12, 20, 21, 22, 23, 31, 32, 33, 35, 42, 44, 50, 52, 53, 54, 57, 64, 65, 67, 74, 75, 76, 77, 78, 85, 86, 88, 91, 93, 101, 102, 104, 109, 112, 113, 114, 115, 116, 124, 125, 128, 134, 135, 136, 146]"
agent_b,L50,short,49,25,24,11,0.6711,149,"[5, 9, 10, 18, 19, 20, 25, 26, 27, 29, 30, 31, 34, 42, 44, 51, 52, 55, 61, 62, 63, 64, 65, 73, 78, 84, 87, 93, 96, 100, 102, 103, 105, 109, 115, 116, 120, 121, 122, 124, 125, 126, 131, 134, 135, 136, 142, 145, 146]"
agent_b,L50,short,47,21,26,5,0.6803,147,"[8, 9, 10, 15, 16, 17, 18, 19, 20, 29, 32, 39, 41, 47, 48, 49, 51, 52, 60, 64, 70, 71, 73, 74, 81, 83, 84, 85, 92, 93, 96, 102, 103, 104, 105, 107, 113, 116, 117, 126, 128, 133, 134, 137, 138, 139, 140]"
agent_b,L50,short,48,27,21,2,0.6757,148,"[6, 9, 17, 18, 19, 20, 21, 28, 29, 30, 31, 32, 40, 41, 42, 51, 52, 61, 62, 69, 70, 71, 73, 79, 80, 82, 92, 96, 97, 100, 101, 102, 107, 108, 111, 112, 117, 118, 120, 122, 128, 129, 130, 132, 138, 139, 141, 143]"
agent_b,L50,short,47,21,26,5,0.6803,147,"[5, 9, 19, 25, 26, 30, 35, 36, 37, 39, 46, 47, 48, 49, 50, 57, 59, 60, 66, 68, 69, 70, 76, 77, 79, 80, 81, 89, 90, 95, 100, 101, 102, 108, 109, 110, 112, 119, 120, 121, 122, 131, 133, 139, 140, 141, 142]"
agent_b,L50,short,49,34,15,5,0.6711,149,"[8, 9, 14, 17, 18, 19, 20, 28, 29, 31, 38, 40, 41, 49, 52, 59, 60, 61, 62, 68, 70, 72, 78, 79, 80, 81, 82, 83, 90, 91, 93, 99, 100, 102, 105, 110, 112, 114, 119, 121, 123, 129, 130, 131, 133, 134, 142, 143, 145]"
agent_b,L50,short,52,31,21,3,0.6579,152,"[4, 9, 17, 18, 19, 24, 26, 27, 28, 32, 39, 40, 41, 42, 50, 52, 58, 59, 60, 61, 62, 70, 72, 73, 74, 84, 86, 92, 93, 94, 95, 102, 103, 104, 106, 111, 113, 114, 115, 122, 123, 125, 126, 128, 136, 137, 143, 144, 145, 146, 148, 149]"
agent_b,L50,short,46,27,19,6,0.6849,146,"[5, 10, 17, 18, 20, 22, 27, 29, 30, 31, 38, 39, 40, 41, 42, 51, 53, 59, 61, 63, 71, 73, 75, 83, 86, 91, 92, 94, 98, 99, 100, 101, 103, 104, 110, 111, 117, 122, 123, 124, 127, 133, 135, 136, 141, 142]"
agent_b,L50,short,48,37,11,4,0.6757,148,"[9, 13, 14, 15, 16, 18, 19, 20, 21, 31, 38, 39, 40, 41, 43, 44, 55, 63, 64, 70, 76, 81, 82, 83, 84, 85, 90, 91, 93, 94, 95, 101, 103, 105, 110, 111, 112, 113, 117, 118, 120, 126, 127, 128, 129, 136, 137, 140]"
agent_b,L50,short,49,26,23,8,0.6711,149,"[4, 9, 11, 19, 20, 21, 27, 29, 30, 31, 40, 42, 48, 51, 56, 58, 59, 60, 61, 69, 70, 71, 77, 78, 80, 82, 83, 92, 93, 98, 99, 100, 101, 103, 105, 111, 112, 113, 114, 116, 122, 124, 130, 135, 136, 137, 140, 146, 147]"
agent_b,L50,short,50,36,14,8,0.6667,150,"[8, 10, 14, 15, 16, 17, 18, 19, 21, 22, 33, 40, 41, 42, 43, 44, 52, 53, 54, 55, 64, 65, 73, 74, 80, 87, 94, 95, 96, 103, 104, 106, 107, 108, 109, 110, 112, 118, 119, 120, 121, 129, 131, 132, 133, 134, 141, 142, 143, 145]"
agent_b,L50,short,50,37,13,8,0.6667,150,"[4, 11, 18, 19, 20, 21, 26, 27, 32, 40, 41, 47, 52, 57, 59, 63, 69, 70, 71, 73, 79, 80, 81, 82, 88, 90, 92, 96, 97, 98, 99, 100, 101, 102, 105, 111, 113, 118, 119, 122, 123, 124, 130, 131, 132, 133, 134, 143, 144, 145]"
agent_b,L50,short,47,27,20,2,0.6803,147,"[8, 9, 14, 15, 19, 20, 22, 29, 30, 32, 39, 41, 47, 48, 49, 51, 61, 67, 68, 69, 71, 72, 78, 81, 82, 89, 91, 92, 97, 98, 99, 100, 101, 102, 109, 112, 113, 118, 119, 120, 122, 123, 129, 132, 133, 142, 143]"
agent_b,L50,short,44,23,21,7,0.6944,144,"[5, 11, 18, 19, 20, 28, 30, 39, 41, 45, 47, 48, 49, 50, 51, 52, 54, 60, 61, 62, 63, 64, 72, 73, 74, 81, 82, 84, 91, 92, 93, 96, 102, 103, 104, 105, 111, 114, 115, 122, 124, 125, 128, 139]"
agent_b,L50,short,44,25,19,7,0.6944,144,"[4, 10, 13, 20, 21, 22, 27, 28, 29, 30, 31, 32, 40, 41, 44, 51, 52, 53, 61, 62, 63, 71, 72, 74, 80, 82, 84, 85, 92, 94, 95, 101, 102, 103, 104, 105, 114, 115, 121, 123, 124, 125, 128, 139]"
agent_b,L50,short,50,23,27,6,0.6667,150,"[4, 9, 17, 18, 21, 27, 30, 36, 38, 39, 47, 48, 49, 50, 51, 53, 60, 61, 62, 69, 71, 72, 73, 74, 76, 83, 84, 85, 86, 93, 97, 105, 107, 113, 115, 116, 117, 118, 120, 125, 126, 127, 128, 129, 130, 138, 139, 140, 147, 148]"
agent_b,L50,short,52,39,13,7,0.6579,152,"[4, 9, 10, 11, 21, 22, 29, 35, 36, 41, 42, 43, 44, 45, 46, 54, 55, 56, 62, 63, 67, 69, 70, 71, 72, 80, 81, 86, 92, 95, 97, 103, 104, 105, 106, 108, 116, 117, 118, 123, 124, 126, 127, 128, 134, 135, 136, 139, 145, 146, 147, 148]"
agent_b,L50,short,49,25,24,8,0.6711,149,"[9, 13, 15, 16, 17, 20, 21, 22, 24, 32, 34, 41, 42, 43, 49, 51, 52, 54, 63, 65, 71, 72, 75, 83, 85, 90, 91, 92, 93, 94, 100, 101, 102, 106, 112, 113, 114, 115, 121, 122, 125, 130, 131, 133, 134, 135, 143, 144, 146]"
agent_b,L50,short,51,29,22,7,0.6623,151,"[4, 13, 19, 20, 21, 26, 27, 28, 29, 31, 32, 33, 34, 35, 43, 44, 46, 55, 56, 58, 65, 66, 67, 75, 76, 78, 86, 87, 94, 95, 96, 97, 100, 106, 108, 109, 111, 117, 118, 119, 120, 127, 128, 129, 130, 137, 138, 140, 141, 148, 149]"
agent_b,L50,short,52,21,31,9,0.6579,152,"[4, 9, 21, 25, 26, 27, 28, 30, 37, 42, 47, 48, 49, 50, 51, 57, 59, 60, 61, 68, 70, 75, 80, 82, 87, 90, 91, 92, 94, 99, 101, 102, 103, 108, 109, 111, 113, 119, 120, 121, 122, 124, 126, 132, 133, 134, 135, 136, 143, 144, 145, 146]"
agent_b,L50,short,49,30,19,7,0.6711,149,"[9, 13, 14, 15, 16, 17, 20, 21, 29, 30, 31, 32, 34, 42, 44, 51, 53, 55, 62, 65, 71, 74, 75, 83, 87, 92, 93, 95, 101, 102, 103, 104, 105, 108, 112, 114, 115, 117, 123, 125, 126, 127, 133, 134, 136, 137, 142, 144, 145]"
agent_b,L100,short,47,27,20,5,0.6803,147,"[4, 12, 18, 20, 29, 31, 33, 39, 40, 42, 43, 48, 49, 50, 51, 53, 61, 62, 63, 64, 66, 67, 68, 75, 76, 77, 78, 86, 87, 88, 96, 97, 98, 99, 107, 109, 117, 118, 119, 121, 128, 129, 130, 137, 138, 139, 140]"
agent_b,L100,short,43,36,7,11,0.6993,143,"[4, 9, 10, 11, 12, 21, 22, 23, 29, 30, 31, 34, 41, 42, 43, 48, 56, 62, 65, 66, 73, 74, 76, 83, 84, 85, 88, 95, 97, 102, 103, 104, 107, 118, 123, 124, 125, 128, 134, 136, 137, 138, 139]"
agent_b,L100,short,49,30,19,0,0.6711,149,"[4, 9, 10, 11, 12, 20, 22, 30, 31, 32, 33, 41, 42, 43, 50, 51, 52, 53, 60, 64, 72, 73, 74, 83, 84, 90, 91, 92, 93, 94, 96, 103, 105, 106, 107, 108, 115, 117, 118, 125, 126, 127, 129, 136, 137, 139, 140, 141, 142]"
agent_b,L100,short,46,30,16,7,0.6849,146,"[4, 10, 20, 24, 25, 26, 27, 31, 37, 40, 46, 48, 51, 56, 58, 60, 62, 70, 71, 75, 78, 80, 81, 87, 89, 91, 94, 96, 101, 102, 104, 105, 109, 114, 115, 116, 117, 123, 125, 126, 127, 134, 135, 136, 137, 144]"
agent_b,L100,short,49,27,22,6,0.6711,149,"[5, 9, 11, 20, 21, 26, 27, 28, 29, 31, 33, 40, 41, 43, 51, 52, 53, 61, 62, 63, 74, 75, 82, 83, 84, 86, 92, 93, 94, 97, 103, 104, 105, 106, 112, 113, 116, 123, 124, 125, 127, 135, 136, 142, 143, 144, 145, 146, 147]"
agent_b,L100,short,49,31,18,5,0.6711,149,"[7, 9, 14, 15, 20, 27, 28, 29, 35, 39, 41, 49, 50, 56, 58, 59, 60, 65, 66, 68, 69, 70, 81, 82, 83, 86, 91, 92, 93, 96, 102, 103, 104, 105, 110, 111, 113, 114, 115, 116, 118, 125, 126, 129, 137, 138, 139, 141, 142]"
agent_b,L100,short,48,24,24,11,0.6757,148,"[4, 15, 21, 25, 28, 29, 34, 35, 38, 39, 45, 46, 48, 49, 50, 56, 57, 60, 66, 67, 69, 71, 77, 78, 79, 81, 88, 89, 90, 98, 99, 100, 101, 108, 109, 110, 111, 112, 119, 122, 124, 131, 132, 133, 140, 141, 142, 143]"
agent_b,L100,short,46,31,15,4,0.6849,146,"[4, 9, 15, 17, 19, 28, 29, 32, 34, 43, 46, 51, 52, 53, 56, 57, 59, 66, 68, 70, 76, 77, 78, 79, 84, 86, 87, 88, 90, 97, 99, 100, 101, 102, 110, 111, 112, 113, 122, 124, 131, 133, 134, 140, 142, 144]"
agent_b,L100,short,45,29,16,6,0.6897,145,"[8, 9, 10, 16, 17, 18, 20, 27, 28, 30, 34, 41, 42, 50, 51, 53, 60, 61, 63, 64, 70, 71, 72, 73, 75, 82, 86, 91, 92, 95, 102, 103, 104, 105, 107, 115, 116, 123, 124, 126, 127, 128, 137, 139, 140]"
agent_b,L100,short,49,30,19,2,0.6711,149,"[4, 9, 15, 16, 18, 19, 26, 27, 29, 30, 39, 40, 47, 48, 50, 51, 52, 59, 60, 61, 62, 69, 71, 72, 79, 80, 82, 90, 92, 97, 98, 99, 100, 101, 102, 109, 110, 113, 119, 121, 124, 125, 127, 136, 143, 144, 145, 146, 147]"
agent_b,L100,short,46,34,12,4,0.6849,146,"[5, 9, 16, 17, 18, 19, 25, 26, 27, 28, 30, 39, 45, 46, 47, 48, 49, 50, 58, 59, 60, 61, 62, 63, 64, 66, 75, 76, 85, 86, 87, 88, 89, 100, 107, 108, 109, 110, 118, 120, 127, 129, 130, 137, 139, 142]"
agent_b,L100,short,46,32,14,6,0.6849,146,"[4, 9, 12, 19, 20, 25, 28, 30, 36, 37, 39, 42, 48, 49, 50, 56, 57, 58, 61, 69, 72, 77, 78, 79, 82, 88, 89, 91, 92, 97, 99, 100, 103, 110, 111, 112, 113, 121, 123, 131, 132, 134, 140, 142, 143, 144]"
agent_b,L100,short,42,23,19,6,0.7042,142,"[4, 9, 11, 19, 20, 21, 22, 23, 29, 30, 32, 35, 43, 46, 53, 55, 56, 63, 65, 67, 75, 76, 77, 83, 86, 88, 90, 96, 97, 99, 100, 106, 107, 109, 110, 117, 122, 124, 131, 133, 134, 138]"
agent_b,L100,short,48,35,13,7,0.6757,148,"[4, 9, 16, 19, 25, 26, 27, 28, 29, 42, 47, 48, 50, 52, 55, 60, 61, 62, 64, 71, 72, 73, 78, 82, 83, 89, 91, 92, 93, 94, 99, 100, 101, 104, 105, 112, 114, 115, 122, 123, 124, 125, 127, 135, 137, 144, 145, 146]"
agent_b,L100,short,45,31,14,12,0.6897,145,"[4, 9, 15, 17, 19, 25, 26, 27, 28, 29, 31, 41, 43, 49, 51, 53, 59, 60, 62, 70, 73, 78, 79, 80, 81, 85, 91, 92, 93, 97, 98, 99, 100, 101, 102, 103, 104, 114, 116, 117, 118, 120, 128, 133, 140]"
agent_b,L100,short,44,30,14,8,0.6944,144,"[7, 8, 9, 15, 16, 17, 19, 20, 31, 32, 39, 40, 41, 43, 44, 45, 52, 53, 54, 55, 64, 67, 74, 75, 81, 82, 83, 85, 86, 93, 95, 100, 106, 108, 114, 119, 125, 126, 127, 128, 129, 135, 138, 139]"
agent_b,L100,short,44,34,10,8,0.6944,144,"[8, 12, 18, 19, 20, 23, 32, 39, 40, 41, 46, 50, 51, 57, 58, 60, 61, 62, 67, 68, 69, 70, 71, 72, 80, 82, 83, 91, 92, 95, 105, 110, 112, 114, 115, 120, 121, 122, 123, 124, 125, 128, 135, 138]"
agent_b,L100,short,49,30,19,6,0.6711,149,"[7, 9, 14, 15, 16, 19, 20, 30, 36, 37, 38, 39, 40, 41, 49, 50, 53, 65, 70, 71, 76, 78, 79, 80, 81, 86, 87, 89, 90, 91, 93, 94, 103, 104, 110, 112, 114, 115, 123, 124, 125, 133, 134, 135, 136, 143, 144, 145, 147]"
agent_b,L100,short,48,31,17,12,0.6757,148,"[5, 9, 10, 13, 20, 21, 27, 29, 30, 33, 40, 43, 50, 51, 52, 58, 61, 64, 71, 72, 77, 78, 80, 81, 83, 89, 90, 91, 93, 98, 99, 100, 101, 102, 104, 111, 112, 113, 119, 120, 121, 123, 124, 132, 133, 137, 144, 145]"
agent_b,L100,short,45,33,12,6,0.6897,145,"[7, 8, 9, 16, 17, 18, 19, 20, 28, 34, 40, 48, 49, 50, 55, 56, 57, 58, 59, 61, 70, 77, 79, 80, 87, 90, 96, 99, 100, 105, 106, 108, 109, 110, 116, 118, 119, 121, 127, 128, 129, 132, 139, 140, 141]"
agent_b,L100,short,41,19,22,6,0.7092,141,"[4, 9, 16, 18, 20, 21, 22, 30, 31, 33, 41, 42, 43, 49, 51, 53, 59, 60, 61, 62, 65, 73, 79, 80, 86, 92, 93, 95, 100, 101, 102, 103, 104, 111, 113, 114, 122, 124, 131, 133, 135]"
agent_b,L100,short,47,31,16,12,0.6803,147,"[7, 8, 11, 15, 18, 19, 27, 28, 29, 31, 32, 39, 40, 42, 50, 53, 61, 62, 64, 67, 72, 73, 74, 75, 83, 90, 95, 96, 97, 98, 101, 107, 108, 109, 110, 115, 116, 117, 118, 119, 120, 128, 129, 130, 138, 139, 141]"
agent_b,L100,short,43,22,21,13,0.6993,143,"[5, 10, 17, 20, 27, 28, 29, 30, 31, 32, 40, 41, 44, 52, 57, 58, 59, 60, 62, 63, 64, 67, 74, 76, 78, 85, 89, 96, 100, 107, 110, 116, 118, 119, 122, 127, 128, 129, 130, 135, 136, 138, 141]"
agent_b,L100,short,46,32,14,11,0.6849,146,"[8, 9, 14, 16, 18, 19, 26, 27, 28, 32, 41, 48, 50, 58, 59, 60, 65, 66, 67, 68, 69, 70, 77, 78, 79, 81, 87, 88, 89, 91, 98, 99, 100, 101, 107, 108, 109, 110, 111, 114, 122, 125, 133, 140, 142, 144]"
agent_b,L100,short,47,26,21,10,0.6803,147,"[4, 10, 17, 18, 19, 27, 28, 29, 30, 33, 40, 41, 47, 48, 50, 52, 58, 60, 62, 68, 69, 70, 72, 79, 80, 81, 84, 91, 94, 98, 99, 100, 101, 102, 110, 111, 114, 122, 123, 130, 132, 133, 139, 140, 142, 143, 145]"
agent_b,L100,short,45,28,17,4,0.6897,145,"[7, 10, 12, 19, 20, 21, 22, 28, 30, 31, 32, 33, 41, 44, 45, 52, 53, 54, 55, 57, 64, 66, 68, 75, 77, 84, 85, 87, 93, 95, 96, 98, 104, 106, 108, 111, 117, 118, 119, 120, 127, 129, 130, 139, 140]"
agent_b,L100,short,49,38,11,5,0.6711,149,"[7, 8, 9, 15, 17, 18, 19, 20, 21, 29, 30, 31, 39, 40, 41, 51, 57, 58, 59, 60, 64, 71, 79, 80, 81, 82, 83, 85, 92, 93, 94, 95, 96, 97, 98, 99, 108, 110, 112, 113, 120, 121, 122, 123, 124, 125, 134, 136, 147]"
agent_b,L100,short,48,24,24,2,0.6757,148,"[4, 9, 10, 17, 18, 19, 20, 26, 27, 29, 30, 39, 40, 41, 42, 51, 53, 62, 63, 70, 71, 72, 75, 81, 82, 83, 85, 86, 92, 94, 96, 97, 98, 99, 107, 109, 110, 118, 119, 120, 121, 122, 123, 134, 137, 143, 144, 145]"
agent_b,L100,short,46,30,16,3,0.6849,146,"[7, 9, 10, 16, 17, 19, 20, 29, 30, 36, 38, 39, 40, 49, 50, 56, 58, 59, 60, 68, 70, 77, 78, 79, 81, 86, 87, 90, 92, 94, 104, 110, 112, 113, 114, 121, 123, 124, 130, 131, 132, 133, 134, 140, 141, 142]"
agent_b,L100,short,46,25,21,3,0.6849,146,"[7, 8, 9, 16, 17, 18, 19, 20, 29, 30, 37, 39, 41, 49, 50, 56, 57, 58, 59, 60, 62, 69, 70, 71, 79, 80, 82, 91, 97, 98, 99, 101, 107, 108, 109, 110, 111, 112, 113, 114, 122, 123, 124, 134, 141, 144]"
agent_b,L100,short,46,21,25,5,0.6849,146,"[4, 9, 16, 17, 18, 19, 25, 28, 29, 31, 38, 39, 40, 47, 48, 49, 52, 58, 59, 61, 62, 63, 64, 72, 73, 75, 82, 84, 91, 92, 93, 94, 100, 101, 102, 106, 113, 115, 117, 118, 125, 127, 128, 135, 137, 139]"
agent_b,L100,short,46,32,14,10,0.6849,146,"[8, 9, 13, 19, 21, 22, 29, 30, 31, 32, 33, 36, 43, 45, 47, 55, 56, 57, 63, 64, 65, 66, 69, 75, 76, 78, 86, 91, 96, 99, 105, 107, 109, 113, 114, 116, 117, 118, 126, 127, 128, 129, 136, 137, 138, 140]"
agent_b,L100,short,49,23,26,2,0.6711,149,"[7, 8, 9, 10, 16, 19, 20, 22, 29, 30, 31, 40, 42, 49, 50, 51, 57, 58, 59, 60, 61, 68, 69, 70, 71, 79, 81, 88, 90, 91, 92, 93, 100, 103, 109, 110, 112, 113, 115, 123, 125, 126, 133, 134, 136, 137, 145, 146, 147]"
agent_b,L100,short,44,23,21,11,0.6944,144,"[7, 10, 12, 18, 19, 20, 22, 29, 30, 33, 41, 47, 49, 50, 51, 56, 58, 59, 60, 62, 69, 70, 72, 79, 80, 82, 89, 90, 92, 98, 99, 100, 102, 105, 111, 112, 114, 121, 122, 123, 130, 132, 133, 142]"
agent_b,L100,short,45,27,18,6,0.6897,145,"[4, 10, 17, 18, 19, 25, 30, 36, 38, 39, 45, 46, 48, 49, 50, 57, 60, 66, 68, 70, 71, 73, 78, 79, 81, 82, 83, 86, 92, 94, 95, 96, 97, 105, 106, 107, 108, 115, 117, 118, 127, 128, 129, 136, 140]"
agent_b,L100,short,48,32,16,8,0.6757,148,"[4, 10, 18, 19, 20, 21, 24, 30, 31, 32, 34, 42, 44, 53, 54, 55, 61, 62, 63, 64, 67, 73, 74, 76, 77, 86, 92, 98, 101, 102, 103, 104, 106, 107, 108, 109, 110, 117, 119, 120, 127, 129, 130, 131, 133, 140, 141, 143]"
agent_b,L100,short,47,29,18,8,0.6803,147,"[4, 11, 18, 19, 25, 27, 30, 33, 39, 41, 46, 48, 49, 50, 51, 58, 59, 61, 68, 69, 70, 71, 72, 73, 80, 81, 84, 92, 93, 98, 102, 103, 104, 111, 113, 114, 120, 121, 123, 126, 127, 134, 135, 136, 137, 138, 139]"
agent_b,L100,short,46,21,25,4,0.6849,146,"[7, 8, 9, 15, 17, 18, 19, 29, 35, 36, 37, 38, 40, 47, 49, 56, 57, 59, 60, 68, 69, 70, 71, 78, 81, 87, 88, 90, 92, 99, 100, 101, 102, 108, 109, 112, 114, 121, 124, 131, 132, 133, 139, 140, 141, 143]"
agent_b,L100,short,46,27,19,6,0.6849,146,"[4, 9, 15, 17, 18, 19, 21, 27, 28, 29, 30, 39, 40, 47, 49, 50, 56, 57, 58, 60, 68, 69, 72, 79, 81, 82, 83, 91, 92, 95, 101, 103, 104, 107, 113, 114, 117, 124, 125, 126, 132, 134, 135, 137, 143, 144]"
agent_b,L100,short,47,26,21,8,0.6803,147,"[8, 10, 14, 15, 18, 19, 26, 29, 35, 36, 39, 42, 48, 49, 50, 53, 60, 61, 62, 64, 65, 72, 75, 83, 86, 90, 92, 93, 94, 97, 103, 105, 110, 113, 114, 116, 123, 124, 125, 126, 132, 134, 135, 136, 142, 143, 145]"
agent_b,L100,short,52,39,13,9,0.6579,152,"[7, 8, 10, 15, 16, 18, 19, 20, 28, 29, 31, 38, 40, 41, 49, 50, 53, 61, 63, 69, 71, 73, 75, 82, 83, 85, 90, 91, 93, 98, 104, 108, 109, 110, 111, 112, 113, 114, 115, 116, 117, 118, 119, 120, 121, 122, 131, 132, 133, 143, 144, 145]"
agent_b,L100,short,42,22,20,6,0.7042,142,"[4, 9, 15, 16, 18, 20, 27, 28, 30, 32, 39, 40, 41, 42, 49, 50, 51, 52, 54, 63, 71, 72, 73, 74, 80, 82, 84, 91, 92, 93, 94, 99, 102, 103, 104, 112, 113, 115, 125, 131, 135, 140]"
agent_b,L100,short,43,22,21,5,0.6993,143,"[8, 10, 11, 15, 18, 19, 21, 23, 31, 32, 40, 41, 42, 43, 45, 46, 49, 56, 57, 64, 68, 74, 75, 77, 84, 85, 87, 88, 89, 90, 97, 99, 100, 107, 109, 110, 113, 122, 129, 130, 132, 138, 141]"
agent_b,L100,short,46,23,23,5,0.6849,146,"[5, 9, 10, 18, 19, 20, 21, 22, 28, 30, 32, 39, 40, 44, 51, 52, 58, 59, 61, 63, 71, 74, 80, 81, 82, 84, 90, 92, 93, 94, 99, 101, 103, 104, 111, 112, 114, 115, 118, 125, 126, 127, 134, 135, 136, 138]"
agent_b,L100,short,44,22,22,6,0.6944,144,"[7, 8, 9, 11, 16, 18, 20, 28, 29, 30, 36, 37, 38, 39, 40, 49, 50, 51, 58, 60, 64, 70, 71, 72, 80, 81, 82, 83, 84, 91, 92, 93, 94, 102, 103, 105, 115, 117, 124, 126, 128, 135, 137, 139]"
agent_b,L100,short,44,18,26,7,0.6944,144,"[8, 12, 17, 19, 26, 28, 29, 34, 35, 36, 37, 38, 39, 46, 50, 57, 58, 60, 66, 67, 72, 78, 79, 80, 82, 88, 89, 92, 98, 102, 103, 110, 111, 112, 114, 119, 121, 122, 124, 131, 134, 139, 140, 142]"
agent_b,L100,short,44,17,27,4,0.6944,144,"[4, 9, 10, 17, 18, 19, 21, 23, 25, 32, 33, 35, 43, 44, 45, 53, 54, 55, 63, 64, 65, 76, 83, 84, 86, 92, 93, 94, 95, 99, 105, 106, 107, 108, 109, 116, 117, 118, 119, 126, 127, 128, 130, 139]"
agent_b,L100,short,44,36,8,4,0.6944,144,"[4, 9, 17, 18, 19, 25, 26, 31, 40, 46, 47, 48, 49, 51, 57, 59, 62, 63, 70, 71, 72, 73, 74, 75, 76, 82, 83, 84, 85, 86, 94, 95, 96, 97, 98, 99, 108, 109, 118, 120, 130, 137, 138, 139]"
agent_b,L100,short,51,34,17,5,0.6623,151,"[8, 9, 11, 15, 17, 18, 19, 20, 28, 30, 36, 37, 38, 40, 48, 49, 50, 51, 59, 60, 61, 69, 70, 71, 72, 85, 90, 91, 92, 100, 103, 107, 108, 109, 110, 111, 115, 121, 122, 123, 124, 125, 133, 136, 137, 143, 144, 145, 147, 148, 149]"
agent_b,L100,short,43,25,18,11,0.6993,143,"[4, 9, 11, 14, 21, 23, 32, 33, 39, 41, 42, 44, 50, 51, 53, 54, 60, 61, 63, 64, 65, 73, 74, 75, 77, 84, 85, 86, 87, 95, 97, 98, 105, 107, 114, 119, 125, 126, 127, 129, 136, 137, 138]"
agent_b,L100,short,42,21,21,6,0.7042,142,"[4, 10, 12, 13, 21, 22, 23, 29, 31, 34, 35, 37, 44, 45, 46, 48, 57, 62, 64, 67, 68, 75, 76, 77, 78, 86, 88, 90, 100, 105, 108, 110, 118, 119, 123, 125, 126, 127, 129, 135, 136, 140]"
agent_b,L100,short,48,30,18,0,0.6757,148,"[8, 9, 14, 15, 18, 19, 26, 27, 29, 30, 31, 32, 39, 40, 42, 51, 52, 58, 59, 60, 62, 70, 71, 72, 80, 82, 83, 84, 91, 94, 101, 102, 103, 104, 105, 106, 112, 114, 115, 116, 118, 119, 120, 128, 129, 131, 140, 142]"
agent_b,L100,short,47,35,12,3,0.6803,147,"[7, 8, 10, 11, 16, 17, 18, 19, 20, 21, 30, 31, 32, 40, 42, 50, 51, 52, 59, 60, 61, 62, 70, 71, 72, 74, 82, 83, 85, 93, 94, 101, 103, 105, 110, 111, 112, 113, 114, 123, 124, 125, 133, 134, 136, 143, 145]"
agent_b,L100,short,41,24,17,4,0.7092,141,"[4, 10, 11, 19, 22, 27, 28, 30, 31, 38, 39, 40, 42, 49, 50, 51, 59, 60, 61, 67, 70, 71, 77, 78, 79, 82, 89, 91, 92, 97, 99, 102, 108, 109, 111, 112, 120, 123, 130, 131, 132]"
agent_b,L100,short,46,32,14,3,0.6849,146,"[4, 10, 17, 18, 20, 21, 29, 31, 37, 38, 39, 40, 41, 42, 45, 52, 53, 54, 55, 56, 65, 67, 74, 77, 81, 86, 90, 96, 97, 98, 99, 100, 101, 107, 108, 109, 110, 111, 113, 120, 121, 122, 131, 132, 139, 143]"
agent_b,L100,short,42,19,23,12,0.7042,142,"[5, 9, 10, 18, 19, 20, 22, 28, 29, 30, 33, 35, 43, 44, 45, 49, 57, 64, 65, 66, 72, 73, 74, 77, 78, 80, 81, 88, 94, 101, 103, 107, 109, 111, 112, 121, 123, 130, 131, 133, 139, 140]"
agent_b,L100,short,44,26,18,12,0.6944,144,"[11, 16, 19, 20, 24, 29, 31, 32, 39, 41, 43, 49, 50, 51, 52, 53, 60, 62, 63, 70, 71, 72, 73, 75, 82, 83, 84, 91, 92, 93, 97, 103, 105, 110, 111, 112, 113, 114, 115, 116, 125, 127, 135, 137]"
agent_b,L100,short,45,23,22,4,0.6897,145,"[4, 9, 16, 17, 18, 19, 28, 29, 36, 37, 38, 39, 40, 41, 48, 49, 51, 60, 62, 68, 70, 71, 73, 79, 82, 88, 89, 90, 91, 93, 99, 100, 101, 102, 103, 104, 112, 113, 114, 121, 122, 125, 133, 135, 138]"
agent_b,L100,short,46,23,23,6,0.6849,146,"[4, 9, 16, 17, 18, 19, 25, 26, 27, 28, 30, 39, 45, 46, 47, 52, 59, 67, 68, 69, 74, 76, 78, 79, 86, 87, 88, 89, 90, 97, 98, 99, 100, 107, 108, 109, 112, 118, 119, 120, 121, 130, 131, 133, 141, 142]"
agent_b,L100,short,40,31,9,16,0.7143,140,"[8, 14, 18, 19, 25, 26, 29, 34, 35, 38, 39, 40, 50, 57, 58, 59, 61, 66, 68, 69, 71, 78, 79, 80, 85, 86, 87, 88, 89, 91, 97, 103, 108, 109, 111, 112, 120, 121, 122, 135]"
agent_b,L100,short,47,30,17,5,0.6803,147,"[4, 9, 15, 16, 17, 19, 26, 27, 28, 31, 39, 45, 46, 48, 50, 58, 60, 65, 67, 70, 76, 77, 80, 86, 89, 91, 94, 95, 97, 98, 100, 106, 107, 108, 109, 110, 116, 117, 118, 119, 120, 121, 122, 132, 139, 141, 142]"
agent_b,L100,short,45,25,20,5,0.6897,145,"[7, 8, 9, 13, 20, 23, 30, 31, 32, 33, 39, 40, 41, 43, 45, 53, 55, 62, 63, 64, 66, 73, 74, 75, 77, 85, 86, 92, 93, 94, 95, 96, 103, 105, 106, 114, 115, 119, 127, 134, 135, 136, 137, 138, 143]"
agent_b,L100,short,47,26,21,10,0.6803,147,"[7, 9, 11, 15, 16, 19, 21, 28, 29, 30, 36, 37, 38, 39, 40, 53, 60, 66, 67, 68, 70, 77, 78, 79, 81, 87, 88, 89, 90, 97, 98, 99, 101, 106, 107, 109, 110, 120, 126, 127, 128, 129, 132, 133, 134, 137, 144]"
agent_b,L100,short,49,26,23,8,0.6711,149,"[7, 8, 9, 10, 14, 21, 27, 28, 29, 31, 32, 39, 40, 42, 49, 50, 51, 55, 63, 69, 70, 72, 78, 80, 81, 84, 90, 91, 92, 94, 95, 102, 103, 105, 110, 111, 112, 116, 123, 124, 125, 127, 134, 135, 137, 144, 145, 146, 147]"
agent_b,L100,short,49,32,17,7,0.6711,149,"[8, 11, 15, 16, 17, 18, 21, 28, 29, 30, 37, 39, 40, 42, 50, 54, 60, 61, 62, 69, 71, 72, 73, 80, 82, 83, 84, 91, 92, 93, 94, 95, 104, 105, 110, 111, 115, 121, 122, 123, 126, 133, 134, 135, 136, 143, 144, 145, 147]"
agent_b,L100,short,46,26,20,6,0.6849,146,"[5, 9, 15, 16, 18, 20, 26, 28, 29, 41, 46, 49, 54, 55, 56, 57, 58, 60, 66, 67, 69, 75, 76, 77, 79, 85, 86, 88, 90, 98, 100, 108, 109, 110, 115, 116, 117, 119, 121, 129, 130, 132, 138, 139, 140, 141]"
agent_b,L100,short,42,25,17,9,0.7042,142,"[4, 10, 17, 20, 28, 29, 34, 36, 37, 38, 39, 46, 49, 54, 55, 56, 57, 60, 66, 67, 69, 72, 79, 80, 82, 92, 97, 98, 99, 100, 101, 107, 109, 110, 112, 118, 119, 120, 121, 127, 134, 137]"
agent_b,L100,short,49,27,22,4,0.6711,149,"[4, 9, 10, 17, 18, 19, 20, 21, 28, 29, 30, 31, 41, 42, 50, 51, 52, 58, 59, 61, 62, 69, 70, 72, 79, 80, 82, 89, 93, 97, 99, 100, 101, 104, 111, 112, 113, 120, 121, 122, 123, 124, 125, 133, 134, 136, 143, 145, 147]"
agent_b,L100,short,47,25,22,4,0.6803,147,"[8, 10, 14, 17, 19, 21, 27, 28, 30, 36, 37, 38, 39, 40, 41, 42, 52, 58, 59, 61, 62, 69, 73, 79, 80, 81, 82, 88, 89, 90, 92, 93, 94, 104, 110, 111, 112, 114, 115, 123, 124, 126, 133, 134, 135, 143, 145]"
agent_b,L100,short,47,38,9,4,0.6803,147,"[4, 10, 17, 19, 24, 26, 27, 28, 29, 37, 38, 39, 45, 46, 47, 48, 49, 57, 60, 61, 73, 78, 79, 80, 81, 82, 89, 90, 93, 97, 98, 99, 102, 110, 111, 112, 113, 120, 122, 123, 130, 132, 134, 140, 141, 142, 143]"
agent_b,L100,short,44,26,18,6,0.6944,144,"[4, 10, 17, 18, 19, 25, 26, 29, 36, 37, 38, 39, 45, 47, 48, 50, 56, 60, 66, 69, 75, 76, 77, 78, 79, 85, 86, 87, 88, 89, 95, 96, 98, 99, 107, 108, 109, 110, 111, 119, 120, 122, 133, 141]"
agent_b,L100,short,46,32,14,9,0.6849,146,"[5, 10, 11, 12, 13, 16, 23, 24, 25, 28, 35, 36, 38, 46, 48, 55, 57, 62, 63, 65, 66, 69, 75, 76, 77, 85, 86, 87, 88, 95, 98, 99, 100, 101, 108, 109, 110, 111, 118, 120, 121, 129, 131, 134, 142, 143]"
agent_b,L100,short,45,31,14,11,0.6897,145,"[7, 8, 9, 16, 17, 18, 19, 28, 29, 35, 36, 39, 47, 49, 55, 56, 57, 58, 60, 67, 68, 69, 70, 71, 74, 81, 83, 91, 92, 99, 100, 102, 108, 110, 113, 119, 120, 126, 131, 132, 133, 138, 139, 141, 142]"
agent_b,L100,short,46,26,20,3,0.6849,146,"[8, 9, 10, 11, 12, 13, 14, 22, 23, 25, 34, 41, 43, 44, 45, 52, 53, 54, 56, 63, 64, 66, 67, 68, 70, 72, 79, 82, 83, 90, 91, 92, 94, 103, 111, 112, 113, 120, 121, 122, 123, 132, 133, 139, 140, 143]"
agent_b,L100,short,48,25,23,5,0.6757,148,"[7, 8, 9, 16, 17, 18, 19, 27, 28, 30, 36, 38, 39, 48, 49, 52, 59, 61, 67, 68, 70, 71, 79, 80, 82, 88, 89, 90, 91, 97, 99, 100, 101, 102, 109, 110, 111, 112, 113, 120, 122, 124, 134, 140, 141, 142, 143, 144]"
agent_b,L100,short,47,25,22,5,0.6803,147,"[6, 9, 10, 17, 18, 20, 26, 27, 28, 29, 30, 42, 49, 50, 58, 59, 61, 66, 67, 68, 69, 71, 77, 78, 79, 82, 89, 90, 91, 92, 93, 95, 101, 104, 111, 114, 120, 121, 122, 123, 126, 134, 140, 141, 142, 143, 144]"
agent_b,L100,short,44,27,17,8,0.6944,144,"[7, 9, 10, 11, 13, 20, 21, 22, 29, 30, 32, 39, 42, 49, 50, 53, 60, 61, 62, 65, 67, 74, 75, 76, 84, 85, 86, 91, 92, 94, 95, 96, 103, 104, 105, 106, 107, 109, 110, 124, 133, 139, 140, 141]"
agent_b,L100,short,47,34,13,4,0.6803,147,"[5, 9, 10, 17, 18, 20, 26, 27, 28, 29, 30, 39, 40, 47, 49, 52, 58, 59, 60, 67, 68, 69, 70, 71, 72, 75, 82, 83, 84, 92, 93, 94, 100, 101, 102, 103, 104, 105, 106, 116, 117, 118, 126, 127, 128, 137, 141]"
agent_b,L100,short,47,26,21,4,0.6803,147,"[7, 8, 11, 16, 19, 25, 26, 28, 29, 35, 37, 39, 47, 48, 50, 57, 59, 65, 67, 68, 69, 77, 78, 79, 80, 86, 87, 89, 90, 97, 100, 101, 108, 111, 113, 119, 120, 122, 128, 129, 130, 132, 138, 140, 141, 143, 144]"
agent_b,L100,short,46,17,29,7,0.6849,146,"[7, 8, 9, 16, 19, 20, 28, 29, 30, 36, 37, 40, 48, 51, 52, 54, 60, 63, 69, 70, 71, 72, 73, 79, 81, 82, 83, 84, 86, 89, 95, 97, 98, 100, 107, 108, 111, 120, 127, 128, 129, 136, 137, 138, 139, 141]"
agent_b,L100,short,47,18,29,13,0.6803,147,"[7, 8, 9, 17, 18, 19, 20, 28, 29, 30, 31, 39, 40, 47, 53, 59, 61, 63, 69, 70, 71, 72, 73, 79, 81, 83, 89, 91, 92, 93, 94, 101, 105, 112, 113, 114, 115, 116, 122, 125, 126, 134, 135, 138, 143, 144, 145]"
agent_b,L100,short,44,27,17,6,0.6944,144,"[7, 8, 9, 19, 22, 30, 31, 32, 37, 38, 39, 40, 45, 52, 53, 54, 55, 61, 64, 65, 71, 73, 74, 75, 82, 83, 84, 87, 92, 93, 94, 95, 102, 103, 106, 116, 121, 122, 123, 124, 125, 133, 135, 137]"
agent_b,L100,short,43,22,21,14,0.6993,143,"[9, 13, 19, 20, 22, 24, 25, 26, 27, 29, 36, 41, 47, 48, 54, 55, 57, 60, 67, 68, 69, 71, 78, 79, 80, 86, 87, 88, 89, 90, 94, 101, 107, 110, 112, 120, 122, 128, 129, 130, 134, 139, 141]"
agent_b,L100,short,46,25,21,4,0.6849,146,"[9, 13, 14, 15, 16, 19, 26, 27, 29, 31, 37, 38, 39, 41, 42, 51, 53, 63, 70, 71, 74, 80, 81, 82, 88, 89, 90, 91, 92, 98, 99, 101, 102, 108, 109, 111, 112, 119, 120, 121, 122, 123, 133, 140, 141, 144]"
agent_b,L100,short,45,31,14,5,0.6897,145,"[5, 9, 11, 12, 13, 14, 15, 23, 25, 26, 29, 36, 37, 38, 46, 47, 48, 49, 57, 58, 59, 66, 67, 68, 69, 70, 71, 72, 73, 84, 92, 93, 95, 103, 107, 112, 113, 114, 117, 125, 129, 135, 136, 138, 140]"
agent_b,L100,short,47,30,17,6,0.6803,147,"[8, 10, 14, 15, 16, 17, 18, 19, 28, 29, 31, 33, 34, 35, 44, 45, 53, 56, 62, 63, 64, 65, 72, 74, 75, 82, 85, 86, 93, 95, 98, 105, 106, 113, 114, 116, 121, 122, 123, 124, 126, 133, 134, 135, 137, 143, 145]"
agent_b,L100,short,47,25,22,9,0.6803,147,"[7, 9, 10, 17, 18, 19, 22, 30, 32, 33, 34, 37, 44, 45, 48, 54, 55, 56, 57, 64, 65, 66, 67, 74, 75, 77, 79, 87, 88, 90, 97, 98, 100, 102, 109, 110, 112, 118, 121, 123, 130, 131, 132, 133, 140, 141, 143]"
agent_b,L100,short,47,28,19,9,0.6803,147,"[8, 11, 16, 17, 19, 26, 27, 31, 37, 39, 45, 46, 47, 49, 50, 56, 57, 58, 61, 67, 68, 69, 70, 78, 83, 90, 92, 93, 102, 103, 106, 107, 108, 110, 112, 113, 120, 121, 124, 131, 132, 133, 134, 140, 141, 142, 144]"
agent_b,L100,short,45,23,22,15,0.6897,145,"[4, 10, 17, 18, 20, 21, 27, 38, 43, 50, 52, 55, 56, 57, 59, 60, 61, 66, 68, 69, 74, 79, 83, 88, 90, 92, 93, 96, 98, 99, 100, 102, 104, 111, 112, 114, 121, 123, 129, 131, 132, 133, 139, 140, 143]"
agent_b,L100,short,46,33,13,7,0.6849,146,"[6, 9, 20, 24, 25, 27, 29, 36, 39, 45, 47, 48, 50, 55, 56, 59, 64, 65, 66, 67, 69, 70, 75, 80, 81, 88, 90, 91, 96, 97, 98, 99, 100, 101, 109, 111, 113, 121, 122, 123, 125, 132, 134, 135, 142, 144]"
agent_b,L100,short,42,26,16,10,0.7042,142,"[4, 9, 10, 17, 18, 19, 21, 27, 29, 31, 39, 41, 47, 49, 50, 51, 58, 65, 70, 71, 72, 73, 75, 80, 81, 82, 83, 84, 91, 92, 93, 94, 100, 101, 102, 103, 104, 119, 127, 133, 134, 135]"
agent_b,L100,short,44,24,20,12,0.6944,144,"[7, 9, 14, 15, 16, 17, 18, 19, 22, 31, 37, 38, 39, 40, 48, 50, 51, 59, 61, 67, 69, 70, 71, 72, 80, 81, 82, 89, 90, 91, 92, 99, 106, 107, 111, 116, 117, 118, 126, 127, 129, 136, 137, 139]"
agent_b,L100,short,46,31,15,9,0.6849,146,"[5, 9, 10, 19, 21, 29, 30, 31, 37, 42, 43, 48, 49, 52, 53, 54, 60, 61, 62, 63, 64, 72, 73, 74, 81, 82, 84, 86, 93, 96, 102, 104, 105, 106, 112, 114, 115, 116, 123, 124, 125, 126, 127, 129, 132, 140]"
agent_b,L100,short,49,19,30,5,0.6711,149,"[7, 8, 9, 16, 19, 26, 28, 29, 35, 36, 37, 38, 39, 46, 47, 48, 50, 51, 58, 59, 62, 70, 71, 78, 81, 86, 88, 89, 90, 93, 100, 101, 102, 103, 104, 108, 115, 116, 122, 123, 124, 125, 126, 127, 135, 136, 137, 145, 147]"
agent_b,L100,short,45,24,21,6,0.6897,145,"[4, 10, 17, 18, 19, 27, 29, 38, 39, 40, 41, 49, 50, 51, 57, 59, 60, 62, 63, 65, 72, 73, 74, 75, 76, 83, 85, 86, 92, 93, 94, 95, 96, 102, 104, 108, 116, 117, 124, 125, 128, 134, 135, 136, 138]"
agent_b,L100,short,43,27,16,9,0.6993,143,"[4, 9, 15, 16, 17, 19, 26, 27, 28, 29, 34, 42, 48, 49, 50, 51, 57, 58, 60, 61, 68, 69, 70, 71, 78, 79, 80, 81, 91, 97, 98, 101, 107, 109, 112, 120, 121, 126, 130, 133, 138, 140, 141]"
agent_b,L100,short,47,19,28,3,0.6803,147,"[5, 10, 17, 18, 19, 20, 21, 27, 29, 30, 32, 39, 40, 41, 48, 49, 51, 58, 59, 61, 62, 64, 65, 74, 77, 86, 92, 93, 95, 96, 102, 103, 105, 106, 112, 113, 114, 116, 118, 127, 129, 135, 136, 137, 138, 139, 140]"
agent_b,L100,short,45,26,19,6,0.6897,145,"[7, 8, 9, 16, 17, 18, 19, 27, 28, 29, 36, 37, 38, 40, 47, 48, 49, 51, 58, 59, 62, 69, 70, 71, 82, 88, 89, 90, 91, 97, 98, 99, 100, 102, 109, 110, 113, 120, 121, 128, 129, 131, 138, 139, 141]"
agent_b,L100,short,43,30,13,10,0.6993,143,"[7, 8, 10, 16, 17, 18, 20, 27, 28, 29, 30, 37, 39, 41, 50, 51, 52, 54, 55, 63, 65, 73, 75, 79, 85, 87, 91, 92, 94, 98, 104, 106, 110, 114, 115, 116, 118, 125, 126, 128, 134, 135, 139]"
agent_b,L100,short,44,28,16,7,0.6944,144,"[7, 8, 10, 16, 17, 18, 21, 29, 30, 31, 32, 33, 40, 41, 42, 44, 52, 53, 54, 55, 64, 65, 72, 73, 74, 75, 82, 83, 85, 86, 87, 95, 97, 99, 107, 110, 116, 119, 127, 128, 131, 137, 138, 140]"
agent_b,L0,middle,31,20,11,0,0.7634,131,"[19, 26, 28, 31, 32, 33, 34, 35, 36, 37, 39, 56, 57, 58, 59, 71, 72, 74, 75, 79, 93, 95, 96, 97, 99, 100, 115, 118, 119, 120, 121]"
agent_b,L0,middle,32,17,15,3,0.7576,132,"[17, 21, 30, 31, 32, 33, 34, 36, 37, 38, 39, 41, 58, 60, 71, 72, 73, 74, 75, 78, 79, 80, 81, 97, 99, 101, 117, 118, 119, 120, 121, 122]"
agent_b,L0,middle,30,24,6,1,0.7692,130,"[8, 18, 19, 21, 36, 37, 38, 40, 52, 53, 55, 56, 57, 58, 59, 60, 62, 78, 79, 80, 81, 82, 98, 100, 102, 103, 117, 120, 121, 124]"
agent_b,L0,middle,32,16,16,1,0.7576,132,"[17, 18, 19, 20, 29, 32, 33, 34, 35, 36, 37, 38, 39, 40, 58, 59, 61, 63, 78, 79, 80, 82, 99, 100, 102, 103, 105, 120, 121, 123, 124, 125]"
agent_b,L0,middle,30,14,16,2,0.7692,130,"[9, 17, 18, 19, 34, 35, 37, 38, 39, 54, 55, 56, 59, 74, 75, 76, 77, 80, 82, 96, 98, 99, 101, 102, 116, 119, 120, 121, 122, 124]"
agent_b,L0,middle,32,14,18,3,0.7576,132,"[8, 16, 17, 18, 19, 20, 21, 22, 39, 41, 42, 43, 56, 58, 60, 61, 62, 63, 67, 83, 84, 86, 101, 102, 103, 104, 105, 106, 108, 125, 126, 127]"
agent_b,L0,middle,25,13,12,4,0.8,125,"[17, 18, 20, 30, 31, 33, 34, 37, 39, 41, 59, 65, 79, 80, 81, 84, 98, 102, 103, 115, 116, 117, 118, 121, 123]"
agent_b,L0,middle,29,19,10,5,0.7752,129,"[17, 18, 19, 27, 29, 30, 33, 34, 35, 36, 37, 38, 39, 40, 41, 59, 60, 61, 62, 63, 80, 81, 83, 84, 100, 102, 103, 109, 124]"
agent_b,L0,middle,30,25,5,2,0.7692,130,"[17, 18, 19, 27, 29, 31, 33, 34, 35, 38, 39, 55, 56, 57, 62, 75, 76, 77, 78, 79, 80, 81, 83, 102, 116, 117, 118, 120, 121, 122]"
agent_b,L0,middle,30,24,6,5,0.7692,130,"[9, 19, 33, 34, 36, 37, 38, 39, 53, 54, 55, 56, 57, 59, 60, 75, 76, 77, 78, 80, 83, 97, 98, 99, 101, 102, 118, 119, 121, 126]"
agent_b,L0,middle,33,25,8,3,0.7519,133,"[17, 18, 20, 21, 32, 33, 34, 35, 36, 37, 38, 39, 40, 41, 59, 64, 76, 78, 79, 80, 82, 83, 84, 86, 102, 104, 106, 120, 121, 122, 123, 124, 125]"
agent_b,L0,middle,28,19,9,2,0.7812,128,"[8, 16, 17, 19, 20, 35, 37, 38, 39, 40, 54, 56, 57, 58, 59, 60, 76, 77, 79, 80, 95, 97, 98, 99, 102, 117, 118, 120]"
agent_b,L0,middle,32,17,15,4,0.7576,132,"[8, 19, 24, 38, 39, 40, 41, 51, 53, 54, 56, 58, 60, 62, 77, 79, 80, 81, 82, 95, 96, 97, 98, 99, 100, 102, 117, 118, 119, 120, 121, 122]"
agent_b,L0,middle,30,23,7,1,0.7692,130,"[18, 19, 29, 32, 33, 34, 35, 36, 38, 40, 55, 56, 57, 60, 74, 76, 77, 78, 79, 81, 96, 97, 98, 99, 101, 102, 118, 119, 121, 122]"
agent_b,L0,middle,32,14,18,2,0.7576,132,"[11, 18, 19, 33, 35, 36, 38, 40, 54, 57, 58, 59, 60, 74, 75, 77, 79, 80, 83, 96, 97, 98, 100, 101, 102, 116, 117, 118, 119, 120, 121, 122]"
agent_b,L0,middle,33,10,23,4,0.7519,133,"[9, 17, 19, 33, 34, 35, 36, 38, 39, 50, 51, 52, 53, 55, 56, 57, 58, 60, 80, 94, 95, 98, 99, 101, 103, 106, 121, 122, 123, 124, 125, 126, 127]"
agent_b,L0,middle,28,25,3,5,0.7812,128,"[17, 18, 19, 27, 28, 29, 31, 32, 33, 34, 35, 36, 37, 38, 39, 58, 60, 73, 74, 76, 78, 82, 98, 100, 115, 117, 118, 119]"
agent_b,L0,middle,29,21,8,5,0.7752,129,"[17, 18, 19, 29, 30, 34, 35, 36, 37, 38, 41, 56, 57, 58, 59, 75, 76, 77, 78, 80, 95, 97, 98, 100, 115, 116, 117, 118, 120]"
agent_b,L0,middle,30,20,10,2,0.7692,130,"[8, 16, 19, 20, 21, 36, 40, 41, 52, 53, 54, 55, 57, 58, 59, 61, 62, 77, 78, 81, 82, 97, 98, 102, 116, 117, 118, 120, 121, 124]"
agent_b,L0,middle,30,18,12,1,0.7692,130,"[8, 16, 17, 19, 21, 37, 38, 39, 40, 42, 54, 56, 58, 60, 61, 62, 77, 78, 79, 80, 81, 82, 83, 100, 103, 104, 120, 121, 123, 124]"
agent_b,L0,middle,33,26,7,3,0.7519,133,"[17, 18, 20, 28, 29, 30, 31, 32, 33, 34, 35, 36, 37, 38, 40, 58, 59, 60, 61, 64, 80, 82, 83, 99, 100, 101, 102, 103, 106, 121, 122, 123, 124]"
agent_b,L0,middle,31,25,6,0,0.7634,131,"[17, 19, 29, 30, 31, 32, 34, 35, 36, 37, 38, 39, 56, 57, 59, 71, 72, 73, 74, 75, 77, 78, 79, 96, 97, 99, 114, 115, 116, 118, 119]"
agent_b,L0,middle,28,18,10,4,0.7812,128,"[8, 16, 17, 19, 35, 36, 37, 38, 39, 50, 51, 52, 53, 54, 56, 57, 60, 62, 78, 79, 81, 82, 98, 99, 101, 105, 121, 123]"
agent_b,L0,middle,31,18,13,6,0.7634,131,"[8, 22, 36, 37, 38, 41, 51, 52, 53, 54, 55, 56, 57, 58, 59, 76, 77, 78, 79, 80, 95, 96, 97, 98, 99, 100, 101, 117, 118, 119, 122]"
agent_b,L0,middle,26,10,16,2,0.7937,126,"[19, 26, 28, 30, 32, 33, 39, 42, 58, 60, 71, 72, 74, 75, 77, 78, 79, 80, 94, 95, 99, 100, 114, 116, 119, 120]"
agent_b,L0,middle,27,14,13,2,0.7874,127,"[8, 16, 17, 19, 20, 22, 38, 40, 44, 57, 59, 61, 62, 76, 77, 78, 79, 80, 82, 95, 98, 100, 101, 102, 116, 118, 122]"
agent_b,L0,middle,29,9,20,0,0.7752,129,"[8, 16, 17, 19, 34, 35, 36, 39, 40, 56, 57, 59, 60, 73, 76, 77, 78, 79, 81, 82, 96, 100, 101, 102, 103, 118, 120, 121, 123]"
agent_b,L0,middle,27,13,14,4,0.7874,127,"[8, 16, 18, 19, 35, 36, 38, 39, 53, 54, 56, 58, 61, 76, 77, 78, 79, 83, 97, 98, 99, 102, 115, 116, 118, 121, 122]"
agent_b,L0,middle,32,28,4,5,0.7576,132,"[20, 29, 30, 31, 32, 33, 34, 35, 36, 37, 39, 40, 42, 58, 60, 63, 76, 77, 78, 79, 81, 82, 84, 100, 101, 102, 103, 104, 120, 121, 122, 125]"
agent_b,L0,middle,36,17,19,1,0.7353,136,"[18, 20, 31, 33, 34, 35, 36, 37, 38, 39, 54, 55, 56, 57, 58, 59, 60, 73, 74, 75, 76, 78, 79, 81, 98, 99, 100, 101, 102, 103, 104, 105, 121, 122, 123, 125]"
agent_b,L0,middle,32,12,20,1,0.7576,132,"[8, 18, 19, 33, 35, 36, 37, 38, 39, 50, 51, 52, 53, 55, 56, 57, 58, 59, 61, 63, 82, 83, 84, 85, 86, 102, 103, 104, 105, 107, 124, 126]"
agent_b,L0,middle,34,17,17,2,0.7463,134,"[8, 16, 17, 18, 20, 35, 37, 38, 39, 40, 54, 55, 57, 58, 59, 61, 76, 77, 78, 79, 80, 81, 97, 98, 99, 100, 102, 103, 119, 120, 121, 122, 124, 125]"
agent_b,L0,middle,26,19,7,4,0.7937,126,"[17, 18, 19, 27, 28, 29, 30, 34, 35, 36, 40, 56, 57, 58, 59, 71, 72, 73, 79, 94, 96, 97, 100, 115, 118, 121]"
agent_b,L0,middle,28,22,6,2,0.7812,128,"[17, 19, 27, 28, 29, 33, 34, 35, 36, 39, 40, 56, 57, 58, 59, 61, 73, 78, 79, 80, 96, 99, 101, 115, 117, 118, 119, 120]"
agent_b,L0,middle,30,18,12,5,0.7692,130,"[8, 16, 17, 18, 19, 21, 38, 40, 41, 42, 43, 44, 46, 62, 63, 64, 69, 84, 85, 86, 100, 101, 102, 104, 107, 121, 123, 125, 126, 128]"
agent_b,L0,middle,28,19,9,3,0.7812,128,"[20, 29, 30, 31, 32, 33, 35, 37, 38, 39, 54, 55, 56, 57, 58, 59, 73, 75, 78, 80, 82, 97, 100, 101, 103, 117, 118, 122]"
agent_b,L0,middle,33,21,12,1,0.7519,133,"[17, 18, 19, 20, 29, 30, 32, 34, 35, 36, 37, 38, 40, 41, 43, 60, 61, 62, 75, 76, 77, 78, 79, 80, 82, 99, 100, 102, 103, 104, 122, 123, 124]"
agent_b,L0,middle,31,15,16,2,0.7634,131,"[8, 16, 17, 18, 19, 35, 36, 37, 38, 40, 54, 55, 56, 57, 58, 60, 61, 77, 80, 81, 82, 99, 100, 101, 103, 118, 119, 120, 121, 122, 126]"
agent_b,L0,middle,30,19,11,4,0.7692,130,"[10, 18, 19, 21, 37, 39, 41, 51, 52, 53, 54, 55, 56, 57, 60, 75, 76, 78, 80, 81, 97, 98, 99, 100, 101, 105, 120, 121, 122, 124]"
agent_b,L0,middle,32,25,7,6,0.7576,132,"[8, 16, 18, 20, 25, 39, 40, 41, 42, 43, 58, 59, 61, 62, 64, 79, 80, 85, 98, 99, 100, 101, 102, 103, 104, 105, 106, 123, 124, 125, 126, 127]"
agent_b,L0,middle,30,18,12,3,0.7692,130,"[17, 18, 19, 21, 32, 35, 36, 37, 39, 41, 57, 58, 59, 60, 61, 75, 76, 78, 80, 81, 96, 97, 98, 103, 116, 117, 118, 120, 121, 122]"
agent_b,L0,middle,31,21,10,3,0.7634,131,"[8, 16, 18, 19, 35, 37, 38, 39, 53, 54, 55, 56, 61, 74, 75, 76, 77, 78, 81, 95, 96, 97, 98, 101, 115, 116, 117, 118, 119, 120, 122]"
agent_b,L0,middle,30,20,10,3,0.7692,130,"[17, 18, 19, 20, 23, 34, 35, 36, 38, 41, 57, 58, 59, 60, 61, 75, 79, 80, 81, 95, 96, 97, 98, 99, 100, 102, 118, 119, 120, 121]"
agent_b,L0,middle,31,19,12,0,0.7634,131,"[9, 18, 20, 34, 35, 36, 39, 40, 42, 53, 54, 56, 57, 59, 61, 62, 77, 78, 80, 81, 82, 97, 99, 100, 102, 117, 118, 119, 120, 121, 122]"
agent_b,L0,middle,30,18,12,4,0.7692,130,"[17, 18, 19, 27, 28, 29, 30, 33, 34, 35, 36, 37, 38, 40, 59, 61, 76, 79, 80, 83, 97, 99, 101, 103, 116, 117, 118, 119, 121, 122]"
agent_b,L0,middle,29,21,8,4,0.7752,129,"[17, 18, 20, 28, 29, 30, 33, 34, 35, 36, 39, 55, 56, 57, 62, 75, 76, 80, 94, 95, 96, 97, 98, 100, 101, 117, 119, 121, 123]"
agent_b,L0,middle,29,20,9,2,0.7752,129,"[17, 18, 19, 20, 21, 37, 39, 41, 56, 58, 59, 61, 62, 66, 78, 79, 81, 82, 83, 84, 98, 101, 102, 105, 121, 123, 124, 125, 126]"
agent_b,L0,middle,35,20,15,2,0.7407,135,"[9, 17, 18, 19, 34, 35, 36, 40, 41, 53, 55, 57, 58, 59, 60, 61, 62, 77, 78, 79, 81, 82, 83, 84, 85, 87, 103, 105, 106, 107, 108, 109, 128, 129, 131]"
agent_b,L0,middle,30,11,19,5,0.7692,130,"[9, 18, 19, 33, 34, 35, 36, 37, 38, 43, 55, 57, 60, 61, 75, 76, 78, 80, 81, 82, 84, 98, 99, 101, 102, 103, 105, 122, 123, 124]"
agent_b,L0,middle,30,20,10,4,0.7692,130,"[8, 16, 18, 20, 35, 37, 38, 40, 52, 53, 54, 56, 57, 60, 74, 75, 76, 78, 79, 82, 96, 98, 100, 114, 116, 117, 120, 121, 122, 124]"
agent_b,L0,middle,32,18,14,0,0.7576,132,"[17, 19, 27, 28, 29, 34, 36, 37, 38, 39, 54, 55, 56, 57, 59, 75, 76, 77, 78, 79, 80, 96, 97, 98, 99, 100, 115, 116, 118, 119, 120, 121]"
agent_b,L0,middle,33,23,10,0,0.7519,133,"[9, 17, 18, 19, 35, 36, 38, 39, 52, 53, 54, 55, 56, 57, 58, 59, 76, 78, 80, 81, 82, 97, 98, 100, 101, 102, 104, 105, 106, 122, 123, 125, 126]"
agent_b,L0,middle,30,20,10,3,0.7692,130,"[8, 16, 17, 18, 19, 35, 36, 37, 41, 53, 54, 56, 57, 58, 61, 75, 77, 78, 79, 80, 81, 96, 97, 99, 100, 101, 103, 119, 120, 122]"
agent_b,L0,middle,28,18,10,3,0.7812,128,"[17, 18, 19, 20, 29, 30, 33, 34, 35, 36, 37, 39, 41, 58, 59, 60, 61, 64, 79, 81, 82, 97, 98, 100, 101, 103, 118, 122]"
agent_b,L0,middle,33,24,9,2,0.7519,133,"[18, 20, 21, 31, 32, 36, 38, 40, 41, 58, 59, 60, 61, 62, 65, 79, 80, 81, 82, 83, 84, 101, 102, 103, 107, 109, 122, 123, 124, 125, 128, 129, 130]"
agent_b,L0,middle,29,13,16,1,0.7752,129,"[17, 19, 20, 28, 29, 30, 32, 33, 34, 35, 36, 37, 38, 39, 40, 58, 60, 73, 74, 79, 81, 96, 98, 99, 102, 118, 119, 121, 122]"
agent_b,L0,middle,30,19,11,2,0.7692,130,"[9, 17, 18, 19, 35, 37, 38, 39, 40, 54, 55, 56, 57, 58, 59, 62, 77, 80, 81, 82, 97, 98, 99, 100, 103, 119, 120, 122, 123, 124]"
agent_b,L0,middle,27,12,15,1,0.7874,127,"[17, 18, 19, 20, 31, 32, 34, 37, 38, 39, 40, 56, 58, 59, 61, 75, 76, 78, 80, 96, 98, 100, 114, 115, 118, 119, 120]"
agent_b,L0,middle,33,15,18,2,0.7519,133,"[18, 19, 29, 30, 33, 35, 37, 38, 41, 56, 57, 58, 59, 70, 71, 74, 75, 76, 77, 78, 79, 94, 95, 96, 97, 98, 99, 101, 117, 118, 119, 120, 121]"
agent_b,L0,middle,27,18,9,4,0.7874,127,"[17, 20, 31, 33, 34, 35, 38, 39, 42, 58, 59, 62, 73, 76, 78, 79, 80, 93, 95, 96, 97, 98, 101, 115, 117, 118, 121]"
agent_b,L0,middle,30,21,9,7,0.7692,130,"[17, 18, 19, 23, 32, 33, 34, 36, 38, 39, 41, 44, 60, 61, 64, 79, 81, 83, 99, 100, 101, 102, 103, 116, 117, 118, 121, 122, 123, 127]"
agent_b,L0,middle,29,17,12,4,0.7752,129,"[17, 19, 27, 28, 29, 31, 33, 34, 35, 36, 37, 40, 57, 58, 59, 72, 75, 76, 78, 79, 83, 99, 100, 115, 116, 117, 118, 120, 121]"
agent_b,L0,middle,30,19,11,2,0.7692,130,"[18, 19, 27, 29, 32, 33, 34, 35, 36, 37, 40, 56, 57, 60, 63, 76, 77, 78, 80, 81, 97, 99, 100, 101, 117, 118, 119, 120, 121, 123]"
agent_b,L0,middle,29,14,15,4,0.7752,129,"[8, 16, 17, 18, 21, 36, 37, 38, 39, 53, 55, 56, 57, 58, 59, 75, 77, 78, 79, 81, 98, 99, 100, 101, 115, 116, 118, 119, 122]"
agent_b,L0,middle,31,23,8,3,0.7634,131,"[17, 18, 21, 31, 32, 34, 37, 40, 41, 42, 58, 60, 61, 62, 74, 77, 78, 79, 80, 81, 83, 98, 99, 100, 101, 102, 118, 119, 120, 121, 122]"
agent_b,L0,middle,29,17,12,3,0.7752,129,"[17, 18, 19, 27, 29, 30, 32, 33, 34, 36, 37, 38, 40, 57, 58, 59, 61, 74, 75, 77, 78, 79, 81, 98, 100, 116, 118, 119, 120]"
agent_b,L0,middle,29,17,12,0,0.7752,129,"[9, 19, 20, 35, 36, 37, 40, 51, 53, 54, 56, 57, 60, 73, 74, 76, 77, 78, 79, 80, 97, 99, 100, 114, 115, 116, 117, 118, 120]"
agent_b,L0,middle,31,13,18,4,0.7634,131,"[17, 19, 29, 30, 31, 32, 33, 35, 36, 37, 39, 40, 57, 59, 61, 75, 77, 78, 79, 83, 98, 99, 100, 101, 103, 118, 120, 121, 123, 124, 125]"
agent_b,L0,middle,31,14,17,1,0.7634,131,"[9, 17, 19, 33, 34, 35, 36, 37, 38, 39, 54, 55, 56, 57, 60, 76, 78, 79, 93, 94, 96, 97, 98, 99, 100, 101, 116, 117, 118, 119, 121]"
agent_b,L0,middle,27,12,15,0,0.7874,127,"[8, 17, 18, 19, 34, 35, 37, 38, 39, 40, 55, 56, 58, 59, 60, 75, 76, 80, 95, 97, 98, 100, 113, 115, 116, 118, 120]"
agent_b,L0,middle,30,24,6,5,0.7692,130,"[9, 17, 18, 20, 35, 38, 40, 51, 52, 54, 58, 59, 60, 63, 78, 80, 81, 83, 98, 99, 100, 101, 102, 103, 117, 118, 119, 121, 123, 125]"
agent_b,L0,middle,33,27,6,2,0.7519,133,"[17, 18, 19, 27, 28, 29, 31, 32, 35, 36, 40, 42, 43, 62, 63, 76, 77, 78, 79, 80, 81, 82, 83, 100, 101, 102, 104, 119, 120, 121, 122, 123, 125]"
agent_b,L0,middle,31,18,13,4,0.7634,131,"[8, 16, 20, 34, 35, 36, 37, 38, 40, 53, 55, 56, 57, 58, 59, 61, 62, 63, 64, 65, 81, 82, 83, 84, 85, 101, 102, 103, 106, 122, 126]"
agent_b,L0,middle,27,10,17,1,0.7874,127,"[9, 17, 18, 19, 20, 35, 36, 38, 39, 40, 41, 55, 59, 61, 75, 77, 79, 80, 81, 96, 98, 99, 102, 117, 119, 120, 121]"
agent_b,L0,middle,30,17,13,7,0.7692,130,"[17, 18, 19, 27, 29, 31, 32, 33, 34, 35, 37, 38, 39, 56, 57, 58, 59, 73, 74, 75, 77, 78, 79, 80, 85, 103, 118, 119, 120, 125]"
agent_b,L0,middle,30,16,14,2,0.7692,130,"[8, 17, 19, 33, 35, 37, 38, 39, 40, 55, 57, 58, 59, 60, 61, 75, 76, 77, 78, 79, 80, 81, 97, 98, 101, 115, 116, 118, 120, 123]"
agent_b,L0,middle,29,18,11,3,0.7752,129,"[17, 18, 19, 28, 29, 30, 31, 32, 33, 34, 35, 36, 37, 39, 57, 58, 59, 60, 74, 75, 78, 80, 96, 98, 102, 118, 119, 120, 123]"
agent_b,L0,middle,24,14,10,8,0.8065,124,"[10, 19, 20, 34, 35, 37, 38, 39, 40, 41, 54, 55, 56, 57, 58, 60, 61, 67, 84, 100, 102, 106, 120, 122]"
agent_b,L0,middle,33,15,18,1,0.7519,133,"[8, 16, 17, 21, 38, 39, 40, 51, 52, 53, 55, 56, 57, 58, 59, 60, 76, 78, 79, 80, 95, 96, 97, 98, 99, 101, 116, 117, 118, 120, 121, 122, 123]"
agent_b,L0,middle,30,27,3,4,0.7692,130,"[17, 18, 19, 27, 28, 29, 30, 31, 32, 33, 34, 35, 36, 37, 38, 39, 41, 61, 75, 76, 80, 83, 98, 100, 101, 102, 103, 120, 122, 127]"
agent_b,L0,middle,33,29,4,1,0.7519,133,"[8, 16, 20, 34, 36, 37, 39, 40, 41, 53, 54, 55, 56, 57, 59, 60, 61, 62, 78, 79, 80, 81, 82, 83, 100, 101, 103, 118, 120, 121, 122, 123, 124]"
agent_b,L0,middle,29,21,8,5,0.7752,129,"[8, 18, 19, 20, 21, 36, 37, 38, 39, 40, 41, 55, 56, 57, 58, 59, 60, 61, 79, 80, 81, 83, 98, 99, 100, 101, 104, 120, 124]"
agent_b,L0,middle,26,12,14,3,0.7937,126,"[8, 16, 17, 19, 22, 38, 40, 41, 55, 56, 58, 62, 76, 77, 79, 80, 81, 82, 96, 97, 98, 99, 103, 118, 121, 123]"
agent_b,L0,middle,27,10,17,1,0.7874,127,"[17, 18, 20, 28, 29, 31, 32, 33, 35, 36, 38, 39, 59, 75, 76, 77, 78, 79, 93, 94, 95, 96, 98, 99, 116, 117, 120]"
agent_b,L0,middle,28,17,11,2,0.7812,128,"[10, 19, 35, 36, 37, 38, 40, 51, 52, 55, 56, 59, 62, 76, 78, 79, 80, 94, 96, 98, 100, 113, 114, 115, 116, 117, 120, 121]"
agent_b,L0,middle,28,19,9,7,0.7812,128,"[17, 18, 20, 31, 32, 33, 34, 36, 38, 42, 61, 71, 72, 73, 74, 75, 76, 77, 80, 81, 97, 98, 99, 100, 102, 119, 120, 121]"
agent_b,L0,middle,29,21,8,5,0.7752,129,"[8, 16, 17, 19, 34, 36, 38, 39, 52, 53, 54, 55, 56, 57, 58, 62, 77, 78, 80, 96, 97, 98, 100, 114, 116, 117, 118, 120, 121]"
agent_b,L0,middle,29,21,8,2,0.7752,129,"[17, 18, 19, 27, 29, 30, 31, 33, 35, 36, 37, 38, 39, 61, 74, 75, 76, 77, 78, 79, 93, 98, 99, 114, 115, 117, 118, 119, 120]"
agent_b,L0,middle,30,23,7,4,0.7692,130,"[17, 18, 19, 27, 29, 30, 31, 32, 33, 34, 35, 36, 37, 38, 39, 57, 59, 73, 74, 76, 77, 78, 80, 96, 97, 99, 101, 118, 120, 124]"
agent_b,L0,middle,29,18,11,1,0.7752,129,"[17, 20, 30, 31, 33, 34, 36, 37, 38, 39, 40, 56, 57, 58, 59, 60, 61, 74, 77, 80, 81, 96, 97, 98, 102, 117, 119, 120, 121]"
agent_b,L0,middle,28,23,5,2,0.7812,128,"[19, 20, 22, 33, 36, 38, 39, 40, 41, 42, 61, 62, 72, 73, 74, 75, 76, 77, 78, 79, 80, 82, 98, 99, 100, 101, 103, 123]"
agent_b,L0,middle,31,19,12,3,0.7634,131,"[17, 18, 19, 27, 29, 30, 31, 32, 34, 35, 38, 39, 40, 57, 58, 60, 72, 74, 76, 77, 79, 80, 82, 98, 99, 100, 101, 102, 120, 121, 124]"
agent_b,L0,middle,28,18,10,2,0.7812,128,"[17, 18, 20, 32, 33, 34, 35, 36, 38, 39, 40, 41, 59, 63, 74, 75, 76, 77, 78, 79, 80, 81, 97, 98, 100, 101, 119, 121]"
agent_b,L0,middle,31,20,11,3,0.7634,131,"[17, 18, 21, 31, 34, 35, 36, 37, 38, 39, 40, 42, 60, 61, 74, 75, 76, 77, 78, 79, 81, 97, 98, 100, 102, 103, 107, 123, 124, 125, 126]"
agent_b,L0,middle,31,24,7,6,0.7634,131,"[10, 19, 34, 35, 36, 37, 38, 42, 53, 54, 56, 57, 58, 62, 79, 80, 92, 93, 94, 95, 96, 97, 99, 100, 103, 118, 119, 120, 121, 122, 123]"
agent_b,L0,middle,31,20,11,5,0.7634,131,"[19, 20, 21, 32, 33, 34, 35, 36, 37, 39, 40, 41, 42, 43, 62, 63, 64, 78, 81, 84, 85, 89, 105, 106, 108, 121, 122, 123, 124, 125, 127]"
agent_b,L0,middle,29,12,17,2,0.7752,129,"[8, 16, 19, 33, 34, 35, 36, 37, 39, 40, 54, 56, 59, 62, 77, 79, 81, 82, 97, 99, 100, 102, 103, 118, 119, 120, 121, 122, 123]"
agent_b,L0,middle,29,18,11,3,0.7752,129,"[17, 19, 27, 28, 29, 30, 32, 33, 35, 37, 38, 39, 56, 57, 58, 59, 60, 62, 75, 76, 79, 80, 81, 97, 98, 99, 102, 119, 123]"
agent_b,L0,middle,32,15,17,3,0.7576,132,"[8, 16, 17, 18, 19, 20, 37, 38, 39, 40, 54, 55, 56, 57, 58, 61, 62, 63, 79, 80, 81, 82, 84, 99, 100, 101, 103, 118, 119, 120, 122, 125]"
agent_b,L0,middle,29,11,18,5,0.7752,129,"[18, 19, 27, 28, 29, 31, 32, 34, 35, 36, 37, 38, 39, 56, 57, 64, 76, 77, 79, 80, 81, 97, 98, 102, 118, 119, 120, 121, 123]"
agent_b,L50,middle,30,27,3,1,0.7692,130,"[8, 18, 19, 20, 36, 38, 39, 42, 56, 57, 58, 59, 60, 61, 62, 63, 80, 82, 83, 84, 86, 101, 103, 104, 105, 120, 122, 123, 125, 126]"
agent_b,L50,middle,28,21,7,3,0.7812,128,"[8, 17, 18, 20, 39, 42, 55, 56, 57, 59, 60, 75, 76, 77, 78, 79, 80, 93, 94, 96, 97, 99, 101, 115, 117, 118, 121, 122]"
agent_b,L50,middle,27,20,7,2,0.7874,127,"[8, 17, 19, 35, 36, 38, 39, 52, 53, 54, 55, 57, 58, 59, 76, 77, 79, 93, 94, 95, 96, 97, 98, 100, 117, 118, 120]"
agent_b,L50,middle,32,20,12,2,0.7576,132,"[8, 17, 18, 20, 21, 38, 39, 41, 43, 57, 59, 60, 61, 63, 78, 79, 80, 81, 82, 83, 97, 98, 99, 101, 102, 104, 120, 121, 122, 123, 124, 125]"
agent_b,L50,middle,28,22,6,4,0.7812,128,"[8, 17, 18, 20, 37, 39, 54, 55, 57, 58, 59, 60, 76, 77, 78, 79, 81, 94, 95, 96, 97, 98, 100, 102, 117, 119, 120, 122]"
agent_b,L50,middle,32,15,17,1,0.7576,132,"[17, 18, 20, 30, 32, 34, 35, 36, 37, 38, 39, 41, 58, 59, 60, 61, 62, 63, 64, 82, 83, 84, 99, 100, 101, 103, 104, 105, 121, 122, 123, 125]"
agent_b,L50,middle,33,21,12,4,0.7519,133,"[17, 18, 19, 30, 31, 32, 34, 35, 37, 42, 58, 59, 60, 74, 76, 77, 79, 80, 81, 83, 97, 98, 99, 101, 102, 103, 104, 119, 120, 121, 122, 124, 125]"
agent_b,L50,middle,30,21,9,2,0.7692,130,"[17, 20, 30, 32, 33, 34, 35, 39, 40, 56, 57, 58, 60, 76, 78, 80, 93, 94, 96, 97, 98, 100, 114, 115, 116, 117, 118, 119, 120, 122]"
agent_b,L50,middle,30,22,8,3,0.7692,130,"[8, 18, 19, 21, 37, 38, 40, 41, 56, 57, 58, 59, 62, 77, 78, 79, 80, 81, 83, 85, 100, 101, 102, 103, 104, 105, 121, 122, 123, 126]"
agent_b,L50,middle,27,15,12,2,0.7874,127,"[17, 19, 21, 31, 32, 34, 37, 38, 40, 56, 57, 61, 77, 78, 80, 81, 96, 97, 98, 99, 101, 102, 104, 105, 120, 122, 125]"
agent_b,L50,middle,30,17,13,2,0.7692,130,"[19, 20, 31, 32, 33, 34, 35, 37, 38, 39, 40, 57, 58, 62, 78, 79, 81, 94, 95, 96, 97, 99, 100, 101, 102, 117, 118, 120, 121, 123]"
agent_b,L50,middle,26,12,14,1,0.7937,126,"[8, 17, 18, 19, 35, 36, 37, 38, 39, 54, 55, 57, 59, 60, 77, 80, 81, 82, 98, 99, 102, 104, 118, 121, 122, 123]"
agent_b,L50,middle,26,18,8,4,0.7937,126,"[9, 17, 18, 19, 35, 37, 38, 41, 57, 58, 60, 76, 77, 79, 81, 96, 98, 100, 114, 115, 116, 117, 118, 119, 121, 123]"
agent_b,L50,middle,27,11,16,3,0.7874,127,"[17, 18, 20, 33, 34, 36, 37, 38, 40, 56, 58, 59, 75, 76, 77, 78, 80, 93, 95, 97, 98, 99, 114, 115, 117, 119, 121]"
agent_b,L50,middle,30,27,3,4,0.7692,130,"[8, 18, 19, 36, 37, 38, 39, 40, 44, 58, 59, 61, 62, 77, 78, 79, 80, 82, 95, 96, 97, 98, 99, 100, 103, 118, 119, 120, 121, 122]"
agent_b,L50,middle,30,13,17,0,0.7692,130,"[8, 19, 36, 37, 39, 50, 53, 54, 55, 56, 58, 59, 78, 79, 90, 91, 92, 93, 94, 95, 96, 97, 99, 114, 115, 116, 117, 118, 119, 120]"
agent_b,L50,middle,28,16,12,0,0.7812,128,"[10, 19, 20, 37, 38, 40, 41, 42, 56, 57, 59, 60, 61, 62, 80, 82, 96, 97, 98, 99, 100, 101, 103, 118, 119, 121, 122, 123]"
agent_b,L50,middle,20,9,11,3,0.8333,120,"[8, 19, 22, 37, 38, 39, 40, 41, 42, 57, 59, 60, 62, 63, 83, 84, 96, 100, 103, 105]"
agent_b,L50,middle,26,10,16,1,0.7937,126,"[8, 17, 19, 34, 35, 36, 37, 38, 39, 53, 56, 57, 58, 59, 75, 77, 78, 80, 94, 96, 98, 99, 114, 116, 117, 119]"
agent_b,L50,middle,26,12,14,3,0.7937,126,"[17, 18, 20, 32, 33, 36, 37, 39, 55, 56, 59, 62, 76, 77, 79, 80, 93, 95, 96, 98, 100, 115, 117, 118, 119, 120]"
agent_b,L50,middle,26,12,14,1,0.7937,126,"[17, 19, 20, 32, 34, 35, 37, 38, 40, 56, 57, 58, 59, 60, 75, 77, 78, 81, 98, 99, 101, 113, 114, 118, 120, 122]"
agent_b,L50,middle,27,17,10,1,0.7874,127,"[8, 17, 19, 35, 37, 39, 41, 55, 58, 59, 60, 76, 77, 78, 79, 80, 93, 94, 95, 98, 100, 114, 115, 117, 119, 120, 121]"
agent_b,L50,middle,27,19,8,1,0.7874,127,"[8, 18, 20, 35, 36, 37, 38, 39, 40, 53, 54, 55, 56, 57, 59, 62, 81, 94, 95, 96, 98, 99, 100, 101, 102, 120, 123]"
agent_b,L50,middle,27,25,2,1,0.7874,127,"[8, 17, 20, 35, 37, 38, 39, 40, 57, 58, 59, 60, 61, 77, 78, 80, 82, 94, 95, 96, 100, 101, 102, 103, 120, 122, 123]"
agent_b,L50,middle,22,11,11,1,0.8197,122,"[8, 19, 20, 36, 37, 38, 39, 40, 57, 59, 60, 76, 77, 78, 81, 96, 98, 99, 100, 118, 119, 120]"
agent_b,L50,middle,26,11,15,4,0.7937,126,"[8, 17, 18, 19, 35, 36, 37, 38, 42, 59, 76, 77, 79, 90, 91, 92, 93, 95, 96, 100, 113, 114, 116, 117, 118, 119]"
agent_b,L50,middle,30,13,17,2,0.7692,130,"[10, 18, 19, 20, 37, 38, 39, 40, 53, 54, 55, 57, 58, 59, 60, 77, 79, 81, 96, 97, 98, 99, 100, 101, 103, 118, 119, 121, 122, 123]"
agent_b,L50,middle,28,17,11,2,0.7812,128,"[10, 18, 19, 21, 37, 38, 39, 40, 53, 55, 56, 57, 59, 60, 78, 79, 80, 93, 94, 97, 102, 103, 118, 119, 120, 122, 123, 125]"
agent_b,L50,middle,28,11,17,1,0.7812,128,"[17, 18, 19, 30, 31, 33, 36, 37, 38, 40, 57, 58, 59, 60, 62, 78, 79, 80, 82, 83, 84, 101, 102, 104, 119, 120, 121, 125]"
agent_b,L50,middle,25,9,16,2,0.8,125,"[17, 18, 19, 21, 34, 35, 36, 37, 38, 40, 60, 61, 76, 77, 79, 81, 82, 97, 98, 101, 102, 104, 119, 122, 123]"
agent_b,L50,middle,27,21,6,3,0.7874,127,"[8, 17, 18, 19, 20, 22, 39, 40, 41, 42, 43, 59, 63, 80, 81, 82, 84, 97, 98, 99, 100, 101, 102, 106, 121, 122, 125]"
agent_b,L50,middle,30,24,6,1,0.7692,130,"[8, 17, 20, 35, 36, 37, 39, 51, 53, 54, 55, 56, 57, 58, 59, 75, 77, 78, 79, 80, 81, 82, 100, 101, 102, 103, 119, 120, 121, 123]"
agent_b,L50,middle,26,10,16,3,0.7937,126,"[20, 32, 33, 34, 35, 36, 37, 39, 42, 58, 60, 75, 78, 81, 94, 98, 100, 101, 111, 113, 114, 115, 116, 117, 118, 121]"
agent_b,L50,middle,28,23,5,1,0.7812,128,"[8, 17, 19, 20, 36, 37, 39, 40, 53, 55, 60, 61, 76, 79, 82, 96, 98, 101, 114, 115, 116, 117, 118, 119, 120, 121, 122, 123]"
agent_b,L50,middle,27,17,10,1,0.7874,127,"[8, 17, 18, 19, 20, 36, 37, 38, 39, 40, 54, 55, 56, 57, 60, 79, 82, 83, 98, 100, 101, 104, 119, 120, 121, 122, 125]"
agent_b,L50,middle,30,24,6,3,0.7692,130,"[20, 30, 32, 33, 34, 35, 38, 40, 57, 58, 61, 75, 76, 77, 78, 79, 80, 94, 95, 96, 97, 98, 99, 100, 102, 117, 118, 119, 120, 121]"
agent_b,L50,middle,30,16,14,1,0.7692,130,"[17, 19, 28, 29, 30, 31, 32, 33, 34, 35, 36, 37, 39, 41, 59, 60, 61, 77, 78, 79, 80, 81, 97, 99, 100, 101, 115, 118, 121, 122]"
agent_b,L50,middle,28,13,15,2,0.7812,128,"[17, 18, 19, 29, 30, 32, 33, 38, 39, 40, 41, 42, 43, 61, 63, 64, 66, 81, 84, 85, 100, 102, 103, 104, 106, 121, 123, 125]"
agent_b,L50,middle,32,20,12,1,0.7576,132,"[9, 18, 20, 21, 37, 38, 39, 41, 42, 57, 58, 59, 61, 62, 63, 65, 81, 82, 84, 99, 100, 101, 102, 103, 104, 119, 120, 121, 122, 123, 125, 127]"
agent_b,L50,middle,23,14,9,4,0.813,123,"[8, 18, 19, 34, 35, 36, 37, 40, 53, 54, 55, 56, 60, 77, 81, 95, 99, 101, 115, 116, 118, 119, 120]"
agent_b,L50,middle,28,17,11,0,0.7812,128,"[9, 17, 22, 37, 38, 40, 41, 42, 56, 57, 59, 60, 61, 62, 78, 79, 81, 82, 83, 96, 97, 100, 101, 102, 103, 104, 121, 124]"
agent_b,L50,middle,30,17,13,3,0.7692,130,"[18, 19, 28, 29, 30, 33, 35, 36, 37, 38, 39, 56, 58, 59, 60, 61, 76, 79, 80, 82, 96, 97, 98, 100, 101, 117, 118, 119, 120, 123]"
agent_b,L50,middle,26,24,2,4,0.7937,126,"[8, 19, 20, 36, 37, 38, 39, 40, 41, 57, 58, 59, 60, 61, 78, 79, 80, 81, 94, 96, 100, 102, 118, 119, 120, 121]"
agent_b,L50,middle,24,17,7,4,0.8065,124,"[8, 17, 19, 20, 36, 39, 40, 55, 56, 57, 58, 61, 76, 77, 78, 82, 96, 97, 98, 101, 102, 117, 118, 121]"
agent_b,L50,middle,25,16,9,3,0.8,125,"[10, 18, 19, 20, 36, 37, 38, 41, 56, 57, 60, 62, 78, 81, 94, 96, 97, 98, 99, 101, 102, 117, 118, 121, 123]"
agent_b,L50,middle,31,14,17,2,0.7634,131,"[17, 18, 20, 30, 31, 32, 34, 38, 39, 56, 57, 58, 59, 60, 61, 62, 64, 81, 82, 83, 97, 99, 100, 102, 103, 117, 118, 119, 120, 121, 123]"
agent_b,L50,middle,27,17,10,3,0.7874,127,"[8, 17, 19, 20, 22, 39, 40, 41, 56, 59, 61, 62, 78, 80, 82, 95, 97, 98, 99, 100, 101, 104, 118, 119, 120, 121, 122]"
agent_b,L50,middle,30,14,16,2,0.7692,130,"[18, 20, 30, 31, 33, 34, 35, 36, 37, 39, 58, 60, 75, 76, 77, 78, 79, 94, 95, 97, 99, 113, 114, 115, 118, 119, 120, 121, 122, 123]"
agent_b,L50,middle,23,13,10,5,0.813,123,"[8, 17, 19, 34, 41, 53, 54, 56, 57, 59, 76, 79, 89, 91, 92, 93, 94, 95, 96, 102, 116, 117, 119]"
agent_b,L50,middle,29,11,18,5,0.7752,129,"[23, 33, 34, 35, 36, 39, 54, 56, 58, 59, 60, 61, 62, 78, 80, 83, 97, 99, 100, 101, 102, 113, 115, 118, 119, 120, 125, 126, 127]"
agent_b,L50,middle,26,18,8,6,0.7937,126,"[17, 18, 20, 30, 31, 32, 34, 35, 36, 37, 38, 39, 40, 58, 59, 62, 77, 78, 79, 81, 97, 98, 100, 115, 119, 122]"
agent_b,L50,middle,26,22,4,3,0.7937,126,"[8, 17, 18, 19, 35, 37, 38, 39, 41, 54, 55, 56, 57, 59, 61, 79, 80, 94, 95, 96, 98, 101, 118, 119, 120, 122]"
agent_b,L50,middle,28,19,9,4,0.7812,128,"[19, 29, 31, 33, 34, 36, 38, 40, 56, 57, 58, 59, 74, 76, 77, 78, 80, 93, 94, 95, 96, 97, 99, 116, 117, 118, 120, 123]"
agent_b,L50,middle,30,21,9,4,0.7692,130,"[8, 18, 19, 34, 38, 39, 41, 43, 57, 58, 59, 60, 61, 62, 79, 80, 81, 85, 99, 100, 101, 102, 103, 104, 119, 120, 121, 122, 123, 125]"
agent_b,L50,middle,28,20,8,3,0.7812,128,"[8, 19, 36, 42, 57, 58, 59, 60, 75, 78, 80, 82, 83, 93, 94, 95, 96, 97, 99, 100, 101, 104, 118, 120, 121, 122, 123, 124]"
agent_b,L50,middle,28,13,15,1,0.7812,128,"[17, 19, 29, 33, 34, 35, 36, 37, 39, 40, 57, 58, 59, 61, 75, 76, 77, 80, 81, 95, 96, 97, 98, 99, 100, 102, 118, 121]"
agent_b,L50,middle,28,21,7,1,0.7812,128,"[10, 18, 19, 34, 35, 36, 37, 39, 52, 53, 54, 55, 57, 59, 75, 76, 77, 78, 80, 95, 96, 97, 98, 99, 116, 117, 118, 119]"
agent_b,L50,middle,29,16,13,2,0.7752,129,"[17, 18, 19, 21, 32, 34, 35, 37, 38, 40, 41, 60, 62, 77, 79, 80, 82, 97, 98, 99, 100, 103, 104, 118, 119, 120, 121, 123, 124]"
agent_b,L50,middle,26,12,14,7,0.7937,126,"[17, 18, 20, 30, 31, 32, 36, 38, 39, 46, 63, 68, 81, 84, 95, 97, 98, 100, 102, 103, 104, 118, 119, 121, 123, 124]"
agent_b,L50,middle,27,14,13,6,0.7874,127,"[8, 17, 21, 37, 38, 39, 41, 55, 57, 58, 59, 62, 77, 78, 79, 80, 82, 83, 100, 102, 103, 104, 119, 120, 121, 122, 125]"
agent_b,L50,middle,29,25,4,5,0.7752,129,"[17, 21, 31, 32, 33, 34, 35, 36, 40, 60, 74, 75, 76, 77, 78, 79, 81, 94, 95, 96, 97, 99, 101, 115, 116, 118, 119, 120, 122]"
agent_b,L50,middle,28,23,5,4,0.7812,128,"[8, 17, 18, 20, 37, 38, 39, 41, 57, 58, 59, 60, 76, 77, 78, 80, 92, 93, 94, 96, 97, 99, 100, 103, 118, 120, 123, 124]"
agent_b,L50,middle,26,17,9,7,0.7937,126,"[8, 17, 18, 19, 20, 36, 37, 38, 40, 53, 54, 57, 58, 60, 61, 81, 86, 98, 99, 100, 105, 118, 119, 120, 121, 122]"
agent_b,L50,middle,26,16,10,1,0.7937,126,"[8, 17, 18, 19, 22, 39, 41, 55, 60, 61, 62, 76, 77, 82, 94, 95, 96, 100, 101, 102, 116, 118, 120, 121, 123, 124]"
agent_b,L50,middle,30,15,15,0,0.7692,130,"[18, 21, 31, 32, 33, 35, 36, 37, 38, 41, 42, 43, 63, 78, 79, 80, 82, 83, 84, 85, 87, 102, 103, 105, 106, 107, 122, 123, 124, 127]"
agent_b,L50,middle,28,19,9,6,0.7812,128,"[17, 22, 33, 34, 35, 39, 54, 57, 58, 62, 74, 76, 78, 79, 91, 92, 93, 94, 96, 99, 112, 113, 114, 115, 116, 117, 118, 119]"
agent_b,L50,middle,27,11,16,2,0.7874,127,"[18, 19, 29, 32, 33, 34, 35, 37, 39, 40, 41, 58, 59, 60, 61, 76, 77, 78, 82, 97, 98, 99, 104, 118, 120, 121, 122]"
agent_b,L50,middle,26,20,6,3,0.7937,126,"[10, 18, 19, 36, 37, 39, 41, 55, 56, 57, 59, 60, 76, 77, 78, 79, 80, 93, 95, 96, 101, 116, 117, 119, 120, 123]"
agent_b,L50,middle,25,13,12,5,0.8,125,"[10, 18, 21, 38, 39, 42, 57, 59, 60, 73, 74, 75, 77, 79, 80, 92, 94, 95, 96, 99, 101, 102, 118, 121, 123]"
agent_b,L50,middle,28,22,6,1,0.7812,128,"[8, 17, 18, 19, 38, 41, 54, 56, 57, 58, 59, 63, 77, 78, 79, 80, 81, 82, 83, 96, 99, 100, 102, 103, 119, 120, 121, 123]"
agent_b,L50,middle,19,13,6,2,0.8403,119,"[11, 19, 22, 38, 39, 40, 54, 55, 58, 61, 62, 76, 77, 78, 82, 83, 96, 105, 106]"
agent_b,L50,middle,29,16,13,3,0.7752,129,"[17, 20, 30, 32, 33, 34, 37, 39, 55, 56, 57, 62, 77, 79, 80, 94, 95, 98, 99, 100, 101, 102, 114, 115, 116, 117, 120, 121, 122]"
agent_b,L50,middle,27,19,8,3,0.7874,127,"[8, 18, 20, 35, 36, 37, 38, 40, 53, 55, 57, 58, 59, 61, 78, 81, 97, 98, 99, 100, 113, 114, 115, 116, 117, 119, 120]"
agent_b,L50,middle,27,13,14,4,0.7874,127,"[9, 17, 18, 19, 21, 39, 40, 41, 42, 44, 58, 60, 64, 80, 81, 82, 83, 98, 99, 100, 104, 106, 120, 121, 123, 124, 125]"
agent_b,L50,middle,30,20,10,1,0.7692,130,"[17, 19, 28, 30, 31, 32, 33, 35, 36, 38, 39, 40, 58, 60, 61, 76, 77, 81, 95, 96, 97, 98, 99, 100, 102, 117, 118, 119, 120, 121]"
agent_b,L50,middle,28,23,5,3,0.7812,128,"[8, 18, 20, 35, 36, 38, 39, 40, 53, 54, 57, 60, 61, 78, 79, 80, 81, 94, 95, 96, 97, 99, 100, 101, 105, 121, 123, 124]"
agent_b,L50,middle,29,21,8,5,0.7752,129,"[17, 19, 20, 32, 33, 34, 37, 39, 40, 56, 58, 59, 61, 77, 78, 79, 80, 94, 96, 97, 98, 100, 114, 115, 116, 117, 118, 119, 124]"
agent_b,L50,middle,25,18,7,3,0.8,125,"[8, 17, 18, 19, 38, 39, 54, 56, 57, 59, 61, 75, 77, 79, 81, 95, 97, 98, 99, 102, 116, 118, 119, 120, 121]"
agent_b,L50,middle,25,11,14,1,0.8,125,"[18, 19, 28, 30, 33, 34, 36, 37, 38, 39, 57, 58, 60, 74, 79, 92, 96, 97, 98, 99, 113, 115, 117, 118, 119]"
agent_b,L50,middle,28,9,19,2,0.7812,128,"[17, 18, 19, 29, 30, 32, 33, 34, 35, 36, 37, 38, 41, 59, 75, 76, 77, 79, 95, 96, 98, 99, 101, 102, 119, 120, 121, 122]"
agent_b,L50,middle,28,19,9,2,0.7812,128,"[18, 19, 29, 30, 31, 33, 35, 36, 37, 40, 59, 61, 76, 77, 78, 79, 80, 96, 97, 99, 101, 113, 115, 116, 117, 118, 119, 120]"
agent_b,L50,middle,28,19,9,5,0.7812,128,"[17, 23, 36, 38, 39, 53, 54, 55, 56, 57, 58, 59, 73, 74, 75, 76, 77, 78, 81, 96, 97, 99, 100, 101, 116, 117, 118, 122]"
agent_b,L50,middle,29,23,6,2,0.7752,129,"[8, 17, 18, 19, 21, 37, 38, 40, 56, 57, 58, 59, 60, 61, 78, 79, 80, 81, 83, 98, 100, 101, 104, 119, 120, 123, 124, 125, 126]"
agent_b,L50,middle,28,21,7,1,0.7812,128,"[17, 19, 28, 30, 32, 33, 34, 35, 36, 39, 56, 59, 73, 76, 79, 92, 93, 94, 95, 96, 97, 98, 101, 115, 116, 117, 119, 120]"
agent_b,L50,middle,27,16,11,1,0.7874,127,"[19, 20, 30, 31, 33, 36, 41, 42, 57, 58, 59, 62, 76, 78, 80, 81, 84, 97, 98, 99, 103, 104, 118, 120, 121, 122, 124]"
agent_b,L50,middle,31,13,18,0,0.7634,131,"[17, 18, 19, 29, 30, 31, 32, 33, 35, 37, 39, 56, 58, 60, 76, 78, 79, 80, 82, 96, 98, 100, 101, 102, 103, 104, 118, 120, 121, 125, 126]"
agent_b,L50,middle,26,16,10,5,0.7937,126,"[17, 18, 20, 30, 32, 33, 34, 36, 37, 38, 40, 57, 59, 74, 75, 77, 79, 94, 95, 96, 97, 101, 114, 117, 118, 120]"
agent_b,L50,middle,30,17,13,6,0.7692,130,"[17, 18, 19, 29, 30, 31, 32, 35, 37, 38, 41, 58, 60, 74, 76, 77, 78, 80, 81, 82, 96, 97, 99, 100, 102, 118, 119, 120, 121, 125]"
agent_b,L50,middle,27,13,14,0,0.7874,127,"[18, 20, 21, 31, 32, 35, 38, 41, 57, 58, 59, 61, 76, 77, 78, 79, 80, 81, 97, 98, 101, 115, 116, 117, 118, 120, 121]"
agent_b,L50,middle,31,21,10,3,0.7634,131,"[17, 18, 20, 30, 32, 35, 36, 37, 38, 39, 41, 59, 60, 61, 63, 79, 80, 81, 83, 98, 100, 101, 102, 103, 104, 117, 118, 119, 120, 121, 124]"
agent_b,L50,middle,27,10,17,3,0.7874,127,"[18, 19, 28, 29, 33, 34, 35, 36, 37, 38, 40, 57, 58, 59, 61, 76, 77, 78, 81, 96, 99, 100, 116, 117, 119, 120, 121]"
agent_b,L50,middle,29,16,13,0,0.7752,129,"[17, 18, 19, 31, 32, 33, 35, 37, 38, 39, 57, 58, 59, 74, 75, 76, 77, 78, 79, 80, 81, 97, 100, 101, 118, 119, 120, 121, 122]"
agent_b,L50,middle,30,19,11,3,0.7692,130,"[17, 18, 19, 30, 31, 32, 33, 34, 35, 36, 37, 39, 41, 62, 78, 79, 80, 81, 95, 96, 98, 102, 114, 116, 117, 118, 119, 120, 122, 123]"
agent_b,L50,middle,25,18,7,7,0.8,125,"[8, 17, 18, 19, 35, 36, 37, 39, 56, 57, 60, 75, 76, 78, 79, 91, 93, 94, 96, 97, 102, 117, 118, 119, 120]"
agent_b,L50,middle,27,17,10,4,0.7874,127,"[9, 20, 35, 38, 42, 53, 54, 55, 57, 58, 59, 60, 61, 77, 78, 79, 82, 97, 99, 100, 101, 116, 117, 118, 119, 120, 121]"
agent_b,L50,middle,28,8,20,8,0.7812,128,"[17, 22, 33, 34, 35, 38, 40, 41, 57, 60, 61, 63, 77, 78, 79, 82, 98, 99, 100, 101, 103, 116, 117, 118, 119, 120, 121, 126]"
agent_b,L50,middle,28,23,5,0,0.7812,128,"[8, 17, 18, 19, 35, 37, 38, 39, 40, 41, 42, 60, 61, 62, 78, 79, 81, 82, 95, 96, 99, 100, 101, 103, 119, 121, 122, 123]"
agent_b,L50,middle,22,14,8,4,0.8197,122,"[17, 21, 32, 33, 34, 36, 38, 39, 55, 57, 58, 60, 62, 77, 79, 80, 82, 101, 113, 115, 117, 118]"
agent_b,L50,middle,28,18,10,2,0.7812,128,"[17, 19, 29, 30, 32, 33, 34, 36, 38, 40, 57, 59, 60, 76, 78, 81, 95, 96, 98, 100, 112, 113, 114, 115, 116, 117, 118, 120]"
agent_b,L50,middle,28,15,13,1,0.7812,128,"[17, 18, 19, 20, 31, 32, 33, 38, 39, 40, 57, 61, 76, 77, 79, 80, 81, 94, 95, 96, 97, 100, 101, 115, 117, 119, 121, 122]"
agent_b,L100,middle,24,18,6,3,0.8065,124,"[17, 21, 33, 35, 36, 37, 38, 39, 41, 57, 58, 59, 60, 61, 82, 95, 97, 98, 99, 101, 118, 119, 120, 121]"
agent_b,L100,middle,25,14,11,0,0.8,125,"[17, 18, 19, 30, 34, 35, 36, 39, 55, 57, 58, 59, 73, 75, 76, 78, 79, 93, 94, 95, 96, 99, 115, 116, 119]"
agent_b,L100,middle,23,16,7,1,0.813,123,"[8, 18, 19, 35, 36, 38, 39, 55, 58, 60, 75, 77, 78, 80, 96, 99, 100, 114, 115, 116, 117, 118, 121]"
agent_b,L100,middle,24,18,6,3,0.8065,124,"[17, 18, 20, 31, 32, 39, 54, 55, 57, 58, 61, 75, 76, 77, 79, 95, 96, 98, 99, 114, 115, 116, 118, 120]"
agent_b,L100,middle,32,26,6,3,0.7576,132,"[17, 18, 19, 30, 31, 33, 34, 35, 36, 37, 38, 39, 56, 58, 59, 75, 76, 77, 80, 95, 96, 97, 98, 99, 100, 101, 103, 120, 122, 123, 124, 127]"
agent_b,L100,middle,27,14,13,1,0.7874,127,"[8, 17, 18, 19, 36, 37, 38, 39, 53, 54, 55, 56, 58, 59, 60, 77, 79, 80, 97, 99, 101, 115, 116, 117, 118, 119, 120]"
agent_b,L100,middle,25,16,9,1,0.8,125,"[8, 18, 19, 35, 36, 37, 39, 55, 57, 58, 60, 76, 78, 79, 80, 97, 98, 99, 100, 101, 116, 117, 118, 119, 121]"
agent_b,L100,middle,23,20,3,3,0.813,123,"[8, 17, 18, 20, 36, 37, 38, 39, 53, 54, 60, 75, 77, 78, 79, 96, 97, 98, 100, 114, 117, 118, 119]"
agent_b,L100,middle,25,20,5,2,0.8,125,"[8, 17, 18, 19, 36, 40, 54, 55, 56, 57, 58, 60, 76, 79, 80, 98, 99, 101, 114, 115, 116, 117, 118, 120, 121]"
agent_b,L100,middle,26,21,5,3,0.7937,126,"[20, 32, 33, 34, 36, 37, 38, 41, 56, 58, 59, 60, 61, 62, 78, 79, 81, 84, 98, 100, 101, 102, 119, 120, 121, 122]"
agent_b,L100,middle,25,15,10,0,0.8,125,"[17, 18, 19, 30, 32, 33, 34, 37, 39, 56, 57, 59, 60, 74, 75, 76, 77, 78, 80, 95, 99, 100, 101, 119, 122]"
agent_b,L100,middle,20,9,11,7,0.8333,120,"[20, 35, 36, 37, 38, 40, 54, 55, 56, 59, 63, 76, 77, 80, 83, 100, 102, 115, 117, 118]"
agent_b,L100,middle,29,23,6,1,0.7752,129,"[19, 32, 33, 34, 37, 40, 54, 55, 57, 58, 59, 60, 61, 77, 79, 80, 81, 83, 99, 103, 116, 117, 118, 119, 120, 121, 122, 123, 124]"
agent_b,L100,middle,28,15,13,5,0.7812,128,"[18, 19, 20, 31, 34, 36, 37, 39, 40, 41, 42, 62, 78, 79, 80, 81, 85, 100, 101, 103, 116, 117, 118, 119, 120, 121, 122, 124]"
agent_b,L100,middle,24,14,10,1,0.8065,124,"[8, 19, 21, 40, 41, 56, 58, 59, 60, 61, 62, 64, 65, 66, 69, 84, 87, 88, 103, 104, 106, 107, 108, 110]"
agent_b,L100,middle,21,12,9,1,0.8264,121,"[17, 19, 30, 31, 32, 36, 39, 55, 56, 58, 60, 75, 79, 80, 94, 96, 99, 102, 116, 118, 119]"
agent_b,L100,middle,21,13,8,2,0.8264,121,"[8, 17, 18, 20, 36, 40, 54, 55, 56, 57, 58, 59, 60, 64, 81, 82, 86, 101, 104, 105, 119]"
agent_b,L100,middle,24,14,10,3,0.8065,124,"[8, 18, 19, 21, 38, 39, 41, 55, 56, 58, 59, 60, 61, 77, 79, 80, 82, 99, 100, 102, 116, 118, 120, 121]"
agent_b,L100,middle,21,16,5,2,0.8264,121,"[18, 19, 31, 35, 36, 38, 39, 55, 57, 58, 59, 75, 77, 79, 95, 98, 99, 113, 114, 116, 117]"
agent_b,L100,middle,23,18,5,6,0.813,123,"[8, 17, 18, 21, 37, 38, 39, 40, 56, 57, 61, 76, 77, 83, 98, 101, 113, 114, 115, 116, 117, 118, 120]"
agent_b,L100,middle,30,10,20,2,0.7692,130,"[19, 30, 31, 32, 33, 35, 36, 37, 38, 39, 55, 56, 57, 60, 75, 76, 78, 79, 80, 81, 83, 84, 101, 102, 103, 104, 121, 122, 123, 125]"
agent_b,L100,middle,28,25,3,2,0.7812,128,"[19, 33, 34, 35, 36, 37, 38, 39, 42, 58, 59, 60, 61, 78, 79, 80, 81, 82, 99, 100, 101, 104, 118, 119, 120, 121, 122, 124]"
agent_b,L100,middle,24,12,12,3,0.8065,124,"[8, 18, 21, 39, 40, 53, 56, 57, 58, 59, 61, 76, 77, 79, 80, 82, 97, 98, 99, 101, 116, 118, 120, 121]"
agent_b,L100,middle,28,15,13,5,0.7812,128,"[8, 17, 18, 19, 36, 37, 38, 39, 40, 42, 58, 60, 61, 63, 80, 81, 82, 84, 99, 100, 103, 107, 120, 122, 123, 124, 125, 126]"
agent_b,L100,middle,28,2,26,2,0.7812,128,"[18, 19, 21, 33, 34, 35, 36, 37, 38, 39, 41, 58, 59, 60, 77, 78, 80, 96, 97, 98, 99, 100, 101, 116, 119, 120, 121, 122]"
agent_b,L100,middle,24,12,12,3,0.8065,124,"[9, 18, 19, 20, 23, 41, 43, 64, 78, 80, 81, 82, 83, 97, 98, 99, 101, 102, 104, 117, 119, 120, 121, 122]"
agent_b,L100,middle,25,13,12,4,0.8,125,"[19, 31, 33, 34, 35, 37, 38, 42, 57, 59, 60, 76, 78, 79, 82, 95, 96, 98, 99, 100, 102, 118, 119, 120, 122]"
agent_b,L100,middle,27,8,19,3,0.7874,127,"[8, 18, 21, 37, 38, 39, 40, 55, 56, 58, 59, 61, 77, 81, 96, 98, 99, 100, 101, 114, 115, 116, 117, 118, 119, 120, 121]"
agent_b,L100,middle,25,18,7,6,0.8,125,"[17, 18, 20, 31, 32, 34, 37, 38, 39, 56, 59, 63, 77, 78, 79, 81, 97, 98, 99, 100, 102, 117, 118, 120, 121]"
agent_b,L100,middle,23,16,7,6,0.813,123,"[8, 17, 18, 20, 36, 38, 41, 42, 43, 46, 62, 65, 68, 84, 85, 87, 88, 102, 103, 104, 105, 107, 111]"
agent_b,L100,middle,23,17,6,2,0.813,123,"[17, 18, 19, 22, 35, 36, 37, 39, 40, 57, 58, 60, 76, 78, 79, 80, 97, 98, 100, 115, 116, 117, 120]"
agent_b,L100,middle,25,7,18,1,0.8,125,"[17, 18, 19, 30, 31, 32, 33, 34, 38, 40, 57, 58, 59, 60, 61, 79, 80, 81, 97, 98, 99, 100, 101, 116, 122]"
agent_b,L100,middle,24,12,12,11,0.8065,124,"[17, 19, 20, 26, 40, 44, 58, 59, 60, 61, 74, 75, 77, 78, 79, 81, 82, 99, 100, 101, 102, 105, 120, 121]"
agent_b,L100,middle,24,12,12,1,0.8065,124,"[8, 17, 18, 20, 36, 37, 40, 57, 58, 59, 60, 77, 78, 79, 80, 95, 96, 97, 100, 114, 115, 117, 119, 120]"
agent_b,L100,middle,25,14,11,6,0.8,125,"[18, 19, 31, 33, 34, 35, 36, 37, 39, 57, 58, 61, 76, 77, 79, 82, 96, 97, 98, 99, 100, 102, 118, 119, 122]"
agent_b,L100,middle,29,21,8,0,0.7752,129,"[17, 19, 30, 31, 32, 33, 34, 35, 37, 38, 40, 57, 60, 74, 75, 78, 79, 80, 94, 95, 96, 97, 98, 100, 117, 118, 119, 121, 122]"
agent_b,L100,middle,20,10,10,4,0.8333,120,"[20, 32, 33, 34, 36, 38, 39, 57, 58, 59, 61, 75, 76, 77, 78, 82, 96, 99, 102, 117]"
agent_b,L100,middle,27,21,6,3,0.7874,127,"[17, 18, 20, 31, 32, 33, 34, 36, 37, 38, 39, 56, 57, 59, 76, 79, 80, 94, 95, 96, 97, 98, 99, 101, 117, 119, 121]"
agent_b,L100,middle,30,21,9,1,0.7692,130,"[17, 18, 19, 21, 33, 34, 35, 36, 39, 40, 57, 59, 60, 74, 75, 77, 78, 79, 81, 96, 97, 98, 99, 100, 102, 118, 119, 120, 121, 122]"
agent_b,L100,middle,21,10,11,2,0.8264,121,"[11, 20, 37, 38, 39, 53, 54, 55, 58, 59, 74, 75, 78, 80, 98, 99, 101, 114, 115, 118, 119]"
agent_b,L100,middle,26,21,5,5,0.7937,126,"[17, 18, 20, 31, 32, 34, 35, 37, 38, 41, 59, 60, 76, 77, 78, 79, 80, 94, 97, 99, 100, 103, 118, 119, 120, 121]"
agent_b,L100,middle,24,7,17,4,0.8065,124,"[8, 17, 20, 36, 38, 39, 40, 56, 57, 59, 60, 77, 78, 79, 82, 96, 98, 99, 101, 114, 118, 119, 120, 121]"
agent_b,L100,middle,26,14,12,4,0.7937,126,"[9, 17, 19, 22, 38, 40, 54, 55, 58, 59, 60, 75, 77, 78, 79, 80, 98, 99, 103, 116, 117, 118, 120, 121, 122, 123]"
agent_b,L100,middle,24,16,8,1,0.8065,124,"[9, 17, 18, 19, 20, 21, 39, 41, 42, 58, 61, 62, 77, 78, 82, 83, 97, 98, 99, 100, 103, 120, 121, 122]"
agent_b,L100,middle,26,15,11,5,0.7937,126,"[8, 17, 19, 36, 37, 38, 39, 41, 56, 57, 58, 59, 61, 77, 78, 80, 83, 99, 100, 101, 102, 116, 117, 118, 119, 120]"
agent_b,L100,middle,26,23,3,1,0.7937,126,"[8, 17, 18, 19, 36, 37, 39, 56, 57, 58, 59, 75, 76, 77, 78, 80, 81, 99, 100, 102, 116, 117, 118, 119, 120, 121]"
agent_b,L100,middle,28,10,18,3,0.7812,128,"[8, 17, 18, 20, 22, 39, 40, 41, 42, 58, 61, 64, 80, 81, 82, 83, 87, 104, 105, 106, 119, 120, 121, 122, 123, 124, 125, 126]"
agent_b,L100,middle,24,12,12,2,0.8065,124,"[17, 20, 31, 32, 33, 35, 36, 37, 40, 57, 58, 62, 78, 80, 81, 84, 97, 98, 99, 101, 102, 117, 120, 122]"
agent_b,L100,middle,23,16,7,4,0.813,123,"[8, 17, 19, 21, 38, 39, 41, 55, 57, 58, 59, 60, 62, 78, 79, 80, 82, 97, 98, 100, 101, 115, 119]"
agent_b,L100,middle,17,4,13,6,0.8547,117,"[8, 18, 21, 22, 38, 39, 40, 41, 46, 63, 84, 96, 98, 99, 101, 102, 105]"
agent_b,L100,middle,28,17,11,2,0.7812,128,"[8, 17, 18, 19, 20, 21, 39, 40, 41, 42, 58, 59, 61, 63, 64, 81, 83, 84, 86, 103, 104, 105, 120, 121, 122, 123, 124, 126]"
agent_b,L100,middle,26,19,7,2,0.7937,126,"[8, 18, 19, 35, 36, 38, 39, 40, 56, 58, 59, 61, 76, 77, 79, 81, 96, 97, 99, 100, 102, 116, 117, 118, 120, 123]"
agent_b,L100,middle,28,21,7,2,0.7812,128,"[17, 19, 20, 31, 32, 33, 34, 35, 36, 38, 40, 41, 42, 60, 61, 63, 80, 81, 82, 84, 100, 101, 102, 103, 120, 121, 122, 124]"
agent_b,L100,middle,22,12,10,1,0.8197,122,"[10, 19, 35, 36, 37, 38, 39, 57, 59, 60, 75, 77, 81, 94, 95, 96, 97, 98, 100, 101, 103, 120]"
agent_b,L100,middle,23,17,6,8,0.813,123,"[10, 18, 20, 36, 37, 38, 39, 41, 56, 57, 58, 61, 77, 79, 83, 98, 101, 114, 115, 116, 117, 118, 119]"
agent_b,L100,middle,30,20,10,2,0.7692,130,"[17, 19, 32, 34, 36, 38, 39, 40, 56, 57, 58, 62, 76, 79, 80, 81, 83, 84, 98, 99, 100, 101, 103, 104, 105, 121, 122, 123, 124, 127]"
agent_b,L100,middle,24,20,4,2,0.8065,124,"[8, 18, 19, 36, 38, 40, 54, 55, 57, 58, 59, 60, 76, 77, 82, 96, 97, 98, 99, 100, 114, 116, 119, 120]"
agent_b,L100,middle,25,16,9,2,0.8,125,"[9, 19, 21, 22, 23, 41, 42, 43, 59, 61, 62, 63, 65, 67, 82, 83, 84, 85, 86, 87, 89, 106, 109, 110, 111]"
agent_b,L100,middle,24,19,5,3,0.8065,124,"[17, 18, 21, 33, 36, 37, 39, 55, 56, 57, 59, 75, 76, 77, 78, 79, 95, 96, 98, 100, 115, 117, 118, 119]"
agent_b,L100,middle,25,20,5,9,0.8,125,"[17, 18, 20, 31, 32, 34, 35, 36, 38, 39, 43, 60, 76, 77, 78, 79, 80, 83, 98, 100, 104, 118, 119, 120, 122]"
agent_b,L100,middle,25,21,4,2,0.8,125,"[17, 19, 31, 34, 36, 37, 39, 40, 57, 58, 59, 60, 76, 78, 79, 81, 97, 98, 101, 115, 116, 117, 118, 119, 120]"
agent_b,L100,middle,26,21,5,1,0.7937,126,"[8, 17, 18, 20, 36, 37, 39, 55, 56, 57, 58, 59, 75, 76, 77, 79, 95, 97, 98, 99, 100, 101, 117, 119, 120, 121]"
agent_b,L100,middle,20,11,9,1,0.8333,120,"[8, 17, 20, 37, 38, 39, 40, 55, 56, 57, 58, 59, 60, 61, 79, 81, 98, 99, 103, 117]"
agent_b,L100,middle,27,22,5,0,0.7874,127,"[8, 17, 18, 19, 20, 21, 38, 40, 41, 57, 60, 61, 76, 77, 78, 79, 81, 97, 98, 100, 101, 102, 116, 117, 118, 121, 122]"
agent_b,L100,middle,25,10,15,1,0.8,125,"[17, 20, 31, 32, 33, 35, 36, 38, 39, 56, 57, 58, 59, 73, 74, 77, 78, 79, 94, 97, 98, 100, 118, 119, 121]"
agent_b,L100,middle,26,19,7,3,0.7937,126,"[9, 18, 19, 21, 37, 38, 40, 56, 57, 59, 63, 80, 81, 94, 96, 98, 100, 101, 102, 103, 117, 118, 119, 120, 122, 123]"
agent_b,L100,middle,24,16,8,3,0.8065,124,"[8, 18, 19, 39, 52, 53, 54, 57, 58, 59, 74, 76, 78, 79, 94, 95, 97, 98, 99, 113, 115, 116, 118, 119]"
agent_b,L100,middle,27,18,9,1,0.7874,127,"[8, 18, 19, 21, 37, 39, 40, 55, 56, 57, 58, 60, 61, 78, 79, 80, 82, 98, 99, 100, 101, 102, 104, 118, 119, 120, 124]"
agent_b,L100,middle,27,7,20,1,0.7874,127,"[19, 20, 31, 33, 34, 35, 36, 38, 39, 40, 57, 58, 59, 60, 75, 78, 79, 80, 94, 95, 96, 99, 100, 115, 117, 119, 121]"
agent_b,L100,middle,24,14,10,0,0.8065,124,"[8, 18, 20, 21, 37, 38, 40, 41, 56, 57, 60, 61, 76, 77, 78, 79, 80, 81, 97, 98, 100, 101, 120, 122]"
agent_b,L100,middle,25,13,12,5,0.8,125,"[17, 18, 21, 33, 35, 36, 38, 39, 40, 56, 57, 60, 76, 77, 78, 79, 80, 83, 100, 101, 116, 118, 120, 121, 123]"
agent_b,L100,middle,21,14,7,2,0.8264,121,"[8, 17, 18, 19, 36, 37, 39, 56, 58, 59, 74, 75, 76, 77, 81, 96, 98, 99, 115, 117, 119]"
agent_b,L100,middle,22,4,18,1,0.8197,122,"[10, 20, 21, 37, 38, 39, 40, 42, 43, 58, 59, 61, 62, 63, 80, 84, 101, 103, 116, 117, 119, 120]"
agent_b,L100,middle,31,18,13,4,0.7634,131,"[8, 17, 18, 19, 21, 23, 25, 42, 44, 47, 65, 79, 80, 81, 82, 83, 85, 101, 102, 103, 104, 105, 107, 121, 122, 123, 124, 125, 126, 127, 128]"
agent_b,L100,middle,29,26,3,5,0.7752,129,"[18, 22, 35, 36, 37, 38, 39, 40, 57, 58, 59, 61, 64, 80, 82, 83, 96, 97, 98, 99, 100, 101, 102, 103, 104, 121, 122, 123, 125]"
agent_b,L100,middle,25,12,13,4,0.8,125,"[9, 17, 21, 38, 39, 40, 54, 56, 58, 59, 60, 62, 77, 79, 82, 83, 84, 85, 87, 103, 105, 107, 108, 109, 111]"
agent_b,L100,middle,27,15,12,1,0.7874,127,"[17, 20, 32, 33, 34, 36, 37, 38, 39, 56, 57, 58, 59, 73, 74, 75, 76, 77, 78, 79, 96, 98, 99, 115, 116, 118, 119]"
agent_b,L100,middle,26,23,3,5,0.7937,126,"[17, 18, 22, 34, 35, 37, 38, 40, 56, 57, 59, 61, 76, 78, 79, 80, 81, 97, 98, 99, 100, 102, 118, 119, 120, 121]"
agent_b,L100,middle,26,20,6,6,0.7937,126,"[8, 17, 19, 24, 41, 54, 55, 56, 59, 60, 77, 79, 80, 96, 97, 98, 100, 113, 114, 115, 116, 117, 118, 119, 120, 122]"
agent_b,L100,middle,22,11,11,4,0.8197,122,"[8, 19, 37, 40, 52, 56, 57, 60, 76, 79, 91, 92, 94, 95, 98, 100, 112, 114, 116, 117, 118, 120]"
agent_b,L100,middle,25,15,10,5,0.8,125,"[17, 18, 19, 30, 31, 33, 34, 35, 36, 39, 55, 57, 58, 60, 75, 77, 78, 80, 83, 99, 101, 117, 119, 120, 123]"
agent_b,L100,middle,24,13,11,4,0.8065,124,"[11, 20, 36, 38, 40, 53, 56, 57, 58, 60, 75, 76, 77, 78, 79, 80, 96, 97, 99, 100, 114, 115, 116, 119]"
agent_b,L100,middle,22,15,7,4,0.8197,122,"[8, 18, 19, 22, 38, 40, 41, 42, 56, 57, 58, 59, 60, 61, 62, 63, 80, 81, 83, 101, 102, 105]"
agent_b,L100,middle,24,16,8,6,0.8065,124,"[18, 20, 31, 32, 33, 34, 37, 38, 39, 57, 58, 59, 73, 74, 75, 80, 96, 98, 99, 104, 117, 119, 120, 122]"
agent_b,L100,middle,28,18,10,2,0.7812,128,"[17, 18, 19, 30, 31, 33, 34, 35, 37, 38, 40, 57, 59, 60, 77, 80, 93, 94, 95, 96, 97, 98, 99, 102, 117, 119, 120, 123]"
agent_b,L100,middle,24,17,7,5,0.8065,124,"[8, 17, 18, 20, 36, 39, 54, 55, 59, 75, 76, 77, 78, 80, 94, 95, 96, 97, 98, 103, 117, 118, 119, 120]"
agent_b,L100,middle,28,20,8,3,0.7812,128,"[17, 19, 22, 34, 36, 37, 39, 41, 56, 57, 58, 59, 60, 74, 75, 77, 79, 80, 95, 96, 99, 100, 115, 116, 117, 118, 119, 120]"
agent_b,L100,middle,26,16,10,2,0.7937,126,"[17, 19, 30, 31, 32, 33, 35, 37, 38, 40, 57, 58, 60, 77, 78, 79, 93, 94, 96, 98, 99, 114, 115, 116, 117, 119]"
agent_b,L100,middle,28,19,9,1,0.7812,128,"[17, 18, 19, 20, 21, 34, 35, 36, 37, 38, 39, 40, 41, 59, 60, 61, 77, 78, 80, 81, 82, 99, 100, 101, 104, 121, 122, 123]"
agent_b,L100,middle,25,22,3,3,0.8,125,"[8, 17, 18, 20, 36, 37, 38, 40, 56, 58, 60, 75, 77, 78, 79, 80, 96, 98, 99, 100, 117, 118, 119, 121, 123]"
agent_b,L100,middle,29,22,7,2,0.7752,129,"[18, 19, 30, 31, 32, 35, 38, 39, 40, 57, 58, 62, 76, 77, 78, 79, 80, 81, 95, 96, 97, 98, 100, 101, 117, 118, 119, 120, 122]"
agent_b,L100,middle,26,18,8,2,0.7937,126,"[17, 19, 31, 32, 33, 35, 36, 37, 38, 39, 42, 59, 60, 61, 63, 81, 82, 97, 98, 99, 101, 102, 118, 119, 120, 122]"
agent_b,L100,middle,26,19,7,5,0.7937,126,"[18, 21, 34, 36, 37, 38, 39, 55, 56, 57, 58, 59, 62, 78, 79, 80, 96, 98, 99, 100, 115, 116, 117, 118, 119, 121]"
agent_b,L100,middle,25,13,12,2,0.8,125,"[8, 17, 19, 20, 21, 38, 39, 41, 44, 60, 61, 62, 77, 79, 80, 81, 82, 97, 98, 102, 116, 117, 120, 121, 122]"
agent_b,L100,middle,22,16,6,3,0.8197,122,"[9, 19, 35, 36, 38, 39, 54, 55, 56, 58, 59, 61, 76, 78, 79, 80, 96, 98, 102, 116, 118, 120]"
agent_b,L100,middle,26,10,16,3,0.7937,126,"[8, 18, 20, 21, 22, 23, 24, 42, 43, 44, 45, 60, 61, 62, 63, 66, 84, 85, 87, 104, 107, 120, 121, 122, 123, 124]"
agent_b,L100,middle,26,18,8,2,0.7937,126,"[8, 18, 19, 35, 37, 39, 41, 56, 57, 58, 59, 60, 76, 77, 78, 79, 81, 97, 99, 100, 114, 116, 117, 118, 119, 120]"
agent_b,L100,middle,23,12,11,6,0.813,123,"[17, 18, 19, 30, 31, 32, 33, 34, 35, 37, 39, 44, 61, 77, 80, 96, 97, 98, 100, 116, 118, 119, 121]"
agent_b,L100,middle,27,15,12,1,0.7874,127,"[17, 20, 21, 34, 35, 37, 38, 39, 40, 41, 42, 61, 62, 77, 80, 81, 82, 83, 98, 99, 100, 101, 102, 104, 120, 123, 124]"
agent_b,L100,middle,27,18,9,1,0.7874,127,"[8, 17, 19, 35, 37, 38, 39, 40, 41, 42, 58, 59, 61, 62, 81, 83, 97, 98, 100, 102, 104, 119, 120, 121, 122, 123, 124]"
agent_b,L0,long,17,12,5,1,0.8547,117,"[13, 26, 28, 29, 53, 56, 57, 58, 60, 82, 83, 84, 85, 86, 87, 88, 89]"
agent_b,L0,long,21,7,14,1,0.8264,121,"[26, 27, 28, 29, 50, 51, 52, 53, 55, 57, 59, 61, 86, 87, 88, 91, 113, 114, 115, 116, 119]"
agent_b,L0,long,23,10,13,1,0.813,123,"[27, 29, 46, 47, 49, 50, 52, 53, 56, 59, 84, 85, 86, 87, 88, 90, 112, 114, 115, 116, 118, 119, 120]"
agent_b,L0,long,24,20,4,2,0.8065,124,"[26, 28, 30, 47, 50, 53, 54, 55, 56, 57, 59, 84, 85, 86, 87, 90, 112, 113, 114, 115, 116, 117, 118, 119]"
agent_b,L0,long,18,11,7,2,0.8475,118,"[26, 28, 31, 47, 48, 52, 54, 56, 57, 58, 60, 85, 86, 89, 90, 112, 113, 116]"
agent_b,L0,long,25,17,8,3,0.8,125,"[26, 27, 28, 29, 45, 46, 47, 48, 49, 50, 52, 55, 59, 61, 87, 88, 89, 90, 91, 93, 117, 118, 119, 120, 123]"
agent_b,L0,long,23,14,9,2,0.813,123,"[26, 27, 28, 30, 32, 49, 51, 53, 56, 57, 58, 59, 60, 61, 87, 88, 89, 90, 92, 93, 95, 118, 121]"
agent_b,L0,long,24,6,18,0,0.8065,124,"[26, 27, 29, 30, 48, 50, 52, 53, 54, 55, 56, 57, 60, 86, 88, 89, 90, 91, 114, 116, 118, 119, 120, 121]"
agent_b,L0,long,25,20,5,1,0.8,125,"[13, 26, 27, 28, 29, 30, 55, 56, 57, 58, 59, 61, 84, 85, 86, 87, 88, 89, 90, 113, 114, 115, 117, 119, 121]"
agent_b,L0,long,18,6,12,3,0.8475,118,"[16, 32, 57, 59, 81, 82, 83, 84, 86, 87, 88, 89, 90, 91, 112, 113, 114, 115]"
agent_b,L0,long,26,24,2,1,0.7937,126,"[13, 25, 26, 27, 29, 30, 55, 56, 59, 61, 82, 83, 84, 85, 86, 87, 88, 89, 91, 114, 116, 117, 118, 119, 120, 122]"
agent_b,L0,long,23,11,12,1,0.813,123,"[26, 27, 29, 44, 48, 50, 51, 54, 55, 56, 58, 60, 85, 87, 89, 111, 113, 114, 115, 117, 119, 120, 121]"
agent_b,L0,long,20,10,10,3,0.8333,120,"[13, 26, 29, 30, 55, 57, 58, 59, 60, 81, 82, 83, 85, 87, 93, 114, 115, 116, 117, 118]"
agent_b,L0,long,23,13,10,2,0.813,123,"[27, 28, 29, 44, 45, 49, 51, 53, 54, 56, 57, 58, 59, 85, 86, 87, 89, 90, 114, 115, 116, 117, 120]"
agent_b,L0,long,24,17,7,1,0.8065,124,"[13, 25, 27, 29, 53, 54, 55, 57, 58, 59, 82, 83, 84, 85, 86, 89, 111, 113, 114, 116, 117, 118, 119, 121]"
agent_b,L0,long,23,18,5,3,0.813,123,"[28, 30, 46, 47, 48, 49, 50, 51, 52, 54, 55, 56, 58, 59, 61, 88, 89, 91, 114, 115, 116, 118, 120]"
agent_b,L0,long,24,10,14,1,0.8065,124,"[14, 29, 30, 31, 55, 56, 58, 59, 60, 61, 82, 84, 85, 87, 89, 90, 91, 92, 93, 117, 118, 119, 120, 121]"
agent_b,L0,long,20,7,13,0,0.8333,120,"[26, 29, 46, 48, 50, 51, 52, 53, 54, 56, 57, 58, 60, 61, 89, 91, 113, 115, 116, 118]"
agent_b,L0,long,21,9,12,0,0.8264,121,"[26, 27, 28, 29, 45, 49, 50, 54, 55, 57, 59, 84, 85, 87, 88, 89, 112, 114, 116, 117, 119]"
agent_b,L0,long,22,13,9,1,0.8197,122,"[13, 26, 27, 28, 29, 54, 56, 57, 60, 81, 82, 83, 84, 85, 86, 89, 90, 91, 116, 118, 119, 120]"
agent_b,L0,long,24,12,12,3,0.8065,124,"[13, 25, 27, 29, 31, 57, 58, 60, 63, 85, 87, 88, 89, 90, 91, 113, 114, 115, 116, 117, 118, 119, 120, 121]"
agent_b,L0,long,27,10,17,1,0.7874,127,"[13, 25, 26, 27, 28, 30, 56, 57, 58, 59, 61, 83, 84, 89, 90, 113, 114, 115, 116, 117, 118, 119, 120, 121, 122, 123, 124]"
agent_b,L0,long,25,13,12,2,0.8,125,"[26, 29, 30, 33, 49, 53, 54, 57, 58, 59, 60, 61, 86, 87, 88, 90, 91, 113, 114, 115, 116, 118, 119, 120, 121]"
agent_b,L0,long,17,10,7,1,0.8547,117,"[26, 27, 28, 30, 48, 49, 50, 53, 55, 57, 58, 59, 60, 61, 87, 90, 92]"
agent_b,L0,long,17,8,9,1,0.8547,117,"[27, 28, 31, 47, 57, 59, 60, 83, 84, 87, 88, 89, 90, 91, 111, 112, 113]"
agent_b,L0,long,24,15,9,1,0.8065,124,"[26, 28, 30, 31, 49, 50, 51, 52, 54, 55, 56, 57, 60, 62, 89, 91, 112, 113, 115, 116, 117, 118, 121, 122]"
agent_b,L0,long,23,7,16,5,0.813,123,"[26, 27, 32, 47, 48, 50, 52, 54, 55, 57, 58, 61, 87, 88, 89, 112, 113, 115, 116, 117, 118, 119, 120]"
agent_b,L0,long,15,8,7,3,0.8696,115,"[14, 26, 29, 31, 34, 58, 59, 60, 61, 64, 87, 88, 91, 92, 93]"
agent_b,L0,long,15,6,9,1,0.8696,115,"[14, 26, 27, 28, 31, 32, 57, 58, 60, 64, 86, 89, 91, 93, 96]"
agent_b,L0,long,23,7,16,2,0.813,123,"[26, 27, 29, 44, 49, 50, 52, 53, 54, 58, 61, 85, 86, 88, 89, 90, 112, 114, 115, 117, 118, 119, 120]"
agent_b,L0,long,25,12,13,3,0.8,125,"[26, 30, 32, 48, 51, 52, 53, 54, 56, 57, 58, 59, 60, 62, 88, 90, 91, 94, 115, 116, 117, 119, 120, 122, 123]"
agent_b,L0,long,16,8,8,3,0.8621,116,"[14, 26, 31, 54, 55, 56, 57, 58, 60, 82, 83, 84, 86, 89, 90, 93]"
agent_b,L0,long,13,4,9,0,0.885,113,"[13, 29, 53, 55, 58, 60, 61, 83, 86, 87, 89, 90, 91]"
agent_b,L0,long,18,9,9,0,0.8475,118,"[13, 25, 26, 27, 29, 30, 57, 58, 60, 81, 82, 85, 86, 87, 88, 90, 115, 116]"
agent_b,L0,long,19,14,5,0,0.8403,119,"[13, 25, 26, 27, 28, 29, 31, 32, 33, 59, 62, 63, 85, 87, 89, 92, 93, 116, 117]"
agent_b,L0,long,16,11,5,5,0.8621,116,"[13, 26, 27, 28, 33, 57, 58, 59, 80, 81, 83, 86, 90, 111, 112, 113]"
agent_b,L0,long,18,12,6,1,0.8475,118,"[13, 25, 26, 27, 29, 55, 57, 58, 59, 60, 82, 83, 84, 85, 86, 87, 88, 91]"
agent_b,L0,long,18,12,6,0,0.8475,118,"[27, 29, 46, 47, 48, 49, 52, 56, 57, 58, 59, 60, 86, 87, 89, 91, 112, 115]"
agent_b,L0,long,21,7,14,0,0.8264,121,"[14, 26, 27, 28, 29, 54, 55, 58, 59, 60, 83, 85, 86, 87, 89, 90, 114, 116, 117, 118, 119]"
agent_b,L0,long,23,12,11,3,0.813,123,"[26, 27, 28, 30, 48, 49, 50, 51, 53, 55, 56, 58, 59, 60, 85, 88, 89, 90, 92, 115, 116, 118, 119]"
agent_b,L0,long,25,17,8,0,0.8,125,"[15, 29, 52, 53, 56, 58, 59, 80, 81, 82, 83, 84, 85, 86, 87, 88, 89, 112, 113, 114, 115, 116, 118, 119, 120]"
agent_b,L0,long,13,10,3,3,0.885,113,"[14, 26, 27, 28, 29, 32, 58, 59, 60, 64, 87, 91, 92]"
agent_b,L0,long,25,3,22,2,0.8,125,"[13, 26, 28, 29, 31, 55, 56, 57, 58, 59, 60, 61, 63, 86, 88, 90, 91, 92, 116, 118, 119, 120, 121, 122, 123]"
agent_b,L0,long,20,8,12,0,0.8333,120,"[26, 29, 31, 48, 51, 52, 53, 54, 55, 56, 57, 60, 61, 88, 89, 90, 93, 94, 115, 117]"
agent_b,L0,long,23,9,14,2,0.813,123,"[26, 27, 28, 29, 45, 46, 47, 49, 50, 52, 54, 56, 58, 59, 84, 85, 87, 88, 90, 115, 117, 118, 120]"
agent_b,L0,long,15,10,5,2,0.8696,115,"[26, 28, 29, 31, 48, 49, 51, 52, 55, 57, 59, 64, 89, 90, 93]"
agent_b,L0,long,17,11,6,0,0.8547,117,"[26, 28, 29, 30, 53, 54, 55, 56, 57, 58, 59, 60, 85, 87, 88, 92, 93]"
agent_b,L0,long,14,7,7,1,0.8772,114,"[13, 26, 27, 29, 53, 56, 57, 59, 80, 81, 84, 85, 90, 112]"
agent_b,L0,long,17,9,8,3,0.8547,117,"[13, 25, 26, 28, 29, 30, 31, 56, 57, 59, 60, 65, 90, 91, 92, 114, 115]"
agent_b,L0,long,14,10,4,2,0.8772,114,"[15, 29, 30, 53, 56, 57, 58, 59, 60, 62, 88, 89, 92, 94]"
agent_b,L0,long,16,9,7,0,0.8621,116,"[13, 25, 26, 29, 30, 31, 32, 58, 59, 62, 85, 87, 88, 89, 91, 92]"
agent_b,L0,long,26,17,9,2,0.7937,126,"[26, 29, 47, 48, 49, 55, 58, 59, 60, 83, 84, 85, 86, 87, 88, 91, 112, 113, 114, 115, 117, 118, 119, 120, 121, 123]"
agent_b,L0,long,19,8,11,3,0.8403,119,"[13, 26, 30, 53, 54, 55, 56, 57, 58, 59, 63, 87, 88, 89, 90, 114, 115, 116, 117]"
agent_b,L0,long,15,5,10,1,0.8696,115,"[26, 27, 28, 30, 49, 51, 55, 57, 58, 59, 60, 61, 89, 90, 91]"
agent_b,L0,long,20,12,8,1,0.8333,120,"[13, 25, 26, 27, 28, 29, 54, 55, 56, 58, 59, 83, 86, 87, 88, 89, 90, 92, 116, 117]"
agent_b,L0,long,25,20,5,5,0.8,125,"[28, 29, 34, 51, 52, 53, 55, 56, 57, 58, 61, 85, 86, 87, 90, 91, 112, 113, 115, 116, 117, 118, 119, 120, 122]"
agent_b,L0,long,16,10,6,0,0.8621,116,"[26, 27, 29, 48, 52, 53, 54, 55, 56, 58, 59, 60, 86, 89, 92, 93]"
agent_b,L0,long,26,8,18,2,0.7937,126,"[27, 30, 46, 47, 48, 50, 52, 53, 54, 55, 56, 57, 58, 59, 84, 85, 86, 88, 89, 112, 113, 114, 116, 117, 118, 120]"
agent_b,L0,long,23,12,11,1,0.813,123,"[27, 28, 29, 30, 31, 53, 54, 55, 56, 59, 60, 61, 63, 89, 91, 92, 93, 114, 115, 116, 117, 120, 121]"
agent_b,L0,long,16,7,9,0,0.8621,116,"[14, 26, 29, 31, 32, 33, 59, 60, 62, 63, 86, 89, 90, 91, 92, 93]"
agent_b,L0,long,20,16,4,0,0.8333,120,"[13, 25, 27, 28, 29, 54, 55, 56, 57, 59, 60, 84, 85, 86, 87, 88, 89, 90, 116, 118]"
agent_b,L0,long,22,20,2,3,0.8197,122,"[13, 25, 27, 28, 29, 30, 55, 56, 57, 58, 59, 61, 84, 86, 87, 88, 90, 114, 115, 116, 117, 118]"
agent_b,L0,long,16,12,4,0,0.8621,116,"[26, 29, 30, 48, 49, 50, 51, 52, 54, 59, 62, 63, 88, 90, 91, 93]"
agent_b,L0,long,16,4,12,5,0.8621,116,"[26, 31, 47, 50, 51, 56, 57, 58, 60, 84, 85, 86, 87, 88, 90, 95]"
agent_b,L0,long,26,14,12,0,0.7937,126,"[13, 25, 27, 30, 54, 55, 56, 57, 58, 59, 60, 61, 84, 85, 86, 87, 88, 89, 90, 91, 115, 116, 117, 119, 120, 121]"
agent_b,L0,long,25,21,4,0,0.8,125,"[13, 26, 28, 29, 53, 54, 55, 56, 57, 58, 60, 83, 84, 85, 86, 87, 88, 90, 113, 115, 116, 117, 118, 120, 121]"
agent_b,L0,long,17,5,12,2,0.8547,117,"[14, 31, 58, 60, 80, 82, 85, 86, 87, 88, 89, 91, 111, 112, 113, 114, 115]"
agent_b,L0,long,17,11,6,1,0.8547,117,"[15, 29, 31, 54, 56, 57, 58, 59, 60, 82, 83, 86, 87, 89, 90, 114, 115]"
agent_b,L0,long,28,11,17,0,0.7812,128,"[13, 25, 28, 30, 54, 55, 57, 58, 59, 60, 82, 83, 84, 85, 86, 90, 92, 93, 94, 95, 118, 119, 120, 121, 123, 124, 125, 126]"
agent_b,L0,long,21,16,5,3,0.8264,121,"[26, 29, 47, 48, 49, 50, 51, 55, 56, 58, 62, 88, 89, 109, 110, 111, 112, 116, 117, 118, 119]"
agent_b,L0,long,19,6,13,1,0.8403,119,"[14, 30, 55, 56, 57, 58, 59, 81, 82, 84, 85, 86, 87, 88, 89, 90, 114, 115, 116]"
agent_b,L0,long,17,12,5,4,0.8547,117,"[13, 25, 28, 32, 56, 57, 58, 61, 84, 85, 86, 88, 89, 90, 113, 114, 115]"
agent_b,L0,long,24,12,12,4,0.8065,124,"[27, 31, 47, 48, 49, 50, 52, 53, 55, 57, 58, 59, 63, 88, 89, 90, 92, 93, 115, 116, 117, 119, 121, 122]"
agent_b,L0,long,20,15,5,1,0.8333,120,"[13, 25, 26, 27, 28, 29, 31, 56, 57, 58, 60, 62, 85, 86, 87, 88, 89, 92, 116, 117]"
agent_b,L0,long,25,12,13,2,0.8,125,"[26, 27, 29, 48, 49, 51, 52, 54, 57, 58, 59, 60, 62, 87, 88, 89, 90, 91, 114, 115, 116, 118, 119, 120, 122]"
agent_b,L0,long,24,10,14,2,0.8065,124,"[26, 27, 30, 47, 49, 53, 55, 56, 58, 59, 60, 62, 86, 87, 88, 91, 112, 113, 114, 117, 119, 120, 121, 122]"
agent_b,L0,long,11,8,3,1,0.9009,111,"[14, 29, 30, 55, 58, 60, 83, 84, 85, 86, 91]"
agent_b,L0,long,19,11,8,2,0.8403,119,"[26, 28, 29, 44, 45, 46, 50, 51, 55, 58, 60, 63, 87, 88, 89, 91, 92, 93, 95]"
agent_b,L0,long,22,12,10,3,0.8197,122,"[26, 27, 29, 47, 49, 50, 51, 52, 54, 55, 57, 59, 60, 89, 92, 112, 113, 114, 115, 117, 118, 119]"
agent_b,L0,long,26,20,6,1,0.7937,126,"[27, 29, 30, 47, 48, 49, 50, 51, 52, 53, 55, 57, 59, 60, 61, 88, 89, 90, 93, 115, 117, 118, 119, 120, 121, 122]"
agent_b,L0,long,15,7,8,2,0.8696,115,"[26, 27, 28, 29, 30, 46, 51, 52, 56, 57, 58, 61, 86, 87, 91]"
agent_b,L0,long,22,9,13,4,0.8197,122,"[14, 26, 31, 54, 55, 56, 60, 80, 81, 82, 83, 84, 85, 86, 89, 90, 114, 115, 116, 117, 118, 120]"
agent_b,L0,long,26,17,9,3,0.7937,126,"[26, 27, 28, 30, 48, 49, 50, 51, 52, 53, 54, 55, 56, 59, 85, 87, 90, 91, 114, 115, 116, 117, 118, 119, 120, 123]"
agent_b,L0,long,23,13,10,0,0.813,123,"[14, 29, 30, 53, 54, 57, 58, 59, 60, 61, 62, 84, 85, 86, 87, 88, 90, 92, 117, 118, 119, 120, 121]"
agent_b,L0,long,17,5,12,8,0.8547,117,"[13, 25, 26, 28, 35, 60, 84, 85, 86, 87, 88, 91, 111, 112, 113, 114, 115]"
agent_b,L0,long,23,9,14,1,0.813,123,"[26, 27, 29, 44, 45, 46, 47, 48, 49, 51, 52, 54, 55, 56, 57, 58, 60, 87, 88, 89, 116, 118, 120]"
agent_b,L0,long,16,8,8,3,0.8621,116,"[13, 26, 27, 28, 30, 55, 58, 60, 81, 82, 84, 85, 86, 87, 88, 90]"
agent_b,L0,long,14,10,4,4,0.8772,114,"[15, 30, 53, 55, 56, 57, 58, 59, 62, 85, 87, 88, 89, 92]"
agent_b,L0,long,24,11,13,0,0.8065,124,"[26, 27, 28, 29, 30, 46, 47, 48, 49, 55, 56, 57, 58, 59, 60, 86, 87, 89, 90, 115, 116, 118, 119, 120]"
agent_b,L0,long,23,18,5,0,0.813,123,"[13, 25, 26, 28, 29, 30, 31, 58, 60, 61, 82, 83, 84, 86, 87, 88, 89, 90, 91, 114, 115, 116, 121]"
agent_b,L0,long,18,7,11,2,0.8475,118,"[26, 28, 29, 44, 45, 46, 50, 51, 52, 56, 57, 58, 61, 87, 89, 113, 114, 116]"
agent_b,L0,long,21,11,10,2,0.8264,121,"[13, 25, 27, 28, 29, 30, 55, 56, 57, 59, 61, 85, 86, 88, 89, 91, 93, 115, 116, 117, 118]"
agent_b,L0,long,23,10,13,1,0.813,123,"[26, 28, 29, 44, 45, 46, 49, 50, 51, 52, 53, 55, 57, 58, 60, 86, 87, 88, 89, 115, 117, 118, 119]"
agent_b,L0,long,19,15,4,1,0.8403,119,"[13, 25, 26, 27, 28, 30, 31, 56, 57, 58, 59, 60, 62, 85, 86, 87, 90, 91, 117]"
agent_b,L0,long,25,12,13,1,0.8,125,"[13, 25, 26, 28, 29, 56, 57, 58, 59, 81, 83, 84, 85, 86, 87, 88, 90, 92, 116, 117, 118, 119, 120, 121, 122]"
agent_b,L0,long,20,11,9,0,0.8333,120,"[13, 25, 26, 28, 29, 54, 55, 56, 58, 59, 82, 83, 84, 87, 89, 113, 114, 115, 117, 118]"
agent_b,L0,long,15,7,8,1,0.8696,115,"[13, 25, 26, 29, 54, 55, 57, 58, 60, 82, 83, 85, 89, 111, 113]"
agent_b,L0,long,22,9,13,1,0.8197,122,"[27, 28, 29, 44, 48, 49, 50, 52, 53, 54, 57, 59, 85, 87, 89, 113, 115, 116, 117, 118, 119, 120]"
agent_b,L0,long,16,12,4,3,0.8621,116,"[13, 25, 27, 28, 29, 30, 31, 33, 59, 60, 62, 63, 85, 87, 90, 96]"
agent_b,L0,long,23,16,7,5,0.813,123,"[27, 28, 34, 52, 53, 54, 58, 59, 82, 85, 87, 88, 89, 90, 110, 111, 112, 113, 114, 117, 118, 119, 120]"
agent_b,L50,long,17,9,8,0,0.8547,117,"[12, 25, 28, 29, 30, 31, 57, 58, 59, 60, 62, 87, 88, 89, 90, 91, 92]"
agent_b,L50,long,15,10,5,2,0.8696,115,"[12, 25, 26, 30, 32, 58, 59, 60, 61, 63, 87, 88, 90, 91, 92]"
agent_b,L50,long,13,8,5,1,0.885,113,"[13, 28, 29, 55, 57, 58, 60, 83, 84, 86, 87, 89, 90]"
agent_b,L50,long,14,10,4,0,0.8772,114,"[12, 25, 26, 27, 28, 30, 56, 57, 59, 60, 86, 88, 89, 90]"
agent_b,L50,long,15,10,5,2,0.8696,115,"[13, 26, 27, 30, 55, 56, 57, 60, 84, 85, 86, 87, 88, 89, 92]"
agent_b,L50,long,16,10,6,4,0.8621,116,"[12, 25, 26, 28, 33, 58, 59, 61, 84, 86, 87, 89, 90, 92, 93, 94]"
agent_b,L50,long,27,14,13,4,0.7874,127,"[27, 28, 30, 47, 48, 50, 51, 52, 53, 54, 56, 58, 60, 86, 87, 88, 91, 114, 115, 117, 118, 119, 121, 122, 123, 124, 125]"
agent_b,L50,long,24,10,14,2,0.8065,124,"[26, 27, 28, 29, 31, 49, 51, 52, 53, 56, 58, 59, 61, 86, 87, 90, 92, 115, 116, 117, 118, 119, 120, 121]"
agent_b,L50,long,9,4,5,6,0.9174,109,"[13, 25, 28, 29, 32, 63, 87, 89, 91]"
agent_b,L50,long,20,10,10,5,0.8333,120,"[28, 29, 46, 47, 49, 50, 51, 53, 54, 55, 56, 57, 58, 60, 86, 87, 92, 115, 117, 118]"
agent_b,L50,long,17,13,4,0,0.8547,117,"[12, 25, 26, 27, 28, 29, 54, 55, 57, 58, 59, 60, 61, 88, 89, 90, 91]"
agent_b,L50,long,21,14,7,0,0.8264,121,"[27, 28, 29, 47, 48, 49, 50, 51, 52, 53, 54, 55, 56, 57, 59, 62, 63, 90, 91, 93, 119]"
agent_b,L50,long,12,11,1,4,0.8929,112,"[12, 25, 27, 28, 29, 54, 56, 59, 60, 65, 90, 91]"
agent_b,L50,long,18,9,9,1,0.8475,118,"[26, 27, 28, 30, 48, 49, 50, 53, 54, 55, 58, 60, 61, 86, 90, 91, 115, 116]"
agent_b,L50,long,15,11,4,0,0.8696,115,"[13, 25, 27, 29, 30, 57, 61, 63, 89, 90, 91, 92, 93, 94, 96]"
agent_b,L50,long,23,13,10,1,0.813,123,"[26, 27, 28, 30, 48, 49, 51, 52, 53, 54, 55, 56, 57, 58, 59, 88, 89, 91, 92, 93, 94, 95, 120]"
agent_b,L50,long,11,6,5,1,0.9009,111,"[12, 26, 27, 29, 54, 59, 82, 84, 87, 88, 91]"
agent_b,L50,long,24,18,6,0,0.8065,124,"[27, 28, 29, 47, 49, 50, 52, 56, 57, 59, 83, 84, 85, 86, 87, 90, 113, 114, 115, 116, 117, 118, 119, 120]"
agent_b,L50,long,15,9,6,2,0.8696,115,"[13, 25, 28, 30, 55, 56, 57, 59, 60, 85, 86, 88, 89, 90, 93]"
agent_b,L50,long,18,15,3,0,0.8475,118,"[28, 29, 46, 48, 49, 51, 55, 57, 59, 85, 87, 88, 89, 110, 111, 112, 113, 114]"
agent_b,L50,long,14,14,0,0,0.8772,114,"[13, 25, 27, 28, 29, 54, 55, 56, 57, 58, 59, 84, 88, 89]"
agent_b,L50,long,26,7,19,1,0.7937,126,"[26, 27, 29, 31, 49, 50, 53, 54, 55, 56, 57, 58, 59, 60, 62, 64, 92, 93, 116, 117, 118, 119, 120, 121, 122, 123]"
agent_b,L50,long,14,10,4,1,0.8772,114,"[12, 25, 26, 27, 28, 30, 56, 58, 59, 62, 86, 88, 89, 91]"
agent_b,L50,long,22,7,15,2,0.8197,122,"[26, 29, 30, 31, 49, 51, 52, 53, 55, 56, 57, 58, 59, 60, 61, 62, 63, 66, 94, 95, 119, 120]"
agent_b,L50,long,21,6,15,1,0.8264,121,"[26, 28, 29, 47, 48, 49, 50, 52, 54, 55, 56, 57, 58, 59, 87, 90, 114, 115, 116, 118, 119]"
agent_b,L50,long,13,7,6,1,0.885,113,"[12, 25, 26, 29, 30, 32, 59, 61, 85, 86, 87, 90, 91]"
agent_b,L50,long,19,5,14,1,0.8403,119,"[26, 29, 47, 48, 50, 51, 52, 54, 55, 56, 57, 58, 60, 86, 89, 113, 114, 115, 116]"
agent_b,L50,long,15,15,0,0,0.8696,115,"[12, 25, 26, 28, 29, 54, 55, 56, 57, 58, 59, 60, 85, 86, 91]"
agent_b,L50,long,13,4,9,1,0.885,113,"[13, 25, 28, 29, 54, 55, 59, 62, 64, 91, 92, 93, 94]"
agent_b,L50,long,16,14,2,1,0.8621,116,"[12, 25, 26, 27, 29, 54, 55, 56, 57, 58, 59, 60, 85, 87, 88, 91]"
agent_b,L50,long,23,10,13,0,0.813,123,"[27, 28, 29, 30, 31, 49, 50, 51, 53, 55, 57, 58, 60, 61, 62, 88, 89, 90, 92, 93, 94, 119, 121]"
agent_b,L50,long,17,11,6,2,0.8547,117,"[26, 28, 29, 32, 53, 56, 57, 59, 60, 61, 62, 87, 89, 90, 91, 92, 94]"
agent_b,L50,long,16,12,4,1,0.8621,116,"[29, 30, 47, 48, 49, 52, 54, 55, 56, 57, 58, 61, 88, 90, 112, 113]"
agent_b,L50,long,22,13,9,3,0.8197,122,"[26, 27, 29, 30, 49, 50, 51, 53, 55, 56, 59, 60, 85, 86, 87, 88, 89, 91, 115, 116, 117, 119]"
agent_b,L50,long,15,14,1,1,0.8696,115,"[13, 26, 28, 31, 56, 58, 59, 60, 84, 85, 86, 87, 89, 90, 91]"
agent_b,L50,long,14,11,3,1,0.8772,114,"[13, 25, 26, 27, 28, 29, 31, 56, 58, 59, 60, 87, 88, 90]"
agent_b,L50,long,14,6,8,1,0.8772,114,"[12, 27, 29, 30, 55, 56, 57, 58, 59, 61, 86, 87, 88, 90]"
agent_b,L50,long,14,11,3,0,0.8772,114,"[12, 25, 27, 28, 29, 30, 55, 56, 58, 59, 60, 87, 89, 90]"
agent_b,L50,long,12,7,5,1,0.8929,112,"[12, 27, 28, 29, 55, 56, 59, 83, 84, 85, 87, 91]"
agent_b,L50,long,21,9,12,1,0.8264,121,"[26, 27, 28, 29, 45, 48, 49, 50, 51, 53, 58, 60, 85, 86, 87, 88, 89, 92, 93, 117, 118]"
agent_b,L50,long,16,5,11,2,0.8621,116,"[26, 29, 30, 48, 50, 51, 53, 54, 57, 59, 62, 89, 91, 112, 113, 114]"
agent_b,L50,long,13,10,3,1,0.885,113,"[15, 29, 30, 55, 56, 58, 61, 84, 85, 86, 87, 88, 90]"
agent_b,L50,long,15,8,7,3,0.8696,115,"[27, 29, 46, 48, 49, 51, 53, 54, 59, 62, 86, 88, 89, 91, 113]"
agent_b,L50,long,15,7,8,1,0.8696,115,"[26, 28, 31, 52, 54, 55, 56, 59, 60, 85, 86, 87, 90, 112, 113]"
agent_b,L50,long,12,8,4,0,0.8929,112,"[12, 25, 26, 27, 28, 29, 56, 57, 59, 85, 86, 89]"
agent_b,L50,long,16,8,8,1,0.8621,116,"[26, 27, 29, 30, 52, 54, 56, 61, 84, 86, 87, 88, 89, 90, 112, 113]"
agent_b,L50,long,13,7,6,1,0.885,113,"[12, 25, 26, 27, 29, 54, 56, 57, 58, 59, 85, 87, 90]"
agent_b,L50,long,14,12,2,0,0.8772,114,"[26, 29, 30, 51, 52, 53, 59, 60, 61, 62, 86, 87, 89, 92]"
agent_b,L50,long,25,11,14,2,0.8,125,"[26, 27, 28, 30, 49, 50, 52, 53, 55, 56, 57, 58, 60, 86, 89, 112, 113, 114, 115, 116, 117, 118, 120, 121, 122]"
agent_b,L50,long,14,10,4,0,0.8772,114,"[12, 25, 28, 29, 30, 56, 59, 60, 84, 85, 86, 87, 89, 90]"
agent_b,L50,long,14,12,2,0,0.8772,114,"[12, 25, 29, 54, 57, 58, 59, 83, 84, 86, 87, 88, 89, 90]"
agent_b,L50,long,12,11,1,3,0.8929,112,"[12, 25, 26, 27, 29, 54, 55, 56, 57, 60, 87, 92]"
agent_b,L50,long,15,11,4,1,0.8696,115,"[12, 25, 26, 27, 30, 56, 58, 59, 84, 85, 87, 88, 89, 91, 92]"
agent_b,L50,long,14,10,4,3,0.8772,114,"[12, 25, 26, 27, 29, 54, 56, 58, 59, 61, 86, 88, 89, 92]"
agent_b,L50,long,23,3,20,0,0.813,123,"[26, 27, 28, 29, 45, 46, 49, 50, 51, 52, 53, 58, 60, 87, 88, 90, 114, 115, 116, 117, 118, 119, 120]"
agent_b,L50,long,14,7,7,3,0.8772,114,"[26, 29, 31, 32, 33, 35, 54, 57, 58, 61, 63, 66, 94, 96]"
agent_b,L50,long,13,10,3,1,0.885,113,"[12, 25, 26, 27, 28, 30, 55, 56, 59, 86, 87, 89, 90]"
agent_b,L50,long,23,12,11,0,0.813,123,"[26, 27, 28, 29, 45, 49, 50, 51, 52, 53, 54, 55, 58, 59, 60, 87, 88, 90, 114, 117, 118, 119, 120]"
agent_b,L50,long,14,9,5,1,0.8772,114,"[12, 25, 26, 27, 29, 31, 59, 60, 84, 86, 88, 89, 90, 91]"
agent_b,L50,long,18,9,9,4,0.8475,118,"[26, 27, 28, 30, 48, 49, 50, 51, 52, 54, 56, 57, 59, 61, 87, 90, 91, 94]"
agent_b,L50,long,14,8,6,5,0.8772,114,"[27, 31, 47, 50, 51, 53, 55, 56, 57, 59, 61, 87, 88, 94]"
agent_b,L50,long,18,14,4,0,0.8475,118,"[12, 25, 26, 27, 28, 29, 30, 58, 59, 60, 87, 88, 89, 90, 91, 92, 93, 95]"
agent_b,L50,long,14,8,6,0,0.8772,114,"[12, 27, 28, 29, 30, 31, 58, 59, 61, 85, 86, 87, 88, 91]"
agent_b,L50,long,19,10,9,0,0.8403,119,"[26, 28, 29, 30, 32, 50, 51, 53, 55, 56, 58, 59, 60, 61, 62, 88, 91, 92, 94]"
agent_b,L50,long,21,16,5,1,0.8264,121,"[28, 29, 46, 48, 49, 52, 54, 55, 57, 58, 59, 60, 61, 86, 87, 88, 89, 92, 116, 118, 119]"
agent_b,L50,long,25,9,16,1,0.8,125,"[26, 27, 28, 29, 45, 46, 47, 49, 50, 51, 52, 54, 56, 57, 58, 59, 61, 90, 92, 93, 118, 119, 121, 122, 123]"
agent_b,L50,long,15,14,1,3,0.8696,115,"[12, 25, 26, 27, 31, 58, 59, 60, 84, 85, 86, 87, 88, 89, 91]"
agent_b,L50,long,16,9,7,1,0.8621,116,"[26, 28, 29, 47, 51, 53, 54, 55, 57, 58, 59, 84, 86, 88, 91, 113]"
agent_b,L50,long,14,10,4,1,0.8772,114,"[12, 27, 28, 29, 31, 57, 59, 60, 84, 85, 86, 87, 89, 90]"
agent_b,L50,long,14,9,5,2,0.8772,114,"[26, 31, 35, 56, 57, 58, 59, 60, 61, 63, 90, 92, 95, 96]"
agent_b,L50,long,14,10,4,0,0.8772,114,"[12, 25, 27, 28, 29, 54, 55, 56, 57, 60, 61, 87, 90, 91]"
agent_b,L50,long,19,6,13,0,0.8403,119,"[26, 27, 28, 30, 48, 50, 52, 53, 55, 56, 57, 60, 85, 86, 88, 89, 90, 114, 116]"
agent_b,L50,long,9,4,5,4,0.9174,109,"[15, 28, 33, 61, 85, 86, 87, 88, 90]"
agent_b,L50,long,22,7,15,4,0.8197,122,"[28, 32, 50, 52, 54, 55, 56, 57, 59, 60, 63, 87, 88, 89, 92, 114, 115, 116, 117, 118, 119, 120]"
agent_b,L50,long,14,8,6,0,0.8772,114,"[12, 25, 27, 29, 54, 55, 56, 58, 59, 85, 86, 87, 88, 89]"
agent_b,L50,long,13,11,2,2,0.885,113,"[13, 26, 27, 28, 30, 56, 59, 60, 61, 86, 87, 88, 92]"
agent_b,L50,long,17,6,11,2,0.8547,117,"[27, 28, 29, 47, 50, 52, 53, 54, 55, 56, 58, 61, 88, 89, 111, 112, 115]"
agent_b,L50,long,15,10,5,1,0.8696,115,"[12, 25, 26, 28, 29, 30, 32, 58, 59, 60, 61, 63, 89, 90, 94]"
agent_b,L50,long,22,12,10,3,0.8197,122,"[27, 28, 31, 47, 48, 49, 50, 51, 52, 56, 59, 60, 85, 87, 88, 89, 91, 114, 115, 117, 119, 120]"
agent_b,L50,long,17,9,8,2,0.8547,117,"[26, 27, 28, 29, 30, 32, 55, 56, 58, 62, 87, 88, 89, 90, 91, 92, 115]"
agent_b,L50,long,19,7,12,3,0.8403,119,"[26, 28, 30, 47, 48, 49, 50, 53, 54, 55, 56, 57, 58, 59, 61, 62, 89, 91, 95]"
agent_b,L50,long,14,13,1,2,0.8772,114,"[12, 26, 27, 28, 29, 54, 55, 56, 57, 58, 59, 62, 89, 90]"
agent_b,L50,long,15,8,7,2,0.8696,115,"[12, 25, 27, 29, 32, 57, 58, 59, 60, 87, 88, 89, 90, 91, 93]"
agent_b,L50,long,17,7,10,3,0.8547,117,"[26, 28, 29, 47, 49, 52, 55, 56, 58, 59, 60, 61, 65, 90, 91, 93, 94]"
agent_b,L50,long,12,6,6,3,0.8929,112,"[15, 28, 29, 55, 56, 59, 82, 83, 85, 87, 88, 92]"
agent_b,L50,long,11,9,2,2,0.9009,111,"[12, 25, 26, 28, 31, 57, 58, 59, 85, 86, 89]"
agent_b,L50,long,14,3,11,2,0.8772,114,"[26, 29, 32, 51, 54, 55, 57, 58, 59, 60, 86, 89, 90, 91]"
agent_b,L50,long,15,14,1,3,0.8696,115,"[27, 29, 50, 51, 52, 53, 55, 56, 57, 61, 86, 87, 88, 89, 91]"
agent_b,L50,long,21,12,9,3,0.8264,121,"[26, 28, 29, 48, 49, 50, 51, 52, 53, 55, 57, 59, 84, 85, 86, 87, 88, 92, 116, 118, 119]"
agent_b,L50,long,15,11,4,0,0.8696,115,"[12, 25, 27, 28, 29, 54, 55, 59, 85, 86, 87, 89, 90, 91, 92]"
agent_b,L50,long,21,14,7,0,0.8264,121,"[26, 28, 29, 47, 48, 49, 50, 51, 52, 53, 54, 55, 59, 60, 61, 62, 89, 90, 91, 92, 117]"
agent_b,L50,long,11,6,5,0,0.9009,111,"[12, 27, 29, 56, 57, 58, 60, 86, 87, 89, 90]"
agent_b,L50,long,11,11,0,8,0.9009,111,"[12, 26, 27, 28, 32, 57, 58, 59, 65, 89, 90]"
agent_b,L50,long,13,10,3,2,0.885,113,"[12, 25, 26, 28, 29, 56, 61, 84, 85, 86, 87, 88, 90]"
agent_b,L50,long,14,8,6,0,0.8772,114,"[12, 25, 26, 27, 29, 54, 55, 57, 59, 85, 88, 89, 90, 91]"
agent_b,L50,long,16,12,4,1,0.8621,116,"[13, 25, 28, 29, 55, 57, 59, 62, 85, 86, 87, 88, 89, 90, 91, 92]"
agent_b,L50,long,12,8,4,2,0.8929,112,"[12, 26, 27, 28, 31, 32, 35, 37, 67, 93, 95, 96]"
agent_b,L50,long,20,11,9,2,0.8333,120,"[27, 31, 47, 48, 51, 53, 54, 56, 57, 58, 59, 61, 62, 89, 91, 92, 115, 116, 117, 118]"
agent_b,L50,long,10,2,8,4,0.9091,110,"[12, 27, 33, 61, 85, 87, 88, 90, 91, 92]"
agent_b,L50,long,17,9,8,3,0.8547,117,"[27, 28, 29, 30, 31, 33, 54, 55, 56, 58, 60, 61, 64, 89, 90, 92, 115]"
agent_b,L100,long,9,8,1,1,0.9174,109,"[12, 26, 27, 28, 29, 57, 60, 87, 89]"
agent_b,L100,long,13,8,5,2,0.885,113,"[27, 28, 29, 32, 33, 57, 58, 59, 60, 62, 65, 91, 94]"
agent_b,L100,long,13,4,9,1,0.885,113,"[27, 28, 29, 51, 54, 55, 56, 58, 59, 85, 87, 88, 90]"
agent_b,L100,long,9,7,2,1,0.9174,109,"[12, 26, 27, 28, 29, 55, 57, 60, 89]"
agent_b,L100,long,13,8,5,1,0.885,113,"[28, 31, 32, 55, 58, 60, 61, 63, 88, 89, 90, 91, 92]"
agent_b,L100,long,10,5,5,2,0.9091,110,"[12, 27, 28, 29, 55, 57, 58, 61, 89, 90]"
agent_b,L100,long,13,2,11,0,0.885,113,"[12, 28, 29, 30, 55, 56, 57, 58, 59, 60, 87, 89, 90]"
agent_b,L100,long,11,4,7,5,0.9009,111,"[27, 28, 31, 52, 53, 56, 57, 58, 62, 88, 91]"
agent_b,L100,long,12,8,4,1,0.8929,112,"[12, 26, 27, 28, 29, 30, 57, 58, 60, 87, 88, 91]"
agent_b,L100,long,8,6,2,4,0.9259,108,"[12, 33, 58, 59, 84, 86, 89, 90]"
agent_b,L100,long,15,12,3,3,0.8696,115,"[27, 28, 33, 55, 56, 58, 59, 60, 85, 86, 87, 88, 89, 90, 91]"
agent_b,L100,long,17,15,2,0,0.8547,117,"[27, 30, 51, 52, 53, 54, 55, 56, 57, 58, 60, 88, 89, 90, 91, 92, 93]"
agent_b,L100,long,14,6,8,2,0.8772,114,"[28, 30, 51, 52, 55, 56, 57, 58, 59, 85, 88, 89, 91, 93]"
agent_b,L100,long,10,5,5,0,0.9091,110,"[13, 27, 28, 29, 56, 57, 59, 86, 87, 90]"
agent_b,L100,long,13,10,3,1,0.885,113,"[27, 28, 30, 32, 56, 57, 58, 59, 60, 61, 86, 87, 91]"
agent_b,L100,long,13,7,6,3,0.885,113,"[27, 28, 29, 30, 32, 57, 59, 60, 61, 86, 88, 89, 93]"
agent_b,L100,long,10,6,4,3,0.9091,110,"[12, 28, 31, 59, 60, 61, 87, 89, 90, 92]"
agent_b,L100,long,13,11,2,6,0.885,113,"[29, 49, 50, 52, 53, 54, 55, 56, 57, 58, 60, 89, 96]"
agent_b,L100,long,11,7,4,1,0.9009,111,"[12, 26, 28, 29, 56, 57, 59, 86, 87, 89, 91]"
agent_b,L100,long,13,13,0,5,0.885,113,"[29, 53, 54, 55, 56, 57, 58, 59, 65, 89, 90, 91, 93]"
agent_b,L100,long,13,7,6,1,0.885,113,"[12, 26, 28, 29, 55, 56, 57, 58, 60, 86, 87, 88, 89]"
agent_b,L100,long,15,11,4,0,0.8696,115,"[27, 29, 30, 31, 32, 54, 55, 57, 60, 61, 62, 88, 89, 91, 92]"
agent_b,L100,long,12,7,5,0,0.8929,112,"[12, 27, 28, 29, 56, 58, 59, 60, 87, 88, 90, 91]"
agent_b,L100,long,13,5,8,4,0.885,113,"[12, 28, 29, 54, 55, 58, 59, 60, 61, 88, 89, 90, 95]"
agent_b,L100,long,12,5,7,1,0.8929,112,"[12, 27, 28, 29, 31, 33, 60, 61, 62, 89, 91, 92]"
agent_b,L100,long,13,6,7,0,0.885,113,"[12, 26, 28, 29, 55, 56, 57, 58, 59, 85, 86, 88, 89]"
agent_b,L100,long,16,7,9,0,0.8621,116,"[27, 28, 29, 31, 32, 54, 55, 56, 58, 59, 61, 62, 63, 90, 91, 94]"
agent_b,L100,long,11,7,4,0,0.9009,111,"[12, 27, 28, 29, 56, 57, 59, 86, 88, 89, 90]"
agent_b,L100,long,12,6,6,1,0.8929,112,"[27, 30, 51, 54, 56, 58, 59, 83, 86, 87, 88, 90]"
agent_b,L100,long,15,9,6,1,0.8696,115,"[27, 28, 29, 31, 53, 56, 57, 58, 60, 85, 86, 87, 88, 90, 91]"
agent_b,L100,long,9,7,2,0,0.9174,109,"[28, 29, 51, 52, 53, 54, 57, 59, 90]"
agent_b,L100,long,11,6,5,3,0.9009,111,"[17, 31, 56, 57, 59, 60, 86, 87, 88, 89, 91]"
agent_b,L100,long,11,4,7,4,0.9009,111,"[12, 26, 28, 29, 30, 31, 35, 61, 62, 92, 94]"
agent_b,L100,long,12,10,2,1,0.8929,112,"[12, 26, 27, 28, 29, 31, 57, 59, 60, 62, 90, 91]"
agent_b,L100,long,9,4,5,0,0.9174,109,"[30, 53, 57, 59, 60, 85, 88, 89, 90]"
agent_b,L100,long,9,9,0,4,0.9174,109,"[28, 29, 30, 35, 60, 61, 86, 92, 93]"
agent_b,L100,long,14,11,3,2,0.8772,114,"[12, 26, 27, 28, 30, 56, 58, 59, 60, 86, 87, 88, 89, 91]"
agent_b,L100,long,13,9,4,1,0.885,113,"[12, 26, 28, 29, 31, 57, 58, 59, 60, 86, 87, 88, 90]"
agent_b,L100,long,10,7,3,1,0.9091,110,"[12, 26, 29, 55, 56, 57, 59, 86, 88, 91]"
agent_b,L100,long,14,4,10,0,0.8772,114,"[27, 28, 29, 51, 52, 55, 56, 57, 58, 59, 85, 86, 88, 89]"
agent_b,L100,long,10,4,6,3,0.9091,110,"[12, 27, 31, 57, 58, 59, 60, 63, 89, 91]"
agent_b,L100,long,11,5,6,2,0.9009,111,"[12, 26, 27, 29, 55, 56, 57, 59, 61, 64, 92]"
agent_b,L100,long,8,3,5,3,0.9259,108,"[13, 27, 28, 31, 60, 87, 88, 89]"
agent_b,L100,long,13,4,9,2,0.885,113,"[15, 28, 29, 30, 31, 32, 33, 60, 61, 62, 64, 92, 94]"
agent_b,L100,long,13,7,6,2,0.885,113,"[12, 26, 27, 28, 30, 56, 57, 58, 59, 86, 87, 88, 90]"
agent_b,L100,long,14,4,10,1,0.8772,114,"[12, 26, 28, 29, 55, 56, 58, 60, 87, 88, 89, 90, 91, 92]"
agent_b,L100,long,13,13,0,1,0.885,113,"[28, 30, 54, 55, 56, 57, 58, 59, 84, 86, 87, 88, 89]"
agent_b,L100,long,10,9,1,6,0.9091,110,"[12, 26, 27, 28, 32, 58, 59, 87, 88, 92]"
agent_b,L100,long,13,8,5,1,0.885,113,"[27, 28, 29, 52, 53, 54, 55, 56, 58, 60, 86, 87, 89]"
agent_b,L100,long,12,8,4,1,0.8929,112,"[13, 27, 28, 29, 30, 57, 58, 59, 60, 86, 87, 91]"
agent_b,L100,long,10,4,6,3,0.9091,110,"[13, 27, 28, 29, 30, 33, 61, 63, 90, 93]"
agent_b,L100,long,15,7,8,0,0.8696,115,"[28, 29, 30, 51, 54, 55, 56, 57, 58, 59, 60, 61, 88, 90, 91]"
agent_b,L100,long,11,6,5,1,0.9009,111,"[12, 29, 54, 55, 56, 59, 85, 86, 87, 89, 93]"
agent_b,L100,long,13,8,5,2,0.885,113,"[27, 29, 30, 32, 56, 57, 59, 61, 62, 63, 91, 92, 95]"
agent_b,L100,long,14,7,7,1,0.8772,114,"[27, 30, 51, 52, 53, 54, 56, 57, 58, 59, 60, 87, 88, 91]"
agent_b,L100,long,11,7,4,2,0.9009,111,"[27, 29, 31, 52, 53, 55, 58, 59, 60, 63, 93]"
agent_b,L100,long,13,10,3,2,0.885,113,"[27, 29, 51, 52, 56, 57, 58, 59, 60, 86, 88, 89, 92]"
agent_b,L100,long,11,7,4,0,0.9009,111,"[29, 49, 53, 54, 55, 57, 58, 59, 85, 86, 89]"
agent_b,L100,long,15,8,7,1,0.8696,115,"[12, 27, 28, 29, 30, 56, 57, 59, 60, 86, 87, 88, 89, 90, 92]"
agent_b,L100,long,9,4,5,3,0.9174,109,"[12, 26, 28, 29, 30, 59, 60, 88, 93]"
agent_b,L100,long,12,5,7,0,0.8929,112,"[27, 28, 29, 51, 52, 54, 55, 56, 58, 59, 85, 89]"
agent_b,L100,long,13,13,0,4,0.885,113,"[28, 30, 51, 52, 56, 57, 59, 83, 84, 85, 86, 87, 92]"
agent_b,L100,long,11,8,3,1,0.9009,111,"[12, 28, 29, 55, 56, 58, 60, 87, 88, 89, 90]"
agent_b,L100,long,9,3,6,1,0.9174,109,"[12, 26, 29, 56, 58, 60, 88, 89, 90]"
agent_b,L100,long,15,12,3,1,0.8696,115,"[27, 28, 30, 51, 52, 53, 54, 55, 57, 59, 86, 87, 89, 90, 91]"
agent_b,L100,long,11,10,1,6,0.9009,111,"[28, 30, 51, 52, 53, 58, 59, 60, 63, 90, 94]"
agent_b,L100,long,8,5,3,2,0.9259,108,"[12, 27, 30, 60, 85, 86, 88, 89]"
agent_b,L100,long,12,7,5,1,0.8929,112,"[28, 30, 54, 56, 57, 59, 60, 84, 87, 88, 89, 91]"
agent_b,L100,long,9,5,4,0,0.9174,109,"[13, 27, 28, 29, 55, 58, 59, 87, 89]"
agent_b,L100,long,11,9,2,1,0.9009,111,"[29, 30, 31, 56, 57, 58, 61, 87, 89, 90, 92]"
agent_b,L100,long,15,12,3,7,0.8696,115,"[27, 28, 31, 52, 53, 54, 55, 56, 57, 58, 59, 61, 88, 89, 94]"
agent_b,L100,long,15,13,2,1,0.8696,115,"[29, 49, 51, 52, 53, 54, 55, 57, 59, 61, 86, 87, 88, 89, 90]"
agent_b,L100,long,13,4,9,1,0.885,113,"[12, 27, 29, 54, 55, 56, 57, 58, 59, 86, 87, 88, 90]"
agent_b,L100,long,9,4,5,1,0.9174,109,"[28, 29, 56, 57, 58, 60, 86, 88, 90]"
agent_b,L100,long,15,7,8,0,0.8696,115,"[27, 29, 50, 51, 52, 53, 54, 56, 58, 59, 85, 86, 87, 88, 89]"
agent_b,L100,long,10,3,7,0,0.9091,110,"[12, 27, 28, 29, 55, 56, 59, 86, 87, 89]"
agent_b,L100,long,12,3,9,3,0.8929,112,"[13, 27, 28, 30, 55, 56, 57, 58, 59, 61, 90, 93]"
agent_b,L100,long,14,12,2,1,0.8772,114,"[27, 28, 30, 55, 56, 57, 58, 59, 84, 86, 87, 88, 89, 90]"
agent_b,L100,long,12,8,4,2,0.8929,112,"[14, 28, 29, 55, 57, 58, 59, 60, 62, 89, 90, 92]"
agent_b,L100,long,10,6,4,0,0.9091,110,"[12, 26, 27, 29, 56, 57, 60, 88, 90, 92]"
agent_b,L100,long,15,6,9,0,0.8696,115,"[27, 29, 31, 32, 56, 57, 59, 61, 62, 63, 89, 90, 91, 92, 93]"
agent_b,L100,long,13,9,4,1,0.885,113,"[28, 30, 51, 52, 53, 56, 58, 59, 60, 86, 88, 89, 91]"
agent_b,L100,long,10,3,7,0,0.9091,110,"[14, 27, 29, 54, 55, 57, 59, 86, 87, 89]"
agent_b,L100,long,9,6,3,4,0.9174,109,"[16, 32, 56, 57, 60, 85, 86, 87, 89]"
agent_b,L100,long,14,6,8,6,0.8772,114,"[12, 26, 27, 28, 29, 55, 57, 58, 59, 60, 61, 89, 90, 97]"
agent_b,L100,long,12,7,5,2,0.8929,112,"[12, 26, 27, 28, 29, 31, 57, 59, 61, 88, 89, 90]"
agent_b,L100,long,14,9,5,0,0.8772,114,"[27, 30, 51, 52, 53, 55, 57, 58, 60, 61, 86, 87, 89, 91]"
agent_b,L100,long,11,7,4,2,0.9009,111,"[27, 28, 30, 51, 52, 53, 55, 59, 87, 88, 91]"
agent_b,L100,long,10,4,6,0,0.9091,110,"[12, 26, 28, 29, 55, 56, 57, 59, 87, 90]"
agent_b,L100,long,15,7,8,0,0.8696,115,"[27, 28, 29, 30, 32, 58, 59, 60, 62, 63, 89, 90, 92, 93, 94]"
agent_b,L100,long,14,10,4,2,0.8772,114,"[13, 28, 29, 30, 56, 57, 58, 59, 61, 88, 90, 91, 92, 94]"
agent_b,L100,long,14,10,4,3,0.8772,114,"[27, 28, 29, 31, 56, 58, 60, 64, 88, 89, 90, 91, 92, 93]"
agent_b,L100,long,12,5,7,0,0.8929,112,"[13, 27, 29, 30, 55, 56, 58, 60, 61, 88, 89, 91]"
agent_b,L100,long,11,6,5,1,0.9009,111,"[12, 26, 28, 29, 30, 56, 59, 61, 88, 89, 90]"
agent_b,L100,long,11,5,6,1,0.9009,111,"[12, 27, 28, 29, 55, 56, 57, 60, 88, 89, 90]"
agent_b,L100,long,14,6,8,1,0.8772,114,"[27, 28, 29, 30, 32, 57, 58, 59, 60, 61, 88, 89, 90, 91]"
agent_b,L100,long,12,3,9,0,0.8929,112,"[13, 27, 28, 29, 30, 56, 57, 58, 60, 86, 89, 90]"
agent_b,L100,long,12,10,2,3,0.8929,112,"[27, 28, 30, 55, 56, 57, 58, 59, 84, 85, 87, 91]"
agent_b,L100,long,12,4,8,1,0.8929,112,"[27, 28, 29, 51, 53, 54, 56, 57, 58, 60, 87, 89]"
agent_b,L100,long,13,12,1,0,0.885,113,"[28, 29, 50, 51, 52, 53, 54, 55, 56, 59, 87, 88, 89]"
