agent_name,layout,event_update_level,num_attention_switches,num_attention_switches_margins,num_attention_switches_middle,inform_loss,reading_speed,total_steps,attention_switches_time_steps_list

Norman,L0,short,27,8,19,12,0.7874,127,"[10, 15, 16, 17, 19, 20, 22, 30, 31, 40, 42, 50, 55, 64, 72, 80, 81, 92, 93, 100, 101, 102, 104, 112, 114, 123, 124]"

Norman,L0,short,29,11,18,4,0.7752,129,"[9, 14, 16, 17, 18, 19, 30, 38, 39, 47, 49, 58, 59, 60, 69, 70, 79, 82, 90, 98, 99, 100, 107, 108, 109, 110, 111, 119, 122]"

Norman,L0,short,31,21,10,5,0.7634,131,"[10, 15, 16, 18, 19, 29, 30, 31, 40, 41, 45, 53, 62, 69, 70, 72, 80, 81, 82, 91, 92, 102, 105, 112, 113, 114, 115, 116, 124, 125, 128]"

Norman,L0,short,26,18,8,18,0.7937,126,"[4, 9, 10, 11, 12, 21, 23, 32, 34, 42, 45, 53, 54, 55, 58, 66, 73, 81, 91, 100, 107, 111, 118, 119, 120, 121]"

Norman,L0,short,28,7,21,6,0.7812,128,"[9, 11, 16, 17, 19, 20, 29, 30, 38, 39, 40, 41, 50, 52, 62, 70, 72, 80, 81, 89, 90, 91, 99, 100, 102, 112, 114, 124]"

Norman,L0,short,24,18,6,11,0.8065,124,"[4, 9, 10, 19, 20, 21, 23, 35, 45, 54, 61, 66, 73, 80, 81, 82, 84, 86, 87, 91, 101, 108, 111, 120]"

Norman,L0,short,31,19,12,4,0.7634,131,"[9, 14, 15, 16, 17, 18, 19, 21, 30, 31, 32, 33, 34, 35, 44, 45, 54, 55, 66, 75, 76, 85, 86, 96, 104, 105, 106, 115, 116, 118, 129]"

Norman,L0,short,32,10,22,8,0.7576,132,"[10, 15, 17, 20, 22, 30, 34, 43, 51, 52, 60, 61, 62, 63, 65, 73, 74, 75, 77, 78, 87, 88, 96, 97, 98, 106, 107, 108, 117, 119, 127, 128]"

Norman,L0,short,30,11,19,3,0.7692,130,"[9, 14, 15, 16, 17, 18, 21, 29, 31, 40, 48, 49, 50, 52, 53, 62, 63, 72, 73, 82, 83, 84, 94, 103, 104, 113, 114, 122, 123, 124]"

Norman,L0,short,33,24,9,5,0.7519,133,"[9, 17, 19, 20, 22, 31, 32, 40, 41, 42, 50, 52, 60, 61, 62, 63, 64, 67, 76, 79, 90, 97, 99, 100, 101, 109, 110, 111, 119, 120, 122, 123, 131]"

Norman,L0,short,30,16,14,9,0.7692,130,"[9, 11, 17, 19, 20, 28, 29, 33, 42, 52, 59, 61, 68, 70, 71, 74, 81, 82, 91, 92, 94, 101, 102, 103, 111, 112, 113, 120, 121, 123]"

Norman,L0,short,31,10,21,3,0.7634,131,"[9, 14, 16, 17, 18, 19, 20, 21, 31, 41, 42, 50, 52, 60, 61, 62, 70, 71, 72, 73, 74, 77, 86, 96, 97, 106, 109, 117, 118, 120, 129]"

Norman,L0,short,26,17,9,15,0.7937,126,"[4, 9, 10, 11, 12, 16, 27, 36, 43, 46, 54, 55, 57, 64, 66, 67, 75, 77, 85, 86, 88, 98, 108, 115, 118, 119]"

Norman,L0,short,28,6,22,5,0.7812,128,"[9, 10, 17, 18, 19, 20, 21, 22, 34, 43, 46, 54, 62, 63, 65, 73, 74, 75, 84, 85, 93, 94, 96, 104, 107, 115, 117, 118]"

Norman,L0,short,30,9,21,7,0.7692,130,"[9, 14, 15, 16, 19, 28, 29, 30, 34, 44, 52, 53, 61, 62, 65, 72, 73, 76, 84, 86, 95, 104, 105, 112, 114, 115, 116, 118, 126, 127]"

Norman,L0,short,22,13,9,9,0.8197,122,"[10, 20, 21, 23, 31, 34, 42, 50, 51, 52, 59, 61, 64, 74, 82, 92, 93, 101, 103, 110, 112, 114]"

Norman,L0,short,28,15,13,7,0.7812,128,"[4, 10, 13, 22, 24, 32, 33, 34, 44, 53, 55, 63, 64, 72, 73, 75, 83, 85, 95, 102, 104, 105, 108, 115, 117, 124, 125, 126]"

Norman,L0,short,33,22,11,6,0.7519,133,"[10, 15, 16, 17, 21, 30, 31, 32, 33, 42, 44, 54, 62, 64, 71, 72, 73, 81, 83, 84, 86, 94, 95, 105, 112, 113, 114, 115, 116, 117, 125, 127, 128]"

Norman,L0,short,31,13,18,6,0.7634,131,"[9, 14, 15, 16, 18, 19, 28, 29, 30, 40, 49, 50, 58, 61, 69, 70, 71, 79, 80, 81, 82, 90, 92, 100, 101, 102, 110, 113, 120, 122, 127]"

Norman,L0,short,35,11,24,6,0.7407,135,"[10, 11, 12, 15, 22, 23, 25, 28, 37, 46, 53, 54, 55, 56, 65, 66, 75, 76, 84, 85, 86, 88, 96, 97, 98, 99, 100, 108, 109, 110, 111, 121, 128, 129, 131]"

Norman,L0,short,29,21,8,10,0.7752,129,"[4, 9, 12, 20, 28, 32, 43, 51, 59, 60, 67, 68, 69, 70, 78, 80, 88, 89, 92, 99, 100, 108, 109, 110, 117, 118, 119, 120, 121]"

Norman,L0,short,30,16,14,5,0.7692,130,"[4, 9, 19, 26, 28, 31, 39, 40, 49, 51, 52, 60, 61, 62, 70, 71, 72, 80, 81, 83, 91, 93, 101, 102, 113, 120, 121, 122, 123, 124]"

Norman,L0,short,34,16,18,3,0.7463,134,"[9, 15, 18, 19, 27, 28, 30, 38, 39, 47, 48, 49, 57, 58, 61, 69, 77, 78, 80, 88, 89, 90, 98, 100, 108, 109, 110, 118, 119, 120, 121, 122, 123, 124]"

Norman,L0,short,31,26,5,2,0.7634,131,"[4, 9, 10, 19, 20, 28, 30, 31, 32, 42, 50, 52, 53, 54, 62, 63, 65, 74, 75, 85, 94, 95, 102, 104, 105, 114, 116, 123, 124, 125, 127]"

Norman,L0,short,27,8,19,6,0.7874,127,"[4, 11, 19, 26, 28, 29, 36, 37, 42, 50, 58, 61, 70, 71, 72, 73, 74, 82, 85, 94, 95, 104, 105, 106, 114, 116, 123]"

Norman,L0,short,27,24,3,5,0.7874,127,"[9, 13, 20, 28, 29, 30, 31, 39, 41, 49, 51, 62, 69, 70, 71, 79, 82, 89, 90, 92, 100, 101, 103, 111, 112, 121, 122]"

Norman,L0,short,29,16,13,8,0.7752,129,"[9, 14, 15, 19, 28, 30, 38, 39, 47, 49, 57, 58, 59, 67, 68, 70, 79, 86, 88, 91, 99, 100, 107, 109, 110, 117, 118, 119, 124]"

Norman,L0,short,30,23,7,4,0.7692,130,"[4, 10, 19, 26, 28, 30, 39, 40, 42, 51, 58, 60, 62, 70, 72, 79, 81, 82, 84, 91, 92, 93, 101, 104, 105, 106, 114, 115, 117, 126]"

Norman,L0,short,31,17,14,10,0.7634,131,"[4, 9, 10, 21, 29, 31, 39, 40, 42, 50, 52, 61, 62, 63, 71, 72, 74, 82, 84, 91, 93, 96, 103, 105, 112, 113, 114, 115, 123, 124, 125]"

Norman,L0,short,33,18,15,2,0.7519,133,"[4, 10, 11, 12, 13, 22, 23, 33, 35, 36, 45, 46, 55, 56, 57, 65, 66, 68, 76, 77, 85, 86, 87, 95, 97, 106, 107, 115, 116, 117, 125, 126, 128]"

Norman,L0,short,26,11,15,8,0.7937,126,"[4, 9, 18, 19, 27, 28, 29, 37, 38, 40, 49, 57, 58, 60, 68, 70, 81, 84, 91, 92, 100, 101, 105, 112, 120, 123]"

Norman,L0,short,31,19,12,7,0.7634,131,"[9, 14, 15, 16, 17, 21, 30, 31, 39, 40, 41, 50, 54, 62, 69, 72, 80, 81, 89, 91, 99, 100, 101, 108, 110, 111, 118, 119, 120, 121, 122]"

Norman,L0,short,33,19,14,5,0.7519,133,"[10, 17, 19, 26, 27, 28, 30, 39, 40, 41, 42, 50, 51, 52, 61, 62, 63, 64, 66, 75, 76, 86, 87, 89, 97, 99, 107, 108, 116, 117, 118, 121, 129]"

Norman,L0,short,27,20,7,10,0.7874,127,"[9, 14, 15, 17, 20, 21, 22, 23, 24, 26, 38, 48, 57, 59, 69, 78, 79, 86, 87, 88, 89, 98, 101, 108, 109, 118, 121]"

Norman,L0,short,30,19,11,4,0.7692,130,"[4, 9, 18, 20, 28, 29, 30, 31, 38, 39, 41, 42, 50, 51, 52, 62, 64, 73, 74, 84, 95, 102, 104, 112, 113, 114, 115, 116, 125, 127]"

Norman,L0,short,33,22,11,2,0.7519,133,"[5, 9, 19, 27, 28, 30, 37, 38, 39, 47, 50, 59, 60, 68, 69, 70, 79, 80, 87, 88, 89, 91, 92, 100, 101, 102, 110, 111, 112, 113, 114, 123, 124]"

Norman,L0,short,30,15,15,10,0.7692,130,"[9, 11, 16, 18, 19, 23, 31, 39, 40, 41, 51, 53, 61, 62, 69, 73, 74, 77, 85, 86, 87, 90, 100, 107, 108, 109, 110, 118, 119, 121]"

Norman,L0,short,27,20,7,8,0.7874,127,"[5, 9, 18, 21, 30, 37, 38, 39, 41, 49, 50, 51, 60, 62, 71, 79, 80, 83, 91, 98, 99, 100, 102, 111, 119, 122, 123]"

Norman,L0,short,31,6,25,8,0.7634,131,"[10, 15, 17, 18, 19, 27, 28, 29, 30, 39, 40, 43, 51, 52, 61, 62, 63, 64, 65, 77, 85, 93, 97, 108, 115, 116, 117, 124, 125, 127, 129]"

Norman,L0,short,30,12,18,5,0.7692,130,"[4, 10, 18, 19, 21, 23, 34, 43, 44, 52, 53, 54, 55, 56, 64, 65, 67, 75, 78, 87, 97, 104, 105, 107, 115, 116, 117, 125, 126, 128]"

Norman,L0,short,34,11,23,4,0.7463,134,"[9, 14, 15, 16, 18, 19, 28, 29, 39, 47, 49, 50, 58, 59, 62, 71, 79, 80, 81, 82, 84, 92, 93, 94, 102, 103, 105, 113, 114, 121, 122, 124, 125, 128]"

Norman,L0,short,29,17,12,3,0.7752,129,"[10, 16, 17, 18, 19, 20, 21, 22, 23, 33, 34, 44, 52, 54, 55, 56, 65, 69, 78, 88, 90, 99, 106, 109, 116, 117, 118, 119, 120]"

Norman,L0,short,28,14,14,4,0.7812,128,"[10, 15, 16, 19, 20, 28, 29, 30, 39, 40, 48, 51, 59, 60, 67, 68, 69, 70, 78, 79, 83, 92, 104, 111, 113, 121, 122, 123]"

Norman,L0,short,33,17,16,9,0.7519,133,"[4, 9, 18, 20, 29, 30, 37, 39, 42, 53, 60, 68, 69, 71, 78, 82, 89, 90, 97, 98, 99, 101, 102, 110, 111, 112, 119, 120, 122, 123, 124, 125, 126]"

Norman,L0,short,31,21,10,9,0.7634,131,"[4, 9, 14, 22, 30, 37, 38, 42, 50, 54, 61, 63, 66, 74, 75, 83, 84, 85, 93, 95, 96, 97, 106, 107, 109, 117, 118, 119, 127, 128, 129]"

Norman,L0,short,32,21,11,5,0.7576,132,"[9, 10, 12, 19, 20, 22, 34, 43, 50, 54, 63, 65, 66, 73, 74, 75, 77, 85, 87, 89, 97, 99, 106, 107, 109, 116, 117, 118, 119, 126, 127, 129]"

Norman,L0,short,37,18,19,3,0.7299,137,"[4, 9, 18, 19, 27, 29, 37, 38, 40, 48, 49, 50, 51, 59, 61, 62, 71, 74, 82, 84, 92, 93, 95, 96, 97, 107, 108, 109, 111, 119, 120, 121, 129, 130, 131, 132, 135]"

Norman,L0,short,31,13,18,3,0.7634,131,"[9, 10, 16, 18, 19, 20, 28, 29, 30, 40, 48, 51, 61, 68, 70, 78, 79, 80, 81, 89, 90, 92, 94, 103, 104, 105, 106, 115, 116, 124, 127]"

Norman,L0,short,33,12,21,7,0.7519,133,"[4, 11, 19, 23, 31, 32, 41, 42, 43, 52, 53, 60, 61, 62, 63, 67, 75, 83, 84, 86, 87, 96, 98, 106, 107, 108, 115, 116, 118, 119, 122, 130, 131]"

Norman,L0,short,30,17,13,6,0.7692,130,"[9, 14, 15, 16, 20, 28, 29, 41, 48, 49, 57, 58, 59, 67, 70, 78, 79, 86, 87, 91, 100, 107, 108, 109, 110, 118, 119, 120, 121, 122]"

Norman,L0,short,29,15,14,10,0.7752,129,"[5, 9, 18, 19, 28, 29, 36, 38, 39, 47, 48, 49, 53, 61, 62, 63, 65, 76, 85, 93, 97, 104, 114, 115, 116, 123, 124, 125, 126]"

Norman,L0,short,25,13,12,5,0.8,125,"[6, 9, 19, 20, 28, 29, 30, 32, 39, 40, 41, 51, 59, 60, 61, 70, 71, 81, 90, 91, 99, 100, 104, 112, 121]"

Norman,L0,short,29,11,18,6,0.7752,129,"[9, 14, 16, 17, 19, 20, 28, 29, 30, 42, 51, 59, 60, 67, 68, 70, 78, 79, 80, 81, 82, 90, 91, 92, 100, 104, 113, 120, 122]"

Norman,L0,short,28,15,13,4,0.7812,128,"[10, 15, 17, 19, 20, 21, 29, 31, 32, 41, 42, 50, 51, 52, 62, 65, 73, 81, 83, 85, 93, 97, 105, 106, 107, 114, 118, 126]"

Norman,L0,short,29,21,8,2,0.7752,129,"[4, 10, 18, 20, 28, 32, 40, 41, 49, 50, 51, 59, 60, 61, 62, 72, 81, 82, 92, 93, 100, 101, 102, 104, 112, 113, 121, 122, 123]"

Norman,L0,short,30,17,13,4,0.7692,130,"[9, 14, 16, 17, 18, 19, 20, 21, 30, 31, 41, 49, 54, 63, 70, 72, 81, 82, 90, 92, 101, 102, 103, 104, 107, 114, 115, 116, 124, 126]"

Norman,L0,short,28,15,13,4,0.7812,128,"[9, 10, 15, 16, 17, 19, 20, 30, 38, 39, 40, 50, 59, 60, 67, 68, 72, 81, 89, 90, 97, 98, 100, 108, 109, 110, 119, 122]"

Norman,L0,short,30,17,13,5,0.7692,130,"[9, 14, 15, 16, 20, 28, 29, 37, 38, 39, 49, 57, 58, 59, 68, 72, 80, 88, 89, 92, 102, 109, 111, 112, 120, 121, 122, 123, 124, 125]"

Norman,L0,short,31,20,11,2,0.7634,131,"[9, 15, 16, 18, 19, 28, 31, 40, 41, 49, 50, 51, 53, 54, 62, 64, 75, 85, 86, 94, 95, 96, 103, 104, 105, 107, 116, 123, 124, 125, 126]"

Norman,L0,short,27,15,12,5,0.7874,127,"[5, 9, 18, 19, 28, 29, 36, 37, 39, 40, 41, 43, 52, 60, 61, 62, 72, 81, 82, 84, 93, 97, 106, 114, 115, 116, 124]"

Norman,L0,short,25,5,20,6,0.8,125,"[4, 12, 20, 29, 30, 31, 39, 41, 49, 52, 60, 61, 62, 64, 72, 73, 83, 85, 93, 94, 95, 103, 105, 109, 117]"

Norman,L0,short,30,17,13,5,0.7692,130,"[5, 9, 10, 19, 20, 30, 32, 34, 42, 45, 54, 61, 62, 63, 71, 73, 80, 81, 82, 83, 91, 93, 101, 102, 105, 113, 114, 122, 123, 124]"

Norman,L0,short,27,14,13,7,0.7874,127,"[11, 12, 19, 22, 30, 32, 44, 51, 52, 54, 63, 70, 71, 73, 75, 83, 84, 91, 92, 95, 96, 100, 107, 114, 116, 117, 125]"

Norman,L0,short,36,20,16,4,0.7353,136,"[4, 9, 10, 20, 28, 29, 30, 38, 39, 41, 42, 50, 51, 54, 62, 70, 72, 73, 74, 82, 83, 84, 86, 87, 99, 107, 108, 109, 110, 111, 112, 120, 121, 122, 131, 134]"

Norman,L0,short,30,20,10,8,0.7692,130,"[9, 14, 15, 16, 18, 19, 20, 29, 30, 39, 40, 48, 49, 53, 62, 70, 72, 80, 82, 91, 100, 101, 102, 106, 113, 114, 115, 123, 124, 126]"

Norman,L0,short,27,19,8,7,0.7874,127,"[9, 14, 15, 16, 18, 20, 28, 29, 30, 34, 43, 51, 52, 53, 63, 71, 72, 73, 74, 85, 93, 94, 103, 104, 106, 114, 117]"

Norman,L0,short,33,18,15,5,0.7519,133,"[4, 10, 18, 19, 27, 28, 30, 31, 39, 40, 43, 52, 60, 61, 70, 71, 79, 80, 81, 90, 91, 92, 93, 94, 103, 104, 111, 112, 113, 114, 123, 124, 126]"

Norman,L0,short,30,18,12,10,0.7692,130,"[4, 9, 18, 19, 27, 28, 30, 37, 38, 39, 41, 44, 53, 62, 63, 72, 74, 82, 84, 91, 92, 93, 102, 106, 113, 120, 121, 123, 124, 127]"

Norman,L0,short,27,11,16,5,0.7874,127,"[9, 11, 13, 20, 22, 24, 33, 34, 42, 43, 44, 45, 53, 54, 55, 64, 66, 75, 83, 84, 86, 94, 96, 105, 106, 109, 119]"

Norman,L0,short,32,12,20,5,0.7576,132,"[11, 16, 17, 18, 20, 28, 30, 31, 39, 43, 51, 59, 60, 61, 69, 70, 71, 79, 80, 81, 90, 91, 93, 102, 109, 111, 112, 113, 120, 121, 122, 123]"

Norman,L0,short,31,23,8,4,0.7634,131,"[6, 9, 10, 12, 22, 33, 41, 42, 50, 51, 52, 59, 61, 62, 63, 71, 73, 74, 82, 84, 92, 93, 94, 95, 96, 106, 114, 115, 118, 125, 127]"

Norman,L0,short,32,17,15,7,0.7576,132,"[4, 9, 18, 19, 29, 30, 31, 34, 42, 43, 51, 52, 54, 62, 64, 72, 73, 75, 87, 95, 102, 103, 104, 106, 107, 114, 115, 116, 118, 119, 128, 129]"

Norman,L0,short,32,16,16,6,0.7576,132,"[4, 10, 18, 19, 20, 28, 29, 30, 38, 39, 40, 49, 52, 60, 61, 62, 63, 64, 65, 74, 76, 85, 86, 87, 96, 97, 106, 107, 108, 116, 121, 128]"

Norman,L0,short,25,12,13,10,0.8,125,"[4, 9, 10, 22, 30, 38, 39, 40, 42, 52, 60, 61, 70, 71, 78, 79, 80, 85, 94, 101, 102, 111, 113, 119, 123]"

Norman,L0,short,27,19,8,7,0.7874,127,"[9, 14, 16, 17, 20, 28, 30, 38, 41, 50, 51, 53, 56, 65, 66, 76, 85, 86, 87, 89, 96, 97, 98, 106, 108, 112, 119]"

Norman,L0,short,32,21,11,5,0.7576,132,"[4, 9, 18, 19, 28, 29, 36, 37, 38, 39, 48, 49, 59, 62, 63, 65, 73, 74, 82, 86, 94, 101, 103, 104, 105, 106, 107, 115, 116, 119, 126, 128]"

Norman,L0,short,32,17,15,4,0.7576,132,"[4, 10, 18, 19, 20, 28, 29, 30, 32, 40, 41, 50, 51, 59, 61, 69, 71, 72, 73, 74, 84, 85, 86, 94, 97, 105, 106, 108, 116, 117, 119, 128]"

Norman,L0,short,25,16,9,5,0.8,125,"[9, 14, 16, 17, 18, 21, 29, 38, 40, 48, 50, 59, 60, 67, 68, 70, 81, 90, 99, 100, 108, 109, 110, 119, 121]"

Norman,L0,short,31,23,8,6,0.7634,131,"[4, 11, 19, 27, 29, 30, 37, 38, 39, 41, 49, 51, 60, 62, 63, 72, 73, 74, 82, 83, 86, 94, 96, 103, 105, 106, 115, 116, 124, 126, 128]"

Norman,L0,short,29,24,5,2,0.7752,129,"[4, 9, 18, 19, 27, 29, 30, 31, 32, 34, 43, 52, 53, 54, 63, 65, 74, 75, 83, 84, 85, 93, 94, 95, 103, 105, 115, 123, 125]"

Norman,L0,short,27,13,14,10,0.7874,127,"[4, 10, 18, 21, 29, 32, 41, 49, 50, 53, 61, 62, 70, 72, 79, 81, 82, 89, 91, 94, 102, 109, 111, 112, 119, 122, 123]"

Norman,L0,short,29,20,9,7,0.7752,129,"[9, 14, 15, 16, 17, 18, 19, 29, 38, 39, 47, 48, 49, 60, 68, 72, 80, 81, 82, 91, 92, 97, 105, 113, 114, 115, 123, 124, 125]"

Norman,L0,short,30,19,11,8,0.7692,130,"[9, 15, 16, 22, 30, 38, 39, 40, 48, 49, 52, 61, 65, 72, 74, 82, 84, 86, 94, 95, 104, 106, 114, 115, 116, 122, 123, 125, 126, 127]"

Norman,L0,short,33,24,9,7,0.7519,133,"[9, 16, 17, 18, 19, 20, 23, 32, 41, 49, 50, 51, 54, 63, 70, 71, 73, 81, 83, 91, 92, 93, 94, 103, 104, 112, 114, 115, 124, 126, 127, 128, 130]"

Norman,L0,short,26,16,10,15,0.7937,126,"[4, 11, 20, 28, 30, 37, 38, 39, 40, 43, 51, 58, 61, 70, 71, 79, 80, 83, 84, 92, 93, 94, 97, 104, 111, 120]"

Norman,L0,short,30,18,12,8,0.7692,130,"[9, 11, 18, 19, 20, 22, 33, 41, 48, 49, 51, 60, 61, 68, 69, 71, 72, 80, 82, 90, 91, 96, 107, 114, 115, 116, 123, 124, 125, 126]"

Norman,L0,short,32,23,9,6,0.7576,132,"[9, 14, 15, 16, 17, 18, 19, 20, 32, 42, 50, 60, 70, 71, 78, 79, 80, 83, 90, 91, 92, 100, 101, 102, 109, 111, 112, 119, 120, 121, 122, 130]"

Norman,L0,short,29,12,17,9,0.7752,129,"[10, 15, 17, 19, 22, 30, 38, 39, 41, 52, 59, 60, 61, 68, 69, 70, 71, 79, 81, 89, 90, 93, 101, 108, 110, 112, 119, 120, 122]"

Norman,L0,short,35,23,12,2,0.7407,135,"[4, 10, 11, 19, 20, 21, 23, 32, 39, 40, 42, 51, 53, 62, 71, 72, 73, 82, 83, 84, 92, 95, 97, 104, 106, 107, 108, 109, 116, 117, 120, 121, 129, 131, 132]"

Norman,L0,short,24,15,9,8,0.8065,124,"[9, 14, 21, 29, 30, 31, 39, 44, 52, 53, 60, 65, 73, 75, 82, 84, 92, 93, 95, 102, 104, 105, 113, 116]"

Norman,L0,short,35,24,11,7,0.7407,135,"[10, 12, 18, 19, 20, 23, 31, 39, 40, 42, 50, 51, 52, 53, 54, 55, 64, 65, 67, 75, 76, 77, 88, 96, 98, 100, 109, 117, 118, 119, 120, 127, 128, 129, 130]"

Norman,L0,short,31,20,11,11,0.7634,131,"[4, 9, 18, 21, 30, 38, 39, 48, 49, 50, 58, 59, 60, 68, 69, 74, 82, 89, 90, 91, 92, 94, 103, 105, 112, 113, 114, 122, 123, 124, 125]"

Norman,L0,short,29,20,9,4,0.7752,129,"[9, 10, 12, 19, 20, 21, 22, 30, 33, 34, 43, 46, 54, 63, 64, 71, 72, 73, 74, 82, 83, 84, 94, 103, 105, 113, 115, 123, 124]"

Norman,L0,short,29,16,13,7,0.7752,129,"[4, 9, 18, 20, 29, 30, 31, 33, 41, 42, 43, 46, 54, 62, 64, 72, 73, 75, 84, 91, 93, 96, 104, 105, 107, 115, 118, 126, 127]"

Norman,L0,short,31,20,11,3,0.7634,131,"[4, 9, 11, 19, 20, 28, 30, 39, 40, 48, 49, 50, 58, 59, 60, 68, 69, 71, 79, 80, 81, 82, 83, 92, 93, 101, 102, 105, 116, 124, 125]"

Norman,L0,short,29,17,12,10,0.7752,129,"[4, 10, 22, 30, 40, 48, 49, 53, 60, 61, 69, 71, 77, 78, 79, 80, 82, 89, 90, 91, 92, 100, 101, 103, 112, 119, 120, 121, 123]"

Norman,L0,short,34,25,9,3,0.7463,134,"[9, 10, 11, 17, 19, 20, 21, 22, 31, 32, 34, 44, 52, 53, 54, 63, 64, 65, 66, 75, 76, 78, 87, 88, 90, 98, 100, 108, 109, 118, 119, 127, 128, 129]"

Norman,L0,short,32,20,12,5,0.7576,132,"[4, 10, 19, 26, 27, 28, 29, 31, 38, 40, 48, 49, 50, 58, 59, 60, 61, 70, 71, 80, 81, 89, 91, 93, 103, 110, 111, 112, 113, 114, 123, 125]"

Norman,L0,short,27,20,7,6,0.7874,127,"[9, 14, 15, 16, 17, 19, 31, 39, 40, 43, 51, 59, 61, 65, 72, 74, 77, 86, 94, 95, 97, 106, 107, 108, 115, 119, 120]"

Norman,L0,short,30,19,11,5,0.7692,130,"[9, 14, 15, 16, 17, 18, 19, 20, 30, 32, 33, 34, 43, 45, 54, 55, 64, 67, 76, 84, 87, 96, 97, 105, 108, 109, 118, 119, 120, 125]"

Norman,L0,short,32,17,15,4,0.7576,132,"[9, 10, 12, 18, 20, 21, 22, 24, 35, 45, 53, 55, 63, 64, 65, 74, 75, 76, 78, 86, 87, 89, 90, 91, 100, 101, 110, 111, 119, 120, 121, 124]"

Norman,L0,short,29,12,17,4,0.7752,129,"[4, 9, 19, 26, 27, 28, 29, 37, 38, 39, 48, 49, 50, 51, 52, 53, 55, 65, 74, 82, 84, 85, 94, 95, 103, 104, 107, 115, 125]"

Norman,L0,short,32,24,8,10,0.7576,132,"[9, 16, 19, 27, 29, 30, 31, 32, 41, 44, 54, 64, 71, 73, 81, 82, 84, 91, 92, 93, 100, 101, 102, 103, 104, 105, 107, 115, 116, 117, 126, 128]"

Norman,L0,short,29,10,19,3,0.7752,129,"[6, 10, 18, 20, 28, 29, 30, 31, 38, 39, 40, 41, 50, 51, 52, 54, 62, 63, 73, 81, 83, 91, 93, 101, 104, 112, 114, 122, 124]"

Norman,L0,short,31,19,12,3,0.7634,131,"[5, 11, 19, 27, 28, 29, 30, 31, 38, 40, 41, 50, 51, 52, 60, 63, 71, 75, 76, 84, 85, 86, 94, 96, 104, 106, 114, 116, 117, 126, 128]"

Norman,L0,short,35,15,20,7,0.7407,135,"[9, 14, 15, 16, 19, 28, 29, 30, 31, 32, 33, 35, 45, 47, 58, 66, 74, 76, 84, 87, 98, 105, 107, 108, 115, 116, 117, 118, 119, 120, 127, 128, 129, 130, 132]"

Norman,L0,short,26,14,12,8,0.7937,126,"[4, 9, 20, 28, 32, 40, 47, 48, 52, 59, 60, 63, 71, 78, 80, 83, 91, 94, 101, 102, 104, 113, 114, 121, 122, 124]"

Norman,L0,short,35,20,15,6,0.7407,135,"[9, 10, 11, 12, 13, 19, 20, 22, 23, 25, 36, 45, 53, 54, 56, 64, 65, 66, 74, 75, 76, 85, 86, 87, 88, 92, 101, 103, 111, 112, 120, 121, 122, 130, 133]"

Norman,L0,short,24,9,15,7,0.8065,124,"[4, 10, 18, 21, 30, 31, 32, 41, 42, 51, 53, 60, 62, 70, 74, 82, 89, 91, 92, 96, 104, 115, 116, 118]"

Norman,L0,short,29,10,19,7,0.7752,129,"[9, 14, 15, 16, 18, 20, 21, 22, 23, 24, 33, 34, 43, 46, 55, 58, 67, 76, 77, 86, 88, 96, 98, 106, 107, 108, 115, 117, 121]"

Norman,L0,short,24,11,13,12,0.8065,124,"[9, 13, 20, 22, 24, 31, 32, 37, 45, 48, 56, 57, 66, 67, 75, 77, 84, 86, 89, 100, 109, 111, 118, 120]"

Norman,L0,short,25,10,15,8,0.8,125,"[4, 11, 19, 20, 31, 39, 42, 50, 51, 52, 59, 61, 63, 71, 72, 73, 77, 85, 93, 94, 97, 105, 113, 114, 116]"

Norman,L0,short,34,9,25,2,0.7463,134,"[9, 15, 16, 17, 19, 20, 28, 29, 30, 31, 33, 43, 51, 52, 53, 54, 55, 64, 65, 74, 75, 77, 86, 88, 96, 97, 106, 107, 115, 116, 117, 125, 126, 128]"

Norman,L0,short,30,11,19,5,0.7692,130,"[10, 15, 16, 18, 20, 28, 32, 40, 48, 49, 51, 59, 60, 67, 68, 69, 70, 71, 81, 89, 92, 100, 101, 109, 110, 111, 112, 120, 121, 122]"

Norman,L0,short,28,17,11,7,0.7812,128,"[4, 10, 18, 20, 28, 32, 33, 36, 48, 56, 57, 60, 67, 68, 76, 77, 78, 79, 86, 90, 92, 101, 102, 103, 113, 121, 122, 124]"

Norman,L0,short,35,25,10,2,0.7407,135,"[5, 10, 18, 19, 27, 29, 30, 37, 38, 40, 48, 50, 58, 59, 60, 68, 69, 71, 79, 80, 81, 89, 90, 91, 100, 101, 102, 103, 112, 113, 114, 115, 117, 125, 127]"

Norman,L0,short,32,12,20,8,0.7576,132,"[4, 10, 18, 19, 23, 31, 40, 41, 42, 51, 54, 61, 62, 63, 65, 73, 74, 76, 84, 85, 93, 94, 95, 98, 107, 108, 110, 111, 120, 121, 129, 130]"

Norman,L0,short,31,18,13,9,0.7634,131,"[4, 10, 18, 21, 29, 30, 33, 41, 46, 54, 62, 70, 72, 73, 80, 81, 82, 83, 84, 86, 94, 95, 103, 104, 105, 114, 115, 123, 124, 125, 127]"

Norman,L0,short,28,12,16,8,0.7812,128,"[9, 14, 16, 17, 18, 19, 28, 29, 38, 40, 48, 51, 59, 60, 67, 69, 73, 81, 89, 92, 101, 102, 103, 110, 111, 115, 122, 124]"

Norman,L0,short,28,17,11,6,0.7812,128,"[5, 9, 18, 20, 28, 30, 38, 39, 47, 50, 57, 58, 59, 67, 68, 69, 78, 82, 90, 98, 100, 101, 109, 111, 118, 121, 123, 124]"

Norman,L0,short,27,16,11,5,0.7874,127,"[9, 15, 19, 26, 27, 28, 30, 38, 39, 40, 49, 52, 62, 69, 71, 72, 80, 83, 91, 92, 100, 103, 110, 112, 120, 121, 122]"

Norman,L0,short,29,20,9,5,0.7752,129,"[4, 10, 18, 19, 29, 30, 37, 39, 41, 43, 51, 52, 53, 54, 63, 64, 67, 75, 85, 88, 98, 106, 107, 108, 117, 118, 125, 126, 127]"

Norman,L0,short,33,20,13,7,0.7519,133,"[4, 9, 12, 20, 29, 30, 32, 33, 41, 43, 45, 53, 55, 63, 66, 74, 81, 82, 83, 85, 93, 95, 96, 104, 105, 106, 107, 115, 118, 126, 127, 128, 129]"

Norman,L0,short,29,11,18,10,0.7752,129,"[10, 15, 16, 17, 18, 19, 29, 37, 38, 39, 47, 48, 49, 58, 60, 69, 71, 80, 87, 88, 89, 90, 94, 102, 109, 112, 113, 114, 117]"

Norman,L0,short,29,10,19,2,0.7752,129,"[9, 14, 15, 16, 19, 27, 28, 29, 39, 48, 49, 50, 51, 59, 60, 61, 69, 70, 72, 81, 89, 92, 101, 109, 110, 111, 119, 120, 121]"

Norman,L0,short,31,22,9,6,0.7634,131,"[4, 9, 18, 19, 20, 21, 29, 31, 41, 49, 50, 51, 52, 53, 61, 62, 63, 66, 75, 85, 94, 102, 104, 111, 113, 114, 116, 123, 124, 125, 129]"

Norman,L0,short,30,17,13,5,0.7692,130,"[9, 14, 15, 17, 18, 19, 20, 21, 31, 33, 42, 50, 54, 63, 65, 72, 73, 74, 75, 83, 84, 85, 86, 95, 96, 104, 106, 114, 118, 126]"

Norman,L0,short,31,17,14,8,0.7634,131,"[4, 9, 19, 21, 30, 31, 39, 41, 45, 55, 65, 72, 73, 74, 81, 84, 93, 94, 101, 102, 104, 105, 106, 107, 108, 116, 117, 119, 127, 128, 129]"

Norman,L0,short,30,18,12,4,0.7692,130,"[5, 9, 18, 20, 28, 29, 30, 38, 39, 41, 49, 50, 58, 60, 62, 70, 71, 73, 75, 83, 84, 87, 95, 96, 105, 108, 109, 116, 120, 128]"

Norman,L0,short,31,19,12,4,0.7634,131,"[9, 11, 17, 19, 20, 21, 30, 31, 40, 43, 51, 56, 64, 71, 73, 75, 83, 85, 93, 94, 96, 104, 105, 112, 113, 114, 117, 124, 125, 126, 129]"

Norman,L0,short,28,20,8,4,0.7812,128,"[4, 9, 18, 21, 29, 33, 41, 43, 54, 61, 62, 63, 64, 65, 74, 75, 83, 85, 87, 95, 96, 97, 105, 107, 117, 124, 125, 126]"

Norman,L0,short,33,15,18,2,0.7519,133,"[10, 16, 17, 18, 19, 29, 37, 38, 40, 48, 49, 57, 60, 67, 70, 71, 81, 83, 90, 91, 92, 93, 94, 102, 103, 104, 105, 106, 116, 124, 126, 127, 128]"

Norman,L0,short,32,17,15,0,0.7576,132,"[9, 15, 16, 17, 18, 19, 30, 31, 32, 33, 42, 43, 51, 52, 53, 62, 64, 74, 82, 83, 84, 94, 102, 103, 104, 105, 113, 114, 115, 123, 124, 125]"

Norman,L0,short,28,15,13,12,0.7812,128,"[10, 15, 16, 17, 18, 23, 31, 39, 48, 51, 58, 59, 61, 71, 80, 81, 88, 89, 90, 92, 100, 101, 108, 109, 110, 113, 123, 124]"

Norman,L0,short,33,14,19,6,0.7519,133,"[4, 9, 12, 20, 21, 23, 32, 33, 41, 45, 53, 54, 61, 62, 65, 75, 76, 78, 86, 87, 88, 96, 97, 98, 99, 107, 108, 110, 111, 120, 121, 122, 123]"

Norman,L0,short,28,14,14,14,0.7812,128,"[6, 11, 19, 21, 29, 30, 36, 43, 51, 59, 60, 62, 70, 73, 82, 90, 91, 97, 98, 99, 100, 102, 110, 111, 112, 120, 121, 122]"

Norman,L0,short,33,20,13,5,0.7519,133,"[9, 14, 15, 16, 17, 18, 19, 28, 29, 31, 40, 44, 54, 63, 65, 72, 73, 75, 83, 84, 92, 93, 94, 102, 103, 104, 112, 113, 114, 116, 123, 124, 125]"

Norman,L0,short,26,5,21,9,0.7937,126,"[10, 15, 17, 18, 19, 20, 29, 30, 31, 40, 41, 42, 43, 52, 53, 62, 64, 72, 76, 84, 87, 98, 106, 107, 111, 119]"

Norman,L0,short,32,21,11,6,0.7576,132,"[4, 9, 10, 19, 22, 31, 40, 42, 50, 51, 53, 61, 62, 70, 71, 72, 73, 81, 82, 84, 92, 93, 94, 95, 103, 106, 107, 115, 118, 125, 126, 127]"

Norman,L0,short,36,19,17,6,0.7353,136,"[10, 15, 16, 17, 18, 22, 31, 34, 42, 43, 52, 53, 61, 65, 72, 73, 74, 82, 84, 91, 93, 96, 103, 104, 112, 115, 116, 123, 124, 125, 126, 127, 128, 129, 130, 131]"

Norman,L0,short,34,22,12,1,0.7463,134,"[4, 9, 10, 20, 21, 22, 32, 40, 42, 50, 51, 53, 62, 70, 71, 72, 73, 74, 75, 76, 84, 85, 86, 94, 95, 96, 97, 106, 108, 109, 111, 121, 131, 132]"

Norman,L0,short,30,16,14,12,0.7692,130,"[4, 9, 10, 11, 20, 21, 22, 25, 35, 44, 52, 53, 54, 62, 63, 65, 74, 82, 83, 88, 96, 104, 106, 114, 115, 116, 117, 124, 125, 127]"

Norman,L0,short,30,10,20,4,0.7692,130,"[9, 10, 15, 16, 17, 19, 20, 21, 30, 31, 40, 41, 50, 52, 61, 63, 71, 72, 74, 82, 83, 92, 95, 103, 111, 113, 121, 122, 123, 124]"

Norman,L0,short,30,10,20,13,0.7692,130,"[10, 13, 20, 22, 23, 24, 33, 34, 35, 36, 45, 47, 48, 49, 57, 58, 59, 61, 62, 63, 65, 75, 84, 85, 87, 101, 109, 117, 120, 128]"

Norman,L0,short,31,18,13,10,0.7634,131,"[4, 9, 21, 29, 36, 39, 40, 48, 50, 53, 60, 61, 69, 70, 71, 73, 80, 81, 82, 84, 92, 93, 101, 102, 103, 105, 113, 117, 125, 126, 127]"

Norman,L0,short,34,23,11,3,0.7463,134,"[4, 10, 18, 20, 21, 30, 32, 33, 41, 43, 51, 52, 53, 54, 62, 63, 64, 72, 73, 74, 75, 76, 79, 88, 96, 97, 106, 107, 116, 117, 118, 126, 127, 128]"

Norman,L0,short,31,24,7,7,0.7634,131,"[4, 9, 12, 20, 21, 23, 32, 42, 51, 52, 59, 60, 61, 62, 63, 73, 81, 82, 83, 92, 93, 101, 102, 104, 112, 113, 114, 116, 117, 125, 126]"

Norman,L0,short,28,18,10,5,0.7812,128,"[4, 10, 18, 19, 29, 37, 39, 47, 49, 56, 57, 59, 67, 68, 69, 77, 79, 86, 87, 90, 92, 93, 94, 103, 106, 113, 114, 126]"

Norman,L0,short,32,16,16,7,0.7576,132,"[9, 15, 17, 18, 19, 29, 30, 31, 39, 41, 43, 52, 53, 61, 62, 63, 71, 72, 73, 82, 83, 84, 85, 89, 97, 98, 106, 108, 111, 120, 127, 129]"

Norman,L0,short,30,9,21,1,0.7692,130,"[5, 9, 19, 20, 28, 30, 37, 38, 39, 41, 49, 50, 51, 60, 61, 62, 63, 71, 73, 82, 83, 91, 93, 101, 102, 103, 110, 115, 123, 124]"

Norman,L0,short,30,17,13,10,0.7692,130,"[9, 11, 16, 18, 19, 20, 28, 30, 40, 41, 44, 53, 54, 62, 63, 64, 65, 74, 75, 83, 84, 89, 97, 105, 112, 113, 115, 116, 124, 127]"

Norman,L0,short,32,19,13,2,0.7576,132,"[9, 10, 11, 17, 18, 19, 21, 30, 31, 32, 42, 50, 52, 62, 63, 72, 73, 74, 75, 84, 86, 94, 95, 103, 104, 105, 114, 117, 118, 120, 127, 129]"

Norman,L0,short,35,24,11,6,0.7407,135,"[4, 10, 18, 20, 32, 39, 41, 49, 50, 51, 58, 59, 61, 69, 70, 71, 73, 81, 82, 83, 91, 92, 93, 101, 102, 103, 110, 111, 112, 113, 114, 123, 124, 125, 126]"

Norman,L0,short,30,9,21,7,0.7692,130,"[9, 14, 16, 17, 19, 27, 28, 31, 40, 48, 49, 50, 52, 53, 62, 63, 71, 72, 73, 82, 83, 84, 97, 106, 113, 115, 116, 117, 126, 127]"

Norman,L0,short,29,13,16,10,0.7752,129,"[11, 16, 17, 18, 19, 20, 21, 22, 31, 34, 45, 53, 61, 64, 67, 75, 77, 85, 86, 88, 96, 97, 98, 100, 110, 112, 119, 122, 123]"

Norman,L0,short,21,14,7,11,0.8264,121,"[9, 14, 15, 16, 19, 27, 30, 38, 41, 51, 54, 63, 70, 72, 79, 81, 84, 94, 106, 112, 116]"

Norman,L0,short,35,16,19,2,0.7407,135,"[6, 9, 10, 19, 20, 28, 29, 31, 38, 39, 40, 41, 51, 59, 60, 62, 70, 71, 72, 73, 74, 75, 77, 87, 97, 99, 107, 108, 109, 117, 119, 128, 129, 130, 131]"

Norman,L0,short,26,9,17,7,0.7937,126,"[10, 15, 18, 19, 20, 28, 32, 40, 42, 50, 52, 60, 61, 62, 69, 70, 71, 72, 80, 81, 83, 92, 93, 101, 104, 116]"

Norman,L0,short,25,13,12,12,0.8,125,"[4, 9, 20, 28, 29, 31, 40, 46, 53, 60, 61, 63, 71, 72, 73, 76, 86, 94, 95, 104, 105, 113, 114, 117, 119]"

Norman,L0,short,31,12,19,11,0.7634,131,"[10, 15, 24, 31, 38, 39, 40, 41, 49, 50, 51, 58, 59, 60, 61, 70, 72, 81, 90, 91, 99, 100, 101, 109, 110, 111, 112, 119, 120, 122, 126]"

Norman,L0,short,36,24,12,2,0.7353,136,"[4, 9, 10, 19, 20, 21, 29, 31, 38, 39, 40, 41, 42, 52, 60, 62, 64, 72, 74, 75, 84, 86, 94, 95, 97, 106, 108, 109, 116, 117, 119, 127, 128, 129, 130, 131]"

Norman,L0,short,29,12,17,2,0.7752,129,"[9, 15, 16, 18, 19, 27, 31, 32, 41, 42, 43, 44, 47, 55, 56, 57, 66, 67, 76, 77, 85, 87, 98, 108, 116, 117, 125, 126, 127]"

Norman,L0,short,30,10,20,4,0.7692,130,"[4, 9, 18, 19, 27, 28, 29, 30, 38, 39, 40, 49, 51, 59, 60, 63, 71, 80, 81, 90, 91, 98, 99, 100, 102, 110, 111, 113, 122, 123]"

Norman,L0,short,32,20,12,2,0.7576,132,"[9, 15, 17, 19, 27, 28, 29, 37, 38, 39, 40, 48, 49, 50, 51, 52, 61, 62, 71, 72, 81, 82, 90, 92, 101, 102, 105, 113, 115, 122, 123, 127]"

Norman,L0,short,30,20,10,4,0.7692,130,"[4, 9, 18, 19, 27, 28, 29, 31, 38, 39, 42, 53, 61, 62, 64, 72, 73, 74, 82, 83, 84, 92, 93, 96, 106, 113, 115, 123, 124, 125]"

Norman,L0,short,27,16,11,10,0.7874,127,"[11, 16, 18, 20, 28, 29, 37, 39, 41, 49, 52, 61, 69, 71, 78, 79, 82, 90, 91, 99, 100, 101, 109, 110, 111, 112, 123]"

Norman,L0,short,28,15,13,6,0.7812,128,"[4, 9, 19, 21, 29, 31, 39, 40, 52, 59, 60, 61, 62, 63, 72, 73, 74, 82, 83, 84, 92, 93, 94, 96, 107, 115, 123, 126]"

Norman,L0,short,36,11,25,1,0.7353,136,"[9, 14, 15, 16, 18, 20, 28, 29, 39, 40, 48, 50, 51, 60, 61, 69, 70, 71, 79, 80, 82, 90, 91, 92, 95, 96, 97, 98, 108, 116, 117, 119, 127, 128, 129, 130]"

Norman,L0,short,26,9,17,6,0.7937,126,"[4, 10, 18, 20, 21, 31, 33, 41, 42, 43, 44, 53, 56, 64, 72, 73, 74, 76, 85, 92, 96, 104, 105, 107, 115, 116]"

Norman,L0,short,27,20,7,4,0.7874,127,"[4, 9, 10, 19, 20, 22, 23, 25, 35, 44, 46, 55, 64, 65, 66, 74, 76, 85, 86, 94, 95, 96, 98, 108, 116, 118, 119]"

Norman,L0,short,30,13,17,10,0.7692,130,"[9, 14, 16, 17, 18, 21, 30, 39, 40, 48, 49, 50, 58, 59, 61, 69, 71, 72, 80, 82, 83, 94, 106, 114, 120, 121, 122, 123, 125, 127]"

Norman,L0,short,32,13,19,5,0.7576,132,"[4, 9, 18, 19, 21, 23, 32, 42, 50, 51, 53, 54, 55, 63, 67, 75, 83, 84, 85, 93, 94, 95, 102, 103, 104, 105, 113, 114, 115, 116, 119, 127]"

Norman,L0,short,28,21,7,5,0.7812,128,"[5, 9, 18, 19, 28, 29, 30, 31, 39, 41, 42, 45, 54, 63, 71, 73, 80, 82, 83, 91, 93, 101, 102, 104, 115, 122, 123, 125]"

Norman,L0,short,32,18,14,8,0.7576,132,"[5, 11, 20, 21, 23, 31, 35, 42, 43, 51, 55, 64, 66, 74, 75, 84, 85, 93, 94, 95, 97, 104, 105, 106, 107, 108, 115, 116, 117, 118, 127, 128]"

Norman,L0,short,33,14,19,7,0.7519,133,"[10, 15, 16, 17, 20, 28, 29, 31, 39, 41, 49, 50, 58, 60, 61, 62, 70, 72, 73, 75, 85, 93, 94, 95, 103, 106, 114, 115, 116, 124, 127, 128, 130]"

Norman,L0,short,31,21,10,1,0.7634,131,"[9, 10, 16, 18, 20, 28, 29, 31, 39, 40, 48, 50, 58, 60, 67, 68, 69, 70, 71, 72, 81, 82, 91, 92, 100, 101, 102, 111, 112, 121, 123]"

Norman,L0,short,27,13,14,13,0.7874,127,"[4, 9, 18, 19, 20, 28, 30, 37, 38, 39, 40, 49, 51, 59, 60, 75, 84, 92, 98, 100, 101, 104, 112, 113, 121, 122, 125]"

Norman,L0,short,28,12,16,4,0.7812,128,"[9, 14, 16, 17, 20, 29, 37, 39, 47, 48, 51, 59, 66, 69, 77, 78, 79, 87, 90, 98, 99, 100, 108, 109, 110, 118, 119, 120]"

Norman,L0,short,33,16,17,0,0.7519,133,"[4, 9, 18, 20, 28, 29, 30, 37, 39, 40, 48, 50, 58, 60, 68, 69, 70, 80, 87, 89, 90, 91, 100, 101, 108, 109, 111, 112, 120, 121, 122, 123, 131]"

Norman,L0,short,29,14,15,4,0.7752,129,"[9, 14, 15, 18, 19, 20, 29, 30, 39, 40, 48, 50, 62, 70, 78, 79, 80, 81, 90, 91, 92, 100, 101, 102, 109, 111, 114, 122, 125]"

Norman,L0,short,27,20,7,6,0.7874,127,"[10, 16, 21, 29, 32, 34, 35, 36, 44, 45, 47, 55, 56, 64, 68, 75, 76, 85, 88, 95, 97, 98, 106, 107, 108, 109, 119]"

Norman,L0,short,30,16,14,7,0.7692,130,"[9, 14, 15, 16, 17, 21, 29, 30, 31, 40, 41, 43, 51, 53, 62, 63, 66, 75, 83, 85, 93, 95, 96, 104, 105, 108, 115, 117, 124, 127]"

Norman,L0,short,28,19,9,12,0.7812,128,"[4, 9, 10, 11, 12, 14, 23, 24, 25, 38, 46, 47, 48, 54, 62, 71, 79, 80, 83, 91, 99, 100, 101, 108, 110, 112, 120, 121]"

Norman,L0,short,37,8,29,3,0.7299,137,"[4, 13, 22, 23, 24, 32, 33, 34, 42, 43, 44, 53, 54, 55, 63, 64, 65, 67, 76, 77, 78, 79, 88, 89, 90, 91, 92, 101, 103, 112, 113, 114, 122, 123, 125, 134, 135]"

Norman,L0,short,33,17,16,4,0.7519,133,"[4, 9, 11, 14, 23, 24, 25, 33, 34, 36, 44, 46, 54, 55, 56, 64, 65, 66, 75, 77, 86, 94, 95, 96, 105, 106, 114, 117, 119, 126, 127, 128, 129]"

Norman,L0,short,28,13,15,8,0.7812,128,"[7, 11, 19, 26, 28, 29, 32, 40, 49, 50, 58, 59, 62, 70, 72, 73, 75, 83, 84, 86, 94, 95, 103, 104, 105, 116, 123, 126]"

Norman,L0,short,26,5,21,1,0.7937,126,"[5, 9, 19, 21, 22, 31, 33, 34, 35, 43, 44, 45, 55, 63, 64, 65, 66, 76, 84, 87, 95, 96, 97, 104, 110, 119]"

Norman,L0,short,26,18,8,7,0.7937,126,"[10, 12, 18, 19, 20, 22, 32, 40, 41, 51, 58, 62, 69, 70, 71, 72, 80, 82, 94, 98, 105, 106, 108, 116, 117, 120]"

Norman,L0,short,27,15,12,11,0.7874,127,"[4, 9, 18, 19, 27, 28, 31, 38, 39, 42, 50, 51, 59, 60, 61, 64, 73, 81, 82, 90, 91, 95, 102, 104, 112, 115, 124]"

Norman,L0,short,29,14,15,8,0.7752,129,"[9, 14, 15, 18, 19, 27, 28, 29, 38, 39, 47, 48, 50, 54, 62, 63, 71, 76, 84, 91, 94, 102, 103, 110, 112, 113, 121, 122, 124]"

Norman,L0,short,32,20,12,8,0.7576,132,"[6, 9, 18, 19, 20, 28, 29, 33, 41, 42, 50, 51, 52, 54, 62, 63, 66, 75, 83, 85, 93, 94, 98, 106, 114, 115, 117, 124, 125, 126, 127, 129]"

Norman,L0,short,31,9,22,6,0.7634,131,"[9, 14, 15, 18, 20, 28, 29, 37, 38, 40, 48, 49, 59, 66, 69, 70, 71, 72, 80, 82, 90, 91, 95, 103, 104, 112, 113, 115, 123, 124, 125]"

Norman,L0,short,25,8,17,17,0.8,125,"[9, 14, 16, 17, 19, 27, 28, 29, 38, 39, 47, 50, 58, 59, 61, 69, 75, 84, 91, 99, 102, 109, 110, 111, 119]"

Norman,L0,short,29,13,16,5,0.7752,129,"[4, 9, 12, 22, 31, 32, 41, 42, 50, 51, 52, 53, 61, 62, 63, 71, 73, 81, 82, 83, 91, 92, 94, 102, 104, 112, 114, 122, 123]"

Norman,L0,short,33,10,23,6,0.7519,133,"[13, 19, 20, 21, 22, 32, 33, 41, 42, 43, 52, 53, 55, 63, 64, 65, 73, 76, 84, 85, 86, 95, 96, 104, 105, 106, 114, 115, 116, 117, 125, 126, 128]"

Norman,L0,short,28,15,13,13,0.7812,128,"[9, 14, 15, 16, 17, 18, 20, 31, 39, 40, 48, 49, 50, 58, 59, 63, 71, 79, 82, 90, 98, 99, 100, 108, 109, 110, 119, 125]"

Norman,L0,short,33,22,11,7,0.7519,133,"[9, 14, 15, 17, 18, 21, 29, 31, 32, 42, 43, 44, 45, 46, 47, 48, 57, 60, 69, 72, 82, 90, 99, 101, 108, 109, 110, 119, 120, 128, 129, 130, 131]"

Norman,L0,short,26,11,15,7,0.7937,126,"[10, 15, 16, 17, 19, 27, 28, 29, 40, 41, 51, 59, 60, 61, 72, 79, 80, 81, 89, 90, 91, 92, 102, 103, 111, 119]"

Norman,L0,short,26,13,13,6,0.7937,126,"[9, 10, 16, 18, 19, 20, 21, 22, 31, 34, 43, 51, 52, 60, 61, 62, 71, 72, 83, 91, 92, 100, 103, 111, 113, 122]"

Norman,L0,short,29,18,11,6,0.7752,129,"[7, 11, 19, 26, 27, 28, 29, 39, 41, 50, 51, 58, 60, 62, 63, 66, 74, 82, 83, 84, 92, 94, 102, 103, 104, 112, 114, 123, 127]"

Norman,L0,short,31,16,15,6,0.7634,131,"[9, 14, 15, 16, 17, 18, 19, 21, 30, 39, 41, 49, 50, 51, 61, 69, 70, 71, 79, 81, 89, 90, 91, 99, 102, 110, 111, 112, 115, 122, 124]"

Norman,L0,short,28,11,17,8,0.7812,128,"[11, 17, 18, 20, 28, 33, 42, 49, 51, 53, 62, 63, 71, 72, 73, 74, 82, 84, 86, 94, 96, 104, 105, 106, 107, 115, 117, 126]"

Norman,L0,short,27,19,8,8,0.7874,127,"[4, 9, 11, 19, 22, 30, 37, 38, 40, 49, 50, 52, 60, 63, 71, 79, 80, 81, 89, 90, 92, 101, 109, 111, 113, 120, 123]"

Norman,L0,short,31,14,17,2,0.7634,131,"[4, 9, 20, 28, 30, 39, 40, 48, 49, 50, 57, 58, 59, 60, 62, 70, 74, 82, 84, 91, 93, 95, 102, 103, 104, 112, 113, 115, 123, 124, 125]"

Norman,L0,short,30,15,15,3,0.7692,130,"[9, 15, 16, 18, 20, 28, 30, 39, 40, 48, 49, 51, 59, 61, 69, 70, 71, 72, 73, 82, 83, 92, 95, 103, 105, 113, 115, 123, 124, 126]"

Norman,L0,short,31,17,14,8,0.7634,131,"[10, 15, 16, 18, 19, 20, 28, 33, 42, 50, 51, 52, 60, 61, 62, 70, 72, 73, 81, 83, 84, 85, 86, 87, 97, 98, 99, 110, 118, 119, 123]"

Norman,L0,short,34,16,18,6,0.7463,134,"[9, 14, 15, 16, 17, 18, 20, 29, 31, 40, 48, 49, 51, 59, 60, 63, 64, 65, 74, 76, 84, 86, 95, 96, 98, 108, 116, 117, 119, 120, 127, 129, 131, 132]"

Norman,L0,short,28,17,11,7,0.7812,128,"[9, 10, 11, 13, 19, 20, 23, 32, 41, 42, 50, 51, 52, 60, 62, 70, 71, 73, 81, 83, 91, 95, 105, 112, 114, 121, 122, 123]"

Norman,L0,short,28,12,16,3,0.7812,128,"[4, 9, 19, 26, 28, 29, 36, 37, 38, 39, 49, 50, 58, 59, 62, 70, 80, 88, 91, 99, 100, 101, 109, 110, 111, 118, 120, 121]"

Norman,L0,short,29,18,11,5,0.7752,129,"[5, 9, 11, 20, 30, 31, 35, 42, 43, 52, 54, 64, 65, 73, 74, 75, 83, 84, 87, 95, 96, 97, 98, 106, 107, 109, 112, 120, 122]"

Norman,L0,short,26,15,11,5,0.7937,126,"[4, 9, 18, 21, 30, 37, 41, 50, 57, 59, 60, 68, 69, 70, 78, 79, 82, 89, 90, 97, 99, 100, 102, 111, 119, 122]"

Norman,L0,short,31,14,17,7,0.7634,131,"[9, 10, 15, 16, 17, 20, 28, 29, 31, 40, 42, 50, 51, 52, 53, 54, 57, 66, 75, 76, 86, 94, 101, 109, 116, 117, 118, 126, 127, 128, 129]"

Norman,L0,short,25,17,8,15,0.8,125,"[9, 14, 15, 17, 18, 22, 32, 41, 48, 51, 58, 59, 60, 68, 69, 72, 80, 82, 90, 92, 93, 101, 102, 109, 117]"

Norman,L0,short,28,15,13,4,0.7812,128,"[4, 9, 10, 11, 20, 21, 30, 33, 41, 42, 54, 63, 73, 74, 81, 82, 83, 84, 92, 94, 101, 103, 106, 114, 122, 123, 125, 126]"

Norman,L0,short,27,10,17,6,0.7874,127,"[4, 10, 18, 19, 27, 28, 29, 38, 39, 47, 48, 49, 58, 59, 60, 70, 79, 80, 83, 93, 100, 101, 102, 110, 113, 120, 123]"

Norman,L0,short,33,14,19,3,0.7519,133,"[4, 10, 18, 19, 27, 28, 29, 30, 31, 39, 41, 49, 50, 51, 61, 69, 71, 79, 80, 81, 82, 90, 92, 100, 101, 103, 110, 111, 112, 113, 114, 123, 125]"

Norman,L0,short,28,13,15,9,0.7812,128,"[9, 15, 16, 19, 27, 28, 29, 30, 38, 41, 49, 50, 52, 60, 63, 71, 81, 82, 83, 91, 92, 93, 101, 102, 106, 116, 123, 125]"

Norman,L0,short,35,11,24,5,0.7407,135,"[9, 15, 16, 17, 18, 19, 20, 21, 23, 32, 33, 42, 43, 52, 53, 62, 64, 72, 73, 83, 91, 92, 93, 94, 95, 98, 106, 108, 116, 117, 118, 121, 128, 129, 132]"

Norman,L0,short,28,25,3,10,0.7812,128,"[5, 9, 19, 28, 31, 38, 39, 47, 49, 50, 51, 52, 53, 54, 62, 63, 65, 74, 75, 84, 85, 93, 94, 95, 99, 107, 111, 120]"

Norman,L0,short,30,15,15,7,0.7692,130,"[12, 19, 22, 29, 30, 31, 32, 33, 43, 51, 52, 53, 54, 56, 65, 72, 73, 74, 75, 85, 93, 94, 95, 103, 104, 106, 114, 115, 123, 126]"

Norman,L0,short,28,13,15,4,0.7812,128,"[5, 9, 18, 19, 20, 28, 29, 30, 38, 39, 40, 50, 58, 59, 63, 72, 80, 81, 83, 84, 85, 95, 96, 97, 107, 108, 109, 120]"

Norman,L0,short,35,10,25,5,0.7407,135,"[9, 11, 13, 14, 22, 23, 24, 33, 34, 35, 36, 46, 54, 59, 67, 69, 77, 78, 79, 87, 88, 89, 97, 98, 99, 101, 109, 111, 119, 120, 121, 122, 131, 132, 133]"

Norman,L0,short,31,6,25,4,0.7634,131,"[9, 10, 16, 17, 18, 19, 21, 29, 30, 31, 41, 42, 50, 51, 52, 62, 70, 72, 80, 81, 84, 92, 100, 101, 102, 103, 111, 112, 114, 121, 124]"

Norman,L0,short,29,20,9,9,0.7752,129,"[9, 10, 15, 16, 17, 18, 19, 20, 30, 32, 41, 49, 50, 53, 65, 72, 80, 82, 84, 92, 96, 104, 111, 114, 120, 121, 122, 123, 124]"

Norman,L0,short,30,17,13,10,0.7692,130,"[4, 10, 18, 19, 20, 21, 22, 24, 34, 48, 57, 65, 67, 76, 83, 84, 89, 97, 98, 105, 107, 108, 115, 116, 117, 118, 125, 126, 127, 128]"

Norman,L0,short,29,17,12,7,0.7752,129,"[9, 14, 17, 18, 19, 21, 31, 32, 33, 42, 43, 51, 53, 61, 63, 74, 82, 83, 84, 91, 92, 95, 103, 104, 110, 117, 125, 126, 127]"

Norman,L0,short,29,11,18,6,0.7752,129,"[9, 15, 16, 17, 18, 19, 28, 31, 40, 48, 50, 58, 60, 67, 69, 79, 88, 89, 90, 98, 100, 107, 109, 110, 111, 112, 119, 121, 123]"

Norman,L0,short,29,12,17,4,0.7752,129,"[4, 9, 19, 28, 30, 37, 38, 39, 47, 48, 49, 58, 59, 67, 68, 69, 77, 78, 80, 81, 84, 92, 93, 102, 105, 113, 121, 122, 123]"

Norman,L0,short,29,16,13,5,0.7752,129,"[9, 14, 15, 16, 19, 28, 30, 38, 39, 49, 51, 61, 69, 70, 78, 80, 87, 88, 89, 90, 97, 99, 100, 107, 108, 109, 110, 118, 122]"

Norman,L0,short,27,18,9,6,0.7874,127,"[4, 11, 19, 20, 21, 22, 25, 33, 34, 42, 43, 46, 55, 63, 64, 68, 76, 77, 87, 95, 97, 99, 106, 108, 116, 118, 119]"

Norman,L0,short,36,24,12,4,0.7353,136,"[4, 9, 10, 14, 23, 32, 33, 35, 36, 38, 39, 48, 49, 51, 60, 68, 69, 70, 79, 80, 88, 89, 91, 101, 108, 110, 112, 119, 120, 121, 122, 123, 131, 132, 133, 134]"

Norman,L0,short,28,18,10,11,0.7812,128,"[9, 10, 11, 12, 13, 19, 20, 21, 22, 23, 32, 36, 46, 59, 67, 75, 76, 86, 94, 95, 97, 105, 106, 115, 116, 122, 125, 126]"

Norman,L0,short,25,12,13,13,0.8,125,"[5, 9, 18, 19, 27, 28, 30, 39, 47, 48, 49, 50, 58, 59, 65, 73, 82, 90, 91, 93, 101, 105, 113, 115, 121]"

Norman,L0,short,32,16,16,4,0.7576,132,"[5, 9, 10, 19, 20, 28, 29, 30, 31, 39, 41, 49, 50, 52, 60, 61, 69, 70, 71, 80, 81, 90, 91, 99, 100, 102, 110, 113, 115, 123, 124, 126]"

Norman,L0,short,28,15,13,8,0.7812,128,"[4, 9, 21, 29, 30, 32, 40, 42, 50, 53, 60, 63, 71, 72, 79, 80, 81, 83, 91, 92, 100, 101, 102, 111, 112, 120, 121, 123]"

Norman,L0,short,26,23,3,6,0.7937,126,"[4, 9, 19, 20, 21, 31, 32, 40, 41, 43, 51, 52, 53, 54, 62, 63, 65, 74, 82, 83, 85, 93, 99, 108, 116, 117]"

Norman,L0,short,24,7,17,9,0.8065,124,"[9, 15, 17, 18, 19, 29, 31, 33, 42, 43, 52, 55, 63, 67, 74, 82, 83, 84, 93, 97, 104, 106, 113, 118]"

Norman,L0,short,32,21,11,6,0.7576,132,"[13, 19, 26, 27, 28, 29, 38, 39, 40, 48, 49, 50, 59, 61, 70, 71, 79, 81, 83, 93, 94, 102, 103, 104, 105, 114, 115, 116, 125, 127, 128, 130]"

Norman,L0,short,34,21,13,1,0.7463,134,"[4, 9, 10, 19, 20, 29, 30, 31, 39, 41, 42, 50, 51, 52, 60, 61, 62, 63, 72, 73, 82, 83, 91, 92, 94, 102, 103, 104, 112, 113, 114, 115, 124, 125]"

Norman,L0,short,30,19,11,4,0.7692,130,"[9, 17, 18, 19, 28, 30, 39, 46, 47, 48, 49, 57, 58, 59, 67, 69, 79, 86, 87, 88, 90, 98, 99, 108, 111, 118, 119, 120, 121, 122]"

Norman,L0,short,31,18,13,8,0.7634,131,"[5, 9, 12, 22, 30, 37, 38, 39, 42, 50, 52, 53, 63, 71, 72, 73, 74, 75, 83, 84, 85, 93, 94, 96, 105, 108, 115, 116, 124, 125, 126]"

Norman,L0,short,32,16,16,3,0.7576,132,"[5, 9, 19, 26, 27, 28, 30, 37, 39, 40, 49, 50, 51, 52, 60, 61, 62, 63, 72, 74, 84, 93, 95, 104, 112, 113, 114, 115, 116, 125, 127, 128]"

Norman,L0,short,28,12,16,7,0.7812,128,"[9, 15, 16, 18, 20, 28, 29, 31, 39, 40, 41, 43, 51, 52, 53, 54, 65, 73, 74, 82, 84, 85, 94, 95, 103, 108, 115, 117]"

Norman,L0,short,29,24,5,10,0.7752,129,"[4, 10, 18, 20, 28, 29, 30, 37, 41, 44, 53, 60, 61, 62, 67, 76, 84, 87, 94, 95, 96, 97, 98, 100, 108, 110, 118, 119, 122]"

Norman,L0,short,27,11,16,13,0.7874,127,"[9, 11, 16, 17, 19, 20, 28, 29, 30, 35, 46, 54, 62, 63, 64, 72, 73, 74, 82, 83, 87, 95, 99, 109, 116, 117, 119]"

Norman,L0,short,31,13,18,10,0.7634,131,"[4, 9, 10, 12, 21, 23, 32, 34, 42, 46, 54, 55, 63, 64, 66, 74, 78, 85, 86, 87, 95, 96, 97, 98, 106, 108, 109, 117, 118, 120, 123]"

Norman,L0,short,30,18,12,7,0.7692,130,"[5, 10, 20, 23, 31, 38, 39, 40, 41, 42, 50, 54, 62, 70, 71, 72, 80, 81, 83, 85, 86, 95, 97, 105, 106, 114, 116, 124, 125, 127]"

Norman,L0,short,27,18,9,4,0.7874,127,"[4, 9, 19, 26, 27, 28, 29, 39, 40, 48, 50, 59, 60, 68, 69, 71, 80, 82, 92, 99, 100, 102, 111, 114, 121, 122, 123]"

Norman,L0,short,32,16,16,8,0.7576,132,"[9, 10, 12, 18, 19, 20, 21, 24, 33, 42, 50, 52, 53, 61, 62, 63, 71, 75, 85, 92, 93, 95, 103, 104, 107, 108, 115, 118, 119, 127, 128, 129]"

Norman,L0,short,32,23,9,4,0.7576,132,"[4, 9, 19, 27, 28, 29, 36, 38, 39, 48, 49, 51, 52, 55, 65, 74, 81, 82, 83, 85, 93, 94, 95, 104, 105, 106, 107, 115, 116, 118, 126, 128]"

Norman,L0,short,38,16,22,2,0.7246,138,"[4, 10, 18, 19, 20, 28, 29, 31, 32, 41, 42, 50, 51, 53, 54, 55, 63, 65, 73, 74, 75, 76, 85, 86, 87, 88, 89, 98, 99, 108, 110, 118, 119, 120, 121, 122, 125, 134]"

Norman,L0,short,24,8,16,15,0.8065,124,"[12, 18, 19, 22, 30, 31, 32, 43, 50, 52, 53, 54, 62, 63, 64, 73, 74, 83, 86, 91, 102, 110, 117, 120]"

Norman,L0,short,30,16,14,5,0.7692,130,"[9, 14, 15, 16, 17, 18, 19, 20, 30, 39, 40, 41, 43, 53, 54, 63, 66, 75, 84, 85, 94, 95, 96, 104, 106, 114, 115, 116, 124, 128]"

Norman,L0,short,29,17,12,16,0.7752,129,"[4, 9, 18, 20, 21, 30, 31, 37, 48, 56, 64, 71, 72, 73, 80, 81, 83, 90, 93, 100, 103, 110, 111, 112, 113, 120, 121, 122, 123]"

Norman,L0,short,29,15,14,7,0.7752,129,"[9, 10, 15, 16, 17, 18, 19, 21, 30, 39, 40, 49, 50, 59, 60, 62, 70, 71, 79, 80, 81, 90, 91, 92, 94, 106, 114, 122, 123]"

Norman,L0,short,29,15,14,4,0.7752,129,"[7, 13, 21, 31, 40, 41, 49, 50, 52, 61, 62, 63, 65, 75, 82, 83, 84, 87, 95, 96, 103, 104, 106, 114, 115, 116, 124, 125, 127]"

Norman,L0,short,30,15,15,10,0.7692,130,"[5, 10, 20, 28, 31, 39, 40, 48, 49, 52, 59, 62, 71, 78, 80, 82, 91, 92, 93, 100, 102, 103, 110, 114, 121, 122, 123, 124, 125, 126]"

Norman,L0,short,34,21,13,2,0.7463,134,"[6, 9, 18, 19, 20, 21, 22, 30, 31, 34, 43, 52, 53, 54, 62, 63, 64, 72, 74, 82, 83, 85, 86, 94, 95, 96, 106, 107, 108, 116, 117, 118, 119, 129]"

Norman,L0,short,28,7,21,7,0.7812,128,"[9, 15, 16, 17, 18, 19, 20, 29, 32, 41, 49, 50, 58, 59, 60, 69, 70, 79, 82, 90, 97, 101, 108, 109, 111, 118, 120, 121]"

Norman,L0,short,29,6,23,7,0.7752,129,"[10, 15, 17, 18, 19, 20, 21, 29, 31, 32, 41, 42, 50, 51, 54, 63, 71, 73, 81, 82, 84, 86, 97, 105, 106, 109, 117, 125, 127]"

Norman,L0,short,30,15,15,3,0.7692,130,"[9, 14, 15, 16, 17, 18, 21, 29, 31, 40, 41, 49, 53, 61, 69, 70, 72, 82, 90, 91, 92, 100, 101, 102, 104, 112, 113, 114, 121, 124]"

Norman,L0,short,30,17,13,11,0.7692,130,"[11, 18, 21, 30, 38, 40, 47, 48, 49, 50, 58, 61, 69, 70, 71, 72, 80, 82, 83, 85, 94, 99, 107, 115, 121, 122, 124, 125, 126, 128]"

Norman,L0,short,29,8,21,4,0.7752,129,"[4, 9, 20, 31, 38, 39, 41, 49, 51, 60, 61, 62, 70, 76, 77, 85, 86, 87, 90, 98, 106, 107, 109, 116, 117, 118, 119, 121, 122]"

Norman,L0,short,30,9,21,10,0.7692,130,"[11, 16, 17, 20, 24, 31, 40, 41, 42, 43, 51, 52, 54, 62, 65, 74, 75, 76, 84, 85, 86, 88, 99, 107, 108, 116, 118, 126, 127, 128]"

Norman,L0,short,32,25,7,4,0.7576,132,"[4, 11, 19, 26, 27, 28, 30, 32, 39, 41, 43, 52, 60, 61, 62, 70, 72, 73, 74, 75, 84, 86, 96, 104, 105, 106, 114, 116, 124, 125, 126, 127]"

Norman,L0,short,32,19,13,11,0.7576,132,"[5, 10, 18, 19, 28, 29, 36, 37, 39, 47, 48, 49, 53, 61, 69, 71, 79, 82, 83, 86, 94, 96, 103, 104, 106, 113, 114, 115, 117, 126, 127, 129]"

Norman,L0,short,31,10,21,5,0.7634,131,"[11, 16, 17, 18, 19, 21, 29, 30, 39, 41, 49, 51, 59, 60, 61, 62, 63, 71, 72, 73, 74, 83, 84, 93, 97, 105, 114, 115, 116, 125, 126]"

Norman,L0,short,28,18,10,1,0.7812,128,"[9, 14, 15, 17, 18, 19, 29, 37, 38, 39, 47, 48, 49, 60, 67, 68, 72, 80, 82, 92, 93, 101, 102, 103, 112, 113, 121, 123]"

Norman,L0,short,28,19,9,8,0.7812,128,"[5, 9, 19, 20, 22, 30, 31, 32, 33, 41, 43, 53, 56, 66, 74, 82, 83, 84, 91, 92, 93, 95, 102, 103, 107, 114, 117, 125]"

Norman,L0,short,27,10,17,1,0.7874,127,"[9, 14, 16, 17, 18, 19, 28, 29, 38, 39, 47, 49, 57, 59, 67, 69, 70, 78, 80, 82, 90, 92, 103, 111, 112, 120, 122]"

Norman,L0,short,34,10,24,10,0.7463,134,"[13, 20, 21, 29, 30, 33, 41, 43, 50, 51, 52, 54, 62, 63, 64, 71, 72, 73, 74, 82, 83, 84, 93, 94, 102, 103, 104, 112, 113, 114, 116, 117, 126, 132]"

Norman,L0,short,27,20,7,7,0.7874,127,"[9, 14, 16, 17, 18, 19, 28, 32, 41, 49, 51, 59, 60, 67, 70, 71, 81, 90, 91, 99, 100, 102, 109, 112, 120, 121, 123]"

Norman,L0,short,29,16,13,10,0.7752,129,"[9, 15, 16, 19, 27, 29, 30, 39, 40, 43, 51, 59, 60, 62, 69, 70, 71, 72, 80, 81, 82, 90, 91, 95, 105, 113, 121, 123, 127]"

Norman,L0,short,33,18,15,5,0.7519,133,"[4, 10, 18, 20, 25, 33, 42, 50, 51, 52, 53, 60, 62, 63, 71, 73, 81, 83, 92, 93, 94, 102, 103, 104, 106, 113, 114, 115, 123, 124, 125, 127, 129]"

Norman,L0,short,28,13,15,13,0.7812,128,"[9, 11, 17, 18, 19, 22, 24, 33, 37, 48, 56, 64, 67, 77, 85, 91, 92, 93, 94, 95, 103, 104, 106, 113, 115, 122, 123, 125]"

Norman,L0,short,30,17,13,5,0.7692,130,"[9, 13, 20, 22, 31, 39, 40, 42, 52, 54, 62, 63, 70, 72, 73, 80, 81, 82, 83, 91, 92, 93, 101, 103, 111, 112, 114, 115, 123, 125]"

Norman,L0,short,32,17,15,8,0.7576,132,"[4, 10, 18, 20, 28, 29, 36, 37, 38, 40, 48, 49, 51, 59, 60, 62, 63, 66, 75, 83, 84, 85, 94, 96, 99, 109, 117, 118, 125, 126, 127, 129]"

Norman,L0,short,31,11,20,3,0.7634,131,"[9, 15, 17, 18, 19, 20, 28, 29, 30, 39, 40, 49, 52, 60, 61, 69, 72, 80, 81, 89, 90, 93, 95, 96, 104, 105, 108, 116, 117, 118, 128]"

Norman,L0,short,30,14,16,6,0.7692,130,"[9, 14, 15, 16, 17, 19, 29, 30, 32, 41, 49, 50, 52, 60, 61, 63, 64, 72, 73, 74, 75, 84, 85, 95, 96, 104, 105, 107, 111, 121]"

Norman,L0,short,32,2,30,2,0.7576,132,"[10, 15, 16, 17, 19, 20, 28, 29, 30, 40, 49, 50, 51, 59, 60, 61, 62, 63, 73, 82, 83, 92, 93, 102, 104, 112, 114, 122, 123, 124, 125, 126]"

Norman,L0,short,31,21,10,7,0.7634,131,"[5, 12, 22, 30, 37, 38, 40, 48, 50, 57, 59, 61, 62, 63, 66, 74, 81, 82, 83, 84, 94, 101, 102, 104, 105, 106, 115, 116, 125, 126, 128]"

Norman,L0,short,27,14,13,10,0.7874,127,"[5, 9, 11, 19, 24, 32, 33, 42, 45, 53, 60, 61, 62, 63, 71, 72, 74, 82, 83, 84, 86, 95, 104, 108, 117, 124, 125]"

Norman,L0,short,31,17,14,3,0.7634,131,"[9, 10, 11, 17, 18, 19, 20, 21, 30, 32, 42, 50, 51, 52, 62, 63, 64, 65, 73, 74, 75, 76, 87, 96, 97, 106, 107, 116, 117, 126, 127]"

Norman,L0,short,32,14,18,12,0.7576,132,"[11, 16, 17, 18, 19, 20, 21, 29, 30, 31, 33, 42, 50, 53, 64, 73, 81, 83, 90, 91, 92, 93, 94, 95, 103, 104, 106, 108, 117, 118, 119, 123]"

Norman,L0,short,31,17,14,6,0.7634,131,"[4, 10, 18, 19, 27, 28, 29, 30, 39, 40, 42, 50, 52, 60, 61, 63, 72, 80, 82, 91, 92, 93, 102, 103, 104, 105, 113, 114, 115, 117, 128]"

Norman,L0,short,31,13,18,6,0.7634,131,"[9, 10, 11, 17, 18, 19, 20, 21, 30, 33, 42, 43, 51, 52, 53, 62, 63, 65, 73, 74, 76, 85, 88, 96, 99, 107, 114, 116, 117, 127, 128]"

Norman,L0,short,31,12,19,5,0.7634,131,"[9, 15, 16, 17, 18, 19, 21, 22, 23, 25, 35, 44, 45, 55, 63, 65, 66, 74, 75, 77, 85, 86, 87, 89, 91, 100, 102, 106, 115, 123, 124]"

Norman,L0,short,29,8,21,10,0.7752,129,"[9, 15, 16, 18, 19, 27, 29, 30, 31, 40, 41, 49, 51, 59, 60, 61, 64, 72, 80, 82, 91, 95, 106, 113, 121, 122, 123, 124, 125]"

Norman,L0,short,28,14,14,7,0.7812,128,"[4, 9, 10, 11, 21, 30, 31, 34, 43, 51, 53, 61, 62, 71, 73, 81, 82, 83, 91, 93, 100, 101, 102, 103, 104, 112, 114, 126]"

Norman,L0,short,33,27,6,4,0.7519,133,"[9, 14, 15, 16, 17, 18, 22, 31, 33, 42, 43, 51, 52, 53, 54, 64, 74, 82, 83, 84, 86, 94, 95, 104, 105, 113, 114, 115, 116, 124, 125, 126, 127]"

Norman,L0,short,27,13,14,7,0.7874,127,"[10, 15, 18, 19, 27, 28, 29, 37, 38, 39, 47, 48, 49, 59, 68, 73, 82, 89, 90, 92, 100, 101, 108, 111, 119, 121, 122]"

Norman,L0,short,33,17,16,4,0.7519,133,"[5, 9, 19, 26, 27, 28, 29, 38, 39, 48, 50, 57, 58, 61, 69, 72, 83, 90, 95, 103, 104, 105, 113, 114, 115, 116, 117, 124, 125, 126, 127, 128, 129]"

Norman,L0,short,33,15,18,7,0.7519,133,"[9, 15, 22, 29, 31, 34, 44, 52, 53, 56, 64, 65, 66, 74, 75, 77, 86, 87, 94, 96, 97, 98, 106, 107, 108, 115, 116, 117, 118, 119, 127, 129, 130]"

Norman,L0,short,28,10,18,7,0.7812,128,"[4, 10, 21, 29, 30, 31, 33, 34, 42, 44, 52, 54, 56, 64, 67, 75, 76, 84, 85, 86, 97, 100, 108, 109, 112, 115, 122, 124]"

Norman,L0,short,34,11,23,6,0.7463,134,"[12, 18, 19, 27, 29, 30, 38, 40, 43, 51, 53, 62, 69, 71, 72, 73, 82, 84, 85, 94, 95, 97, 105, 106, 107, 108, 116, 117, 118, 119, 120, 121, 128, 131]"

Norman,L0,short,27,7,20,5,0.7874,127,"[10, 11, 17, 19, 22, 32, 40, 41, 42, 43, 51, 52, 53, 54, 58, 66, 75, 76, 84, 85, 88, 96, 97, 98, 107, 111, 120]"

Norman,L0,short,28,22,6,2,0.7812,128,"[9, 14, 15, 16, 19, 29, 31, 40, 49, 52, 59, 60, 62, 63, 70, 72, 73, 82, 83, 91, 92, 93, 101, 103, 111, 114, 122, 123]"

Norman,L0,short,28,18,10,6,0.7812,128,"[9, 11, 12, 20, 21, 25, 33, 34, 36, 45, 47, 55, 56, 64, 66, 77, 84, 86, 94, 95, 97, 105, 106, 113, 115, 117, 125, 126]"

Norman,L0,short,31,15,16,4,0.7634,131,"[4, 9, 18, 20, 28, 29, 37, 38, 39, 48, 50, 51, 59, 60, 61, 62, 70, 71, 72, 80, 81, 82, 83, 84, 95, 98, 100, 110, 111, 113, 124]"

Norman,L0,short,32,19,13,9,0.7576,132,"[9, 14, 15, 16, 18, 21, 31, 39, 40, 48, 49, 50, 58, 59, 61, 70, 78, 80, 87, 88, 89, 90, 98, 99, 100, 102, 110, 111, 112, 120, 121, 126]"

Norman,L0,short,25,15,10,12,0.8,125,"[10, 16, 18, 19, 27, 30, 38, 39, 47, 48, 50, 58, 59, 61, 69, 71, 81, 91, 98, 99, 104, 110, 114, 120, 122]"

Norman,L0,short,32,23,9,4,0.7576,132,"[4, 9, 18, 19, 27, 29, 30, 39, 41, 42, 50, 51, 52, 60, 61, 63, 71, 74, 83, 92, 100, 101, 102, 104, 112, 113, 114, 122, 123, 124, 125, 126]"

Norman,L0,short,38,19,19,3,0.7246,138,"[9, 10, 16, 18, 19, 20, 21, 29, 31, 40, 41, 42, 43, 44, 45, 46, 56, 58, 68, 76, 77, 79, 87, 89, 90, 98, 100, 108, 109, 110, 118, 120, 121, 122, 130, 132, 133, 134]"

Norman,L0,short,34,26,8,3,0.7463,134,"[9, 15, 16, 17, 19, 21, 30, 31, 32, 42, 43, 44, 52, 53, 54, 56, 65, 66, 74, 76, 77, 86, 87, 95, 96, 98, 106, 107, 108, 116, 117, 119, 127, 128]"

Norman,L0,short,28,23,5,5,0.7812,128,"[4, 10, 11, 19, 20, 22, 32, 40, 41, 42, 43, 53, 61, 65, 73, 80, 83, 90, 91, 92, 93, 101, 102, 104, 112, 113, 121, 124]"

Norman,L0,short,26,15,11,11,0.7937,126,"[5, 9, 20, 28, 30, 32, 34, 35, 42, 43, 44, 45, 54, 57, 65, 75, 77, 85, 86, 89, 96, 98, 99, 108, 114, 121]"

Norman,L0,short,27,23,4,8,0.7874,127,"[4, 9, 10, 14, 22, 30, 32, 40, 41, 42, 51, 52, 60, 66, 74, 75, 84, 86, 94, 95, 97, 98, 107, 109, 117, 118, 119]"

Norman,L0,short,31,14,17,9,0.7634,131,"[9, 14, 20, 21, 24, 35, 43, 50, 51, 52, 53, 63, 64, 66, 73, 75, 83, 84, 85, 94, 95, 104, 105, 106, 113, 114, 115, 116, 118, 125, 127]"

Norman,L0,short,32,22,10,3,0.7576,132,"[4, 9, 19, 29, 36, 37, 38, 39, 47, 48, 49, 57, 60, 62, 70, 72, 81, 90, 91, 92, 93, 94, 96, 103, 105, 106, 108, 115, 117, 119, 128, 129]"

Norman,L0,short,30,20,10,8,0.7692,130,"[4, 9, 10, 11, 20, 22, 33, 41, 42, 43, 52, 53, 61, 62, 63, 71, 72, 73, 74, 75, 87, 95, 96, 104, 105, 109, 117, 124, 125, 126]"

Norman,L0,short,28,19,9,6,0.7812,128,"[4, 11, 19, 20, 28, 29, 30, 31, 33, 43, 51, 52, 56, 65, 66, 74, 75, 76, 77, 78, 88, 99, 106, 107, 108, 109, 111, 122]"

Norman,L0,short,34,23,11,1,0.7463,134,"[5, 9, 18, 19, 29, 38, 39, 40, 48, 49, 51, 59, 60, 62, 63, 64, 65, 75, 76, 84, 88, 96, 97, 98, 106, 107, 108, 115, 116, 117, 118, 126, 127, 128]"

Norman,L0,short,31,16,15,10,0.7634,131,"[9, 17, 18, 19, 20, 28, 29, 30, 33, 42, 53, 61, 62, 64, 72, 73, 76, 88, 95, 104, 110, 111, 112, 113, 114, 121, 122, 123, 124, 125, 126]"

Norman,L0,short,29,14,15,10,0.7752,129,"[9, 10, 17, 18, 19, 22, 32, 40, 49, 50, 58, 62, 69, 70, 72, 79, 81, 90, 92, 94, 102, 103, 104, 107, 114, 115, 117, 124, 126]"

Norman,L0,short,30,14,16,3,0.7692,130,"[9, 14, 15, 16, 17, 18, 20, 30, 31, 40, 41, 49, 52, 60, 63, 71, 79, 81, 89, 90, 91, 92, 101, 102, 109, 111, 112, 119, 120, 122]"

Norman,L0,short,28,18,10,4,0.7812,128,"[9, 10, 15, 17, 19, 20, 28, 31, 39, 40, 42, 52, 60, 61, 63, 64, 72, 75, 76, 84, 85, 88, 100, 107, 108, 109, 111, 120]"

Norman,L0,short,35,23,12,0,0.7407,135,"[9, 10, 15, 16, 17, 18, 19, 21, 22, 32, 33, 43, 44, 45, 47, 56, 57, 66, 68, 77, 78, 87, 88, 96, 97, 98, 106, 107, 108, 109, 118, 119, 127, 128, 129]"

Norman,L0,short,34,19,15,5,0.7463,134,"[9, 15, 16, 17, 18, 19, 20, 21, 30, 31, 41, 42, 53, 61, 62, 65, 73, 74, 75, 76, 77, 78, 79, 87, 88, 89, 99, 107, 108, 111, 119, 121, 128, 131]"

Norman,L0,short,32,23,9,4,0.7576,132,"[9, 14, 17, 21, 29, 30, 31, 40, 41, 49, 51, 52, 53, 54, 55, 56, 65, 68, 76, 77, 78, 86, 87, 88, 97, 99, 107, 108, 116, 121, 129, 130]"

Norman,L0,short,31,9,22,15,0.7634,131,"[4, 12, 20, 23, 33, 40, 43, 52, 58, 59, 60, 61, 64, 74, 81, 82, 83, 84, 92, 93, 95, 103, 106, 114, 115, 117, 124, 126, 127, 128, 129]"

Norman,L0,short,32,22,10,4,0.7576,132,"[10, 15, 17, 18, 20, 22, 31, 32, 41, 42, 44, 52, 53, 62, 65, 74, 82, 84, 91, 92, 93, 94, 102, 103, 104, 105, 113, 115, 116, 117, 126, 127]"

Norman,L0,short,30,17,13,10,0.7692,130,"[5, 9, 10, 19, 20, 28, 29, 33, 42, 50, 51, 52, 60, 62, 65, 73, 82, 87, 94, 101, 102, 103, 104, 111, 112, 114, 115, 116, 119, 122]"

Norman,L0,short,24,11,13,8,0.8065,124,"[9, 14, 16, 17, 18, 19, 28, 29, 40, 48, 49, 51, 60, 68, 70, 78, 83, 90, 98, 99, 102, 109, 111, 122]"

Norman,L0,short,31,10,21,10,0.7634,131,"[10, 15, 16, 18, 19, 20, 21, 30, 31, 35, 45, 53, 61, 64, 71, 73, 75, 83, 86, 94, 101, 102, 104, 105, 112, 113, 114, 115, 123, 124, 126]"

Norman,L0,short,28,23,5,4,0.7812,128,"[9, 10, 11, 12, 18, 19, 21, 24, 33, 42, 43, 51, 52, 53, 62, 64, 73, 82, 83, 91, 92, 94, 102, 105, 112, 114, 122, 125]"

Norman,L0,short,34,24,10,4,0.7463,134,"[4, 9, 10, 11, 13, 22, 31, 32, 33, 34, 43, 46, 55, 57, 58, 66, 67, 68, 76, 77, 78, 86, 88, 96, 97, 98, 99, 100, 108, 111, 119, 120, 129, 130]"

Norman,L0,short,32,27,5,3,0.7576,132,"[4, 9, 18, 19, 20, 21, 30, 32, 41, 42, 50, 51, 52, 53, 55, 65, 74, 75, 83, 84, 85, 86, 87, 95, 96, 98, 106, 108, 117, 119, 126, 129]"

Norman,L0,short,28,11,17,8,0.7812,128,"[11, 16, 17, 18, 22, 30, 38, 40, 51, 58, 59, 61, 68, 69, 71, 80, 83, 91, 98, 100, 102, 111, 112, 113, 114, 123, 125, 126]"

Norman,L0,short,34,16,18,4,0.7463,134,"[5, 9, 18, 19, 27, 28, 29, 37, 40, 50, 57, 60, 68, 69, 70, 73, 80, 81, 89, 91, 99, 100, 101, 109, 110, 112, 113, 114, 116, 124, 127, 128, 130, 132]"

Norman,L0,short,30,12,18,3,0.7692,130,"[6, 10, 20, 28, 29, 36, 37, 38, 39, 40, 48, 51, 59, 60, 61, 69, 70, 72, 81, 85, 94, 101, 102, 103, 105, 113, 114, 115, 123, 125]"

Norman,L0,short,28,16,12,9,0.7812,128,"[4, 9, 10, 11, 21, 22, 23, 32, 33, 34, 43, 46, 54, 63, 65, 73, 77, 87, 94, 96, 103, 104, 105, 106, 109, 117, 124, 125]"

Norman,L0,short,28,22,6,5,0.7812,128,"[4, 10, 18, 19, 20, 29, 31, 33, 41, 42, 43, 52, 55, 56, 66, 75, 78, 85, 86, 87, 90, 100, 107, 108, 109, 117, 118, 120]"

Norman,L0,short,27,10,17,4,0.7874,127,"[4, 9, 19, 26, 27, 28, 29, 37, 38, 39, 48, 51, 60, 70, 78, 79, 87, 88, 89, 97, 99, 108, 109, 110, 117, 118, 120]"

Norman,L0,short,29,10,19,3,0.7752,129,"[4, 10, 18, 19, 20, 28, 30, 37, 38, 39, 40, 49, 51, 59, 60, 61, 70, 72, 80, 81, 92, 100, 101, 102, 109, 110, 111, 114, 123]"

Norman,L0,short,31,16,15,5,0.7634,131,"[9, 14, 17, 18, 19, 27, 30, 38, 39, 47, 48, 49, 57, 58, 59, 68, 72, 80, 87, 89, 96, 98, 100, 107, 110, 111, 112, 119, 120, 121, 122]"

Norman,L0,short,30,17,13,6,0.7692,130,"[9, 14, 15, 18, 19, 20, 21, 22, 23, 33, 35, 44, 45, 54, 57, 65, 73, 74, 75, 83, 85, 94, 96, 105, 107, 116, 123, 124, 125, 128]"

Norman,L0,short,27,23,4,2,0.7874,127,"[4, 9, 19, 20, 21, 22, 31, 32, 40, 42, 50, 52, 53, 54, 62, 64, 72, 75, 76, 85, 86, 89, 99, 108, 109, 118, 119]"

Norman,L0,short,30,13,17,7,0.7692,130,"[9, 13, 20, 22, 30, 31, 33, 41, 43, 54, 62, 70, 71, 73, 81, 82, 83, 90, 92, 94, 102, 103, 110, 112, 113, 114, 116, 123, 124, 126]"

Norman,L0,short,27,17,10,10,0.7874,127,"[4, 11, 19, 27, 29, 31, 34, 41, 43, 51, 52, 59, 60, 61, 62, 71, 72, 73, 81, 83, 91, 94, 102, 106, 113, 114, 120]"

Norman,L0,short,32,22,10,3,0.7576,132,"[5, 10, 18, 19, 20, 29, 32, 33, 41, 42, 45, 53, 55, 63, 64, 72, 74, 75, 85, 92, 93, 94, 95, 96, 104, 106, 115, 116, 117, 118, 127, 128]"

Norman,L0,short,31,13,18,6,0.7634,131,"[4, 9, 10, 19, 21, 31, 32, 33, 34, 43, 44, 53, 55, 58, 66, 74, 75, 77, 85, 87, 89, 97, 98, 106, 107, 111, 118, 126, 127, 128, 129]"

Norman,L0,short,31,20,11,4,0.7634,131,"[5, 10, 18, 19, 20, 28, 29, 32, 39, 41, 42, 43, 52, 53, 55, 56, 65, 68, 76, 77, 79, 88, 90, 91, 99, 100, 102, 112, 113, 122, 124]"

Norman,L0,short,31,21,10,6,0.7634,131,"[5, 9, 11, 19, 20, 22, 31, 33, 41, 42, 43, 52, 53, 64, 72, 73, 74, 76, 84, 85, 93, 94, 95, 96, 104, 105, 106, 114, 115, 117, 126]"

Norman,L0,short,30,16,14,6,0.7692,130,"[9, 10, 11, 12, 14, 15, 16, 17, 25, 26, 27, 38, 46, 47, 50, 52, 61, 70, 75, 83, 91, 92, 93, 94, 95, 105, 113, 115, 123, 126]"

Norman,L0,short,38,28,10,1,0.7246,138,"[9, 10, 15, 16, 17, 18, 19, 20, 21, 22, 24, 33, 35, 44, 53, 54, 55, 65, 66, 67, 68, 69, 70, 80, 89, 90, 100, 101, 109, 111, 119, 120, 121, 122, 130, 131, 132, 133]"

Norman,L0,short,28,17,11,13,0.7812,128,"[5, 10, 18, 19, 27, 28, 29, 33, 42, 51, 59, 60, 70, 78, 81, 88, 89, 90, 92, 99, 100, 103, 110, 111, 113, 114, 123, 126]"

Norman,L0,short,27,19,8,10,0.7874,127,"[4, 10, 11, 19, 21, 22, 31, 32, 39, 41, 43, 52, 60, 62, 64, 65, 67, 75, 80, 88, 97, 104, 107, 116, 117, 118, 125]"

Norman,L0,short,29,16,13,11,0.7752,129,"[9, 14, 16, 17, 18, 21, 33, 44, 53, 61, 62, 69, 70, 71, 72, 82, 83, 84, 91, 92, 96, 104, 111, 112, 113, 115, 122, 123, 124]"

Norman,L0,short,30,17,13,7,0.7692,130,"[4, 9, 18, 22, 30, 38, 39, 41, 50, 51, 59, 60, 62, 63, 72, 75, 83, 84, 91, 92, 93, 96, 103, 104, 106, 113, 116, 124, 125, 126]"

Norman,L0,short,32,7,25,7,0.7576,132,"[9, 10, 11, 18, 19, 20, 21, 29, 30, 31, 33, 43, 51, 52, 53, 54, 55, 56, 65, 66, 67, 68, 77, 80, 90, 100, 109, 110, 112, 120, 122, 130]"

Norman,L0,short,32,16,16,10,0.7576,132,"[9, 14, 15, 16, 20, 28, 30, 38, 39, 40, 48, 50, 52, 60, 62, 70, 73, 81, 82, 90, 91, 92, 93, 94, 95, 96, 107, 115, 116, 118, 126, 130]"

Norman,L0,short,27,9,18,9,0.7874,127,"[4, 12, 21, 29, 31, 39, 40, 41, 49, 50, 51, 59, 60, 64, 72, 73, 74, 75, 83, 86, 95, 102, 104, 105, 116, 123, 125]"

Norman,L0,short,28,17,11,11,0.7812,128,"[9, 15, 16, 20, 29, 37, 38, 39, 47, 48, 51, 59, 60, 69, 71, 72, 80, 81, 82, 85, 87, 95, 96, 105, 106, 113, 115, 122]"

Norman,L0,short,31,15,16,6,0.7634,131,"[6, 9, 11, 19, 21, 31, 34, 41, 42, 43, 45, 54, 55, 63, 64, 65, 73, 74, 75, 83, 84, 85, 93, 94, 95, 105, 108, 118, 125, 126, 127]"

Norman,L0,short,28,10,18,9,0.7812,128,"[10, 15, 17, 18, 19, 20, 21, 29, 30, 31, 32, 41, 42, 43, 52, 55, 64, 73, 82, 83, 84, 92, 95, 103, 106, 113, 116, 124]"

Norman,L0,short,30,17,13,10,0.7692,130,"[9, 12, 13, 20, 21, 22, 23, 24, 33, 37, 45, 46, 54, 56, 57, 65, 66, 68, 78, 82, 91, 98, 99, 100, 101, 102, 110, 111, 116, 124]"

Norman,L0,short,28,16,12,6,0.7812,128,"[5, 9, 20, 28, 32, 39, 46, 49, 51, 58, 59, 60, 68, 70, 71, 81, 88, 92, 98, 100, 101, 104, 111, 114, 115, 123, 124, 125]"

Norman,L0,short,28,16,12,8,0.7812,128,"[9, 17, 18, 19, 21, 29, 30, 31, 32, 41, 43, 54, 57, 67, 68, 69, 71, 79, 80, 81, 89, 91, 94, 103, 112, 119, 121, 122]"

Norman,L0,short,32,19,13,2,0.7576,132,"[9, 15, 16, 20, 28, 29, 37, 39, 48, 49, 58, 59, 66, 70, 78, 79, 88, 89, 90, 91, 100, 101, 108, 109, 110, 112, 113, 114, 115, 122, 124, 125]"

Norman,L0,short,31,22,9,3,0.7634,131,"[4, 9, 18, 19, 29, 30, 38, 43, 51, 53, 60, 61, 62, 64, 75, 77, 84, 85, 86, 87, 96, 98, 106, 108, 116, 117, 118, 119, 127, 128, 129]"

Norman,L0,short,31,17,14,7,0.7634,131,"[4, 9, 20, 28, 29, 31, 40, 48, 49, 53, 60, 61, 62, 71, 73, 80, 81, 83, 84, 91, 92, 93, 94, 96, 106, 108, 115, 116, 118, 126, 129]"

Norman,L0,short,30,13,17,10,0.7692,130,"[10, 15, 17, 20, 29, 31, 41, 48, 49, 50, 59, 60, 67, 68, 72, 79, 80, 81, 82, 83, 87, 95, 104, 105, 115, 117, 125, 126, 127, 128]"

Norman,L0,short,28,17,11,5,0.7812,128,"[9, 10, 13, 21, 30, 34, 44, 51, 54, 55, 56, 64, 65, 69, 79, 87, 88, 89, 90, 91, 100, 101, 109, 112, 119, 120, 121, 123]"

Norman,L0,short,28,10,18,7,0.7812,128,"[4, 11, 20, 21, 29, 30, 34, 42, 53, 61, 62, 70, 71, 73, 80, 81, 82, 85, 94, 101, 102, 103, 112, 113, 114, 116, 117, 125]"

Norman,L0,short,32,12,20,2,0.7576,132,"[5, 10, 11, 13, 22, 23, 24, 35, 36, 37, 38, 46, 47, 48, 49, 59, 60, 68, 70, 71, 73, 83, 92, 94, 102, 104, 105, 113, 115, 123, 124, 125]"

Norman,L0,short,28,5,23,6,0.7812,128,"[10, 15, 17, 18, 19, 27, 30, 38, 39, 47, 48, 49, 50, 52, 62, 63, 71, 72, 73, 82, 83, 92, 93, 101, 103, 105, 117, 124]"

Norman,L0,short,28,14,14,12,0.7812,128,"[4, 9, 18, 20, 28, 29, 36, 37, 38, 42, 50, 51, 54, 55, 63, 65, 73, 74, 76, 78, 92, 102, 109, 117, 118, 119, 120, 121]"

Norman,L0,short,33,21,12,1,0.7519,133,"[5, 9, 18, 19, 27, 28, 29, 30, 31, 39, 40, 42, 51, 52, 61, 63, 64, 74, 82, 83, 84, 85, 86, 96, 104, 105, 106, 107, 115, 117, 126, 127, 128]"

Norman,L0,short,35,16,19,1,0.7407,135,"[6, 9, 19, 21, 22, 23, 33, 42, 43, 44, 47, 55, 57, 64, 66, 67, 75, 76, 78, 87, 95, 96, 97, 98, 106, 107, 108, 109, 116, 117, 118, 120, 128, 129, 130]"

Norman,L0,short,29,20,9,7,0.7752,129,"[12, 21, 28, 30, 38, 40, 47, 48, 49, 50, 58, 59, 62, 69, 71, 73, 81, 83, 91, 92, 93, 102, 103, 110, 112, 113, 121, 123, 124]"

Norman,L0,short,28,10,18,5,0.7812,128,"[4, 9, 18, 19, 27, 28, 29, 37, 38, 39, 48, 49, 60, 68, 69, 77, 78, 80, 87, 88, 90, 97, 101, 104, 112, 120, 121, 122]"

Norman,L0,short,26,15,11,5,0.7937,126,"[10, 15, 16, 20, 29, 30, 38, 41, 49, 50, 58, 60, 67, 71, 80, 81, 88, 92, 99, 100, 102, 109, 110, 111, 113, 123]"

Norman,L0,short,29,17,12,4,0.7752,129,"[9, 14, 16, 17, 18, 21, 29, 30, 31, 40, 42, 51, 52, 53, 55, 64, 66, 74, 75, 83, 85, 87, 88, 89, 90, 98, 102, 111, 121]"

Norman,L0,short,27,13,14,9,0.7874,127,"[4, 10, 19, 20, 28, 29, 30, 37, 38, 39, 40, 41, 50, 51, 52, 61, 62, 65, 73, 81, 82, 84, 86, 96, 105, 113, 118]"

Norman,L0,short,29,14,15,4,0.7752,129,"[4, 9, 18, 20, 28, 29, 37, 38, 39, 48, 49, 51, 60, 68, 69, 70, 78, 79, 82, 90, 91, 93, 102, 103, 111, 112, 113, 120, 124]"

Norman,L0,short,30,19,11,8,0.7692,130,"[10, 15, 16, 17, 18, 20, 22, 30, 32, 41, 42, 44, 53, 55, 63, 64, 72, 73, 74, 83, 85, 93, 94, 102, 103, 106, 114, 117, 124, 126]"

Norman,L0,short,34,18,16,6,0.7463,134,"[9, 10, 16, 18, 19, 21, 22, 30, 32, 43, 51, 53, 61, 62, 69, 70, 73, 81, 83, 84, 85, 93, 94, 95, 103, 104, 105, 106, 107, 108, 117, 121, 128, 130]"

Norman,L0,short,32,14,18,3,0.7576,132,"[9, 14, 15, 16, 17, 19, 28, 29, 30, 39, 40, 48, 49, 51, 52, 53, 62, 64, 75, 83, 85, 93, 94, 102, 103, 105, 113, 114, 121, 123, 124, 125]"

Norman,L0,short,29,24,5,1,0.7752,129,"[10, 18, 19, 20, 29, 30, 38, 39, 40, 41, 43, 51, 52, 53, 55, 64, 65, 66, 68, 77, 78, 79, 90, 100, 108, 109, 110, 111, 121]"

Norman,L0,short,29,15,14,14,0.7752,129,"[5, 15, 24, 31, 32, 33, 40, 42, 43, 51, 52, 55, 62, 63, 74, 84, 92, 93, 99, 101, 102, 103, 110, 112, 113, 114, 121, 122, 124]"

Norman,L0,short,32,8,24,3,0.7576,132,"[10, 15, 16, 17, 21, 29, 30, 38, 39, 40, 48, 50, 51, 59, 60, 62, 70, 72, 81, 89, 91, 92, 102, 109, 110, 111, 112, 113, 120, 121, 122, 123]"

Norman,L0,short,32,10,22,2,0.7576,132,"[9, 15, 16, 17, 19, 20, 31, 39, 40, 48, 49, 50, 58, 60, 61, 69, 70, 71, 79, 81, 82, 91, 92, 93, 101, 102, 103, 113, 114, 121, 123, 125]"

Norman,L0,short,27,14,13,6,0.7874,127,"[9, 10, 11, 12, 18, 19, 21, 22, 32, 33, 44, 46, 47, 56, 58, 67, 75, 78, 89, 96, 97, 106, 107, 114, 115, 116, 119]"

Norman,L0,short,29,16,13,3,0.7752,129,"[9, 14, 16, 18, 20, 28, 29, 30, 33, 42, 50, 51, 52, 60, 62, 70, 71, 72, 73, 82, 83, 92, 94, 104, 113, 114, 122, 123, 124]"

Norman,L0,short,26,16,10,8,0.7937,126,"[6, 10, 18, 19, 27, 29, 32, 41, 52, 61, 69, 72, 79, 81, 89, 90, 92, 98, 99, 100, 101, 109, 111, 113, 121, 123]"

Norman,L0,short,32,19,13,7,0.7576,132,"[11, 16, 17, 18, 20, 21, 29, 31, 33, 42, 50, 51, 53, 54, 55, 56, 65, 68, 76, 79, 80, 81, 84, 93, 102, 103, 113, 120, 121, 122, 123, 125]"

Norman,L0,short,29,17,12,5,0.7752,129,"[10, 15, 17, 19, 20, 28, 29, 30, 38, 39, 40, 50, 53, 61, 63, 71, 72, 73, 74, 83, 88, 96, 103, 104, 105, 115, 122, 124, 125]"

Norman,L0,short,30,7,23,4,0.7692,130,"[4, 12, 20, 21, 22, 23, 24, 25, 34, 35, 36, 37, 46, 47, 56, 58, 67, 75, 76, 77, 87, 88, 89, 91, 93, 105, 113, 115, 116, 126]"

Norman,L0,short,25,14,11,7,0.8,125,"[9, 15, 16, 17, 18, 19, 21, 29, 32, 41, 50, 51, 53, 54, 55, 64, 65, 73, 77, 85, 95, 102, 106, 114, 117]"

Norman,L0,short,31,20,11,1,0.7634,131,"[5, 9, 19, 20, 28, 29, 30, 31, 32, 33, 41, 42, 43, 51, 53, 61, 62, 63, 73, 84, 94, 95, 102, 103, 105, 113, 114, 115, 116, 126, 127]"

Norman,L0,short,31,18,13,8,0.7634,131,"[9, 10, 12, 18, 19, 20, 23, 35, 44, 51, 52, 62, 63, 71, 72, 73, 81, 82, 83, 84, 92, 93, 94, 95, 103, 104, 107, 115, 116, 125, 127]"

Norman,L0,short,32,20,12,6,0.7576,132,"[9, 10, 15, 16, 19, 20, 29, 30, 31, 40, 42, 50, 51, 61, 69, 71, 76, 84, 91, 92, 93, 94, 95, 96, 105, 106, 114, 115, 116, 124, 125, 127]"

Norman,L0,short,28,16,12,11,0.7812,128,"[12, 13, 14, 22, 23, 29, 36, 45, 52, 55, 62, 66, 68, 75, 76, 78, 85, 86, 87, 95, 96, 97, 98, 106, 109, 116, 118, 121]"

Norman,L0,short,28,14,14,4,0.7812,128,"[9, 14, 15, 16, 17, 18, 19, 20, 31, 40, 50, 58, 59, 61, 69, 70, 79, 82, 90, 99, 100, 108, 109, 110, 118, 119, 120, 121]"

Norman,L0,short,34,7,27,8,0.7463,134,"[10, 15, 16, 17, 19, 28, 29, 30, 31, 40, 41, 42, 50, 51, 53, 64, 72, 75, 84, 85, 94, 96, 98, 106, 107, 108, 115, 117, 118, 119, 126, 128, 129, 131]"

Norman,L0,short,28,15,13,6,0.7812,128,"[4, 9, 18, 21, 22, 30, 31, 32, 40, 41, 42, 50, 52, 54, 55, 58, 66, 75, 76, 84, 86, 87, 96, 100, 111, 118, 120, 121]"

Norman,L0,short,26,9,17,5,0.7937,126,"[5, 9, 20, 29, 37, 39, 40, 49, 50, 58, 59, 60, 70, 78, 83, 91, 98, 100, 108, 109, 110, 116, 117, 118, 119, 120]"

Norman,L0,short,26,15,11,10,0.7937,126,"[4, 9, 18, 19, 27, 28, 31, 38, 39, 41, 49, 50, 59, 63, 71, 80, 89, 90, 98, 99, 102, 109, 110, 117, 118, 121]"

Norman,L0,short,25,15,10,4,0.8,125,"[10, 13, 20, 22, 23, 31, 32, 34, 43, 46, 54, 55, 56, 65, 67, 75, 76, 78, 87, 97, 104, 105, 109, 116, 117]"

Norman,L0,short,31,15,16,6,0.7634,131,"[4, 9, 19, 20, 23, 31, 32, 41, 42, 43, 44, 46, 56, 57, 65, 67, 68, 79, 87, 89, 98, 100, 107, 108, 109, 117, 118, 119, 127, 128, 129]"

Norman,L0,short,30,10,20,5,0.7692,130,"[5, 9, 18, 20, 28, 29, 36, 37, 38, 39, 49, 50, 58, 59, 60, 70, 71, 72, 75, 83, 84, 96, 103, 106, 114, 115, 124, 125, 126, 128]"

Norman,L0,short,29,21,8,2,0.7752,129,"[4, 9, 18, 20, 29, 30, 31, 33, 42, 50, 51, 52, 53, 54, 63, 64, 72, 73, 74, 83, 85, 95, 102, 105, 106, 113, 116, 125, 126]"

Norman,L0,short,33,14,19,4,0.7519,133,"[6, 10, 20, 21, 22, 23, 24, 33, 34, 42, 44, 47, 55, 56, 66, 74, 75, 76, 84, 85, 86, 94, 95, 96, 105, 106, 108, 116, 117, 118, 127, 128, 131]"

Norman,L0,short,30,16,14,4,0.7692,130,"[11, 17, 22, 29, 30, 32, 33, 34, 35, 36, 44, 45, 46, 55, 58, 67, 77, 78, 79, 88, 89, 98, 100, 107, 108, 109, 110, 118, 120, 121]"

Norman,L0,short,36,20,16,3,0.7353,136,"[9, 11, 17, 18, 20, 21, 22, 23, 32, 33, 43, 51, 52, 53, 62, 63, 71, 72, 73, 83, 85, 94, 95, 96, 97, 107, 108, 109, 117, 119, 120, 121, 122, 131, 132, 134]"

Norman,L0,short,28,15,13,12,0.7812,128,"[7, 11, 20, 28, 29, 30, 31, 41, 43, 48, 57, 65, 73, 74, 76, 83, 86, 87, 95, 96, 99, 106, 107, 108, 109, 110, 119, 121]"

Norman,L0,short,29,11,18,9,0.7752,129,"[9, 14, 15, 16, 17, 18, 19, 20, 22, 31, 41, 42, 50, 51, 52, 54, 55, 64, 65, 74, 75, 80, 89, 98, 99, 110, 118, 119, 127]"

Norman,L0,short,27,20,7,9,0.7874,127,"[5, 9, 10, 19, 20, 23, 32, 33, 41, 42, 43, 53, 61, 62, 64, 72, 77, 85, 96, 104, 112, 113, 114, 120, 121, 122, 124]"

Norman,L0,short,27,15,12,8,0.7874,127,"[9, 14, 19, 27, 31, 39, 40, 41, 42, 50, 52, 62, 63, 70, 71, 73, 81, 82, 84, 92, 94, 101, 102, 103, 112, 113, 117]"

Norman,L0,short,32,17,15,5,0.7576,132,"[4, 9, 18, 20, 28, 29, 36, 37, 38, 40, 48, 50, 58, 59, 61, 69, 70, 78, 79, 80, 88, 89, 92, 101, 102, 103, 111, 112, 113, 121, 122, 124]"

Norman,L0,short,29,9,20,2,0.7752,129,"[4, 9, 18, 19, 29, 36, 37, 38, 39, 40, 48, 51, 59, 60, 68, 69, 70, 80, 87, 88, 90, 91, 100, 102, 110, 111, 118, 121, 122]"

Norman,L0,short,29,12,17,8,0.7752,129,"[9, 15, 16, 17, 18, 19, 21, 29, 30, 31, 40, 41, 50, 53, 62, 70, 71, 72, 75, 85, 93, 94, 102, 106, 113, 114, 122, 123, 124]"

Norman,L0,short,23,14,9,9,0.813,123,"[6, 10, 18, 19, 28, 31, 40, 48, 49, 50, 51, 58, 60, 61, 69, 70, 71, 79, 82, 90, 93, 105, 115]"

Norman,L0,short,27,18,9,17,0.7874,127,"[9, 17, 18, 21, 33, 41, 49, 50, 51, 58, 59, 60, 61, 68, 74, 86, 93, 101, 103, 109, 110, 111, 114, 120, 121, 122, 123]"

Norman,L0,short,32,9,23,4,0.7576,132,"[10, 15, 17, 18, 20, 22, 31, 40, 42, 50, 52, 61, 63, 71, 72, 74, 81, 84, 92, 93, 101, 102, 103, 110, 111, 112, 113, 114, 122, 123, 125, 126]"

Norman,L0,short,35,23,12,3,0.7407,135,"[4, 10, 18, 19, 20, 28, 29, 31, 38, 42, 50, 51, 52, 53, 61, 62, 63, 71, 72, 74, 85, 93, 94, 97, 98, 99, 107, 108, 109, 118, 119, 127, 128, 129, 130]"

Norman,L0,short,30,20,10,5,0.7692,130,"[10, 11, 13, 14, 21, 22, 23, 24, 33, 36, 45, 53, 54, 55, 63, 64, 65, 73, 75, 84, 85, 94, 95, 103, 104, 105, 113, 116, 124, 126]"

Norman,L0,short,30,19,11,4,0.7692,130,"[4, 9, 18, 20, 30, 31, 32, 41, 42, 44, 52, 53, 61, 62, 63, 71, 73, 82, 83, 92, 93, 102, 103, 106, 114, 116, 123, 124, 125, 126]"

Norman,L0,short,29,13,16,4,0.7752,129,"[9, 10, 12, 18, 20, 21, 29, 30, 31, 40, 42, 51, 52, 53, 65, 74, 75, 83, 84, 86, 95, 103, 104, 105, 113, 114, 115, 123, 125]"

Norman,L0,short,30,21,9,5,0.7692,130,"[5, 9, 18, 20, 28, 30, 38, 39, 40, 41, 43, 44, 53, 56, 66, 74, 75, 83, 84, 85, 93, 94, 95, 103, 105, 113, 115, 117, 126, 128]"

Norman,L0,short,33,20,13,2,0.7519,133,"[5, 9, 19, 20, 21, 31, 39, 40, 41, 49, 50, 51, 60, 62, 72, 79, 80, 81, 82, 90, 91, 92, 99, 102, 104, 112, 113, 114, 115, 116, 124, 125, 128]"

Norman,L0,short,35,14,21,3,0.7407,135,"[5, 10, 18, 19, 20, 28, 29, 30, 31, 39, 40, 42, 43, 51, 52, 53, 62, 63, 72, 75, 84, 92, 95, 104, 105, 106, 108, 109, 116, 118, 119, 121, 130, 131, 132]"

Norman,L0,short,28,17,11,8,0.7812,128,"[5, 9, 10, 13, 22, 23, 24, 33, 34, 35, 39, 47, 55, 57, 65, 66, 68, 69, 79, 87, 88, 89, 97, 100, 109, 117, 119, 120]"

Norman,L0,short,27,15,12,12,0.7874,127,"[9, 11, 17, 18, 19, 20, 28, 30, 38, 39, 40, 48, 49, 50, 59, 60, 61, 62, 63, 72, 74, 83, 87, 95, 105, 114, 118]"

Norman,L0,short,26,16,10,5,0.7937,126,"[5, 9, 19, 28, 29, 36, 37, 39, 47, 48, 51, 62, 70, 71, 79, 80, 82, 91, 99, 100, 101, 110, 112, 119, 120, 121]"

Norman,L0,short,31,22,9,4,0.7634,131,"[4, 9, 11, 20, 21, 30, 31, 38, 41, 49, 50, 51, 59, 61, 62, 63, 71, 72, 74, 83, 91, 94, 102, 103, 111, 112, 113, 120, 121, 122, 124]"

Norman,L0,short,29,13,16,5,0.7752,129,"[6, 9, 18, 19, 20, 21, 30, 32, 39, 40, 41, 49, 50, 53, 62, 70, 71, 73, 75, 86, 96, 105, 113, 114, 115, 124, 125, 126, 127]"

Norman,L0,short,26,8,18,6,0.7937,126,"[5, 11, 19, 26, 27, 29, 36, 37, 38, 39, 49, 57, 58, 60, 69, 70, 79, 80, 89, 90, 94, 102, 111, 119, 120, 121]"

Norman,L0,short,33,15,18,4,0.7519,133,"[11, 16, 17, 18, 19, 20, 23, 32, 33, 34, 36, 46, 56, 66, 73, 74, 75, 77, 85, 86, 87, 95, 96, 97, 98, 106, 107, 108, 116, 117, 119, 127, 129]"

Norman,L0,short,30,16,14,10,0.7692,130,"[9, 15, 17, 22, 34, 43, 50, 54, 61, 64, 70, 71, 72, 73, 75, 83, 85, 92, 94, 102, 104, 111, 112, 113, 114, 115, 122, 124, 125, 126]"

Norman,L0,short,35,25,10,7,0.7407,135,"[4, 9, 10, 13, 22, 31, 32, 33, 36, 44, 46, 48, 49, 50, 51, 60, 61, 69, 70, 71, 72, 73, 74, 83, 84, 93, 96, 106, 114, 118, 127, 128, 129, 130, 132]"

Norman,L0,short,29,17,12,6,0.7752,129,"[5, 9, 10, 21, 29, 33, 40, 49, 50, 52, 53, 60, 61, 62, 64, 73, 80, 81, 83, 91, 93, 102, 104, 111, 112, 113, 121, 122, 123]"

Norman,L0,short,30,9,21,5,0.7692,130,"[4, 9, 10, 14, 22, 23, 24, 33, 34, 35, 37, 45, 47, 57, 65, 66, 74, 76, 86, 94, 95, 96, 104, 105, 106, 113, 115, 116, 124, 127]"

Norman,L0,short,33,20,13,5,0.7519,133,"[4, 13, 21, 29, 30, 31, 32, 40, 42, 50, 52, 60, 61, 62, 63, 71, 73, 75, 84, 85, 93, 94, 95, 96, 98, 106, 107, 115, 118, 119, 126, 128, 129]"

Norman,L0,short,28,13,15,13,0.7812,128,"[9, 10, 11, 17, 19, 22, 31, 37, 47, 55, 63, 71, 72, 73, 84, 91, 92, 93, 103, 109, 110, 111, 113, 114, 115, 116, 124, 126]"

Norman,L0,short,27,14,13,7,0.7874,127,"[10, 17, 21, 29, 30, 31, 42, 49, 51, 58, 60, 61, 68, 69, 70, 73, 81, 82, 90, 91, 92, 100, 102, 110, 111, 113, 122]"

Norman,L0,short,35,9,26,5,0.7407,135,"[11, 16, 18, 19, 20, 28, 29, 33, 42, 43, 51, 54, 62, 63, 70, 71, 72, 73, 81, 82, 83, 84, 93, 94, 102, 103, 104, 113, 114, 122, 124, 125, 126, 127, 128]"

Norman,L0,short,28,20,8,4,0.7812,128,"[4, 9, 10, 19, 20, 28, 29, 30, 39, 40, 42, 50, 51, 54, 62, 63, 73, 81, 82, 83, 93, 102, 103, 111, 112, 114, 122, 125]"

Norman,L0,short,31,16,15,4,0.7634,131,"[9, 17, 18, 19, 20, 28, 30, 38, 39, 41, 50, 58, 59, 60, 67, 68, 69, 72, 81, 82, 90, 92, 93, 101, 102, 107, 114, 116, 124, 125, 127]"

Norman,L0,short,30,9,21,2,0.7692,130,"[9, 14, 16, 17, 18, 19, 29, 38, 39, 48, 49, 50, 58, 60, 68, 69, 70, 80, 87, 88, 89, 92, 101, 103, 104, 112, 113, 115, 123, 125]"

Norman,L0,short,29,11,18,6,0.7752,129,"[9, 14, 15, 17, 20, 28, 29, 30, 31, 41, 49, 50, 51, 60, 61, 62, 70, 71, 73, 82, 86, 94, 102, 103, 104, 112, 113, 115, 125]"

Norman,L0,short,25,18,7,10,0.8,125,"[9, 15, 16, 19, 21, 30, 31, 40, 41, 43, 51, 52, 54, 66, 75, 84, 89, 97, 105, 106, 107, 113, 115, 116, 117]"

Norman,L0,short,27,15,12,11,0.7874,127,"[9, 16, 17, 18, 19, 20, 29, 31, 39, 40, 44, 52, 61, 63, 71, 74, 81, 82, 83, 91, 92, 94, 104, 111, 112, 114, 115]"

Norman,L0,short,26,14,12,8,0.7937,126,"[9, 15, 17, 18, 20, 28, 29, 42, 49, 58, 61, 69, 72, 80, 81, 82, 89, 90, 91, 92, 102, 110, 111, 112, 120, 122]"

Norman,L0,short,30,21,9,5,0.7692,130,"[9, 10, 11, 12, 19, 20, 22, 25, 34, 45, 53, 54, 55, 64, 65, 72, 73, 74, 75, 83, 85, 86, 94, 95, 97, 105, 106, 116, 124, 126]"

Norman,L0,short,26,13,13,12,0.7937,126,"[6, 10, 18, 19, 27, 28, 33, 41, 49, 57, 58, 59, 67, 68, 71, 79, 87, 88, 89, 96, 97, 99, 102, 110, 120, 123]"

Norman,L0,short,34,18,16,3,0.7463,134,"[4, 9, 19, 26, 28, 29, 30, 32, 39, 40, 41, 42, 50, 52, 60, 61, 62, 63, 65, 74, 75, 77, 86, 87, 90, 99, 107, 108, 109, 118, 119, 127, 128, 129]"

Norman,L0,short,32,16,16,7,0.7576,132,"[9, 14, 16, 17, 21, 29, 37, 38, 39, 41, 49, 50, 51, 59, 60, 62, 72, 80, 83, 91, 99, 100, 101, 108, 109, 110, 111, 119, 120, 121, 123, 125]"

Norman,L0,short,28,11,17,3,0.7812,128,"[4, 9, 18, 20, 28, 29, 36, 38, 40, 48, 49, 50, 59, 60, 69, 70, 71, 79, 80, 82, 90, 92, 93, 104, 113, 120, 123, 124]"

Norman,L0,short,31,14,17,3,0.7634,131,"[4, 9, 13, 21, 29, 30, 31, 32, 39, 40, 41, 42, 53, 61, 62, 70, 71, 72, 80, 81, 83, 92, 94, 102, 103, 104, 111, 112, 113, 114, 124]"

Norman,L0,short,29,15,14,4,0.7752,129,"[4, 9, 18, 19, 21, 22, 31, 33, 41, 42, 46, 54, 55, 56, 58, 66, 67, 76, 77, 85, 86, 87, 95, 96, 98, 108, 111, 119, 127]"

Norman,L0,short,32,15,17,5,0.7576,132,"[5, 10, 18, 21, 29, 30, 31, 38, 39, 40, 44, 53, 55, 56, 65, 66, 67, 75, 78, 86, 87, 88, 91, 99, 101, 110, 113, 114, 117, 126, 127, 128]"

Norman,L0,short,30,17,13,4,0.7692,130,"[9, 14, 15, 16, 20, 28, 30, 38, 39, 48, 49, 50, 51, 59, 60, 61, 69, 70, 72, 80, 81, 89, 90, 91, 100, 101, 109, 110, 112, 121]"

Norman,L0,short,33,22,11,6,0.7519,133,"[9, 14, 15, 16, 17, 18, 19, 28, 29, 40, 48, 50, 58, 60, 67, 68, 70, 78, 79, 80, 90, 91, 92, 100, 101, 102, 103, 114, 121, 122, 123, 124, 126]"

Norman,L0,short,34,11,23,5,0.7463,134,"[9, 10, 11, 12, 18, 19, 20, 21, 22, 31, 32, 34, 44, 55, 63, 64, 75, 83, 84, 86, 94, 95, 97, 107, 108, 115, 116, 117, 118, 119, 120, 128, 129, 131]"

Norman,L0,short,32,17,15,7,0.7576,132,"[9, 13, 23, 32, 40, 41, 42, 50, 52, 66, 73, 76, 85, 91, 92, 93, 94, 95, 102, 103, 105, 106, 107, 114, 115, 116, 117, 118, 120, 128, 129, 130]"

Norman,L0,short,34,17,17,3,0.7463,134,"[4, 9, 18, 19, 27, 28, 31, 39, 40, 48, 49, 50, 59, 60, 68, 69, 70, 80, 87, 88, 89, 90, 93, 101, 108, 110, 111, 119, 120, 121, 129, 130, 131, 132]"

Norman,L0,short,30,11,19,10,0.7692,130,"[5, 9, 18, 20, 28, 29, 30, 37, 38, 39, 41, 49, 51, 60, 69, 70, 78, 79, 80, 90, 91, 93, 101, 102, 107, 115, 122, 123, 125, 127]"

Norman,L0,short,30,9,21,6,0.7692,130,"[9, 14, 15, 16, 17, 19, 28, 31, 39, 41, 49, 50, 58, 59, 60, 70, 78, 79, 80, 81, 89, 91, 93, 102, 106, 113, 121, 122, 123, 124]"

Norman,L0,short,37,22,15,3,0.7299,137,"[9, 15, 16, 17, 19, 27, 28, 29, 30, 41, 49, 51, 59, 60, 62, 63, 65, 67, 75, 76, 84, 85, 86, 87, 88, 97, 99, 108, 109, 117, 118, 120, 128, 129, 133, 134, 135]"

Norman,L0,short,27,16,11,9,0.7874,127,"[5, 9, 18, 21, 30, 37, 38, 39, 50, 59, 68, 69, 76, 77, 78, 79, 87, 89, 92, 99, 100, 103, 104, 111, 113, 117, 124]"

Norman,L0,short,28,13,15,3,0.7812,128,"[9, 14, 15, 17, 18, 19, 29, 37, 38, 39, 47, 48, 50, 58, 61, 69, 71, 80, 82, 91, 102, 103, 110, 112, 114, 122, 123, 124]"

Norman,L0,short,32,11,21,2,0.7576,132,"[4, 9, 19, 27, 29, 37, 38, 39, 40, 48, 49, 50, 51, 60, 61, 62, 63, 72, 73, 74, 83, 84, 92, 93, 94, 95, 103, 105, 114, 115, 124, 127]"

Norman,L0,short,31,12,19,1,0.7634,131,"[4, 10, 19, 26, 28, 29, 36, 39, 47, 48, 49, 50, 51, 61, 69, 71, 79, 80, 81, 82, 90, 92, 94, 103, 104, 112, 113, 114, 121, 123, 125]"

Norman,L0,short,32,13,19,2,0.7576,132,"[9, 14, 15, 16, 18, 19, 30, 31, 39, 40, 41, 49, 51, 52, 62, 63, 71, 72, 73, 74, 85, 93, 94, 102, 103, 104, 112, 113, 114, 121, 122, 125]"

Norman,L0,short,27,12,15,5,0.7874,127,"[9, 18, 19, 26, 28, 29, 37, 38, 40, 48, 49, 57, 58, 60, 68, 72, 80, 88, 89, 90, 97, 99, 100, 108, 109, 110, 120]"

Norman,L0,short,35,16,19,8,0.7407,135,"[4, 9, 10, 13, 22, 31, 32, 33, 34, 35, 45, 53, 54, 55, 56, 60, 69, 77, 79, 87, 88, 90, 91, 92, 103, 110, 112, 113, 114, 115, 116, 117, 125, 126, 127]"

Norman,L0,short,29,16,13,9,0.7752,129,"[4, 9, 18, 22, 24, 32, 33, 42, 45, 53, 54, 58, 65, 74, 76, 84, 85, 93, 94, 95, 102, 103, 104, 108, 116, 123, 124, 125, 126]"

Norman,L0,short,32,8,24,3,0.7576,132,"[9, 15, 16, 18, 19, 27, 28, 30, 31, 32, 33, 42, 43, 52, 53, 54, 63, 65, 73, 74, 76, 86, 87, 88, 96, 100, 109, 118, 125, 127, 128, 129]"

Norman,L0,short,33,16,17,3,0.7519,133,"[4, 9, 18, 19, 27, 28, 30, 31, 32, 40, 41, 43, 51, 52, 53, 62, 63, 71, 75, 83, 91, 92, 94, 95, 103, 104, 106, 107, 116, 117, 125, 126, 127]"

Norman,L0,short,30,13,17,6,0.7692,130,"[4, 9, 18, 19, 27, 28, 31, 38, 41, 49, 56, 57, 58, 59, 61, 70, 72, 80, 81, 82, 83, 92, 93, 94, 96, 106, 114, 115, 123, 125]"

Norman,L0,short,32,10,22,8,0.7576,132,"[4, 11, 19, 20, 29, 30, 31, 38, 39, 40, 41, 49, 50, 51, 52, 54, 64, 67, 76, 78, 87, 95, 96, 97, 98, 99, 103, 111, 119, 121, 129, 130]"

Norman,L0,short,31,10,21,10,0.7634,131,"[10, 15, 17, 18, 19, 20, 28, 30, 38, 39, 41, 43, 44, 45, 46, 50, 62, 71, 79, 87, 88, 89, 97, 99, 107, 108, 109, 118, 119, 121, 129]"

Norman,L0,short,32,11,21,3,0.7576,132,"[7, 11, 12, 22, 30, 31, 32, 33, 41, 42, 44, 53, 54, 62, 63, 64, 74, 82, 83, 86, 94, 95, 102, 103, 104, 105, 113, 114, 115, 116, 124, 126]"

Norman,L0,short,29,14,15,7,0.7752,129,"[9, 14, 17, 18, 19, 20, 28, 29, 32, 41, 49, 50, 59, 60, 61, 70, 72, 82, 83, 84, 92, 94, 102, 105, 112, 114, 116, 123, 127]"

Norman,L0,short,34,26,8,0,0.7463,134,"[6, 9, 10, 19, 20, 21, 22, 31, 32, 33, 43, 52, 53, 55, 64, 65, 73, 74, 75, 76, 77, 87, 95, 96, 97, 105, 106, 107, 108, 109, 117, 118, 119, 129]"

Norman,L0,short,33,11,22,8,0.7519,133,"[9, 11, 16, 17, 18, 20, 21, 22, 24, 33, 35, 44, 53, 55, 56, 65, 66, 74, 76, 77, 78, 79, 87, 89, 90, 91, 100, 101, 109, 110, 112, 120, 123]"

Norman,L0,short,28,20,8,12,0.7812,128,"[5, 9, 13, 22, 30, 31, 39, 40, 41, 49, 50, 51, 55, 63, 71, 72, 74, 82, 83, 92, 93, 102, 104, 111, 112, 113, 122, 124]"

Norman,L0,short,30,21,9,6,0.7692,130,"[11, 16, 17, 19, 27, 29, 31, 40, 49, 50, 58, 60, 63, 70, 73, 80, 81, 83, 90, 91, 94, 102, 104, 111, 112, 113, 115, 123, 125, 126]"

Norman,L0,short,26,15,11,7,0.7937,126,"[4, 9, 10, 20, 21, 30, 31, 32, 33, 35, 44, 53, 54, 64, 72, 73, 74, 87, 97, 103, 104, 106, 114, 115, 116, 124]"

Norman,L0,short,29,12,17,7,0.7752,129,"[9, 16, 17, 18, 19, 29, 37, 38, 39, 41, 42, 43, 51, 52, 54, 64, 66, 75, 77, 86, 87, 95, 96, 97, 105, 106, 107, 116, 121]"

Norman,L0,short,29,25,4,4,0.7752,129,"[5, 9, 19, 26, 27, 28, 30, 37, 40, 41, 50, 52, 60, 62, 71, 80, 81, 90, 91, 92, 93, 101, 103, 104, 105, 113, 114, 116, 125]"

Norman,L0,short,28,23,5,6,0.7812,128,"[5, 9, 10, 21, 30, 35, 43, 51, 52, 59, 63, 64, 65, 66, 74, 75, 77, 85, 86, 87, 97, 98, 106, 108, 116, 117, 118, 126]"

Norman,L0,short,30,21,9,11,0.7692,130,"[4, 9, 18, 22, 30, 37, 38, 41, 49, 50, 59, 60, 68, 73, 80, 84, 92, 100, 102, 108, 110, 111, 112, 113, 120, 121, 122, 123, 124, 126]"

Norman,L0,short,29,18,11,6,0.7752,129,"[12, 19, 20, 28, 29, 31, 40, 47, 48, 49, 50, 58, 59, 60, 69, 70, 79, 81, 82, 83, 91, 93, 102, 104, 112, 113, 122, 123, 125]"

Norman,L0,short,32,10,22,2,0.7576,132,"[9, 14, 15, 16, 19, 20, 22, 30, 31, 32, 41, 42, 50, 53, 62, 65, 74, 75, 78, 86, 87, 88, 97, 98, 100, 108, 109, 110, 118, 119, 122, 130]"

Norman,L0,short,31,16,15,13,0.7634,131,"[10, 11, 14, 21, 22, 26, 33, 37, 45, 55, 62, 63, 64, 65, 73, 75, 83, 84, 85, 92, 94, 95, 103, 104, 107, 114, 117, 124, 125, 126, 127]"

Norman,L0,short,30,25,5,5,0.7692,130,"[5, 9, 20, 28, 29, 30, 31, 32, 39, 41, 43, 52, 60, 61, 62, 64, 72, 73, 82, 84, 92, 94, 104, 111, 112, 113, 114, 122, 123, 125]"

Norman,L0,short,35,18,17,4,0.7407,135,"[9, 15, 16, 18, 21, 29, 30, 32, 41, 42, 43, 51, 53, 54, 55, 56, 58, 68, 76, 78, 87, 95, 97, 105, 107, 114, 115, 117, 118, 119, 120, 121, 128, 129, 131]"

Norman,L0,short,32,17,15,5,0.7576,132,"[4, 10, 20, 30, 31, 40, 41, 42, 44, 52, 53, 56, 65, 73, 74, 82, 83, 84, 92, 94, 95, 96, 103, 104, 105, 106, 115, 116, 124, 125, 126, 127]"

Norman,L0,short,32,17,15,6,0.7576,132,"[5, 9, 18, 19, 27, 29, 37, 38, 40, 48, 49, 51, 59, 62, 70, 71, 73, 82, 85, 87, 95, 96, 97, 104, 107, 108, 115, 117, 118, 126, 127, 129]"

Norman,L0,short,33,21,12,4,0.7519,133,"[10, 16, 17, 20, 28, 30, 31, 32, 33, 34, 35, 44, 45, 54, 55, 56, 67, 76, 84, 86, 89, 97, 98, 106, 108, 111, 118, 119, 120, 121, 129, 130, 131]"

Norman,L0,short,33,8,25,4,0.7519,133,"[9, 14, 16, 17, 18, 19, 28, 30, 38, 39, 42, 50, 51, 60, 62, 70, 71, 72, 73, 82, 83, 92, 94, 102, 103, 105, 113, 114, 115, 116, 123, 124, 126]"

Norman,L0,short,29,16,13,4,0.7752,129,"[9, 14, 15, 16, 18, 19, 20, 30, 38, 39, 40, 49, 51, 59, 61, 69, 72, 82, 90, 91, 93, 101, 102, 103, 111, 114, 122, 123, 124]"

Norman,L0,short,34,13,21,6,0.7463,134,"[10, 14, 20, 21, 22, 23, 34, 42, 44, 51, 52, 54, 62, 64, 65, 72, 73, 76, 85, 86, 94, 95, 96, 97, 98, 106, 107, 108, 117, 118, 119, 128, 129, 132]"

Norman,L0,short,32,17,15,5,0.7576,132,"[4, 9, 10, 19, 20, 28, 29, 32, 34, 42, 45, 53, 54, 55, 56, 57, 58, 60, 69, 80, 88, 89, 91, 99, 100, 104, 112, 113, 120, 121, 122, 123]"

Norman,L0,short,32,13,19,10,0.7576,132,"[12, 19, 21, 33, 40, 41, 48, 50, 51, 54, 62, 63, 70, 71, 72, 73, 74, 75, 76, 77, 85, 89, 97, 105, 106, 107, 114, 116, 118, 125, 126, 128]"

Norman,L0,short,30,10,20,8,0.7692,130,"[10, 15, 16, 17, 18, 21, 30, 38, 39, 41, 49, 50, 51, 59, 61, 70, 71, 72, 81, 83, 87, 95, 105, 115, 121, 122, 123, 124, 125, 127]"

Norman,L0,short,26,9,17,3,0.7937,126,"[10, 15, 16, 17, 18, 20, 21, 30, 31, 40, 41, 50, 51, 52, 54, 63, 71, 74, 83, 92, 93, 102, 104, 112, 113, 123]"

Norman,L0,short,31,17,14,1,0.7634,131,"[5, 10, 11, 19, 20, 21, 29, 30, 31, 32, 40, 41, 42, 51, 52, 61, 62, 72, 73, 74, 77, 86, 94, 95, 96, 97, 107, 115, 117, 126, 127]"

Norman,L50,short,31,19,12,3,0.7634,131,"[5, 9, 19, 20, 28, 30, 38, 39, 40, 48, 49, 51, 59, 60, 63, 71, 78, 79, 80, 81, 82, 93, 94, 95, 102, 104, 105, 116, 124, 125, 126]"

Norman,L50,short,34,13,21,3,0.7463,134,"[5, 9, 18, 19, 20, 28, 29, 30, 31, 39, 40, 42, 50, 51, 53, 62, 63, 64, 65, 67, 75, 78, 87, 95, 96, 97, 106, 107, 115, 116, 117, 125, 126, 128]"

Norman,L50,short,33,10,23,4,0.7519,133,"[10, 14, 15, 18, 21, 29, 30, 31, 32, 40, 41, 42, 50, 52, 53, 61, 62, 65, 73, 81, 82, 83, 84, 93, 96, 104, 106, 113, 114, 115, 117, 125, 127]"

Norman,L50,short,34,20,14,5,0.7463,134,"[4, 9, 10, 11, 20, 22, 30, 31, 32, 33, 41, 42, 43, 44, 53, 54, 63, 65, 66, 74, 75, 76, 77, 87, 89, 98, 101, 109, 117, 118, 119, 127, 128, 131]"

Norman,L50,short,35,18,17,8,0.7407,135,"[9, 10, 14, 17, 21, 23, 31, 35, 44, 52, 59, 60, 61, 62, 70, 71, 73, 80, 81, 82, 84, 86, 93, 95, 103, 105, 112, 113, 114, 115, 116, 117, 119, 127, 128]"

Norman,L50,short,29,17,12,7,0.7752,129,"[9, 10, 11, 16, 17, 18, 20, 21, 30, 31, 39, 40, 41, 50, 52, 53, 62, 63, 74, 76, 77, 85, 87, 88, 99, 107, 108, 114, 121]"

Norman,L50,short,30,15,15,5,0.7692,130,"[4, 10, 18, 19, 27, 28, 30, 37, 38, 39, 47, 48, 49, 50, 59, 61, 69, 71, 79, 80, 83, 91, 93, 102, 110, 112, 113, 120, 121, 123]"

Norman,L50,short,30,15,15,6,0.7692,130,"[5, 9, 11, 19, 20, 22, 31, 35, 43, 52, 54, 61, 62, 63, 65, 73, 74, 76, 86, 88, 95, 97, 98, 105, 106, 108, 115, 118, 119, 121]"

Norman,L50,short,36,22,14,3,0.7353,136,"[5, 9, 11, 13, 21, 22, 31, 32, 40, 41, 42, 50, 51, 52, 60, 61, 62, 63, 64, 66, 67, 77, 78, 80, 90, 99, 107, 108, 109, 119, 126, 128, 129, 130, 131, 132]"

Norman,L50,short,31,20,11,5,0.7634,131,"[4, 10, 18, 19, 27, 28, 29, 36, 37, 38, 39, 40, 48, 49, 51, 60, 68, 70, 72, 81, 82, 83, 92, 93, 101, 102, 103, 113, 120, 121, 125]"

Norman,L50,short,31,21,10,4,0.7634,131,"[4, 11, 18, 19, 28, 29, 30, 31, 39, 40, 42, 51, 59, 60, 61, 71, 78, 79, 82, 83, 91, 93, 94, 96, 105, 112, 114, 115, 124, 125, 126]"

Norman,L50,short,31,9,22,3,0.7634,131,"[9, 13, 14, 15, 16, 18, 20, 30, 38, 39, 40, 48, 50, 52, 60, 62, 70, 71, 73, 82, 84, 92, 93, 94, 95, 103, 104, 105, 114, 115, 127]"

Norman,L50,short,30,15,15,7,0.7692,130,"[9, 10, 14, 18, 23, 30, 39, 40, 50, 51, 58, 59, 60, 61, 69, 70, 71, 79, 81, 90, 91, 99, 100, 101, 109, 110, 111, 113, 121, 125]"

Norman,L50,short,33,12,21,3,0.7519,133,"[9, 10, 11, 15, 16, 17, 18, 20, 21, 32, 33, 42, 43, 52, 53, 61, 62, 63, 73, 81, 83, 92, 94, 102, 103, 104, 112, 114, 115, 117, 125, 126, 129]"

Norman,L50,short,29,19,10,9,0.7752,129,"[4, 9, 20, 22, 29, 30, 31, 32, 40, 41, 42, 50, 51, 53, 62, 63, 65, 73, 75, 76, 84, 85, 88, 99, 107, 115, 116, 126, 127]"

Norman,L50,short,30,15,15,1,0.7692,130,"[4, 9, 18, 19, 20, 28, 29, 31, 32, 40, 42, 51, 52, 60, 62, 70, 72, 79, 80, 81, 82, 83, 91, 94, 103, 113, 114, 121, 123, 124]"

Norman,L50,short,28,16,12,6,0.7812,128,"[9, 14, 15, 17, 19, 20, 23, 32, 33, 41, 44, 52, 53, 54, 64, 72, 73, 76, 86, 93, 94, 102, 105, 112, 113, 115, 124, 126]"

Norman,L50,short,31,20,11,5,0.7634,131,"[9, 13, 14, 15, 17, 18, 19, 28, 30, 38, 39, 40, 49, 51, 59, 60, 61, 70, 71, 72, 74, 85, 92, 93, 94, 103, 106, 114, 115, 119, 129]"

Norman,L50,short,32,6,26,6,0.7576,132,"[6, 9, 19, 26, 27, 28, 29, 30, 31, 39, 40, 42, 51, 56, 64, 73, 75, 76, 85, 86, 94, 96, 98, 105, 106, 107, 108, 117, 118, 126, 127, 128]"

Norman,L50,short,34,28,6,3,0.7463,134,"[9, 13, 14, 15, 16, 17, 18, 19, 28, 29, 38, 39, 48, 49, 50, 51, 52, 61, 62, 64, 73, 81, 82, 83, 92, 93, 102, 103, 107, 116, 124, 125, 126, 127]"

Norman,L50,short,31,19,12,3,0.7634,131,"[6, 9, 20, 27, 28, 29, 30, 31, 32, 33, 43, 51, 52, 54, 62, 63, 71, 73, 81, 82, 83, 84, 85, 93, 95, 97, 105, 107, 116, 124, 126]"

Norman,L50,short,30,25,5,7,0.7692,130,"[4, 9, 11, 19, 21, 29, 30, 33, 41, 49, 50, 51, 52, 53, 62, 63, 73, 81, 82, 83, 84, 86, 88, 96, 97, 100, 108, 111, 119, 121]"

Norman,L50,short,30,17,13,7,0.7692,130,"[10, 14, 15, 16, 17, 18, 19, 21, 30, 31, 33, 42, 43, 54, 55, 63, 64, 66, 75, 83, 84, 85, 89, 98, 107, 110, 117, 118, 119, 126]"

Norman,L50,short,32,20,12,3,0.7576,132,"[4, 9, 18, 19, 21, 31, 40, 41, 43, 50, 51, 52, 53, 61, 62, 64, 74, 82, 86, 93, 94, 95, 96, 104, 105, 107, 114, 115, 116, 123, 125, 127]"

Norman,L50,short,33,18,15,3,0.7519,133,"[11, 17, 18, 19, 20, 21, 31, 33, 41, 42, 44, 52, 53, 56, 57, 65, 66, 67, 68, 79, 88, 89, 91, 98, 100, 101, 109, 111, 119, 120, 122, 130, 131]"

Norman,L50,short,28,18,10,15,0.7812,128,"[11, 17, 19, 22, 23, 30, 33, 35, 44, 45, 47, 55, 57, 65, 69, 76, 78, 86, 88, 89, 97, 99, 106, 107, 108, 109, 116, 124]"

Norman,L50,short,32,27,5,5,0.7576,132,"[4, 9, 11, 19, 20, 22, 30, 31, 39, 41, 49, 51, 52, 61, 62, 63, 65, 74, 75, 76, 77, 78, 87, 88, 97, 99, 109, 116, 117, 118, 126, 130]"

Norman,L50,short,30,14,16,4,0.7692,130,"[9, 13, 14, 15, 16, 17, 18, 21, 30, 40, 50, 60, 67, 68, 69, 70, 78, 81, 88, 89, 90, 99, 100, 108, 109, 110, 117, 118, 120, 123]"

Norman,L50,short,31,27,4,8,0.7634,131,"[4, 9, 10, 19, 22, 31, 38, 39, 40, 41, 42, 44, 53, 62, 63, 71, 72, 73, 74, 75, 77, 86, 94, 95, 97, 104, 107, 115, 116, 120, 127]"

Norman,L50,short,32,19,13,7,0.7576,132,"[5, 9, 18, 19, 27, 28, 29, 36, 37, 38, 39, 43, 52, 60, 68, 69, 70, 78, 79, 80, 88, 89, 90, 98, 99, 101, 102, 105, 113, 116, 124, 125]"

Norman,L50,short,31,14,17,5,0.7634,131,"[10, 14, 15, 16, 19, 28, 31, 39, 40, 50, 51, 59, 60, 61, 69, 70, 71, 79, 80, 81, 90, 91, 93, 101, 103, 111, 112, 113, 120, 121, 123]"

Norman,L50,short,33,14,19,6,0.7519,133,"[5, 9, 19, 26, 27, 28, 29, 36, 38, 39, 40, 41, 49, 54, 62, 70, 72, 79, 80, 81, 84, 93, 95, 103, 104, 105, 112, 114, 115, 116, 124, 125, 127]"

Norman,L50,short,29,22,7,5,0.7752,129,"[9, 13, 14, 15, 16, 17, 18, 20, 29, 30, 39, 40, 41, 53, 62, 70, 74, 82, 89, 92, 93, 100, 104, 113, 115, 122, 123, 124, 125]"

Norman,L50,short,25,17,8,5,0.8,125,"[4, 9, 10, 20, 21, 22, 30, 33, 41, 43, 46, 55, 64, 65, 72, 76, 83, 85, 93, 96, 102, 104, 106, 114, 117]"

Norman,L50,short,30,16,14,5,0.7692,130,"[4, 9, 19, 20, 21, 23, 31, 32, 40, 42, 50, 51, 52, 60, 61, 62, 70, 71, 73, 84, 92, 93, 100, 102, 103, 112, 113, 120, 122, 124]"

Norman,L50,short,32,13,19,4,0.7576,132,"[5, 9, 18, 19, 20, 29, 30, 31, 39, 40, 41, 50, 51, 60, 63, 70, 71, 79, 81, 89, 90, 91, 99, 101, 102, 110, 111, 112, 115, 123, 124, 125]"

Norman,L50,short,22,7,15,30,0.8197,122,"[10, 15, 16, 17, 20, 28, 29, 31, 39, 40, 41, 49, 50, 51, 59, 60, 61, 75, 90, 100, 107, 115]"

Norman,L50,short,30,20,10,7,0.7692,130,"[4, 9, 18, 20, 28, 31, 38, 39, 40, 41, 50, 52, 62, 69, 71, 72, 79, 81, 82, 90, 92, 94, 101, 102, 104, 113, 120, 121, 122, 123]"

Norman,L50,short,28,18,10,7,0.7812,128,"[11, 17, 18, 19, 20, 28, 29, 31, 33, 34, 35, 43, 44, 45, 54, 58, 67, 75, 86, 89, 97, 100, 107, 108, 111, 112, 119, 123]"

Norman,L50,short,27,6,21,8,0.7874,127,"[10, 15, 16, 18, 20, 28, 29, 36, 37, 38, 40, 49, 50, 59, 60, 68, 70, 81, 88, 89, 91, 99, 100, 102, 103, 115, 125]"

Norman,L50,short,29,15,14,10,0.7752,129,"[4, 10, 18, 19, 27, 28, 31, 38, 39, 44, 51, 59, 60, 62, 69, 72, 79, 80, 83, 94, 101, 102, 103, 110, 113, 120, 121, 122, 123]"

Norman,L50,short,31,12,19,5,0.7634,131,"[10, 16, 17, 18, 19, 20, 28, 29, 31, 41, 49, 51, 59, 61, 70, 71, 79, 82, 89, 90, 91, 92, 93, 95, 103, 105, 112, 115, 124, 125, 126]"

Norman,L50,short,32,15,17,5,0.7576,132,"[4, 9, 18, 19, 27, 28, 29, 32, 40, 41, 49, 50, 51, 59, 60, 61, 69, 70, 74, 82, 91, 99, 100, 101, 102, 110, 112, 119, 120, 121, 122, 130]"

Norman,L50,short,32,6,26,3,0.7576,132,"[10, 14, 16, 18, 19, 21, 29, 30, 32, 40, 41, 42, 50, 51, 52, 53, 61, 63, 64, 73, 74, 84, 92, 93, 94, 95, 104, 106, 115, 116, 126, 127]"

Norman,L50,short,34,9,25,12,0.7463,134,"[8, 15, 22, 29, 30, 33, 40, 42, 49, 50, 51, 53, 62, 69, 70, 72, 79, 80, 81, 82, 90, 91, 92, 101, 102, 103, 104, 105, 107, 115, 117, 125, 126, 128]"

Norman,L50,short,29,16,13,8,0.7752,129,"[4, 12, 19, 20, 30, 31, 38, 39, 40, 42, 52, 60, 61, 62, 65, 73, 74, 82, 84, 92, 93, 96, 103, 104, 108, 116, 117, 125, 127]"

Norman,L50,short,32,7,25,4,0.7576,132,"[10, 14, 15, 18, 19, 20, 28, 29, 30, 31, 39, 40, 43, 52, 60, 61, 70, 72, 81, 82, 84, 91, 92, 95, 103, 104, 105, 113, 114, 115, 123, 125]"

Norman,L50,short,32,15,17,9,0.7576,132,"[9, 14, 15, 17, 18, 20, 28, 29, 30, 38, 41, 45, 55, 64, 71, 72, 79, 80, 81, 82, 83, 94, 102, 103, 104, 105, 106, 114, 115, 117, 126, 127]"

Norman,L50,short,32,16,16,7,0.7576,132,"[4, 9, 19, 20, 22, 30, 31, 32, 34, 42, 45, 53, 57, 65, 72, 73, 74, 75, 77, 86, 94, 97, 104, 105, 106, 114, 115, 116, 123, 124, 126, 127]"

Norman,L50,short,30,16,14,8,0.7692,130,"[13, 18, 19, 22, 29, 30, 40, 48, 49, 50, 57, 58, 59, 62, 70, 72, 79, 81, 83, 91, 92, 99, 103, 109, 110, 111, 112, 113, 122, 123]"

Norman,L50,short,30,5,25,5,0.7692,130,"[10, 15, 16, 17, 19, 27, 28, 30, 31, 39, 41, 49, 50, 51, 53, 61, 62, 63, 75, 85, 93, 100, 102, 103, 110, 113, 120, 122, 123, 124]"

Norman,L50,short,31,18,13,8,0.7634,131,"[4, 9, 18, 19, 20, 28, 29, 30, 38, 39, 42, 50, 53, 61, 62, 65, 73, 77, 84, 94, 101, 102, 104, 106, 113, 114, 115, 122, 123, 125, 126]"

Norman,L50,short,29,16,13,10,0.7752,129,"[9, 13, 14, 16, 17, 18, 20, 32, 40, 41, 49, 50, 51, 59, 60, 63, 72, 79, 80, 81, 85, 92, 93, 95, 103, 104, 115, 123, 124]"

Norman,L50,short,29,19,10,12,0.7752,129,"[9, 13, 14, 15, 19, 27, 29, 36, 38, 40, 48, 49, 57, 58, 59, 67, 68, 69, 78, 79, 80, 83, 91, 99, 107, 115, 122, 123, 125]"

Norman,L50,short,33,9,24,4,0.7519,133,"[9, 11, 15, 16, 17, 18, 19, 22, 30, 31, 33, 42, 43, 52, 53, 61, 62, 63, 64, 73, 75, 83, 84, 86, 95, 96, 104, 108, 116, 117, 125, 126, 127]"

Norman,L50,short,30,18,12,3,0.7692,130,"[5, 9, 19, 29, 36, 37, 39, 49, 50, 57, 58, 61, 68, 69, 70, 71, 73, 81, 84, 92, 93, 100, 101, 104, 111, 112, 113, 115, 122, 124]"

Norman,L50,short,36,20,16,4,0.7353,136,"[10, 14, 17, 18, 20, 30, 31, 39, 40, 41, 50, 52, 60, 62, 71, 72, 79, 80, 81, 82, 90, 91, 92, 100, 101, 102, 109, 110, 111, 114, 122, 123, 124, 132, 133, 134]"

Norman,L50,short,29,18,11,4,0.7752,129,"[4, 9, 11, 19, 20, 22, 30, 32, 41, 50, 51, 59, 60, 62, 69, 70, 71, 80, 82, 91, 92, 100, 102, 109, 110, 112, 120, 121, 122]"

Norman,L50,short,33,23,10,6,0.7519,133,"[10, 14, 15, 16, 17, 18, 19, 28, 29, 34, 42, 43, 52, 57, 65, 66, 74, 77, 86, 87, 88, 95, 97, 98, 107, 108, 109, 116, 117, 118, 119, 127, 129]"

Norman,L50,short,32,14,18,4,0.7576,132,"[5, 10, 18, 19, 20, 28, 30, 37, 39, 41, 49, 50, 53, 61, 62, 64, 73, 80, 81, 82, 83, 91, 92, 95, 102, 103, 105, 113, 115, 122, 124, 125]"

Norman,L50,short,26,20,6,2,0.7937,126,"[9, 14, 15, 16, 18, 19, 27, 29, 40, 49, 50, 51, 61, 69, 71, 81, 89, 91, 98, 99, 100, 101, 111, 118, 120, 122]"

Norman,L50,short,31,18,13,6,0.7634,131,"[9, 13, 14, 15, 16, 17, 18, 19, 21, 32, 41, 49, 50, 51, 52, 60, 61, 62, 71, 72, 83, 91, 94, 102, 103, 107, 114, 115, 123, 124, 126]"

Norman,L50,short,30,18,12,2,0.7692,130,"[4, 10, 18, 19, 20, 29, 31, 40, 41, 43, 51, 52, 54, 63, 65, 74, 81, 82, 84, 85, 93, 95, 96, 104, 105, 107, 114, 115, 118, 128]"

Norman,L50,short,32,19,13,7,0.7576,132,"[6, 9, 18, 19, 30, 37, 39, 48, 49, 56, 57, 58, 60, 69, 72, 73, 81, 82, 83, 85, 93, 94, 95, 96, 103, 104, 105, 108, 116, 123, 125, 128]"

Norman,L50,short,32,16,16,6,0.7576,132,"[9, 14, 15, 17, 18, 20, 28, 31, 40, 41, 49, 51, 52, 61, 63, 71, 73, 80, 81, 83, 91, 92, 100, 101, 102, 103, 111, 112, 115, 116, 125, 127]"

Norman,L50,short,33,19,14,2,0.7519,133,"[4, 9, 10, 20, 28, 30, 38, 40, 48, 50, 57, 58, 59, 60, 69, 70, 72, 79, 81, 89, 90, 91, 92, 102, 109, 110, 111, 113, 120, 121, 122, 123, 125]"

Norman,L50,short,29,16,13,10,0.7752,129,"[4, 10, 18, 19, 21, 22, 30, 31, 34, 42, 50, 52, 60, 62, 69, 70, 75, 83, 91, 93, 99, 103, 104, 105, 108, 115, 117, 124, 126]"

Norman,L50,short,31,16,15,3,0.7634,131,"[9, 13, 14, 15, 17, 18, 19, 28, 30, 38, 39, 40, 42, 51, 61, 62, 71, 72, 80, 81, 82, 83, 84, 93, 94, 95, 107, 115, 116, 125, 126]"

Norman,L50,short,34,11,23,4,0.7463,134,"[4, 10, 18, 19, 27, 28, 30, 38, 39, 40, 41, 49, 50, 51, 61, 69, 70, 71, 73, 81, 82, 92, 101, 103, 110, 111, 112, 119, 120, 121, 122, 123, 131, 132]"

Norman,L50,short,27,10,17,7,0.7874,127,"[9, 15, 16, 17, 20, 28, 29, 30, 33, 41, 42, 44, 47, 57, 65, 66, 75, 77, 85, 86, 94, 95, 97, 107, 114, 115, 119]"

Norman,L50,short,25,9,16,6,0.8,125,"[9, 10, 14, 15, 16, 17, 20, 29, 30, 38, 41, 49, 50, 51, 60, 62, 70, 71, 79, 80, 82, 92, 105, 113, 122]"

Norman,L50,short,35,8,27,1,0.7407,135,"[9, 13, 14, 15, 16, 17, 20, 29, 30, 39, 40, 41, 42, 43, 52, 53, 61, 63, 73, 74, 84, 91, 92, 93, 94, 95, 96, 97, 107, 108, 116, 118, 119, 128, 129]"

Norman,L50,short,28,8,20,3,0.7812,128,"[10, 14, 15, 16, 17, 18, 20, 29, 31, 39, 42, 50, 51, 52, 60, 61, 63, 71, 72, 82, 90, 91, 92, 100, 101, 103, 113, 122]"

Norman,L50,short,30,15,15,10,0.7692,130,"[4, 9, 18, 19, 29, 36, 41, 49, 57, 59, 66, 69, 70, 76, 78, 79, 81, 88, 89, 90, 92, 100, 102, 109, 110, 111, 118, 120, 121, 127]"

Norman,L50,short,32,13,19,8,0.7576,132,"[4, 10, 18, 19, 20, 28, 29, 31, 40, 43, 50, 51, 55, 63, 70, 72, 79, 80, 81, 82, 90, 91, 92, 103, 111, 112, 113, 115, 122, 124, 125, 126]"

Norman,L50,short,32,9,23,4,0.7576,132,"[9, 14, 15, 16, 17, 19, 28, 30, 38, 39, 49, 57, 58, 60, 61, 62, 70, 71, 72, 80, 81, 82, 85, 93, 96, 104, 112, 113, 115, 123, 124, 125]"

Norman,L50,short,32,13,19,6,0.7576,132,"[9, 10, 16, 17, 18, 21, 30, 39, 40, 41, 49, 51, 59, 60, 61, 69, 73, 80, 82, 89, 90, 91, 92, 93, 101, 102, 104, 112, 115, 123, 124, 126]"

Norman,L50,short,32,20,12,8,0.7576,132,"[9, 14, 15, 16, 17, 18, 19, 29, 37, 38, 40, 48, 49, 50, 51, 59, 60, 61, 70, 71, 78, 86, 93, 97, 108, 115, 116, 117, 118, 119, 120, 130]"

Norman,L50,short,34,21,13,7,0.7463,134,"[9, 13, 14, 16, 17, 18, 19, 28, 29, 38, 39, 47, 50, 58, 59, 60, 62, 72, 80, 82, 83, 84, 87, 95, 96, 97, 101, 109, 118, 119, 120, 128, 129, 132]"

Norman,L50,short,31,19,12,7,0.7634,131,"[4, 10, 18, 19, 27, 28, 31, 38, 39, 40, 44, 52, 54, 63, 64, 72, 73, 74, 82, 85, 93, 95, 103, 104, 111, 114, 122, 123, 124, 126, 127]"

Norman,L50,short,33,13,20,5,0.7519,133,"[9, 13, 14, 15, 16, 19, 20, 22, 30, 34, 42, 50, 51, 52, 53, 61, 63, 65, 73, 74, 82, 86, 93, 94, 96, 105, 106, 113, 116, 124, 125, 126, 127]"

Norman,L50,short,32,22,10,2,0.7576,132,"[9, 13, 15, 16, 18, 21, 30, 31, 32, 40, 42, 51, 54, 62, 63, 71, 72, 74, 75, 76, 85, 86, 95, 97, 105, 106, 113, 114, 115, 116, 124, 126]"

Norman,L50,short,26,18,8,11,0.7937,126,"[9, 13, 15, 16, 17, 18, 19, 29, 40, 48, 49, 52, 60, 62, 68, 76, 83, 87, 93, 95, 96, 97, 104, 108, 116, 117]"

Norman,L50,short,30,10,20,12,0.7692,130,"[4, 10, 11, 12, 22, 32, 33, 36, 45, 54, 61, 62, 63, 64, 65, 66, 70, 79, 89, 97, 98, 104, 105, 107, 111, 118, 119, 126, 127, 128]"

Norman,L50,short,28,16,12,6,0.7812,128,"[10, 14, 19, 26, 27, 28, 29, 36, 37, 39, 47, 48, 50, 58, 59, 67, 69, 78, 79, 88, 91, 101, 109, 110, 112, 119, 120, 123]"

Norman,L50,short,34,22,12,4,0.7463,134,"[4, 10, 18, 19, 27, 28, 29, 36, 37, 38, 39, 47, 49, 50, 52, 61, 64, 72, 73, 77, 85, 93, 94, 95, 96, 103, 104, 106, 115, 117, 127, 128, 129, 130]"

Norman,L50,short,31,16,15,8,0.7634,131,"[4, 9, 18, 20, 29, 30, 39, 41, 52, 59, 60, 64, 71, 75, 82, 83, 84, 87, 95, 96, 102, 103, 105, 107, 114, 115, 117, 118, 125, 127, 129]"

Norman,L50,short,30,19,11,6,0.7692,130,"[4, 9, 10, 19, 20, 21, 22, 31, 33, 42, 51, 55, 63, 70, 71, 72, 75, 83, 84, 85, 94, 96, 103, 105, 113, 114, 116, 124, 126, 127]"

Norman,L50,short,28,15,13,4,0.7812,128,"[4, 9, 18, 25, 32, 33, 35, 44, 51, 54, 62, 63, 64, 71, 72, 74, 84, 91, 92, 93, 94, 104, 111, 112, 113, 116, 125, 126]"

Norman,L50,short,34,21,13,2,0.7463,134,"[9, 13, 14, 15, 16, 18, 19, 20, 29, 31, 42, 51, 52, 53, 62, 64, 72, 73, 82, 83, 91, 92, 93, 94, 95, 105, 112, 113, 114, 115, 116, 124, 126, 128]"

Norman,L50,short,27,11,16,9,0.7874,127,"[4, 9, 18, 19, 29, 36, 37, 38, 39, 46, 47, 49, 58, 60, 68, 70, 78, 81, 88, 89, 90, 98, 99, 102, 112, 119, 121]"

Norman,L50,short,28,22,6,11,0.7812,128,"[5, 10, 18, 19, 21, 29, 30, 34, 44, 52, 60, 62, 69, 70, 71, 72, 74, 82, 83, 92, 95, 102, 103, 111, 112, 114, 122, 123]"

Norman,L50,short,33,15,18,7,0.7519,133,"[4, 10, 18, 20, 29, 30, 32, 42, 44, 52, 55, 62, 63, 70, 72, 73, 82, 83, 91, 92, 93, 100, 101, 103, 106, 113, 114, 122, 123, 124, 125, 126, 127]"

Norman,L50,short,31,19,12,8,0.7634,131,"[9, 10, 14, 17, 18, 19, 22, 34, 41, 43, 51, 52, 53, 54, 62, 63, 66, 74, 82, 84, 85, 92, 94, 95, 103, 104, 106, 114, 118, 126, 128]"

Norman,L50,short,30,20,10,3,0.7692,130,"[5, 9, 10, 20, 28, 29, 30, 31, 40, 41, 49, 51, 53, 61, 63, 71, 74, 84, 92, 93, 94, 101, 104, 111, 112, 113, 115, 122, 123, 124]"

Norman,L50,short,33,17,16,7,0.7519,133,"[4, 9, 18, 20, 21, 30, 32, 40, 42, 53, 60, 61, 63, 64, 71, 72, 73, 75, 83, 84, 85, 93, 97, 105, 107, 115, 116, 117, 124, 125, 128, 129, 130]"

Norman,L50,short,33,16,17,10,0.7519,133,"[7, 10, 18, 19, 20, 29, 30, 38, 39, 40, 52, 60, 67, 68, 69, 71, 78, 81, 88, 90, 91, 99, 100, 101, 110, 111, 118, 119, 120, 121, 122, 123, 129]"

Norman,L50,short,29,20,9,9,0.7752,129,"[9, 10, 12, 18, 19, 22, 30, 33, 41, 49, 52, 59, 61, 63, 72, 79, 80, 81, 82, 91, 92, 99, 102, 103, 105, 113, 116, 123, 124]"

Norman,L50,short,34,10,24,13,0.7463,134,"[10, 16, 17, 18, 19, 28, 33, 42, 49, 56, 58, 59, 67, 68, 71, 78, 79, 80, 83, 90, 91, 99, 100, 101, 108, 109, 110, 111, 118, 120, 122, 130, 131, 132]"

Norman,L50,short,31,16,15,13,0.7634,131,"[9, 13, 16, 17, 19, 21, 29, 30, 34, 42, 50, 51, 59, 63, 71, 72, 75, 83, 84, 85, 93, 95, 96, 104, 105, 106, 107, 108, 109, 116, 123]"

Norman,L50,short,35,4,31,4,0.7407,135,"[10, 15, 16, 19, 20, 23, 30, 31, 39, 40, 41, 42, 51, 52, 53, 61, 62, 64, 73, 81, 82, 83, 84, 94, 95, 96, 97, 105, 107, 116, 117, 125, 126, 127, 129]"

Norman,L50,short,31,13,18,4,0.7634,131,"[9, 10, 14, 15, 18, 19, 21, 29, 30, 38, 40, 49, 50, 51, 59, 62, 70, 72, 80, 81, 90, 91, 99, 100, 101, 102, 103, 105, 113, 114, 124]"

Norman,L50,short,29,15,14,5,0.7752,129,"[4, 10, 18, 19, 30, 37, 38, 41, 50, 58, 60, 61, 68, 69, 70, 71, 79, 80, 81, 89, 93, 100, 101, 108, 109, 110, 112, 121, 122]"

Norman,L50,short,32,14,18,3,0.7576,132,"[5, 10, 18, 19, 28, 29, 36, 37, 39, 46, 47, 48, 49, 51, 60, 61, 71, 80, 84, 92, 94, 101, 102, 103, 110, 111, 112, 113, 114, 115, 124, 125]"

Norman,L50,short,35,19,16,4,0.7407,135,"[9, 13, 14, 15, 16, 17, 18, 19, 21, 30, 39, 40, 48, 50, 60, 62, 70, 71, 81, 89, 90, 91, 93, 94, 102, 103, 104, 112, 113, 114, 116, 124, 126, 127, 130]"

Norman,L50,short,32,17,15,3,0.7576,132,"[7, 10, 13, 21, 22, 30, 32, 34, 42, 44, 51, 52, 53, 54, 62, 63, 64, 75, 84, 85, 93, 95, 97, 105, 106, 113, 114, 115, 117, 118, 127, 128]"

Norman,L50,short,30,22,8,8,0.7692,130,"[4, 9, 18, 19, 21, 29, 31, 33, 41, 42, 50, 55, 63, 67, 74, 83, 84, 91, 92, 94, 101, 102, 103, 104, 111, 115, 122, 123, 124, 125]"

Norman,L50,short,31,12,19,8,0.7634,131,"[4, 10, 11, 20, 21, 24, 34, 35, 43, 44, 46, 54, 55, 63, 67, 74, 75, 83, 85, 87, 95, 96, 98, 105, 106, 109, 116, 117, 126, 127, 129]"

Norman,L50,short,31,17,14,5,0.7634,131,"[9, 10, 14, 15, 16, 20, 23, 24, 32, 34, 37, 45, 53, 56, 65, 67, 79, 87, 88, 89, 92, 101, 108, 109, 110, 111, 112, 120, 121, 122, 123]"

Norman,L50,short,28,16,12,4,0.7812,128,"[4, 11, 19, 26, 28, 29, 37, 38, 39, 46, 48, 49, 57, 60, 69, 76, 77, 78, 79, 87, 88, 89, 100, 109, 116, 117, 118, 121]"

Norman,L50,short,33,17,16,11,0.7519,133,"[4, 9, 10, 19, 20, 28, 31, 32, 33, 34, 36, 45, 47, 49, 51, 59, 60, 73, 82, 89, 90, 91, 92, 98, 106, 113, 114, 121, 122, 123, 124, 125, 126]"

Norman,L50,short,35,21,14,6,0.7407,135,"[4, 9, 18, 23, 30, 37, 38, 39, 40, 48, 49, 50, 60, 61, 68, 69, 71, 79, 80, 81, 90, 91, 99, 100, 102, 110, 111, 112, 119, 121, 122, 123, 124, 125, 126]"

Norman,L50,short,32,18,14,6,0.7576,132,"[4, 9, 10, 13, 21, 22, 32, 33, 34, 35, 43, 46, 54, 59, 68, 77, 79, 86, 87, 88, 89, 90, 100, 107, 110, 118, 119, 120, 121, 122, 123, 125]"

Norman,L50,short,28,13,15,5,0.7812,128,"[4, 9, 10, 19, 20, 29, 30, 37, 40, 48, 50, 59, 60, 67, 68, 69, 71, 80, 82, 90, 91, 99, 100, 101, 110, 112, 120, 124]"

Norman,L50,short,32,18,14,6,0.7576,132,"[9, 13, 15, 17, 18, 19, 20, 30, 32, 33, 34, 45, 57, 65, 72, 75, 83, 85, 86, 94, 95, 96, 104, 105, 106, 113, 114, 115, 116, 125, 126, 127]"

Norman,L50,short,32,16,16,2,0.7576,132,"[5, 9, 10, 20, 28, 29, 31, 38, 40, 48, 50, 58, 60, 61, 62, 70, 71, 73, 81, 82, 83, 92, 94, 95, 102, 104, 105, 113, 114, 116, 125, 127]"

Norman,L50,short,33,14,19,5,0.7519,133,"[11, 17, 19, 26, 27, 28, 29, 37, 38, 39, 47, 48, 49, 58, 59, 67, 68, 69, 78, 79, 87, 88, 89, 97, 98, 100, 108, 109, 112, 120, 127, 129, 131]"

Norman,L50,short,27,6,21,10,0.7874,127,"[9, 10, 12, 18, 19, 20, 21, 22, 31, 32, 33, 34, 48, 57, 66, 74, 75, 76, 84, 85, 86, 95, 96, 98, 106, 109, 120]"

Norman,L50,short,29,17,12,7,0.7752,129,"[10, 15, 16, 17, 18, 22, 31, 39, 40, 41, 49, 53, 60, 61, 62, 63, 73, 80, 81, 84, 92, 93, 97, 105, 111, 113, 115, 124, 125]"

Norman,L50,short,35,10,25,9,0.7407,135,"[10, 14, 16, 17, 19, 21, 27, 34, 35, 37, 45, 46, 48, 59, 60, 62, 70, 71, 72, 73, 75, 83, 84, 93, 95, 104, 113, 114, 115, 122, 123, 124, 125, 126, 128]"

Norman,L50,short,29,14,15,10,0.7752,129,"[5, 13, 21, 30, 36, 38, 39, 46, 47, 48, 49, 50, 51, 60, 61, 69, 70, 71, 79, 80, 81, 89, 91, 99, 100, 103, 111, 120, 122]"

Norman,L50,short,37,18,19,3,0.7299,137,"[4, 10, 18, 19, 20, 28, 29, 30, 38, 40, 42, 50, 51, 60, 61, 62, 70, 72, 73, 75, 84, 85, 87, 95, 96, 97, 98, 99, 107, 109, 117, 118, 119, 120, 128, 131, 133]"

Norman,L50,short,32,19,13,3,0.7576,132,"[11, 13, 18, 19, 20, 22, 30, 31, 33, 43, 51, 52, 53, 54, 62, 63, 64, 73, 74, 84, 91, 92, 94, 102, 103, 104, 105, 113, 114, 115, 124, 125]"

Norman,L50,short,28,13,15,5,0.7812,128,"[9, 14, 16, 17, 18, 19, 22, 31, 40, 41, 52, 60, 61, 68, 69, 70, 72, 79, 80, 82, 91, 93, 101, 102, 103, 113, 122, 123]"

Norman,L50,short,29,20,9,18,0.7752,129,"[9, 13, 15, 16, 20, 28, 29, 32, 40, 45, 55, 65, 73, 81, 87, 88, 91, 98, 99, 100, 101, 107, 109, 110, 111, 112, 115, 123, 125]"

Norman,L50,short,32,16,16,14,0.7576,132,"[10, 14, 15, 16, 17, 19, 20, 30, 33, 42, 50, 51, 55, 64, 72, 73, 74, 75, 76, 84, 86, 94, 96, 104, 105, 106, 107, 108, 115, 116, 118, 121]"

Norman,L50,short,37,14,23,3,0.7299,137,"[10, 14, 16, 18, 19, 20, 21, 23, 31, 32, 34, 43, 44, 45, 54, 55, 63, 64, 65, 74, 75, 84, 85, 86, 95, 96, 104, 105, 107, 115, 116, 124, 125, 126, 127, 128, 129]"

Norman,L50,short,28,11,17,5,0.7812,128,"[4, 9, 19, 29, 36, 37, 38, 39, 47, 48, 49, 50, 59, 60, 68, 69, 70, 78, 81, 89, 90, 92, 101, 102, 106, 113, 122, 124]"

Norman,L50,short,29,17,12,6,0.7752,129,"[12, 17, 19, 20, 21, 29, 30, 31, 33, 42, 50, 51, 54, 63, 71, 72, 73, 75, 77, 78, 86, 89, 96, 97, 98, 99, 109, 110, 121]"

Norman,L50,short,34,9,25,10,0.7463,134,"[4, 10, 18, 19, 27, 28, 30, 37, 38, 39, 40, 48, 49, 53, 63, 70, 71, 72, 73, 74, 82, 83, 84, 85, 86, 87, 96, 98, 106, 108, 116, 117, 126, 127]"

Norman,L50,short,29,14,15,8,0.7752,129,"[9, 13, 14, 16, 17, 19, 28, 29, 37, 39, 48, 53, 60, 67, 68, 69, 77, 78, 81, 90, 98, 99, 107, 108, 110, 117, 118, 119, 122]"

Norman,L50,short,31,16,15,8,0.7634,131,"[9, 12, 18, 19, 21, 31, 40, 41, 42, 49, 50, 51, 52, 65, 73, 80, 85, 91, 92, 93, 101, 102, 104, 110, 111, 114, 121, 122, 123, 125, 126]"

Norman,L50,short,30,14,16,9,0.7692,130,"[4, 11, 20, 27, 30, 33, 40, 44, 51, 58, 59, 61, 68, 69, 71, 78, 83, 91, 93, 100, 101, 102, 109, 110, 113, 114, 121, 122, 123, 124]"

Norman,L50,short,30,16,14,7,0.7692,130,"[9, 10, 13, 19, 21, 29, 30, 32, 40, 41, 49, 51, 60, 62, 71, 74, 81, 82, 83, 90, 91, 92, 93, 101, 102, 104, 113, 121, 122, 124]"

Norman,L50,short,32,15,17,9,0.7576,132,"[10, 15, 17, 18, 19, 27, 28, 33, 41, 49, 52, 59, 60, 61, 62, 70, 72, 74, 82, 83, 90, 91, 92, 93, 101, 103, 111, 112, 114, 122, 123, 125]"

Norman,L50,short,31,17,14,5,0.7634,131,"[4, 10, 18, 19, 28, 29, 30, 37, 38, 39, 40, 48, 50, 58, 60, 61, 69, 70, 71, 79, 82, 90, 91, 92, 95, 104, 114, 121, 123, 124, 125]"

Norman,L50,short,28,15,13,6,0.7812,128,"[9, 13, 14, 17, 18, 19, 27, 31, 40, 49, 50, 59, 61, 69, 70, 78, 79, 80, 88, 89, 90, 93, 103, 110, 111, 113, 120, 122]"

Norman,L50,short,33,13,20,13,0.7519,133,"[7, 14, 22, 30, 37, 38, 39, 40, 48, 49, 50, 58, 59, 61, 69, 70, 72, 79, 82, 90, 91, 92, 93, 101, 103, 104, 105, 113, 114, 116, 117, 125, 128]"

Norman,L50,short,28,20,8,7,0.7812,128,"[5, 9, 18, 19, 20, 21, 22, 23, 34, 42, 43, 52, 53, 61, 62, 65, 74, 83, 92, 93, 100, 101, 102, 103, 111, 115, 122, 124]"

Norman,L50,short,31,12,19,2,0.7634,131,"[5, 9, 10, 19, 21, 30, 31, 38, 39, 40, 42, 50, 51, 61, 68, 71, 79, 80, 81, 90, 92, 99, 101, 102, 103, 104, 112, 113, 114, 121, 124]"

Norman,L50,short,34,18,16,3,0.7463,134,"[10, 14, 15, 17, 18, 19, 27, 29, 31, 39, 40, 48, 49, 50, 58, 59, 60, 69, 70, 78, 80, 88, 91, 99, 100, 107, 108, 109, 110, 119, 121, 123, 124, 125]"

Norman,L50,short,32,26,6,5,0.7576,132,"[4, 9, 10, 12, 13, 22, 24, 32, 33, 43, 51, 52, 53, 61, 65, 73, 81, 83, 91, 92, 93, 94, 95, 104, 105, 106, 107, 114, 116, 118, 126, 128]"

Norman,L50,short,32,20,12,4,0.7576,132,"[4, 9, 10, 11, 21, 30, 34, 41, 42, 44, 52, 55, 63, 64, 71, 72, 74, 82, 84, 92, 93, 94, 103, 104, 111, 112, 113, 114, 121, 122, 123, 124]"

Norman,L50,short,31,22,9,7,0.7634,131,"[9, 14, 15, 17, 18, 19, 27, 28, 29, 38, 39, 48, 51, 59, 67, 68, 69, 77, 79, 80, 81, 90, 94, 102, 109, 110, 111, 114, 121, 123, 125]"

Norman,L50,short,26,11,15,13,0.7937,126,"[4, 10, 18, 20, 28, 31, 40, 41, 42, 43, 52, 54, 62, 63, 67, 74, 81, 82, 88, 96, 102, 103, 106, 113, 115, 121]"

Norman,L50,short,32,17,15,7,0.7576,132,"[4, 9, 11, 19, 20, 28, 30, 37, 38, 39, 41, 44, 52, 60, 61, 63, 71, 72, 73, 82, 85, 93, 94, 96, 103, 104, 105, 107, 116, 117, 125, 127]"

Norman,L50,short,31,20,11,5,0.7634,131,"[10, 16, 17, 21, 30, 37, 38, 40, 48, 50, 58, 60, 62, 69, 70, 72, 73, 81, 83, 91, 92, 96, 104, 106, 107, 114, 115, 116, 117, 126, 128]"

Norman,L50,short,31,20,11,1,0.7634,131,"[11, 17, 19, 20, 21, 29, 30, 31, 39, 40, 41, 51, 52, 60, 62, 63, 73, 74, 82, 84, 92, 93, 95, 103, 104, 111, 113, 114, 122, 123, 124]"

Norman,L50,short,35,14,21,3,0.7407,135,"[9, 15, 16, 18, 19, 27, 28, 30, 38, 39, 49, 56, 57, 58, 59, 67, 68, 69, 77, 78, 79, 87, 88, 89, 98, 99, 107, 109, 117, 118, 119, 120, 121, 124, 133]"

Norman,L50,short,28,11,17,8,0.7812,128,"[11, 17, 19, 20, 27, 28, 31, 39, 41, 45, 54, 61, 64, 72, 74, 81, 82, 83, 84, 85, 87, 96, 104, 105, 106, 114, 116, 117]"

Norman,L50,short,32,10,22,4,0.7576,132,"[9, 10, 14, 16, 17, 19, 20, 21, 31, 33, 41, 42, 43, 52, 54, 62, 64, 72, 73, 74, 82, 83, 85, 93, 95, 103, 104, 105, 113, 114, 117, 125]"

Norman,L50,short,32,15,17,8,0.7576,132,"[5, 10, 18, 19, 27, 29, 30, 31, 40, 41, 50, 51, 59, 60, 62, 70, 71, 79, 81, 82, 83, 92, 93, 94, 96, 104, 105, 106, 107, 116, 118, 127]"

Norman,L50,short,28,16,12,8,0.7812,128,"[4, 9, 19, 26, 27, 28, 32, 40, 49, 51, 59, 60, 62, 69, 71, 73, 76, 84, 94, 102, 103, 106, 113, 114, 120, 121, 123, 124]"

Norman,L50,short,36,18,18,7,0.7353,136,"[4, 9, 10, 11, 20, 21, 29, 30, 31, 32, 40, 41, 42, 50, 51, 52, 54, 65, 73, 81, 83, 91, 92, 93, 94, 95, 97, 108, 117, 119, 127, 128, 129, 130, 131, 132]"

Norman,L50,short,29,16,13,6,0.7752,129,"[4, 9, 18, 19, 20, 28, 29, 30, 38, 39, 41, 50, 58, 59, 62, 71, 74, 82, 83, 91, 94, 102, 105, 112, 113, 116, 122, 123, 124]"

Norman,L50,short,27,14,13,3,0.7874,127,"[9, 10, 11, 12, 19, 20, 21, 22, 23, 36, 44, 45, 54, 55, 63, 65, 66, 77, 86, 88, 96, 98, 105, 107, 108, 121, 122]"

Norman,L50,short,28,17,11,10,0.7812,128,"[12, 17, 18, 19, 20, 28, 29, 32, 41, 42, 43, 53, 60, 62, 63, 72, 73, 80, 86, 93, 95, 103, 105, 106, 113, 114, 116, 122]"

Norman,L50,short,31,12,19,6,0.7634,131,"[4, 10, 18, 22, 30, 37, 39, 40, 51, 58, 60, 69, 70, 71, 79, 80, 81, 88, 89, 90, 91, 92, 93, 101, 102, 103, 111, 113, 120, 124, 125]"

Norman,L50,short,35,17,18,6,0.7407,135,"[9, 13, 15, 16, 17, 18, 19, 20, 29, 33, 41, 50, 51, 52, 53, 54, 55, 66, 74, 76, 85, 92, 93, 94, 95, 103, 104, 105, 113, 115, 116, 117, 125, 126, 128]"

Norman,L50,short,30,9,21,2,0.7692,130,"[4, 9, 18, 19, 27, 30, 37, 38, 39, 40, 49, 50, 60, 67, 69, 70, 78, 79, 80, 91, 99, 100, 101, 108, 110, 111, 118, 121, 122, 123]"

Norman,L50,short,30,13,17,9,0.7692,130,"[12, 17, 20, 29, 31, 40, 42, 49, 50, 51, 52, 59, 61, 63, 71, 73, 80, 82, 90, 92, 99, 100, 102, 110, 111, 113, 120, 121, 122, 125]"

Norman,L50,short,30,17,13,5,0.7692,130,"[10, 15, 18, 19, 21, 29, 31, 39, 40, 49, 51, 60, 61, 68, 69, 70, 71, 79, 80, 82, 92, 93, 101, 104, 105, 112, 113, 115, 116, 128]"

Norman,L50,short,27,15,12,6,0.7874,127,"[9, 10, 16, 20, 21, 22, 30, 31, 33, 35, 43, 45, 54, 55, 56, 57, 65, 69, 78, 86, 87, 95, 98, 99, 108, 112, 121]"

Norman,L50,short,37,28,9,3,0.7299,137,"[4, 9, 10, 20, 22, 32, 39, 41, 42, 43, 50, 52, 54, 62, 63, 65, 73, 74, 75, 83, 85, 87, 95, 96, 97, 98, 99, 100, 101, 102, 112, 120, 121, 122, 130, 131, 132]"

Norman,L50,short,29,16,13,9,0.7752,129,"[4, 10, 18, 19, 28, 29, 30, 37, 38, 39, 40, 41, 45, 54, 63, 73, 82, 83, 85, 93, 96, 105, 112, 114, 115, 121, 122, 123, 125]"

Norman,L50,short,28,14,14,10,0.7812,128,"[4, 9, 10, 20, 29, 33, 40, 41, 48, 49, 50, 51, 59, 61, 68, 69, 72, 80, 81, 82, 91, 96, 103, 110, 112, 120, 121, 125]"

Norman,L50,short,29,13,16,12,0.7752,129,"[10, 16, 17, 19, 20, 30, 38, 39, 42, 50, 51, 53, 54, 55, 60, 71, 80, 88, 96, 98, 100, 107, 108, 109, 115, 117, 118, 120, 122]"

Norman,L50,short,31,18,13,8,0.7634,131,"[9, 11, 15, 17, 18, 19, 20, 23, 31, 39, 40, 44, 53, 62, 70, 72, 80, 81, 83, 90, 91, 94, 102, 103, 105, 113, 114, 118, 125, 127, 129]"

Norman,L50,short,29,14,15,15,0.7752,129,"[4, 9, 13, 21, 22, 25, 33, 40, 41, 42, 43, 51, 53, 55, 64, 65, 68, 76, 80, 89, 97, 105, 109, 116, 117, 124, 125, 126, 127]"

Norman,L50,short,30,15,15,8,0.7692,130,"[6, 10, 18, 19, 21, 29, 30, 37, 41, 49, 50, 51, 52, 60, 61, 64, 72, 77, 85, 93, 95, 103, 104, 105, 107, 115, 116, 119, 126, 127]"

Norman,L50,short,32,15,17,4,0.7576,132,"[9, 10, 14, 16, 17, 18, 19, 20, 29, 30, 33, 42, 50, 52, 61, 62, 63, 72, 73, 81, 84, 85, 88, 97, 105, 108, 109, 118, 119, 126, 127, 129]"

Norman,L50,short,36,17,19,1,0.7353,136,"[9, 13, 14, 16, 17, 18, 19, 21, 30, 38, 39, 40, 49, 50, 58, 60, 69, 71, 73, 81, 84, 85, 92, 93, 94, 96, 97, 98, 106, 107, 108, 117, 118, 119, 128, 129]"

Norman,L50,short,30,12,18,2,0.7692,130,"[4, 9, 18, 19, 29, 36, 37, 38, 39, 46, 48, 50, 58, 59, 67, 69, 70, 79, 80, 88, 90, 91, 100, 102, 112, 113, 114, 122, 123, 125]"

Norman,L50,short,30,13,17,4,0.7692,130,"[4, 9, 18, 19, 27, 28, 30, 37, 38, 39, 48, 49, 50, 58, 60, 69, 70, 78, 79, 80, 89, 90, 91, 94, 102, 110, 112, 114, 122, 123]"

Norman,L50,short,27,10,17,9,0.7874,127,"[5, 9, 11, 19, 20, 28, 30, 37, 38, 39, 41, 42, 51, 52, 60, 61, 62, 72, 73, 77, 85, 94, 95, 98, 107, 112, 119]"

Norman,L50,short,35,18,17,2,0.7407,135,"[9, 13, 14, 15, 17, 20, 29, 31, 39, 40, 41, 50, 52, 60, 61, 62, 70, 71, 72, 80, 81, 82, 91, 92, 100, 101, 103, 110, 111, 113, 122, 123, 131, 132, 133]"

Norman,L50,short,30,16,14,13,0.7692,130,"[4, 9, 18, 19, 21, 29, 31, 39, 40, 48, 49, 50, 59, 64, 74, 81, 89, 91, 93, 100, 101, 103, 110, 111, 112, 119, 120, 121, 122, 124]"

Norman,L50,short,30,10,20,5,0.7692,130,"[4, 9, 10, 11, 24, 32, 33, 40, 41, 44, 52, 53, 55, 63, 64, 66, 74, 75, 76, 85, 86, 94, 96, 104, 107, 108, 109, 110, 118, 122]"

Norman,L50,short,32,24,8,8,0.7576,132,"[4, 11, 19, 20, 21, 22, 30, 31, 34, 42, 50, 55, 63, 70, 71, 72, 74, 82, 83, 84, 92, 95, 105, 112, 113, 114, 116, 117, 124, 125, 126, 127]"

Norman,L50,short,37,17,20,11,0.7299,137,"[11, 17, 18, 19, 21, 32, 40, 44, 51, 58, 59, 61, 64, 71, 72, 73, 80, 81, 83, 84, 91, 92, 93, 94, 96, 97, 98, 99, 107, 108, 110, 118, 119, 120, 128, 129, 131]"

Norman,L50,short,27,19,8,8,0.7874,127,"[11, 17, 18, 19, 20, 21, 22, 31, 32, 43, 51, 52, 60, 61, 62, 65, 75, 82, 83, 84, 85, 88, 97, 105, 109, 117, 125]"

Norman,L50,short,31,16,15,5,0.7634,131,"[4, 10, 12, 21, 29, 30, 31, 41, 49, 50, 53, 60, 61, 68, 69, 70, 72, 79, 80, 83, 91, 94, 96, 104, 105, 112, 114, 115, 123, 124, 125]"

Norman,L50,short,31,19,12,4,0.7634,131,"[9, 10, 11, 15, 17, 18, 19, 20, 21, 30, 31, 42, 50, 51, 59, 63, 71, 72, 80, 82, 84, 91, 93, 102, 104, 111, 113, 120, 121, 122, 123]"

Norman,L50,short,34,18,16,6,0.7463,134,"[4, 9, 10, 19, 20, 21, 29, 30, 32, 45, 53, 54, 62, 63, 65, 73, 74, 82, 83, 84, 85, 93, 94, 96, 103, 105, 107, 114, 116, 123, 124, 125, 126, 128]"

Norman,L50,short,31,18,13,6,0.7634,131,"[4, 9, 11, 12, 14, 22, 23, 25, 33, 36, 38, 46, 47, 58, 66, 68, 69, 70, 71, 79, 80, 81, 84, 94, 103, 112, 113, 120, 122, 124, 125]"

Norman,L50,short,35,10,25,3,0.7407,135,"[9, 11, 12, 18, 19, 20, 21, 22, 31, 32, 33, 34, 35, 36, 45, 46, 57, 65, 66, 67, 76, 77, 85, 86, 88, 96, 98, 106, 107, 108, 116, 117, 119, 128, 130]"

Norman,L50,short,34,18,16,4,0.7463,134,"[9, 13, 14, 16, 17, 19, 27, 28, 29, 37, 39, 42, 50, 59, 61, 69, 70, 79, 80, 88, 89, 90, 98, 99, 101, 109, 110, 118, 119, 120, 121, 129, 131, 132]"

Norman,L50,short,31,14,17,6,0.7634,131,"[4, 9, 10, 19, 20, 33, 40, 41, 49, 51, 59, 60, 61, 62, 69, 70, 71, 72, 81, 82, 90, 91, 92, 97, 105, 112, 113, 114, 116, 123, 126]"

Norman,L50,short,30,21,9,2,0.7692,130,"[9, 14, 16, 18, 19, 27, 29, 36, 37, 38, 39, 47, 49, 58, 59, 67, 68, 69, 78, 79, 81, 91, 100, 101, 108, 111, 118, 119, 120, 122]"

Norman,L50,short,35,21,14,7,0.7407,135,"[4, 9, 11, 19, 20, 29, 30, 31, 33, 42, 50, 51, 52, 60, 62, 70, 71, 72, 81, 82, 85, 86, 90, 98, 106, 107, 114, 115, 117, 124, 125, 126, 127, 128, 130]"

Norman,L50,short,33,23,10,4,0.7519,133,"[4, 10, 11, 12, 20, 22, 23, 31, 33, 41, 43, 51, 52, 53, 61, 62, 63, 72, 73, 77, 85, 93, 95, 103, 104, 106, 113, 116, 123, 124, 125, 127, 129]"

Norman,L50,short,30,20,10,3,0.7692,130,"[4, 9, 18, 19, 27, 28, 30, 37, 38, 39, 40, 48, 50, 58, 60, 68, 70, 78, 79, 80, 81, 89, 90, 91, 101, 109, 113, 120, 121, 122]"

Norman,L50,short,34,13,21,11,0.7463,134,"[4, 11, 18, 20, 25, 33, 40, 43, 52, 53, 60, 62, 64, 73, 74, 81, 82, 83, 85, 86, 95, 96, 97, 101, 108, 110, 117, 118, 119, 120, 121, 122, 130, 131]"

Norman,L50,short,33,18,15,3,0.7519,133,"[4, 9, 10, 19, 21, 30, 37, 38, 39, 41, 49, 52, 53, 63, 71, 72, 73, 80, 81, 83, 91, 93, 94, 101, 102, 103, 104, 106, 114, 115, 123, 124, 125]"

Norman,L50,short,31,19,12,5,0.7634,131,"[9, 13, 18, 20, 21, 22, 30, 31, 32, 40, 41, 42, 43, 52, 53, 54, 64, 73, 75, 83, 85, 92, 93, 97, 107, 114, 115, 117, 124, 125, 126]"

Norman,L50,short,27,8,19,10,0.7874,127,"[10, 15, 16, 17, 18, 19, 27, 28, 32, 40, 41, 49, 50, 53, 61, 64, 72, 79, 81, 86, 94, 103, 110, 113, 121, 123, 124]"

Norman,L50,short,38,32,6,3,0.7246,138,"[11, 17, 18, 19, 26, 29, 30, 39, 41, 49, 50, 60, 68, 69, 70, 72, 73, 74, 75, 76, 84, 85, 87, 95, 97, 98, 99, 100, 101, 111, 119, 120, 122, 123, 124, 132, 133, 134]"

Norman,L50,short,34,18,16,9,0.7463,134,"[4, 10, 20, 28, 29, 30, 34, 42, 43, 44, 48, 55, 56, 65, 66, 73, 75, 77, 86, 89, 97, 99, 105, 106, 107, 108, 109, 116, 118, 119, 126, 128, 129, 130]"

Norman,L50,short,33,12,21,4,0.7519,133,"[4, 9, 19, 26, 27, 29, 30, 37, 40, 49, 53, 60, 61, 62, 69, 70, 71, 72, 80, 82, 90, 91, 92, 93, 94, 96, 104, 106, 114, 115, 123, 124, 126]"

Norman,L50,short,32,20,12,4,0.7576,132,"[4, 9, 18, 19, 22, 32, 40, 41, 51, 58, 60, 61, 62, 69, 72, 79, 80, 81, 82, 83, 85, 94, 95, 96, 103, 104, 107, 114, 116, 117, 126, 127]"

Norman,L50,short,34,11,23,7,0.7463,134,"[5, 9, 10, 21, 28, 29, 31, 38, 39, 40, 41, 49, 51, 52, 61, 63, 71, 73, 84, 85, 94, 95, 97, 100, 107, 108, 115, 117, 118, 119, 121, 123, 131, 132]"

Norman,L50,short,25,12,13,17,0.8,125,"[12, 17, 18, 19, 20, 28, 29, 32, 40, 48, 55, 62, 71, 80, 84, 90, 91, 99, 100, 102, 108, 113, 119, 120, 122]"

Norman,L50,short,29,17,12,5,0.7752,129,"[4, 9, 18, 19, 20, 28, 31, 38, 39, 40, 42, 52, 60, 61, 62, 73, 81, 82, 84, 92, 94, 101, 104, 111, 113, 120, 121, 122, 123]"

Norman,L50,short,30,16,14,6,0.7692,130,"[7, 10, 18, 19, 27, 28, 29, 32, 40, 48, 49, 50, 52, 54, 64, 72, 73, 82, 83, 91, 92, 93, 101, 102, 104, 111, 115, 122, 123, 124]"

Norman,L50,short,26,16,10,9,0.7937,126,"[4, 9, 19, 28, 31, 39, 46, 48, 49, 52, 59, 60, 61, 68, 71, 81, 89, 91, 93, 101, 105, 112, 118, 120, 121, 124]"

Norman,L50,short,30,23,7,13,0.7692,130,"[9, 10, 14, 15, 16, 19, 20, 23, 33, 43, 51, 53, 60, 61, 62, 64, 72, 73, 82, 84, 91, 94, 106, 113, 120, 121, 122, 123, 124, 128]"

Norman,L50,short,33,13,20,6,0.7519,133,"[4, 10, 18, 19, 27, 29, 37, 39, 47, 48, 49, 57, 58, 59, 60, 68, 70, 78, 79, 80, 81, 84, 92, 102, 106, 113, 115, 122, 123, 124, 125, 126, 127]"

Norman,L50,short,29,16,13,9,0.7752,129,"[10, 16, 17, 19, 20, 23, 30, 32, 41, 49, 51, 59, 62, 69, 75, 84, 91, 92, 99, 100, 101, 102, 103, 109, 110, 112, 113, 121, 123]"

Norman,L50,short,35,12,23,6,0.7407,135,"[4, 9, 20, 28, 29, 30, 37, 38, 39, 40, 41, 42, 46, 54, 55, 56, 57, 59, 68, 69, 70, 71, 80, 81, 90, 93, 102, 110, 111, 119, 120, 121, 122, 130, 132]"

Norman,L50,short,32,18,14,2,0.7576,132,"[5, 9, 11, 20, 29, 30, 37, 39, 41, 49, 50, 51, 59, 60, 61, 69, 70, 71, 80, 82, 90, 91, 92, 93, 101, 103, 111, 112, 113, 121, 122, 124]"

Norman,L50,short,32,13,19,8,0.7576,132,"[4, 10, 18, 22, 29, 35, 42, 49, 50, 51, 52, 61, 63, 70, 71, 72, 83, 91, 92, 98, 99, 100, 101, 102, 109, 110, 111, 112, 119, 120, 122, 130]"

Norman,L50,short,21,14,7,17,0.8264,121,"[5, 11, 21, 28, 29, 37, 38, 40, 41, 42, 50, 51, 54, 66, 73, 80, 82, 90, 94, 106, 115]"

Norman,L50,short,31,12,19,7,0.7634,131,"[11, 17, 18, 20, 21, 30, 32, 42, 50, 52, 59, 60, 61, 68, 69, 70, 72, 79, 81, 89, 90, 91, 99, 101, 102, 111, 112, 114, 121, 122, 125]"

Norman,L50,short,35,23,12,6,0.7407,135,"[10, 14, 15, 16, 17, 18, 19, 20, 29, 30, 31, 32, 41, 42, 43, 52, 53, 62, 64, 73, 74, 82, 83, 85, 95, 103, 104, 105, 107, 115, 116, 124, 125, 126, 130]"

Norman,L50,short,36,14,22,8,0.7353,136,"[5, 11, 18, 21, 28, 30, 37, 38, 39, 40, 42, 51, 59, 60, 63, 70, 71, 79, 80, 81, 90, 91, 100, 102, 109, 110, 111, 113, 120, 121, 122, 123, 131, 132, 133, 134]"

Norman,L50,short,31,9,22,8,0.7634,131,"[9, 15, 16, 17, 18, 20, 21, 22, 24, 33, 41, 42, 43, 52, 53, 61, 63, 71, 72, 74, 82, 84, 88, 97, 105, 107, 114, 116, 117, 125, 126]"

Norman,L50,short,30,17,13,12,0.7692,130,"[9, 10, 14, 15, 16, 17, 19, 20, 21, 24, 33, 42, 43, 52, 54, 62, 65, 75, 83, 93, 97, 104, 105, 112, 113, 115, 116, 117, 124, 125]"

Norman,L50,short,33,20,13,4,0.7519,133,"[9, 14, 15, 16, 17, 20, 28, 29, 37, 39, 48, 49, 50, 58, 59, 61, 69, 70, 78, 80, 87, 88, 89, 91, 100, 101, 102, 103, 112, 113, 121, 122, 125]"

Norman,L50,short,34,15,19,5,0.7463,134,"[4, 9, 18, 19, 27, 28, 30, 37, 38, 39, 47, 49, 57, 58, 59, 69, 77, 78, 81, 89, 90, 91, 92, 101, 102, 104, 112, 113, 120, 121, 122, 123, 131, 132]"

Norman,L50,short,32,19,13,9,0.7576,132,"[4, 9, 12, 20, 23, 32, 39, 40, 41, 42, 52, 60, 61, 62, 63, 70, 71, 72, 76, 85, 93, 94, 95, 103, 104, 105, 106, 114, 115, 116, 125, 128]"

Norman,L50,short,32,6,26,2,0.7576,132,"[9, 15, 16, 17, 19, 27, 28, 29, 30, 31, 39, 40, 42, 51, 60, 61, 63, 71, 72, 73, 83, 91, 92, 94, 104, 111, 112, 113, 114, 122, 123, 125]"

Norman,L50,short,31,18,13,5,0.7634,131,"[11, 17, 19, 20, 22, 23, 31, 32, 33, 34, 43, 44, 47, 56, 64, 67, 75, 82, 83, 85, 94, 95, 103, 105, 113, 115, 116, 123, 124, 125, 126]"

Norman,L50,short,30,10,20,5,0.7692,130,"[4, 11, 18, 20, 28, 29, 36, 37, 38, 39, 47, 49, 58, 59, 61, 70, 71, 79, 81, 89, 93, 101, 108, 109, 111, 112, 120, 122, 124, 125]"

Norman,L50,short,32,10,22,5,0.7576,132,"[4, 9, 11, 21, 28, 29, 30, 37, 38, 40, 48, 49, 50, 58, 60, 62, 72, 79, 81, 82, 90, 91, 92, 100, 101, 104, 113, 114, 115, 116, 124, 126]"

Norman,L50,short,33,25,8,5,0.7519,133,"[9, 14, 15, 18, 19, 21, 31, 40, 41, 49, 51, 59, 61, 62, 70, 71, 72, 74, 82, 83, 90, 91, 92, 93, 101, 102, 107, 114, 116, 118, 126, 127, 130]"

Norman,L50,short,29,23,6,5,0.7752,129,"[9, 13, 15, 19, 21, 29, 30, 38, 39, 40, 43, 51, 52, 61, 62, 70, 72, 73, 83, 91, 92, 94, 102, 104, 113, 114, 121, 122, 125]"

Norman,L50,short,26,19,7,3,0.7937,126,"[5, 9, 18, 19, 21, 30, 37, 40, 41, 49, 50, 52, 60, 61, 69, 70, 71, 80, 82, 91, 98, 101, 109, 112, 121, 122]"

Norman,L50,short,30,15,15,8,0.7692,130,"[9, 14, 16, 18, 19, 21, 30, 34, 41, 49, 50, 51, 53, 56, 64, 73, 74, 76, 84, 85, 86, 87, 95, 96, 97, 107, 114, 116, 120, 128]"

Norman,L50,short,31,16,15,6,0.7634,131,"[4, 9, 18, 20, 28, 29, 36, 38, 39, 46, 47, 48, 49, 50, 60, 70, 78, 79, 82, 91, 98, 100, 104, 112, 118, 119, 120, 121, 122, 125, 126]"

Norman,L50,short,34,13,21,6,0.7463,134,"[9, 13, 14, 15, 16, 17, 19, 20, 23, 32, 41, 49, 50, 51, 52, 61, 64, 73, 81, 82, 83, 84, 87, 95, 96, 104, 105, 106, 114, 116, 124, 125, 127, 128]"

Norman,L50,short,29,14,15,8,0.7752,129,"[9, 11, 15, 16, 18, 19, 22, 30, 32, 40, 41, 45, 55, 65, 72, 73, 83, 90, 92, 93, 103, 109, 110, 113, 120, 122, 123, 124, 125]"

Norman,L50,short,33,6,27,3,0.7519,133,"[9, 13, 14, 17, 18, 20, 28, 30, 31, 40, 41, 42, 50, 51, 53, 61, 62, 63, 64, 73, 74, 75, 84, 85, 95, 104, 105, 113, 114, 115, 119, 127, 128]"

Norman,L50,short,26,17,9,5,0.7937,126,"[4, 9, 19, 26, 27, 29, 36, 38, 40, 49, 57, 59, 61, 72, 82, 90, 92, 98, 99, 100, 101, 102, 113, 120, 121, 124]"

Norman,L50,short,31,16,15,8,0.7634,131,"[6, 9, 11, 20, 21, 29, 31, 39, 42, 49, 52, 60, 61, 62, 69, 70, 71, 72, 85, 93, 100, 102, 103, 110, 113, 120, 121, 122, 123, 124, 126]"

Norman,L50,short,29,8,21,8,0.7752,129,"[10, 14, 15, 18, 19, 20, 21, 29, 30, 31, 33, 42, 51, 53, 61, 64, 72, 79, 80, 81, 82, 92, 100, 101, 105, 112, 119, 120, 122]"

Norman,L50,short,30,11,19,7,0.7692,130,"[5, 9, 18, 20, 28, 29, 36, 37, 38, 40, 48, 49, 53, 61, 68, 70, 71, 79, 80, 82, 90, 92, 100, 101, 102, 110, 113, 120, 123, 126]"

Norman,L50,short,32,11,21,2,0.7576,132,"[10, 16, 17, 19, 27, 28, 29, 36, 38, 40, 48, 49, 50, 51, 52, 60, 61, 62, 71, 73, 82, 83, 91, 92, 93, 102, 104, 112, 114, 123, 124, 125]"

Norman,L50,short,31,17,14,4,0.7634,131,"[4, 9, 21, 28, 29, 31, 38, 39, 40, 49, 50, 60, 67, 68, 69, 70, 78, 80, 88, 89, 90, 98, 100, 102, 111, 118, 119, 120, 121, 122, 123]"

Norman,L50,short,32,17,15,5,0.7576,132,"[4, 10, 11, 19, 20, 21, 22, 30, 31, 33, 41, 42, 44, 46, 47, 48, 49, 50, 59, 60, 62, 72, 80, 81, 82, 91, 92, 101, 104, 112, 121, 125]"

Norman,L50,short,31,15,16,8,0.7634,131,"[4, 9, 11, 19, 22, 31, 32, 33, 41, 43, 44, 52, 54, 62, 63, 65, 79, 87, 95, 101, 102, 103, 107, 114, 116, 117, 123, 124, 125, 127, 128]"

Norman,L50,short,33,21,12,2,0.7519,133,"[9, 13, 15, 16, 17, 19, 27, 28, 29, 37, 38, 39, 48, 49, 51, 60, 70, 71, 82, 83, 85, 92, 93, 94, 95, 103, 104, 106, 116, 118, 127, 129, 130]"

Norman,L50,short,29,12,17,5,0.7752,129,"[4, 9, 19, 26, 27, 28, 29, 37, 40, 48, 49, 57, 58, 60, 70, 77, 78, 79, 81, 90, 97, 98, 100, 107, 108, 109, 113, 120, 121]"

Norman,L50,short,31,17,14,16,0.7634,131,"[4, 9, 19, 22, 29, 31, 32, 39, 41, 42, 50, 51, 52, 60, 61, 62, 63, 72, 73, 81, 90, 98, 105, 112, 114, 115, 122, 123, 125, 126, 127]"

Norman,L50,short,30,21,9,14,0.7692,130,"[9, 10, 11, 12, 21, 25, 32, 43, 50, 51, 52, 53, 60, 61, 62, 65, 74, 81, 82, 83, 84, 85, 86, 87, 96, 99, 108, 116, 117, 121]"

Norman,L50,short,36,21,15,7,0.7353,136,"[10, 14, 15, 16, 18, 19, 20, 21, 33, 42, 50, 51, 52, 54, 55, 56, 64, 65, 66, 67, 78, 80, 88, 92, 101, 109, 110, 111, 112, 119, 120, 121, 123, 131, 132, 133]"

Norman,L50,short,39,16,23,3,0.7194,139,"[9, 10, 11, 15, 16, 18, 19, 20, 23, 32, 34, 43, 51, 52, 54, 62, 63, 72, 73, 74, 75, 83, 85, 93, 94, 95, 96, 97, 98, 99, 101, 109, 112, 113, 114, 124, 133, 135, 136]"

Norman,L50,short,31,18,13,2,0.7634,131,"[9, 13, 16, 17, 20, 29, 37, 39, 48, 49, 60, 67, 68, 69, 76, 77, 79, 83, 90, 91, 92, 94, 102, 103, 104, 111, 112, 114, 121, 123, 124]"

Norman,L50,short,30,15,15,5,0.7692,130,"[9, 10, 13, 19, 20, 21, 25, 27, 35, 36, 44, 47, 55, 57, 66, 67, 75, 76, 79, 87, 90, 91, 99, 102, 110, 112, 119, 120, 122, 124]"

Norman,L50,short,32,22,10,5,0.7576,132,"[4, 9, 13, 22, 29, 30, 31, 32, 40, 41, 42, 43, 52, 56, 64, 65, 73, 74, 76, 84, 85, 86, 87, 98, 107, 108, 115, 116, 119, 126, 127, 128]"

Norman,L50,short,26,16,10,13,0.7937,126,"[11, 17, 18, 19, 20, 30, 31, 34, 41, 42, 43, 52, 54, 63, 64, 72, 73, 75, 86, 93, 95, 103, 105, 112, 113, 117]"

Norman,L50,short,32,15,17,2,0.7576,132,"[9, 14, 15, 16, 18, 19, 27, 28, 29, 37, 40, 48, 49, 51, 61, 69, 71, 72, 80, 82, 84, 91, 92, 93, 101, 102, 103, 104, 114, 115, 124, 125]"

Norman,L50,short,35,25,10,1,0.7407,135,"[9, 13, 14, 16, 17, 18, 19, 28, 29, 30, 31, 40, 41, 51, 59, 61, 69, 70, 71, 80, 82, 90, 91, 101, 108, 109, 110, 111, 118, 120, 121, 128, 130, 131, 132]"

Norman,L50,short,30,13,17,6,0.7692,130,"[6, 9, 10, 21, 31, 38, 39, 41, 42, 43, 45, 46, 47, 55, 58, 59, 68, 69, 77, 78, 79, 88, 89, 91, 99, 101, 110, 118, 120, 125]"

Norman,L50,short,31,22,9,7,0.7634,131,"[10, 14, 15, 16, 17, 18, 19, 20, 29, 31, 39, 40, 48, 49, 52, 60, 61, 70, 74, 84, 92, 94, 107, 113, 114, 115, 117, 124, 125, 127, 129]"

Norman,L50,short,25,9,16,9,0.8,125,"[11, 18, 19, 26, 27, 28, 30, 39, 47, 48, 52, 61, 68, 70, 77, 78, 79, 82, 89, 94, 102, 104, 106, 113, 116]"

Norman,L50,short,32,9,23,7,0.7576,132,"[13, 19, 20, 21, 23, 30, 33, 41, 42, 43, 52, 53, 56, 65, 73, 74, 81, 82, 83, 84, 91, 92, 93, 94, 96, 104, 105, 113, 115, 123, 125, 126]"

Norman,L50,short,35,16,19,4,0.7407,135,"[9, 12, 20, 27, 28, 29, 30, 38, 39, 40, 42, 50, 51, 52, 53, 61, 63, 64, 65, 75, 78, 86, 87, 96, 97, 105, 106, 108, 115, 116, 118, 119, 127, 128, 129]"

Norman,L50,short,31,7,24,14,0.7634,131,"[11, 17, 20, 28, 35, 43, 50, 51, 58, 59, 60, 63, 70, 72, 80, 81, 87, 88, 90, 92, 99, 100, 101, 102, 103, 104, 113, 114, 115, 123, 125]"

Norman,L50,short,31,19,12,4,0.7634,131,"[9, 13, 15, 19, 27, 30, 39, 40, 41, 51, 58, 59, 61, 69, 71, 72, 80, 81, 85, 92, 101, 102, 108, 109, 110, 111, 112, 121, 122, 123, 124]"

Norman,L50,short,34,18,16,10,0.7463,134,"[10, 11, 12, 20, 21, 22, 26, 34, 41, 42, 43, 46, 54, 56, 66, 75, 76, 84, 90, 97, 98, 105, 106, 107, 108, 109, 110, 112, 119, 120, 121, 129, 130, 131]"

Norman,L50,short,32,19,13,7,0.7576,132,"[7, 10, 18, 19, 29, 31, 38, 39, 40, 42, 53, 60, 61, 63, 64, 65, 67, 75, 77, 87, 95, 97, 105, 106, 113, 114, 115, 116, 123, 125, 126, 127]"

Norman,L50,short,34,20,14,2,0.7463,134,"[6, 9, 18, 20, 29, 38, 39, 40, 48, 49, 51, 59, 61, 62, 69, 70, 71, 72, 82, 90, 91, 92, 101, 102, 109, 110, 111, 112, 119, 121, 122, 130, 131, 132]"

Norman,L50,short,34,6,28,6,0.7463,134,"[9, 10, 12, 18, 19, 21, 22, 30, 31, 32, 33, 34, 43, 45, 48, 58, 66, 69, 77, 86, 87, 88, 89, 97, 99, 107, 108, 109, 118, 120, 128, 129, 130, 132]"

Norman,L50,short,32,19,13,4,0.7576,132,"[5, 10, 18, 19, 21, 29, 30, 31, 40, 42, 50, 52, 54, 63, 64, 75, 84, 91, 92, 93, 95, 102, 103, 104, 111, 112, 113, 114, 121, 122, 124, 125]"

Norman,L50,short,35,17,18,2,0.7407,135,"[5, 9, 18, 19, 22, 30, 31, 32, 41, 42, 50, 52, 60, 61, 62, 71, 72, 79, 80, 81, 82, 92, 93, 94, 102, 103, 104, 106, 107, 115, 117, 118, 126, 127, 130]"

Norman,L50,short,27,12,15,14,0.7874,127,"[4, 14, 24, 31, 37, 39, 41, 53, 60, 67, 68, 69, 70, 78, 79, 80, 90, 96, 98, 99, 100, 107, 109, 110, 112, 120, 121]"

Norman,L50,short,32,15,17,7,0.7576,132,"[10, 14, 16, 17, 19, 20, 21, 23, 32, 33, 41, 43, 44, 45, 46, 50, 59, 67, 68, 69, 79, 80, 83, 84, 93, 96, 104, 112, 113, 114, 121, 124]"

Norman,L50,short,32,20,12,3,0.7576,132,"[4, 9, 10, 11, 12, 13, 22, 23, 24, 33, 34, 36, 48, 56, 57, 65, 66, 67, 76, 77, 78, 86, 87, 89, 98, 106, 109, 118, 125, 126, 127, 128]"

Norman,L50,short,33,11,22,8,0.7519,133,"[9, 16, 17, 21, 28, 30, 40, 49, 57, 60, 67, 68, 69, 76, 78, 79, 80, 87, 88, 89, 90, 91, 92, 101, 102, 104, 112, 113, 114, 116, 124, 127, 130]"

Norman,L50,short,31,18,13,11,0.7634,131,"[9, 16, 17, 19, 22, 29, 31, 39, 42, 49, 50, 58, 59, 61, 69, 70, 78, 79, 81, 89, 93, 101, 102, 103, 104, 106, 114, 116, 124, 125, 129]"

Norman,L50,short,31,22,9,8,0.7634,131,"[4, 10, 18, 19, 27, 30, 31, 38, 40, 41, 44, 52, 53, 54, 62, 63, 64, 66, 67, 75, 76, 79, 89, 97, 98, 106, 108, 115, 116, 119, 122]"

Norman,L50,short,28,13,15,6,0.7812,128,"[9, 10, 14, 15, 19, 20, 28, 29, 30, 38, 40, 48, 49, 51, 61, 69, 70, 74, 82, 89, 90, 91, 92, 100, 102, 110, 115, 123]"

Norman,L50,short,29,16,13,4,0.7752,129,"[10, 15, 16, 19, 20, 21, 29, 30, 31, 41, 43, 51, 52, 60, 61, 62, 70, 73, 82, 83, 84, 91, 92, 95, 103, 106, 114, 116, 125]"

Norman,L50,short,31,14,17,2,0.7634,131,"[4, 10, 19, 20, 22, 30, 32, 39, 41, 42, 50, 52, 60, 62, 72, 81, 82, 90, 92, 93, 99, 100, 101, 102, 103, 111, 112, 114, 116, 123, 125]"

Norman,L50,short,28,15,13,7,0.7812,128,"[4, 9, 18, 19, 27, 29, 40, 47, 48, 49, 54, 62, 63, 70, 71, 72, 77, 84, 85, 95, 102, 105, 116, 122, 123, 124, 125, 126]"

Norman,L50,short,30,18,12,6,0.7692,130,"[9, 13, 16, 17, 18, 19, 27, 28, 30, 39, 47, 48, 49, 57, 59, 67, 69, 79, 84, 92, 99, 100, 101, 108, 109, 110, 112, 120, 121, 122]"

Norman,L50,short,29,11,18,7,0.7752,129,"[5, 9, 18, 20, 31, 38, 39, 42, 43, 50, 51, 52, 54, 63, 64, 73, 76, 83, 85, 93, 94, 96, 104, 106, 114, 115, 116, 123, 126]"

Norman,L50,short,30,26,4,3,0.7692,130,"[4, 11, 19, 20, 21, 30, 31, 39, 40, 42, 51, 60, 62, 69, 71, 72, 73, 74, 82, 84, 85, 94, 95, 96, 104, 106, 113, 117, 124, 126]"

Norman,L50,short,35,13,22,2,0.7407,135,"[10, 11, 15, 17, 18, 19, 20, 22, 30, 31, 32, 41, 43, 52, 53, 61, 63, 71, 72, 73, 81, 82, 83, 92, 93, 102, 103, 107, 108, 117, 118, 126, 127, 128, 130]"

Norman,L50,short,32,15,17,12,0.7576,132,"[9, 14, 15, 16, 17, 18, 19, 28, 32, 40, 48, 52, 61, 69, 70, 78, 79, 80, 81, 89, 90, 91, 93, 94, 95, 103, 107, 114, 115, 123, 125, 127]"

Norman,L50,short,29,16,13,9,0.7752,129,"[4, 11, 18, 20, 29, 37, 38, 40, 48, 49, 50, 58, 59, 60, 68, 69, 70, 78, 79, 80, 91, 99, 101, 109, 110, 117, 118, 119, 123]"

Norman,L50,short,32,21,11,6,0.7576,132,"[4, 10, 20, 27, 28, 29, 30, 31, 39, 41, 42, 43, 51, 52, 54, 64, 66, 74, 75, 77, 78, 86, 90, 100, 108, 115, 116, 117, 118, 126, 127, 128]"

Norman,L50,short,31,14,17,7,0.7634,131,"[9, 11, 17, 18, 19, 20, 22, 24, 33, 41, 43, 45, 53, 56, 64, 66, 74, 75, 83, 85, 94, 95, 103, 104, 105, 112, 113, 117, 124, 125, 126]"

Norman,L50,short,38,23,15,6,0.7246,138,"[12, 17, 18, 19, 22, 29, 31, 32, 40, 42, 50, 51, 52, 61, 63, 72, 79, 80, 81, 83, 90, 91, 92, 93, 94, 96, 97, 106, 107, 109, 110, 111, 112, 113, 121, 122, 124, 133]"

Norman,L50,short,34,22,12,3,0.7463,134,"[4, 10, 18, 19, 27, 28, 30, 37, 38, 39, 47, 48, 49, 57, 58, 60, 68, 69, 71, 80, 81, 89, 90, 91, 94, 95, 104, 105, 106, 114, 115, 116, 126, 127]"

Norman,L50,short,33,18,15,3,0.7519,133,"[4, 9, 18, 19, 21, 30, 38, 39, 42, 49, 50, 59, 60, 67, 69, 70, 71, 72, 73, 74, 77, 87, 95, 97, 105, 106, 107, 114, 117, 124, 125, 126, 127]"

Norman,L50,short,32,13,19,5,0.7576,132,"[10, 15, 16, 17, 18, 19, 22, 30, 38, 39, 41, 52, 53, 54, 62, 63, 65, 73, 74, 75, 76, 84, 86, 94, 95, 96, 104, 105, 108, 116, 124, 126]"

Norman,L50,short,33,25,8,6,0.7519,133,"[4, 9, 18, 20, 28, 31, 38, 39, 40, 48, 50, 59, 60, 62, 70, 71, 72, 73, 74, 75, 84, 87, 96, 104, 105, 107, 114, 117, 118, 125, 126, 127, 130]"

Norman,L50,short,32,22,10,12,0.7576,132,"[4, 9, 19, 20, 21, 29, 30, 33, 41, 42, 43, 51, 52, 55, 66, 75, 82, 83, 84, 85, 86, 94, 95, 99, 107, 114, 115, 117, 124, 125, 126, 129]"

Norman,L50,short,29,15,14,9,0.7752,129,"[12, 20, 28, 29, 30, 32, 33, 34, 35, 36, 37, 40, 48, 50, 59, 62, 72, 73, 82, 84, 94, 101, 103, 106, 113, 114, 121, 124, 125]"

Norman,L50,short,29,18,11,18,0.7752,129,"[4, 9, 18, 19, 27, 28, 30, 40, 48, 52, 59, 60, 61, 62, 72, 80, 87, 94, 95, 96, 102, 103, 105, 106, 109, 116, 118, 119, 127]"

Norman,L50,short,29,11,18,8,0.7752,129,"[9, 13, 18, 19, 20, 21, 29, 30, 31, 39, 40, 41, 49, 52, 60, 61, 69, 70, 71, 73, 83, 92, 101, 105, 111, 112, 119, 121, 122]"

Norman,L50,short,27,15,12,11,0.7874,127,"[9, 10, 14, 15, 16, 17, 18, 22, 30, 38, 39, 40, 48, 54, 62, 70, 79, 80, 82, 89, 90, 92, 101, 110, 111, 120, 122]"

Norman,L50,short,31,17,14,4,0.7634,131,"[9, 13, 14, 15, 17, 18, 20, 22, 30, 31, 39, 40, 41, 42, 51, 52, 61, 62, 64, 73, 82, 84, 92, 93, 102, 104, 112, 113, 121, 122, 123]"

Norman,L50,short,37,16,21,2,0.7299,137,"[9, 13, 15, 16, 17, 21, 29, 30, 38, 39, 41, 42, 50, 51, 52, 60, 61, 62, 71, 72, 73, 74, 75, 76, 78, 88, 89, 97, 98, 99, 108, 109, 118, 119, 127, 129, 130]"

Norman,L50,short,34,15,19,7,0.7463,134,"[9, 13, 14, 15, 17, 18, 20, 29, 37, 39, 48, 49, 57, 58, 59, 60, 61, 66, 74, 82, 83, 86, 93, 94, 102, 103, 105, 113, 114, 115, 117, 118, 126, 128]"

Norman,L50,short,27,9,18,12,0.7874,127,"[9, 13, 17, 21, 29, 36, 37, 38, 40, 49, 57, 60, 67, 68, 69, 71, 79, 80, 81, 89, 91, 99, 100, 106, 114, 121, 122]"

Norman,L50,short,28,16,12,11,0.7812,128,"[4, 9, 20, 27, 29, 30, 32, 34, 43, 45, 54, 61, 62, 64, 71, 72, 74, 83, 84, 92, 93, 94, 104, 105, 112, 113, 114, 120]"

Norman,L50,short,30,15,15,7,0.7692,130,"[9, 13, 15, 17, 18, 19, 20, 29, 30, 38, 39, 40, 48, 52, 60, 61, 72, 84, 92, 99, 100, 101, 108, 109, 110, 111, 118, 119, 120, 122]"

Norman,L50,short,33,18,15,6,0.7519,133,"[10, 14, 15, 16, 17, 19, 20, 21, 22, 31, 33, 42, 51, 53, 62, 63, 64, 65, 73, 74, 75, 78, 86, 88, 98, 106, 108, 116, 118, 125, 126, 127, 128]"

Norman,L50,short,33,11,22,2,0.7519,133,"[4, 9, 19, 20, 28, 29, 31, 38, 39, 40, 41, 49, 51, 59, 60, 61, 62, 70, 71, 73, 74, 84, 93, 94, 95, 103, 104, 105, 114, 117, 125, 126, 128]"

Norman,L50,short,31,12,19,6,0.7634,131,"[9, 13, 16, 17, 18, 19, 20, 29, 31, 39, 40, 41, 49, 50, 51, 52, 53, 62, 63, 73, 74, 82, 83, 86, 95, 103, 105, 115, 123, 124, 125]"

Norman,L50,short,30,10,20,12,0.7692,130,"[9, 15, 16, 17, 18, 19, 20, 26, 34, 43, 53, 54, 56, 64, 65, 74, 75, 82, 84, 86, 94, 95, 96, 104, 105, 106, 115, 116, 125, 126]"

Norman,L50,short,30,13,17,9,0.7692,130,"[9, 13, 14, 15, 17, 18, 20, 29, 34, 42, 51, 61, 62, 63, 71, 72, 73, 80, 81, 82, 84, 91, 93, 101, 102, 103, 112, 113, 120, 124]"

Norman,L50,short,30,16,14,3,0.7692,130,"[11, 17, 18, 19, 21, 29, 30, 31, 39, 40, 41, 50, 53, 62, 70, 72, 79, 81, 82, 89, 90, 92, 102, 109, 110, 111, 112, 121, 124, 125]"

Norman,L50,short,32,20,12,8,0.7576,132,"[11, 19, 20, 21, 22, 29, 33, 40, 41, 43, 51, 52, 54, 62, 63, 72, 73, 80, 82, 83, 84, 85, 86, 95, 96, 97, 105, 109, 118, 125, 126, 128]"

Norman,L50,short,24,14,10,5,0.8065,124,"[4, 9, 18, 19, 28, 29, 38, 40, 42, 50, 51, 52, 55, 64, 65, 74, 77, 84, 85, 93, 94, 96, 107, 120]"

Norman,L50,short,24,13,11,16,0.8065,124,"[13, 19, 20, 21, 28, 31, 39, 40, 42, 49, 52, 59, 60, 62, 71, 78, 85, 92, 94, 95, 106, 109, 117, 118]"

Norman,L50,short,27,16,11,7,0.7874,127,"[4, 9, 18, 20, 23, 25, 34, 41, 42, 44, 48, 55, 56, 57, 58, 66, 67, 68, 69, 77, 80, 88, 90, 99, 108, 110, 119]"

Norman,L50,short,32,16,16,8,0.7576,132,"[8, 14, 22, 29, 30, 33, 40, 41, 42, 51, 52, 62, 63, 72, 73, 81, 82, 83, 91, 92, 94, 101, 102, 103, 104, 105, 106, 108, 118, 125, 126, 127]"

Norman,L50,short,29,19,10,8,0.7752,129,"[5, 11, 18, 19, 20, 32, 39, 40, 49, 50, 60, 67, 68, 69, 72, 80, 87, 88, 89, 90, 91, 101, 108, 112, 120, 121, 122, 123, 125]"

Norman,L50,short,35,8,27,4,0.7407,135,"[10, 11, 12, 18, 19, 20, 21, 23, 31, 33, 42, 50, 51, 52, 53, 61, 65, 73, 74, 75, 83, 85, 92, 93, 94, 95, 96, 105, 106, 115, 116, 117, 126, 127, 128]"

Norman,L50,short,26,16,10,14,0.7937,126,"[4, 9, 18, 19, 27, 30, 38, 39, 48, 51, 58, 60, 68, 70, 77, 79, 88, 91, 97, 98, 99, 101, 108, 109, 112, 124]"

Norman,L50,short,32,23,9,0,0.7576,132,"[4, 9, 19, 27, 28, 29, 30, 37, 39, 40, 48, 51, 53, 62, 64, 72, 73, 74, 83, 84, 85, 93, 94, 95, 102, 103, 106, 114, 115, 117, 118, 128]"

Norman,L50,short,33,21,12,3,0.7519,133,"[10, 14, 15, 21, 28, 29, 37, 39, 48, 49, 50, 58, 59, 61, 70, 71, 72, 79, 82, 92, 100, 102, 108, 109, 110, 111, 112, 115, 116, 117, 118, 126, 128]"

Norman,L50,short,31,7,24,2,0.7634,131,"[10, 15, 16, 17, 18, 19, 27, 28, 29, 37, 39, 41, 42, 51, 52, 60, 63, 71, 72, 73, 83, 91, 92, 94, 103, 111, 113, 114, 121, 123, 125]"

Norman,L50,short,28,15,13,3,0.7812,128,"[4, 9, 10, 20, 29, 30, 31, 38, 39, 40, 42, 50, 52, 61, 62, 70, 71, 72, 81, 82, 90, 94, 103, 105, 112, 114, 116, 126]"

Norman,L50,short,33,18,15,7,0.7519,133,"[10, 14, 16, 17, 18, 19, 20, 23, 33, 41, 42, 43, 51, 54, 55, 63, 64, 68, 76, 84, 86, 94, 95, 97, 105, 106, 113, 115, 116, 117, 125, 126, 127]"

Norman,L50,short,29,9,20,7,0.7752,129,"[4, 10, 19, 21, 31, 39, 40, 42, 49, 50, 52, 53, 61, 62, 65, 73, 75, 83, 85, 94, 96, 103, 104, 105, 106, 108, 117, 119, 127]"

Norman,L50,short,26,13,13,3,0.7937,126,"[10, 14, 15, 17, 19, 21, 23, 24, 36, 44, 52, 53, 54, 62, 63, 64, 74, 81, 84, 85, 93, 95, 107, 114, 115, 118]"

Norman,L50,short,28,17,11,0,0.7812,128,"[9, 10, 15, 17, 19, 20, 28, 29, 30, 38, 39, 40, 48, 49, 50, 51, 60, 61, 71, 80, 81, 91, 99, 101, 111, 118, 120, 121]"

Norman,L50,short,29,16,13,4,0.7752,129,"[9, 14, 15, 17, 20, 28, 29, 30, 40, 48, 49, 50, 58, 59, 60, 68, 69, 70, 78, 79, 80, 88, 91, 99, 100, 110, 111, 114, 122]"

Norman,L50,short,31,10,21,4,0.7634,131,"[9, 10, 17, 18, 19, 20, 28, 29, 30, 38, 39, 40, 42, 51, 52, 60, 61, 63, 74, 82, 83, 84, 93, 94, 102, 104, 113, 115, 123, 124, 126]"

Norman,L50,short,30,10,20,8,0.7692,130,"[10, 14, 17, 20, 28, 29, 30, 39, 40, 48, 49, 50, 51, 59, 60, 65, 73, 80, 81, 82, 91, 92, 93, 103, 110, 111, 112, 113, 121, 123]"

Norman,L50,short,32,11,21,5,0.7576,132,"[9, 10, 14, 16, 17, 22, 30, 38, 39, 40, 41, 49, 50, 52, 53, 61, 63, 71, 73, 82, 83, 84, 86, 94, 95, 97, 105, 106, 107, 117, 126, 129]"

Norman,L50,short,31,17,14,5,0.7634,131,"[4, 9, 18, 19, 27, 28, 29, 37, 38, 41, 50, 59, 60, 68, 70, 78, 79, 80, 89, 90, 97, 98, 100, 103, 110, 111, 119, 120, 121, 122, 123]"

Norman,L50,short,30,16,14,9,0.7692,130,"[4, 9, 10, 20, 28, 30, 31, 32, 45, 53, 65, 72, 74, 80, 81, 83, 91, 93, 94, 102, 103, 104, 105, 109, 116, 118, 125, 126, 127, 128]"

Norman,L50,short,32,16,16,13,0.7576,132,"[6, 9, 18, 21, 28, 35, 42, 49, 52, 59, 61, 68, 70, 71, 72, 79, 80, 81, 82, 84, 92, 93, 100, 101, 103, 112, 113, 120, 121, 122, 124, 125]"

Norman,L50,short,33,20,13,12,0.7519,133,"[4, 9, 13, 21, 28, 29, 30, 33, 41, 49, 50, 51, 54, 64, 71, 72, 73, 80, 83, 85, 87, 95, 98, 105, 106, 107, 114, 115, 116, 119, 126, 127, 129]"

Norman,L50,short,32,16,16,9,0.7576,132,"[10, 15, 16, 19, 26, 27, 28, 29, 30, 39, 42, 55, 62, 69, 70, 73, 80, 81, 83, 90, 92, 93, 101, 105, 106, 107, 114, 115, 116, 117, 126, 128]"

Norman,L50,short,26,12,14,13,0.7937,126,"[10, 15, 16, 17, 18, 19, 24, 32, 33, 42, 43, 51, 52, 53, 56, 64, 66, 68, 78, 86, 87, 96, 99, 107, 113, 120]"

Norman,L50,short,29,18,11,6,0.7752,129,"[9, 12, 19, 20, 21, 30, 32, 39, 40, 41, 49, 51, 61, 68, 69, 71, 78, 80, 81, 82, 90, 91, 95, 103, 104, 113, 115, 123, 124]"

Norman,L50,short,29,12,17,5,0.7752,129,"[4, 9, 18, 19, 20, 28, 29, 30, 39, 40, 49, 51, 60, 61, 68, 69, 73, 80, 81, 89, 93, 101, 108, 110, 112, 119, 120, 121, 123]"

Norman,L50,short,33,15,18,4,0.7519,133,"[10, 14, 15, 16, 17, 19, 27, 29, 30, 32, 33, 44, 45, 46, 58, 66, 67, 75, 76, 78, 86, 89, 96, 97, 98, 99, 107, 108, 109, 116, 118, 119, 131]"

Norman,L50,short,33,16,17,10,0.7519,133,"[4, 9, 21, 30, 31, 32, 34, 36, 45, 47, 55, 56, 64, 67, 68, 75, 76, 79, 80, 83, 90, 91, 96, 105, 111, 112, 113, 114, 117, 118, 119, 127, 129]"

Norman,L50,short,31,12,19,5,0.7634,131,"[7, 10, 18, 19, 27, 28, 30, 37, 38, 39, 40, 49, 50, 59, 60, 71, 78, 79, 80, 81, 89, 90, 92, 101, 102, 110, 111, 112, 120, 121, 124]"

Norman,L50,short,32,12,20,5,0.7576,132,"[10, 14, 16, 20, 21, 29, 30, 31, 40, 41, 49, 50, 51, 59, 60, 64, 72, 79, 81, 83, 91, 92, 93, 95, 103, 104, 113, 114, 115, 123, 124, 125]"

Norman,L50,short,32,24,8,5,0.7576,132,"[4, 10, 18, 21, 29, 30, 31, 32, 34, 42, 44, 52, 53, 61, 62, 64, 73, 74, 84, 85, 86, 94, 95, 96, 98, 106, 107, 114, 116, 118, 126, 127]"

Norman,L50,short,31,18,13,5,0.7634,131,"[4, 9, 19, 27, 28, 29, 36, 37, 39, 46, 48, 49, 58, 61, 68, 69, 71, 80, 83, 91, 92, 100, 104, 111, 113, 114, 115, 122, 124, 125, 126]"

Norman,L50,short,31,26,5,2,0.7634,131,"[4, 9, 10, 11, 21, 22, 23, 33, 34, 42, 43, 44, 53, 54, 62, 63, 64, 73, 75, 84, 85, 94, 97, 105, 106, 113, 114, 116, 117, 126, 127]"

Norman,L50,short,35,24,11,3,0.7407,135,"[4, 9, 18, 21, 29, 30, 32, 42, 43, 50, 52, 54, 63, 70, 71, 72, 73, 74, 82, 83, 86, 87, 88, 96, 97, 98, 108, 115, 116, 117, 118, 120, 128, 129, 131]"

Norman,L50,short,34,12,22,4,0.7463,134,"[4, 9, 13, 22, 24, 25, 26, 34, 35, 36, 44, 45, 47, 56, 58, 68, 69, 77, 78, 79, 86, 87, 88, 90, 99, 100, 108, 109, 110, 111, 112, 120, 123, 124]"

Norman,L50,short,30,17,13,6,0.7692,130,"[10, 15, 17, 19, 21, 29, 30, 31, 34, 42, 50, 52, 60, 64, 72, 73, 80, 81, 83, 91, 92, 93, 101, 104, 111, 112, 113, 120, 122, 123]"

Norman,L50,short,26,16,10,7,0.7937,126,"[4, 9, 18, 19, 27, 28, 30, 38, 39, 46, 47, 49, 57, 58, 59, 71, 80, 87, 89, 91, 98, 101, 108, 111, 118, 121]"

Norman,L50,short,32,13,19,8,0.7576,132,"[9, 10, 15, 17, 18, 19, 21, 29, 30, 31, 42, 47, 56, 64, 71, 72, 73, 75, 84, 85, 86, 88, 97, 105, 108, 109, 110, 117, 120, 128, 129, 130]"

Norman,L50,short,35,17,18,6,0.7407,135,"[4, 9, 19, 22, 31, 35, 43, 50, 51, 53, 60, 61, 62, 69, 70, 71, 72, 79, 80, 81, 82, 90, 91, 92, 99, 100, 102, 104, 112, 113, 121, 123, 131, 132, 133]"

Norman,L50,short,32,11,21,2,0.7576,132,"[6, 9, 10, 19, 20, 21, 29, 32, 33, 41, 42, 43, 51, 52, 53, 62, 63, 72, 73, 81, 83, 84, 92, 94, 95, 103, 104, 107, 115, 116, 124, 126]"

Norman,L50,short,31,15,16,0,0.7634,131,"[4, 9, 18, 19, 27, 29, 37, 39, 47, 48, 49, 57, 59, 61, 62, 70, 71, 72, 81, 82, 90, 91, 92, 100, 101, 102, 110, 112, 119, 121, 123]"

Norman,L50,short,33,18,15,6,0.7519,133,"[9, 14, 15, 16, 18, 19, 28, 29, 30, 33, 41, 42, 43, 52, 53, 54, 57, 66, 67, 68, 69, 79, 88, 89, 97, 98, 99, 108, 110, 118, 119, 127, 128]"

Norman,L50,short,28,15,13,8,0.7812,128,"[4, 9, 19, 27, 30, 38, 39, 40, 48, 49, 50, 58, 61, 68, 70, 77, 78, 79, 81, 92, 98, 102, 109, 110, 112, 119, 120, 122]"

Norman,L50,short,25,19,6,10,0.8,125,"[4, 9, 10, 21, 28, 29, 30, 32, 40, 41, 43, 51, 53, 62, 66, 76, 84, 91, 92, 93, 101, 106, 113, 119, 123]"

Norman,L50,short,31,11,20,7,0.7634,131,"[9, 11, 17, 18, 19, 20, 29, 33, 42, 49, 51, 53, 55, 63, 64, 66, 67, 75, 76, 77, 85, 86, 87, 95, 96, 97, 105, 108, 115, 119, 127]"

Norman,L50,short,32,11,21,4,0.7576,132,"[5, 9, 18, 19, 20, 29, 31, 38, 39, 40, 48, 50, 58, 60, 62, 70, 71, 79, 82, 90, 91, 99, 100, 101, 110, 111, 112, 119, 123, 124, 125, 127]"

Norman,L50,short,26,17,9,14,0.7937,126,"[9, 14, 15, 16, 17, 18, 19, 21, 22, 23, 32, 34, 36, 46, 55, 59, 69, 77, 86, 93, 97, 105, 107, 113, 115, 119]"

Norman,L50,short,32,13,19,8,0.7576,132,"[10, 14, 15, 17, 18, 19, 27, 28, 29, 37, 40, 50, 53, 62, 64, 72, 73, 83, 84, 92, 93, 94, 96, 105, 111, 112, 113, 114, 115, 116, 124, 129]"

Norman,L50,short,27,19,8,4,0.7874,127,"[4, 9, 10, 11, 20, 21, 30, 31, 32, 43, 50, 51, 52, 60, 61, 63, 71, 72, 74, 84, 92, 93, 94, 105, 116, 123, 125]"

Norman,L50,short,33,22,11,5,0.7519,133,"[9, 14, 15, 17, 19, 28, 31, 40, 48, 52, 59, 60, 61, 62, 70, 75, 83, 91, 92, 93, 94, 95, 103, 104, 105, 107, 114, 116, 117, 118, 119, 128, 129]"

Norman,L50,short,35,18,17,3,0.7407,135,"[9, 10, 15, 21, 28, 29, 30, 32, 40, 42, 50, 51, 52, 53, 54, 56, 58, 66, 67, 68, 70, 79, 81, 89, 90, 99, 100, 101, 102, 112, 113, 121, 122, 123, 133]"

Norman,L50,short,30,16,14,8,0.7692,130,"[9, 13, 15, 16, 18, 19, 27, 28, 29, 30, 39, 40, 42, 51, 60, 61, 69, 72, 84, 92, 99, 101, 104, 110, 111, 112, 119, 120, 121, 123]"

Norman,L50,short,30,17,13,4,0.7692,130,"[9, 19, 27, 29, 36, 38, 41, 48, 49, 51, 59, 60, 67, 68, 71, 78, 80, 81, 82, 83, 90, 91, 93, 102, 103, 111, 114, 115, 124, 125]"

Norman,L50,short,31,15,16,3,0.7634,131,"[4, 11, 18, 19, 20, 28, 29, 30, 31, 40, 41, 50, 52, 53, 61, 63, 71, 74, 83, 91, 92, 93, 94, 95, 102, 103, 105, 115, 122, 124, 125]"

Norman,L50,short,30,21,9,4,0.7692,130,"[9, 15, 17, 19, 26, 28, 29, 36, 37, 38, 40, 48, 49, 50, 58, 59, 60, 69, 71, 79, 81, 90, 98, 99, 100, 108, 109, 110, 112, 122]"

Norman,L50,short,32,21,11,4,0.7576,132,"[9, 13, 15, 16, 17, 18, 19, 29, 31, 39, 41, 50, 58, 59, 60, 68, 69, 70, 79, 80, 81, 89, 90, 91, 93, 95, 104, 112, 113, 114, 122, 125]"

Norman,L50,short,33,16,17,10,0.7519,133,"[10, 16, 17, 19, 22, 30, 31, 39, 42, 49, 52, 59, 60, 62, 70, 71, 72, 79, 80, 81, 83, 91, 92, 100, 101, 102, 103, 110, 111, 112, 113, 116, 126]"

Norman,L50,short,34,22,12,4,0.7463,134,"[4, 9, 20, 27, 32, 39, 40, 47, 50, 51, 52, 53, 61, 62, 63, 64, 65, 74, 76, 84, 85, 93, 94, 95, 102, 103, 104, 105, 113, 114, 115, 124, 125, 126]"

Norman,L50,short,29,13,16,3,0.7752,129,"[5, 9, 19, 26, 27, 28, 29, 36, 39, 46, 48, 50, 58, 59, 68, 69, 71, 79, 80, 88, 89, 91, 99, 100, 109, 111, 118, 119, 121]"

Norman,L50,short,30,24,6,7,0.7692,130,"[4, 9, 19, 20, 21, 23, 31, 32, 33, 41, 42, 44, 52, 53, 54, 56, 65, 73, 74, 77, 80, 89, 97, 100, 107, 109, 118, 119, 126, 127]"

Norman,L50,short,33,10,23,5,0.7519,133,"[4, 9, 18, 19, 28, 29, 30, 31, 39, 40, 41, 49, 50, 53, 61, 62, 70, 71, 72, 73, 74, 76, 84, 85, 94, 95, 105, 106, 114, 115, 118, 126, 127]"

Norman,L50,short,30,11,19,4,0.7692,130,"[9, 13, 14, 16, 18, 20, 28, 29, 30, 39, 41, 50, 58, 59, 61, 62, 70, 71, 72, 81, 84, 91, 92, 100, 101, 103, 111, 112, 121, 122]"

Norman,L50,short,32,20,12,7,0.7576,132,"[9, 13, 15, 18, 19, 31, 39, 40, 49, 50, 52, 59, 61, 62, 71, 72, 80, 81, 82, 89, 91, 92, 95, 103, 104, 105, 112, 113, 114, 115, 124, 127]"

Norman,L50,short,35,23,12,5,0.7407,135,"[4, 9, 10, 13, 21, 22, 30, 34, 42, 44, 51, 53, 61, 62, 63, 71, 72, 73, 75, 83, 85, 86, 94, 95, 98, 106, 107, 109, 110, 118, 119, 121, 123, 131, 132]"

Norman,L50,short,30,15,15,4,0.7692,130,"[5, 9, 18, 21, 28, 29, 31, 38, 40, 48, 49, 50, 58, 61, 68, 69, 70, 78, 80, 89, 90, 99, 101, 108, 109, 110, 111, 118, 121, 122]"

Norman,L50,short,35,9,26,3,0.7407,135,"[4, 9, 18, 19, 20, 28, 30, 37, 38, 39, 40, 51, 59, 60, 68, 69, 70, 71, 72, 81, 83, 92, 93, 94, 95, 96, 104, 106, 107, 108, 117, 119, 121, 123, 133]"

Norman,L50,short,35,26,9,7,0.7407,135,"[5, 10, 18, 20, 28, 29, 37, 38, 40, 48, 49, 50, 52, 60, 62, 72, 73, 74, 82, 83, 85, 93, 94, 95, 96, 97, 98, 107, 108, 116, 117, 118, 120, 129, 131]"

Norman,L50,short,34,15,19,7,0.7463,134,"[5, 10, 18, 19, 20, 28, 29, 31, 32, 40, 41, 42, 43, 52, 56, 65, 73, 74, 77, 85, 86, 95, 97, 105, 106, 107, 108, 115, 116, 119, 127, 128, 129, 130]"

Norman,L50,short,34,10,24,6,0.7463,134,"[4, 9, 10, 22, 29, 30, 31, 33, 42, 43, 44, 45, 46, 48, 57, 58, 59, 68, 70, 78, 79, 89, 97, 99, 106, 107, 108, 109, 111, 120, 121, 128, 130, 132]"

Norman,L50,short,34,17,17,7,0.7463,134,"[4, 9, 18, 20, 28, 29, 36, 37, 38, 39, 41, 51, 59, 60, 61, 69, 70, 72, 80, 81, 83, 84, 86, 88, 98, 106, 107, 109, 117, 118, 119, 127, 128, 129]"

Norman,L50,short,35,19,16,9,0.7407,135,"[12, 20, 28, 30, 37, 38, 40, 47, 48, 49, 50, 58, 59, 62, 71, 78, 79, 80, 88, 89, 90, 98, 99, 100, 109, 110, 111, 118, 119, 120, 121, 128, 129, 130, 131]"

Norman,L50,short,31,12,19,4,0.7634,131,"[4, 9, 18, 21, 31, 39, 40, 47, 48, 49, 50, 59, 60, 61, 62, 63, 71, 72, 73, 81, 82, 83, 92, 93, 102, 103, 112, 113, 114, 115, 125]"

Norman,L50,short,32,21,11,3,0.7576,132,"[4, 9, 10, 20, 28, 30, 32, 40, 42, 49, 51, 61, 62, 72, 79, 80, 81, 82, 89, 91, 92, 93, 95, 103, 104, 105, 112, 114, 115, 116, 124, 127]"

Norman,L50,short,31,27,4,6,0.7634,131,"[9, 13, 14, 15, 16, 18, 19, 20, 21, 30, 31, 40, 41, 42, 43, 52, 53, 62, 66, 75, 83, 91, 92, 95, 105, 106, 113, 115, 117, 125, 126]"

Norman,L50,short,34,18,16,2,0.7463,134,"[9, 16, 17, 18, 21, 29, 31, 32, 33, 41, 42, 43, 44, 53, 56, 64, 66, 76, 84, 85, 86, 95, 96, 104, 105, 106, 110, 117, 118, 121, 122, 130, 131, 132]"

Norman,L50,short,28,14,14,12,0.7812,128,"[4, 13, 21, 29, 36, 37, 38, 39, 47, 50, 53, 60, 63, 71, 73, 81, 83, 91, 92, 99, 100, 103, 111, 112, 113, 120, 121, 124]"

Norman,L50,short,29,20,9,19,0.7752,129,"[9, 13, 14, 15, 20, 28, 29, 30, 36, 45, 56, 63, 70, 72, 79, 80, 81, 82, 83, 84, 91, 92, 95, 104, 113, 114, 115, 124, 126]"

Norman,L50,short,33,21,12,2,0.7519,133,"[9, 13, 14, 15, 16, 17, 18, 20, 29, 37, 39, 40, 48, 49, 50, 51, 59, 61, 70, 71, 72, 80, 81, 82, 90, 91, 92, 93, 102, 103, 113, 122, 125]"

Norman,L50,short,34,22,12,9,0.7463,134,"[4, 10, 11, 19, 20, 21, 29, 30, 33, 42, 43, 45, 53, 54, 56, 61, 69, 77, 86, 88, 95, 98, 99, 106, 107, 108, 109, 116, 118, 119, 126, 127, 128, 129]"

Norman,L50,short,31,24,7,7,0.7634,131,"[9, 10, 11, 15, 16, 17, 18, 20, 22, 26, 35, 43, 44, 45, 47, 57, 65, 67, 75, 77, 85, 86, 87, 95, 98, 106, 108, 116, 118, 126, 127]"

Norman,L50,short,30,17,13,13,0.7692,130,"[4, 9, 10, 11, 21, 30, 32, 39, 40, 42, 50, 51, 53, 54, 56, 57, 66, 68, 79, 86, 87, 90, 100, 107, 108, 115, 116, 117, 118, 123]"

Norman,L50,short,29,18,11,12,0.7752,129,"[4, 9, 11, 21, 29, 30, 37, 38, 39, 40, 49, 51, 52, 53, 55, 64, 66, 74, 76, 84, 85, 93, 96, 104, 105, 107, 114, 115, 119]"

Norman,L50,short,29,11,18,5,0.7752,129,"[9, 11, 15, 17, 18, 19, 21, 30, 40, 48, 49, 51, 59, 61, 69, 70, 80, 81, 89, 91, 99, 100, 102, 110, 111, 118, 119, 121, 122]"

Norman,L50,short,32,17,15,2,0.7576,132,"[4, 9, 18, 19, 20, 21, 29, 30, 31, 39, 40, 41, 42, 43, 52, 53, 62, 63, 64, 76, 85, 93, 94, 95, 96, 103, 106, 107, 118, 126, 127, 128]"

Norman,L50,short,31,18,13,7,0.7634,131,"[10, 17, 19, 27, 28, 30, 32, 44, 52, 59, 61, 63, 70, 71, 72, 73, 81, 82, 83, 90, 91, 92, 94, 95, 104, 105, 106, 113, 114, 117, 126]"

Norman,L50,short,39,21,18,1,0.7194,139,"[9, 13, 16, 17, 18, 19, 27, 28, 29, 37, 38, 39, 48, 49, 57, 58, 59, 60, 61, 62, 71, 73, 74, 75, 76, 77, 85, 86, 87, 97, 105, 107, 108, 117, 118, 126, 127, 128, 130]"

Norman,L50,short,31,24,7,7,0.7634,131,"[5, 9, 11, 20, 23, 30, 31, 38, 39, 41, 42, 43, 51, 52, 53, 56, 65, 74, 83, 84, 94, 101, 102, 103, 105, 113, 114, 123, 124, 125, 127]"

Norman,L50,short,35,19,16,2,0.7407,135,"[9, 15, 16, 19, 26, 27, 28, 29, 37, 39, 47, 49, 57, 59, 60, 68, 69, 70, 78, 80, 81, 89, 90, 91, 92, 93, 95, 105, 113, 114, 117, 125, 126, 127, 129]"

Norman,L50,short,30,14,16,4,0.7692,130,"[4, 9, 11, 20, 28, 30, 37, 40, 42, 49, 50, 52, 61, 69, 71, 78, 79, 80, 81, 89, 91, 102, 109, 110, 111, 119, 120, 121, 122, 123]"

Norman,L50,short,29,14,15,9,0.7752,129,"[9, 15, 16, 17, 18, 19, 20, 32, 42, 49, 53, 60, 61, 64, 76, 84, 92, 93, 94, 101, 102, 103, 104, 110, 113, 114, 122, 123, 124]"

Norman,L50,short,31,18,13,7,0.7634,131,"[5, 9, 11, 22, 29, 32, 39, 40, 42, 49, 51, 59, 63, 70, 71, 78, 79, 80, 82, 90, 94, 102, 103, 110, 111, 112, 113, 120, 121, 122, 123]"

Norman,L50,short,29,16,13,8,0.7752,129,"[5, 9, 11, 19, 21, 29, 30, 31, 39, 40, 42, 50, 51, 52, 53, 55, 65, 73, 77, 86, 94, 95, 104, 105, 113, 114, 116, 123, 125]"

Norman,L50,short,29,18,11,9,0.7752,129,"[11, 18, 19, 27, 30, 39, 40, 48, 49, 50, 52, 60, 61, 69, 70, 71, 72, 73, 86, 93, 94, 96, 104, 106, 115, 122, 123, 124, 125]"

Norman,L50,short,31,17,14,8,0.7634,131,"[12, 18, 19, 20, 21, 26, 33, 40, 42, 43, 44, 53, 54, 62, 64, 74, 81, 82, 83, 85, 93, 96, 104, 111, 112, 113, 114, 121, 122, 123, 126]"

Norman,L50,short,28,16,12,12,0.7812,128,"[9, 10, 14, 15, 16, 18, 19, 20, 30, 38, 39, 40, 42, 52, 60, 61, 63, 67, 75, 83, 84, 91, 92, 95, 103, 104, 109, 119]"

Norman,L50,short,33,13,20,6,0.7519,133,"[11, 19, 20, 27, 29, 31, 38, 42, 49, 50, 59, 61, 69, 72, 79, 81, 87, 88, 90, 92, 99, 100, 101, 109, 110, 111, 112, 113, 114, 115, 123, 124, 125]"

Norman,L50,short,34,22,12,4,0.7463,134,"[10, 14, 16, 19, 20, 28, 30, 32, 40, 41, 42, 44, 53, 61, 62, 64, 72, 74, 75, 83, 84, 85, 92, 93, 94, 95, 96, 105, 106, 114, 115, 116, 127, 128]"

Norman,L50,short,30,20,10,10,0.7692,130,"[9, 10, 14, 16, 17, 18, 20, 22, 30, 31, 32, 34, 45, 54, 62, 66, 74, 81, 82, 83, 85, 94, 95, 96, 104, 105, 109, 116, 124, 128]"

Norman,L50,short,30,20,10,12,0.7692,130,"[9, 13, 19, 20, 21, 29, 30, 31, 39, 40, 43, 51, 56, 64, 71, 72, 73, 80, 81, 85, 93, 94, 105, 113, 115, 122, 123, 124, 125, 127]"

Norman,L50,short,35,16,19,6,0.7407,135,"[10, 15, 17, 18, 19, 27, 29, 36, 37, 38, 41, 49, 50, 58, 59, 60, 68, 69, 71, 79, 80, 88, 89, 91, 99, 100, 102, 110, 111, 119, 120, 121, 128, 130, 131]"

Norman,L50,short,34,21,13,2,0.7463,134,"[6, 9, 18, 19, 27, 28, 29, 36, 37, 38, 40, 41, 50, 52, 60, 63, 64, 73, 74, 75, 83, 84, 87, 96, 98, 106, 107, 109, 117, 118, 119, 120, 128, 130]"

Norman,L50,short,32,15,17,2,0.7576,132,"[9, 14, 15, 16, 17, 19, 27, 29, 37, 38, 39, 40, 41, 50, 51, 52, 53, 55, 64, 65, 74, 76, 84, 85, 86, 96, 104, 105, 106, 115, 117, 126]"

Norman,L50,short,31,15,16,3,0.7634,131,"[5, 9, 10, 11, 20, 21, 29, 30, 31, 39, 40, 41, 43, 51, 52, 53, 64, 75, 83, 84, 86, 94, 96, 104, 105, 106, 113, 117, 125, 126, 128]"

Norman,L50,short,32,13,19,10,0.7576,132,"[10, 14, 15, 16, 19, 29, 37, 39, 49, 56, 57, 58, 59, 60, 61, 64, 74, 84, 91, 93, 101, 102, 103, 109, 110, 112, 114, 121, 123, 124, 125, 127]"

Norman,L50,short,26,15,11,8,0.7937,126,"[4, 10, 19, 20, 30, 32, 39, 40, 41, 43, 50, 53, 65, 72, 80, 81, 82, 92, 94, 102, 104, 105, 106, 107, 116, 119]"

Norman,L50,short,31,21,10,4,0.7634,131,"[9, 10, 11, 16, 17, 18, 19, 20, 21, 30, 31, 33, 42, 43, 54, 62, 64, 73, 84, 93, 101, 102, 103, 109, 110, 112, 114, 121, 124, 125, 126]"

Norman,L50,short,33,9,24,5,0.7519,133,"[9, 16, 17, 18, 19, 27, 29, 37, 38, 39, 41, 43, 51, 52, 53, 54, 63, 67, 75, 83, 84, 85, 92, 93, 94, 95, 104, 105, 113, 114, 116, 124, 126]"

Norman,L50,short,31,7,24,3,0.7634,131,"[11, 18, 19, 26, 27, 28, 29, 36, 39, 47, 49, 50, 52, 60, 62, 72, 79, 80, 82, 89, 90, 92, 93, 101, 102, 103, 104, 105, 115, 124, 125]"

Norman,L50,short,30,14,16,5,0.7692,130,"[10, 14, 15, 19, 26, 27, 28, 29, 31, 39, 40, 48, 49, 50, 58, 59, 62, 71, 80, 81, 90, 91, 99, 100, 102, 110, 111, 118, 120, 122]"

Norman,L50,short,27,16,11,5,0.7874,127,"[12, 17, 18, 19, 26, 27, 28, 29, 37, 38, 39, 48, 49, 57, 58, 59, 68, 70, 80, 88, 89, 99, 100, 110, 118, 119, 120]"

Norman,L50,short,32,19,13,7,0.7576,132,"[4, 10, 18, 19, 20, 28, 29, 31, 39, 40, 41, 43, 51, 52, 53, 62, 65, 74, 75, 76, 84, 85, 86, 88, 97, 104, 105, 106, 108, 116, 118, 128]"

Norman,L50,short,26,10,16,11,0.7937,126,"[10, 15, 16, 18, 19, 27, 29, 30, 38, 41, 49, 50, 52, 60, 63, 71, 72, 75, 83, 90, 92, 93, 96, 106, 113, 117]"

Norman,L50,short,29,17,12,9,0.7752,129,"[10, 14, 15, 16, 17, 18, 19, 29, 37, 38, 40, 48, 49, 50, 59, 62, 70, 79, 80, 88, 91, 99, 100, 108, 109, 111, 114, 121, 124]"

Norman,L50,short,32,11,21,3,0.7576,132,"[4, 10, 18, 19, 20, 28, 29, 30, 38, 39, 40, 49, 50, 58, 60, 69, 70, 71, 73, 82, 83, 92, 94, 101, 102, 103, 105, 106, 117, 126, 127, 128]"

Norman,L50,short,32,17,15,7,0.7576,132,"[4, 12, 19, 22, 29, 30, 32, 33, 41, 42, 44, 52, 53, 61, 62, 64, 72, 74, 77, 85, 87, 96, 104, 105, 107, 115, 116, 117, 124, 125, 126, 127]"

Norman,L50,short,32,17,15,1,0.7576,132,"[9, 13, 14, 15, 16, 18, 19, 29, 40, 48, 49, 50, 58, 59, 60, 68, 70, 71, 72, 80, 82, 90, 92, 100, 101, 102, 103, 110, 111, 113, 121, 124]"

Norman,L50,short,33,17,16,4,0.7519,133,"[9, 11, 15, 16, 17, 18, 19, 20, 21, 22, 32, 41, 42, 51, 52, 60, 63, 71, 72, 73, 81, 82, 83, 84, 96, 104, 114, 121, 122, 123, 127, 129, 130]"

Norman,L50,short,27,17,10,11,0.7874,127,"[5, 12, 19, 21, 28, 30, 34, 41, 42, 49, 50, 51, 55, 66, 74, 82, 83, 94, 100, 102, 103, 110, 111, 112, 113, 121, 123]"

Norman,L50,short,31,16,15,4,0.7634,131,"[4, 9, 10, 19, 20, 29, 32, 39, 40, 41, 42, 50, 52, 54, 62, 63, 71, 72, 73, 81, 82, 84, 85, 93, 94, 95, 104, 106, 114, 117, 126]"

Norman,L50,short,32,17,15,5,0.7576,132,"[12, 17, 19, 20, 23, 33, 34, 43, 44, 52, 53, 54, 61, 65, 72, 73, 74, 81, 83, 84, 91, 93, 94, 102, 103, 104, 112, 114, 121, 122, 124, 125]"

Norman,L50,short,33,21,12,4,0.7519,133,"[4, 9, 12, 20, 21, 22, 30, 31, 32, 41, 42, 43, 44, 53, 54, 55, 64, 66, 74, 75, 83, 84, 85, 93, 95, 103, 104, 105, 113, 114, 117, 125, 126]"

Norman,L50,short,31,13,18,7,0.7634,131,"[9, 13, 15, 16, 17, 18, 19, 21, 30, 31, 32, 34, 44, 53, 61, 62, 63, 71, 72, 76, 84, 91, 92, 95, 104, 111, 112, 114, 122, 123, 124]"

Norman,L50,short,33,13,20,6,0.7519,133,"[4, 10, 19, 22, 29, 30, 37, 38, 39, 40, 41, 51, 54, 62, 70, 72, 73, 80, 81, 83, 91, 92, 93, 102, 103, 112, 114, 121, 122, 124, 125, 126, 128]"

Norman,L50,short,33,16,17,5,0.7519,133,"[9, 10, 14, 15, 16, 17, 19, 20, 21, 22, 32, 33, 34, 35, 44, 46, 55, 58, 67, 76, 86, 88, 96, 97, 98, 106, 108, 117, 118, 119, 127, 128, 130]"

Norman,L50,short,29,12,17,3,0.7752,129,"[4, 11, 18, 19, 27, 28, 29, 36, 37, 39, 47, 48, 49, 58, 61, 69, 70, 71, 80, 81, 89, 91, 92, 100, 102, 110, 112, 121, 122]"

Norman,L50,short,27,12,15,13,0.7874,127,"[10, 14, 15, 16, 17, 18, 21, 30, 40, 48, 50, 60, 67, 68, 69, 72, 81, 87, 88, 89, 90, 98, 100, 102, 113, 120, 121]"

Norman,L50,short,35,19,16,5,0.7407,135,"[10, 11, 17, 18, 19, 20, 21, 29, 32, 40, 41, 49, 50, 54, 62, 63, 72, 73, 75, 83, 84, 92, 95, 96, 105, 107, 114, 115, 116, 117, 118, 126, 127, 129, 131]"

Norman,L50,short,35,17,18,7,0.7407,135,"[9, 10, 11, 12, 14, 21, 24, 32, 33, 34, 42, 44, 53, 54, 55, 56, 57, 60, 69, 78, 86, 87, 88, 89, 97, 100, 101, 109, 110, 111, 114, 122, 123, 131, 132]"

Norman,L50,short,31,16,15,11,0.7634,131,"[11, 18, 19, 26, 27, 28, 29, 36, 38, 41, 51, 60, 67, 68, 70, 77, 78, 79, 80, 88, 89, 92, 100, 101, 108, 109, 110, 111, 112, 121, 126]"

Norman,L50,short,32,21,11,6,0.7576,132,"[12, 18, 19, 21, 29, 30, 38, 39, 40, 42, 50, 51, 60, 63, 71, 72, 79, 80, 82, 90, 92, 93, 95, 105, 111, 112, 113, 114, 116, 124, 126, 127]"

Norman,L50,short,32,25,7,3,0.7576,132,"[4, 10, 11, 20, 21, 29, 30, 31, 39, 41, 42, 44, 52, 53, 54, 55, 64, 65, 73, 74, 75, 77, 86, 88, 99, 107, 114, 115, 116, 117, 125, 127]"

Norman,L50,short,31,14,17,6,0.7634,131,"[9, 10, 11, 12, 13, 14, 19, 21, 22, 23, 24, 34, 43, 44, 53, 54, 62, 64, 74, 75, 83, 84, 88, 96, 99, 107, 115, 116, 117, 126, 128]"

Norman,L50,short,35,23,12,7,0.7407,135,"[9, 10, 14, 15, 16, 17, 19, 20, 22, 31, 32, 34, 44, 45, 57, 65, 73, 74, 76, 79, 88, 90, 98, 99, 100, 102, 110, 111, 118, 119, 120, 121, 129, 130, 132]"

Norman,L50,short,30,12,18,16,0.7692,130,"[4, 9, 25, 32, 39, 40, 48, 49, 50, 54, 62, 72, 74, 80, 81, 83, 85, 92, 93, 94, 95, 102, 104, 106, 114, 116, 122, 124, 125, 127]"

Norman,L50,short,31,21,10,2,0.7634,131,"[5, 9, 18, 19, 27, 28, 29, 36, 37, 38, 39, 40, 41, 42, 52, 61, 63, 72, 75, 83, 91, 92, 95, 96, 104, 105, 107, 115, 117, 124, 127]"

Norman,L50,short,31,20,11,11,0.7634,131,"[4, 10, 18, 20, 21, 23, 31, 32, 33, 34, 39, 48, 58, 66, 69, 76, 77, 79, 80, 81, 90, 91, 99, 100, 102, 111, 112, 119, 121, 122, 123]"

Norman,L50,short,33,20,13,2,0.7519,133,"[4, 9, 18, 19, 20, 28, 29, 31, 32, 34, 36, 46, 54, 55, 63, 65, 66, 74, 75, 76, 84, 86, 95, 96, 103, 105, 106, 115, 116, 123, 124, 125, 126]"

Norman,L50,short,33,22,11,13,0.7519,133,"[9, 13, 14, 15, 16, 18, 19, 28, 30, 38, 39, 48, 49, 51, 59, 60, 61, 62, 65, 70, 79, 88, 96, 98, 108, 116, 117, 124, 125, 126, 127, 128, 130]"

Norman,L50,short,37,20,17,5,0.7299,137,"[9, 13, 14, 15, 16, 19, 22, 31, 40, 41, 42, 50, 52, 54, 63, 64, 73, 75, 85, 92, 94, 102, 103, 105, 113, 114, 116, 125, 126, 127, 128, 129, 130, 131, 132, 133, 134]"

Norman,L50,short,32,21,11,10,0.7576,132,"[4, 9, 18, 19, 21, 29, 31, 33, 41, 42, 50, 51, 52, 53, 57, 65, 74, 82, 83, 84, 92, 93, 95, 102, 103, 104, 105, 113, 114, 115, 119, 127]"

Norman,L50,short,31,20,11,6,0.7634,131,"[5, 9, 18, 20, 28, 31, 39, 48, 49, 50, 51, 59, 61, 68, 69, 71, 79, 82, 90, 91, 99, 100, 103, 110, 111, 112, 119, 120, 121, 123, 124]"

Norman,L50,short,34,18,16,2,0.7463,134,"[9, 13, 17, 18, 20, 28, 30, 38, 39, 40, 48, 49, 50, 58, 59, 60, 63, 72, 73, 81, 82, 83, 91, 92, 93, 102, 103, 104, 112, 113, 114, 115, 123, 126]"

Norman,L50,short,28,15,13,6,0.7812,128,"[5, 10, 18, 19, 27, 28, 29, 30, 38, 40, 48, 51, 59, 61, 71, 78, 82, 90, 94, 101, 103, 110, 111, 112, 113, 120, 122, 124]"

Norman,L50,short,28,19,9,9,0.7812,128,"[4, 9, 10, 11, 12, 21, 24, 32, 33, 42, 44, 52, 53, 54, 56, 66, 74, 77, 89, 98, 105, 106, 107, 109, 116, 117, 118, 121]"

Norman,L50,short,34,24,10,7,0.7463,134,"[9, 12, 18, 20, 27, 29, 30, 31, 40, 41, 42, 43, 44, 45, 57, 65, 73, 74, 75, 83, 84, 85, 92, 94, 96, 99, 107, 108, 109, 114, 121, 122, 123, 125]"

Norman,L50,short,32,17,15,1,0.7576,132,"[9, 13, 14, 16, 17, 18, 19, 20, 29, 31, 39, 41, 50, 51, 61, 62, 70, 72, 80, 81, 82, 83, 91, 92, 93, 103, 104, 114, 121, 122, 123, 124]"

Norman,L50,short,35,22,13,5,0.7407,135,"[10, 16, 19, 23, 31, 38, 39, 41, 48, 49, 51, 52, 60, 61, 62, 63, 64, 66, 74, 76, 84, 85, 92, 93, 95, 96, 104, 107, 114, 115, 116, 117, 125, 126, 127]"

Norman,L50,short,29,12,17,5,0.7752,129,"[4, 9, 18, 21, 28, 30, 37, 39, 40, 48, 49, 51, 59, 60, 68, 70, 78, 81, 88, 89, 90, 99, 101, 109, 110, 111, 118, 119, 121]"

Norman,L50,short,31,24,7,7,0.7634,131,"[9, 13, 18, 19, 21, 31, 38, 41, 48, 50, 51, 59, 61, 69, 70, 71, 74, 81, 82, 89, 92, 101, 102, 106, 113, 116, 117, 124, 125, 126, 127]"

Norman,L50,short,26,17,9,15,0.7937,126,"[9, 11, 15, 16, 17, 18, 19, 20, 21, 22, 32, 34, 45, 56, 64, 72, 76, 84, 93, 94, 101, 102, 103, 107, 114, 118]"

Norman,L50,short,33,12,21,2,0.7519,133,"[9, 13, 17, 18, 19, 28, 29, 36, 37, 38, 40, 41, 49, 51, 59, 60, 62, 71, 72, 73, 83, 92, 93, 101, 102, 104, 112, 113, 120, 121, 122, 123, 131]"

Norman,L50,short,33,19,14,8,0.7519,133,"[10, 14, 15, 18, 19, 27, 28, 29, 37, 38, 39, 42, 53, 61, 63, 73, 80, 81, 82, 83, 90, 91, 92, 93, 102, 103, 111, 112, 113, 121, 122, 123, 125]"

Norman,L50,short,33,15,18,11,0.7519,133,"[5, 9, 18, 19, 27, 31, 32, 33, 41, 42, 44, 52, 53, 54, 55, 57, 67, 75, 76, 77, 78, 87, 88, 96, 98, 104, 112, 119, 120, 121, 122, 130, 131]"

Norman,L50,short,34,12,22,7,0.7463,134,"[10, 17, 18, 19, 20, 28, 29, 30, 39, 40, 41, 42, 50, 51, 52, 53, 54, 63, 65, 76, 84, 93, 94, 96, 104, 105, 112, 113, 114, 115, 117, 118, 127, 130]"

Norman,L50,short,37,25,12,6,0.7299,137,"[4, 11, 18, 19, 27, 28, 29, 36, 37, 38, 40, 50, 58, 59, 67, 68, 69, 70, 80, 88, 89, 90, 91, 92, 100, 102, 103, 112, 114, 115, 123, 124, 125, 126, 127, 128, 131]"

Norman,L50,short,30,18,12,7,0.7692,130,"[4, 9, 11, 19, 21, 29, 30, 32, 40, 41, 45, 53, 61, 62, 64, 72, 74, 82, 83, 85, 87, 95, 98, 105, 107, 114, 117, 124, 126, 128]"

Norman,L50,short,34,12,22,1,0.7463,134,"[5, 9, 18, 19, 29, 36, 37, 38, 39, 41, 49, 50, 58, 59, 61, 62, 70, 72, 82, 83, 84, 92, 94, 95, 102, 103, 104, 105, 106, 114, 116, 125, 126, 127]"

Norman,L50,short,38,17,21,3,0.7246,138,"[7, 10, 18, 19, 20, 21, 30, 31, 32, 33, 41, 42, 44, 53, 62, 63, 71, 72, 73, 81, 82, 83, 92, 93, 95, 103, 104, 113, 114, 121, 122, 123, 124, 132, 133, 134, 135, 136]"

Norman,L50,short,32,18,14,1,0.7576,132,"[9, 13, 15, 17, 19, 29, 38, 39, 40, 48, 49, 50, 59, 60, 70, 71, 74, 75, 76, 87, 94, 95, 96, 104, 105, 107, 114, 116, 117, 125, 126, 128]"

Norman,L50,short,34,12,22,5,0.7463,134,"[10, 14, 16, 18, 19, 27, 28, 30, 39, 40, 41, 44, 52, 53, 54, 62, 64, 73, 74, 82, 83, 84, 85, 86, 87, 96, 97, 99, 107, 108, 117, 119, 128, 130]"

Norman,L50,short,31,11,20,5,0.7634,131,"[11, 17, 18, 19, 20, 21, 29, 30, 32, 44, 53, 54, 56, 64, 65, 66, 75, 76, 85, 86, 96, 97, 104, 106, 107, 114, 115, 118, 126, 127, 128]"

Norman,L50,short,34,16,18,4,0.7463,134,"[4, 9, 18, 20, 21, 22, 24, 32, 33, 36, 44, 46, 54, 56, 65, 66, 74, 75, 76, 84, 85, 86, 88, 97, 105, 107, 114, 117, 118, 119, 120, 127, 129, 130]"

Norman,L50,short,32,10,22,4,0.7576,132,"[4, 9, 19, 27, 28, 29, 36, 38, 39, 46, 48, 50, 61, 68, 69, 70, 71, 73, 81, 82, 83, 91, 92, 94, 102, 103, 105, 114, 115, 122, 124, 126]"

Norman,L50,short,31,20,11,15,0.7634,131,"[4, 11, 18, 26, 33, 40, 47, 48, 49, 50, 58, 61, 68, 69, 70, 71, 72, 80, 81, 82, 90, 91, 92, 100, 101, 102, 110, 112, 114, 122, 123]"

Norman,L50,short,30,19,11,8,0.7692,130,"[9, 14, 15, 16, 18, 19, 27, 28, 29, 37, 38, 39, 48, 50, 58, 60, 68, 69, 80, 83, 91, 99, 100, 101, 104, 111, 112, 114, 121, 124]"

Norman,L50,short,33,16,17,3,0.7519,133,"[5, 9, 18, 19, 28, 30, 37, 38, 40, 41, 49, 50, 51, 59, 60, 62, 70, 71, 79, 80, 81, 82, 86, 94, 103, 104, 105, 113, 114, 115, 123, 124, 125]"

Norman,L50,short,31,15,16,3,0.7634,131,"[9, 13, 14, 15, 16, 17, 19, 28, 30, 39, 48, 49, 58, 60, 69, 70, 78, 80, 89, 90, 93, 94, 102, 103, 104, 112, 114, 121, 122, 123, 126]"

Norman,L50,short,29,22,7,5,0.7752,129,"[9, 13, 18, 19, 21, 22, 23, 33, 42, 43, 47, 56, 63, 64, 68, 76, 83, 85, 86, 95, 96, 105, 106, 115, 116, 117, 118, 119, 121]"

Norman,L50,short,27,16,11,4,0.7874,127,"[4, 10, 18, 19, 20, 29, 30, 31, 32, 34, 42, 44, 54, 62, 64, 73, 75, 83, 84, 85, 96, 103, 105, 106, 113, 114, 116]"

Norman,L50,short,32,17,15,4,0.7576,132,"[5, 9, 22, 29, 38, 39, 46, 48, 49, 57, 59, 67, 69, 76, 77, 78, 80, 81, 82, 90, 91, 92, 93, 101, 102, 103, 112, 113, 120, 121, 122, 124]"

Norman,L50,short,28,13,15,11,0.7812,128,"[5, 9, 10, 21, 28, 29, 30, 37, 38, 39, 40, 48, 49, 53, 61, 69, 70, 74, 85, 93, 99, 100, 101, 105, 112, 113, 120, 123]"

Norman,L50,short,31,13,18,6,0.7634,131,"[9, 10, 11, 13, 19, 20, 21, 23, 31, 32, 34, 44, 53, 54, 62, 63, 66, 75, 76, 84, 87, 95, 97, 98, 100, 108, 109, 110, 118, 119, 122]"

Norman,L50,short,31,13,18,8,0.7634,131,"[10, 14, 16, 17, 18, 20, 28, 29, 32, 40, 42, 52, 60, 61, 62, 71, 72, 79, 80, 81, 82, 90, 91, 94, 102, 103, 111, 112, 115, 123, 124]"

Norman,L50,short,34,21,13,5,0.7463,134,"[5, 9, 11, 19, 20, 22, 30, 31, 35, 36, 44, 45, 46, 56, 64, 68, 78, 85, 87, 88, 95, 97, 98, 105, 106, 107, 108, 115, 116, 117, 119, 127, 128, 130]"

Norman,L50,short,33,16,17,9,0.7519,133,"[5, 10, 19, 27, 28, 29, 31, 38, 39, 41, 49, 51, 59, 64, 71, 78, 79, 80, 81, 89, 92, 99, 101, 109, 110, 111, 112, 119, 120, 121, 122, 123, 126]"

Norman,L50,short,31,18,13,3,0.7634,131,"[9, 12, 18, 20, 28, 30, 31, 39, 40, 41, 49, 50, 51, 52, 60, 61, 62, 71, 73, 75, 84, 87, 95, 96, 98, 106, 107, 114, 117, 126, 127]"

Norman,L50,short,33,22,11,5,0.7519,133,"[4, 11, 18, 21, 28, 29, 31, 39, 40, 41, 49, 51, 52, 53, 62, 64, 72, 73, 74, 76, 84, 85, 88, 96, 103, 104, 105, 106, 117, 124, 125, 126, 128]"

Norman,L50,short,28,12,16,4,0.7812,128,"[4, 10, 18, 19, 31, 38, 39, 47, 48, 49, 57, 58, 60, 68, 69, 70, 71, 79, 80, 81, 89, 92, 100, 101, 109, 111, 120, 121]"

Norman,L50,short,33,18,15,5,0.7519,133,"[4, 10, 18, 19, 27, 28, 29, 36, 37, 39, 47, 48, 50, 58, 59, 60, 68, 70, 78, 79, 80, 88, 89, 92, 99, 100, 108, 111, 118, 119, 120, 122, 131]"

Norman,L50,short,33,20,13,6,0.7519,133,"[4, 9, 18, 19, 28, 29, 34, 42, 49, 50, 57, 58, 59, 60, 69, 70, 78, 79, 80, 88, 89, 90, 91, 92, 100, 101, 102, 103, 104, 106, 117, 126, 127]"

Norman,L50,short,35,12,23,9,0.7407,135,"[9, 13, 14, 17, 18, 19, 27, 33, 41, 50, 57, 58, 59, 60, 68, 69, 70, 71, 72, 73, 81, 82, 84, 93, 95, 98, 106, 113, 114, 116, 125, 126, 127, 129, 130]"

Norman,L50,short,30,13,17,4,0.7692,130,"[10, 14, 15, 16, 19, 27, 28, 29, 37, 38, 39, 47, 48, 49, 51, 61, 70, 72, 80, 81, 89, 91, 100, 101, 103, 114, 121, 122, 123, 125]"

Norman,L50,short,32,9,23,3,0.7576,132,"[10, 14, 16, 18, 19, 27, 29, 31, 39, 41, 49, 50, 59, 60, 68, 70, 78, 79, 80, 89, 91, 99, 100, 101, 108, 109, 111, 119, 120, 121, 129, 130]"

Norman,L50,short,28,22,6,6,0.7812,128,"[9, 13, 14, 15, 16, 17, 19, 31, 39, 40, 43, 51, 53, 63, 71, 72, 79, 81, 84, 92, 93, 100, 102, 104, 113, 121, 122, 123]"

Norman,L50,short,30,17,13,12,0.7692,130,"[4, 9, 10, 20, 21, 22, 30, 32, 33, 38, 46, 54, 66, 74, 80, 81, 82, 83, 84, 92, 93, 94, 96, 105, 109, 118, 125, 126, 127, 128]"

Norman,L50,short,32,14,18,2,0.7576,132,"[5, 10, 18, 19, 27, 28, 30, 38, 39, 43, 51, 52, 60, 62, 63, 70, 71, 72, 73, 82, 83, 84, 92, 93, 94, 103, 104, 112, 114, 122, 123, 124]"

Norman,L50,short,33,17,16,2,0.7519,133,"[10, 14, 15, 16, 18, 22, 30, 31, 32, 40, 42, 43, 44, 53, 55, 63, 64, 65, 73, 74, 75, 76, 77, 85, 87, 96, 97, 105, 107, 116, 118, 126, 128]"

Norman,L50,short,31,11,20,4,0.7634,131,"[5, 9, 20, 21, 28, 29, 31, 38, 39, 40, 42, 50, 52, 60, 61, 62, 70, 71, 73, 81, 82, 90, 91, 93, 102, 103, 113, 114, 121, 122, 125]"

Norman,L50,short,28,19,9,9,0.7812,128,"[4, 9, 10, 19, 20, 28, 29, 32, 41, 49, 50, 51, 59, 62, 72, 79, 80, 82, 87, 95, 102, 103, 104, 112, 113, 114, 121, 122]"

Norman,L50,short,31,15,16,10,0.7634,131,"[9, 13, 14, 15, 16, 18, 19, 28, 31, 40, 42, 50, 51, 52, 53, 62, 63, 72, 74, 83, 89, 96, 97, 107, 108, 109, 116, 117, 118, 119, 124]"

Norman,L50,short,28,16,12,4,0.7812,128,"[4, 10, 20, 27, 30, 38, 39, 46, 48, 49, 57, 60, 68, 69, 77, 79, 81, 88, 92, 99, 100, 101, 102, 109, 111, 112, 120, 122]"

Norman,L50,short,34,12,22,5,0.7463,134,"[4, 11, 18, 19, 20, 28, 30, 37, 38, 39, 40, 41, 49, 50, 52, 63, 64, 72, 73, 74, 75, 83, 84, 86, 95, 98, 106, 114, 116, 123, 124, 125, 126, 128]"

Norman,L50,short,31,12,19,12,0.7634,131,"[10, 15, 16, 17, 19, 22, 30, 32, 46, 54, 62, 69, 70, 71, 80, 81, 82, 88, 90, 91, 92, 94, 102, 103, 110, 111, 112, 113, 114, 122, 124]"

Norman,L100,short,25,17,8,5,0.8,125,"[4, 9, 18, 19, 29, 38, 39, 48, 51, 58, 60, 70, 72, 76, 83, 92, 94, 100, 101, 103, 112, 113, 119, 120, 123]"

Norman,L100,short,35,18,17,7,0.7407,135,"[10, 16, 17, 19, 28, 32, 41, 48, 49, 57, 58, 59, 60, 67, 68, 69, 70, 78, 79, 80, 89, 90, 98, 99, 100, 108, 109, 111, 119, 120, 121, 123, 131, 132, 133]"

Norman,L100,short,28,15,13,4,0.7812,128,"[4, 9, 11, 19, 20, 21, 29, 30, 32, 41, 49, 51, 59, 60, 61, 69, 70, 71, 79, 80, 81, 89, 92, 101, 108, 109, 112, 121]"

Norman,L100,short,28,16,12,4,0.7812,128,"[4, 10, 18, 20, 28, 29, 30, 31, 39, 41, 49, 50, 51, 53, 63, 71, 72, 73, 81, 82, 86, 87, 95, 98, 106, 109, 116, 118]"

Norman,L100,short,30,17,13,6,0.7692,130,"[4, 10, 18, 19, 20, 21, 22, 24, 34, 42, 43, 44, 54, 55, 64, 65, 66, 68, 77, 86, 90, 97, 99, 107, 108, 110, 117, 118, 119, 121]"

Norman,L100,short,29,17,12,4,0.7752,129,"[4, 9, 18, 19, 20, 28, 29, 30, 39, 40, 48, 52, 53, 61, 63, 71, 73, 74, 75, 85, 88, 96, 106, 113, 114, 115, 116, 124, 125]"

Norman,L100,short,31,22,9,9,0.7634,131,"[8, 11, 18, 19, 20, 28, 29, 30, 39, 40, 50, 51, 53, 61, 63, 71, 74, 83, 91, 93, 100, 101, 102, 103, 104, 106, 114, 115, 117, 125, 127]"

Norman,L100,short,32,25,7,3,0.7576,132,"[4, 9, 10, 12, 20, 21, 29, 30, 32, 34, 42, 43, 44, 53, 55, 64, 72, 73, 74, 82, 85, 93, 94, 103, 104, 106, 113, 114, 115, 117, 125, 127]"

Norman,L100,short,28,15,13,5,0.7812,128,"[4, 10, 11, 19, 21, 29, 30, 31, 32, 40, 41, 42, 51, 53, 62, 70, 72, 80, 81, 82, 91, 92, 93, 103, 106, 113, 115, 126]"

Norman,L100,short,27,14,13,11,0.7874,127,"[8, 11, 17, 18, 19, 27, 28, 29, 38, 39, 47, 48, 50, 58, 62, 72, 80, 81, 88, 90, 93, 101, 104, 111, 113, 122, 123]"

Norman,L100,short,30,8,22,5,0.7692,130,"[9, 14, 15, 16, 18, 19, 28, 30, 39, 41, 49, 50, 51, 52, 61, 62, 70, 72, 73, 81, 82, 84, 92, 93, 101, 105, 114, 122, 123, 124]"

Norman,L100,short,32,17,15,7,0.7576,132,"[4, 9, 12, 20, 22, 23, 32, 33, 41, 42, 43, 51, 52, 54, 62, 64, 65, 67, 78, 86, 93, 95, 96, 104, 105, 108, 116, 117, 118, 120, 121, 124]"

Norman,L100,short,29,13,16,9,0.7752,129,"[10, 11, 17, 18, 20, 21, 22, 23, 24, 33, 38, 47, 55, 63, 64, 65, 73, 75, 76, 84, 85, 88, 96, 98, 108, 115, 116, 118, 125]"

Norman,L100,short,33,13,20,7,0.7519,133,"[4, 9, 18, 19, 27, 28, 29, 30, 31, 39, 42, 43, 52, 55, 64, 72, 73, 81, 82, 86, 93, 100, 101, 102, 104, 111, 112, 113, 115, 123, 124, 126, 127]"

Norman,L100,short,33,11,22,4,0.7519,133,"[5, 10, 12, 20, 21, 22, 31, 32, 33, 34, 36, 46, 54, 55, 56, 59, 67, 68, 77, 78, 79, 87, 88, 90, 98, 99, 100, 109, 110, 119, 120, 128, 131]"

Norman,L100,short,33,13,20,6,0.7519,133,"[4, 9, 18, 19, 27, 28, 29, 39, 40, 41, 44, 53, 60, 61, 62, 63, 71, 72, 74, 82, 83, 84, 92, 93, 94, 95, 96, 97, 106, 108, 117, 126, 129]"

Norman,L100,short,29,19,10,9,0.7752,129,"[8, 10, 15, 17, 19, 29, 38, 42, 50, 57, 59, 60, 70, 72, 79, 80, 81, 88, 92, 100, 102, 112, 118, 119, 120, 121, 123, 124, 125]"

Norman,L100,short,32,19,13,8,0.7576,132,"[9, 10, 11, 20, 21, 22, 31, 32, 43, 51, 53, 61, 64, 71, 73, 80, 82, 90, 91, 92, 94, 101, 102, 104, 111, 112, 113, 114, 121, 122, 123, 125]"

Norman,L100,short,30,21,9,1,0.7692,130,"[9, 10, 15, 19, 21, 22, 23, 31, 33, 34, 35, 36, 37, 39, 40, 51, 60, 69, 70, 78, 79, 80, 91, 101, 102, 110, 111, 113, 121, 123]"

Norman,L100,short,33,20,13,4,0.7519,133,"[4, 9, 10, 11, 20, 22, 31, 32, 33, 34, 46, 54, 61, 62, 63, 64, 65, 73, 76, 84, 85, 94, 97, 106, 107, 108, 116, 117, 119, 120, 128, 130, 131]"

Norman,L100,short,31,24,7,7,0.7634,131,"[5, 10, 18, 20, 30, 37, 40, 47, 48, 49, 50, 51, 59, 62, 70, 73, 81, 83, 90, 91, 92, 93, 94, 95, 105, 112, 113, 115, 124, 125, 126]"

Norman,L100,short,32,16,16,0,0.7576,132,"[6, 9, 18, 19, 27, 28, 29, 38, 40, 41, 42, 50, 52, 60, 61, 62, 70, 71, 72, 73, 82, 83, 91, 92, 93, 94, 103, 104, 112, 114, 115, 125]"

Norman,L100,short,28,8,20,5,0.7812,128,"[8, 9, 14, 15, 19, 27, 28, 30, 39, 47, 48, 49, 50, 58, 60, 61, 70, 71, 79, 81, 82, 91, 92, 100, 102, 111, 115, 125]"

Norman,L100,short,31,23,8,6,0.7634,131,"[4, 11, 20, 28, 29, 37, 39, 47, 51, 59, 61, 68, 69, 70, 78, 79, 81, 88, 90, 91, 92, 101, 102, 103, 105, 112, 113, 116, 117, 125, 127]"

Norman,L100,short,32,19,13,3,0.7576,132,"[5, 9, 10, 19, 20, 23, 32, 39, 42, 51, 52, 60, 61, 62, 70, 71, 72, 80, 81, 82, 83, 85, 93, 95, 104, 106, 107, 114, 115, 117, 125, 127]"

Norman,L100,short,30,15,15,12,0.7692,130,"[8, 9, 10, 11, 17, 18, 19, 21, 31, 32, 42, 50, 51, 52, 53, 62, 63, 71, 74, 81, 89, 97, 104, 105, 114, 115, 122, 123, 124, 125]"

Norman,L100,short,29,9,20,9,0.7752,129,"[8, 9, 15, 16, 18, 20, 28, 29, 39, 42, 50, 58, 59, 63, 70, 78, 80, 87, 89, 90, 91, 95, 102, 109, 110, 111, 112, 121, 122]"

Norman,L100,short,33,25,8,2,0.7519,133,"[4, 9, 10, 21, 29, 30, 38, 39, 40, 49, 50, 59, 60, 68, 70, 71, 73, 81, 82, 84, 92, 93, 94, 103, 104, 111, 112, 113, 114, 115, 123, 124, 126]"

Norman,L100,short,28,8,20,2,0.7812,128,"[4, 9, 18, 19, 27, 28, 29, 37, 39, 47, 48, 49, 57, 58, 60, 68, 71, 80, 81, 90, 91, 99, 101, 109, 113, 120, 121, 125]"

Norman,L100,short,30,17,13,4,0.7692,130,"[8, 9, 14, 15, 16, 17, 19, 20, 22, 31, 32, 42, 43, 53, 62, 63, 64, 72, 73, 74, 83, 86, 96, 104, 111, 112, 114, 122, 124, 126]"

Norman,L100,short,35,6,29,6,0.7407,135,"[8, 9, 14, 17, 18, 19, 21, 30, 31, 40, 41, 51, 52, 60, 61, 62, 63, 71, 72, 74, 82, 84, 92, 94, 103, 104, 105, 106, 114, 115, 116, 119, 127, 128, 132]"

Norman,L100,short,33,15,18,4,0.7519,133,"[9, 14, 16, 18, 19, 27, 28, 29, 30, 39, 41, 49, 50, 58, 60, 68, 69, 70, 74, 82, 83, 84, 87, 96, 99, 107, 108, 116, 117, 118, 119, 127, 129]"

Norman,L100,short,30,20,10,10,0.7692,130,"[4, 9, 18, 21, 29, 37, 38, 40, 48, 51, 58, 62, 71, 72, 79, 80, 81, 82, 83, 92, 93, 94, 101, 103, 104, 111, 112, 113, 118, 126]"

Norman,L100,short,33,20,13,5,0.7519,133,"[5, 10, 19, 27, 28, 29, 31, 39, 41, 51, 52, 53, 60, 61, 62, 64, 72, 73, 81, 82, 83, 91, 92, 93, 94, 103, 104, 112, 113, 114, 123, 124, 127]"

Norman,L100,short,31,14,17,3,0.7634,131,"[6, 11, 20, 28, 29, 30, 31, 34, 41, 43, 44, 53, 55, 63, 64, 65, 75, 83, 84, 85, 86, 94, 95, 96, 105, 106, 113, 115, 116, 125, 127]"

Norman,L100,short,30,20,10,2,0.7692,130,"[8, 11, 17, 18, 20, 21, 30, 31, 41, 42, 50, 52, 53, 54, 62, 64, 65, 66, 76, 84, 87, 95, 96, 104, 105, 106, 117, 124, 126, 127]"

Norman,L100,short,32,19,13,8,0.7576,132,"[9, 10, 15, 16, 17, 19, 20, 21, 22, 23, 26, 36, 45, 53, 55, 57, 66, 74, 75, 76, 77, 79, 81, 90, 98, 102, 103, 111, 113, 115, 123, 125]"

Norman,L100,short,26,18,8,9,0.7937,126,"[4, 9, 10, 11, 13, 22, 34, 45, 52, 56, 62, 63, 64, 66, 76, 79, 87, 95, 96, 97, 104, 105, 106, 107, 111, 118]"

Norman,L100,short,30,16,14,6,0.7692,130,"[8, 9, 14, 15, 16, 17, 19, 28, 30, 39, 47, 48, 50, 51, 53, 64, 73, 83, 92, 99, 101, 102, 109, 110, 111, 112, 113, 120, 122, 123]"

Norman,L100,short,29,17,12,6,0.7752,129,"[6, 10, 20, 28, 29, 30, 38, 39, 41, 49, 50, 57, 58, 59, 62, 70, 71, 72, 74, 82, 83, 86, 94, 96, 106, 113, 115, 116, 127]"

Norman,L100,short,30,21,9,4,0.7692,130,"[11, 17, 18, 20, 29, 32, 40, 41, 42, 49, 50, 51, 52, 53, 54, 63, 65, 75, 83, 85, 93, 94, 95, 104, 105, 112, 113, 115, 124, 125]"

Norman,L100,short,31,14,17,6,0.7634,131,"[8, 9, 15, 19, 20, 28, 29, 31, 40, 41, 50, 53, 54, 63, 64, 65, 66, 74, 75, 76, 86, 87, 89, 97, 99, 107, 108, 109, 113, 121, 129]"

Norman,L100,short,32,19,13,11,0.7576,132,"[4, 9, 10, 16, 25, 33, 34, 35, 44, 46, 54, 55, 59, 66, 67, 75, 76, 77, 85, 86, 87, 88, 89, 99, 107, 108, 109, 117, 119, 121, 129, 130]"

Norman,L100,short,32,19,13,5,0.7576,132,"[9, 10, 15, 17, 18, 19, 20, 29, 31, 33, 42, 43, 44, 46, 48, 57, 58, 69, 80, 88, 95, 97, 98, 106, 108, 109, 111, 112, 113, 121, 123, 126]"

Norman,L100,short,32,16,16,8,0.7576,132,"[4, 9, 22, 29, 30, 37, 38, 39, 40, 41, 43, 51, 52, 60, 61, 62, 70, 75, 83, 91, 92, 94, 101, 102, 103, 110, 113, 114, 122, 123, 124, 126]"

Norman,L100,short,31,12,19,8,0.7634,131,"[9, 10, 11, 17, 19, 22, 31, 32, 34, 44, 48, 55, 56, 64, 65, 66, 74, 75, 78, 86, 87, 95, 96, 97, 106, 107, 115, 117, 124, 126, 129]"

Norman,L100,short,30,8,22,15,0.7692,130,"[8, 9, 11, 17, 18, 19, 21, 22, 23, 32, 35, 44, 47, 55, 56, 57, 59, 60, 61, 70, 71, 76, 87, 95, 103, 113, 120, 121, 122, 123]"

Norman,L100,short,29,13,16,7,0.7752,129,"[11, 17, 18, 21, 29, 31, 39, 41, 49, 50, 52, 60, 62, 71, 79, 80, 81, 88, 89, 93, 100, 101, 108, 109, 110, 111, 113, 122, 124]"

Norman,L100,short,29,12,17,9,0.7752,129,"[9, 14, 15, 16, 17, 18, 19, 29, 39, 46, 48, 49, 58, 59, 69, 70, 78, 79, 83, 90, 91, 96, 103, 110, 111, 112, 113, 115, 125]"

Norman,L100,short,33,12,21,3,0.7519,133,"[4, 9, 19, 27, 28, 29, 37, 38, 39, 47, 48, 49, 50, 51, 59, 61, 69, 70, 71, 73, 82, 83, 91, 94, 102, 103, 112, 113, 114, 115, 116, 125, 128]"

Norman,L100,short,30,25,5,5,0.7692,130,"[4, 9, 10, 11, 12, 21, 23, 33, 41, 42, 43, 51, 52, 53, 54, 63, 64, 72, 75, 76, 85, 86, 87, 96, 97, 109, 118, 125, 126, 127]"

Norman,L100,short,35,10,25,10,0.7407,135,"[9, 15, 18, 22, 29, 39, 50, 57, 58, 64, 70, 78, 80, 81, 88, 89, 90, 91, 93, 101, 103, 104, 105, 106, 108, 115, 116, 117, 118, 119, 120, 121, 129, 130, 132]"

Norman,L100,short,33,16,17,3,0.7519,133,"[5, 9, 10, 19, 20, 31, 38, 42, 43, 44, 52, 53, 54, 62, 63, 65, 66, 76, 78, 87, 89, 97, 98, 106, 107, 108, 110, 117, 118, 119, 127, 128, 130]"

Norman,L100,short,27,8,19,2,0.7874,127,"[10, 15, 17, 18, 19, 20, 28, 30, 40, 48, 50, 59, 60, 67, 69, 70, 79, 84, 93, 94, 101, 106, 114, 115, 123, 124, 125]"

Norman,L100,short,30,12,18,13,0.7692,130,"[8, 10, 17, 18, 19, 20, 28, 29, 30, 39, 40, 48, 49, 50, 51, 62, 70, 72, 73, 78, 89, 97, 104, 106, 114, 115, 122, 123, 124, 125]"

Norman,L100,short,36,18,18,7,0.7353,136,"[8, 10, 16, 17, 19, 22, 34, 43, 50, 51, 52, 54, 63, 70, 72, 73, 74, 82, 83, 84, 85, 93, 95, 99, 107, 108, 116, 117, 118, 119, 120, 127, 128, 129, 130, 131]"

Norman,L100,short,30,13,17,3,0.7692,130,"[4, 11, 21, 29, 30, 31, 38, 39, 40, 42, 51, 58, 59, 61, 69, 70, 71, 72, 80, 82, 84, 93, 94, 95, 103, 104, 105, 114, 116, 125]"

Norman,L100,short,26,13,13,24,0.7937,126,"[8, 12, 18, 19, 20, 28, 30, 38, 39, 47, 56, 64, 73, 84, 91, 92, 94, 101, 104, 111, 112, 113, 121, 122, 123, 124]"

Norman,L100,short,33,14,19,17,0.7519,133,"[9, 14, 15, 16, 18, 19, 28, 29, 30, 39, 40, 41, 44, 57, 65, 73, 74, 83, 85, 88, 95, 101, 108, 115, 116, 117, 118, 124, 125, 127, 128, 129, 130]"

Norman,L100,short,29,16,13,6,0.7752,129,"[8, 9, 10, 15, 17, 19, 20, 22, 33, 45, 53, 62, 64, 73, 81, 82, 85, 92, 93, 101, 102, 103, 110, 111, 112, 113, 114, 122, 125]"

Norman,L100,short,33,19,14,10,0.7519,133,"[4, 9, 18, 19, 20, 28, 29, 30, 38, 39, 41, 49, 50, 54, 62, 63, 68, 77, 85, 93, 94, 95, 96, 104, 105, 106, 113, 115, 116, 117, 126, 127, 128]"

Norman,L100,short,32,16,16,2,0.7576,132,"[8, 9, 15, 16, 17, 19, 28, 31, 40, 41, 42, 43, 52, 53, 61, 62, 63, 71, 72, 73, 82, 83, 92, 94, 102, 103, 114, 122, 123, 125, 126, 127]"

Norman,L100,short,31,17,14,6,0.7634,131,"[4, 9, 10, 19, 21, 29, 30, 38, 44, 52, 53, 61, 62, 63, 72, 73, 81, 82, 83, 91, 92, 93, 101, 103, 110, 111, 114, 121, 122, 123, 127]"

Norman,L100,short,31,22,9,7,0.7634,131,"[4, 10, 18, 19, 28, 29, 37, 38, 39, 50, 59, 67, 68, 69, 76, 77, 79, 86, 87, 88, 89, 90, 98, 100, 103, 110, 111, 113, 114, 122, 127]"

Norman,L100,short,33,20,13,4,0.7519,133,"[4, 9, 19, 28, 29, 37, 39, 40, 48, 49, 50, 57, 58, 59, 60, 61, 69, 70, 74, 83, 91, 92, 94, 102, 103, 105, 112, 113, 114, 122, 123, 125, 128]"

Norman,L100,short,32,22,10,3,0.7576,132,"[8, 10, 11, 17, 19, 20, 22, 30, 31, 33, 42, 52, 53, 61, 63, 72, 73, 81, 82, 83, 93, 94, 103, 104, 111, 112, 113, 114, 121, 122, 123, 126]"

Norman,L100,short,34,19,15,8,0.7463,134,"[4, 9, 10, 19, 23, 31, 38, 42, 44, 52, 54, 61, 64, 65, 73, 74, 75, 83, 84, 85, 93, 94, 95, 96, 104, 105, 106, 114, 116, 117, 118, 126, 127, 132]"

Norman,L100,short,31,16,15,5,0.7634,131,"[4, 9, 19, 27, 31, 40, 47, 50, 59, 61, 69, 71, 79, 81, 83, 90, 91, 93, 100, 101, 102, 103, 111, 112, 113, 120, 121, 122, 124, 125, 126]"

Norman,L100,short,33,22,11,5,0.7519,133,"[10, 11, 12, 13, 20, 21, 22, 23, 32, 33, 42, 43, 45, 53, 55, 65, 75, 83, 84, 85, 93, 94, 95, 103, 104, 105, 106, 108, 116, 117, 125, 126, 128]"

Norman,L100,short,33,12,21,8,0.7519,133,"[5, 9, 10, 20, 22, 30, 34, 42, 43, 44, 52, 53, 54, 57, 65, 66, 74, 75, 76, 77, 78, 87, 88, 96, 97, 98, 99, 102, 110, 112, 120, 121, 124]"

Norman,L100,short,32,25,7,5,0.7576,132,"[8, 9, 14, 15, 16, 17, 18, 19, 29, 38, 40, 48, 49, 50, 59, 61, 69, 70, 72, 83, 91, 98, 99, 100, 101, 109, 111, 112, 119, 120, 121, 124]"

Norman,L100,short,30,18,12,11,0.7692,130,"[4, 9, 18, 19, 23, 33, 41, 48, 49, 50, 57, 58, 59, 62, 71, 79, 80, 81, 89, 90, 91, 93, 102, 104, 111, 112, 114, 121, 122, 125]"

Norman,L100,short,32,14,18,4,0.7576,132,"[8, 9, 11, 17, 20, 28, 29, 30, 39, 40, 48, 49, 51, 59, 60, 61, 69, 70, 71, 80, 81, 90, 91, 99, 100, 101, 109, 110, 111, 112, 120, 125]"

Norman,L100,short,26,13,13,16,0.7937,126,"[9, 14, 15, 16, 18, 19, 28, 31, 41, 49, 58, 59, 66, 68, 69, 78, 84, 91, 98, 99, 106, 107, 110, 117, 118, 123]"

Norman,L100,short,30,24,6,2,0.7692,130,"[5, 9, 20, 28, 29, 37, 39, 47, 50, 57, 58, 59, 60, 69, 70, 77, 79, 80, 90, 92, 93, 101, 103, 104, 105, 112, 114, 115, 124, 125]"

Norman,L100,short,31,18,13,5,0.7634,131,"[8, 11, 17, 18, 19, 20, 29, 31, 40, 41, 50, 51, 59, 61, 69, 71, 72, 80, 82, 90, 92, 93, 94, 103, 104, 112, 113, 116, 124, 125, 128]"

Norman,L100,short,30,14,16,5,0.7692,130,"[9, 14, 15, 19, 20, 28, 29, 30, 31, 32, 36, 46, 54, 64, 72, 73, 74, 82, 83, 85, 93, 94, 96, 104, 105, 107, 108, 116, 120, 121]"

Norman,L100,short,28,19,9,4,0.7812,128,"[4, 9, 10, 19, 20, 30, 38, 40, 41, 43, 51, 52, 54, 62, 63, 65, 73, 76, 84, 86, 93, 94, 95, 105, 113, 114, 116, 126]"

Norman,L100,short,31,19,12,7,0.7634,131,"[5, 9, 18, 21, 32, 39, 40, 47, 48, 51, 58, 59, 60, 69, 70, 77, 79, 81, 88, 89, 91, 99, 100, 102, 109, 110, 111, 112, 120, 121, 123]"

Norman,L100,short,27,14,13,8,0.7874,127,"[4, 9, 10, 11, 20, 23, 34, 42, 50, 52, 59, 60, 62, 64, 71, 73, 74, 84, 85, 86, 89, 97, 106, 109, 116, 118, 125]"

Norman,L100,short,30,20,10,6,0.7692,130,"[4, 11, 19, 20, 23, 31, 32, 36, 44, 45, 53, 55, 56, 65, 66, 74, 78, 86, 93, 96, 104, 106, 108, 110, 117, 118, 119, 120, 121, 122]"

Norman,L100,short,31,13,18,4,0.7634,131,"[9, 15, 16, 17, 18, 19, 28, 29, 38, 39, 47, 48, 49, 58, 59, 60, 69, 70, 79, 80, 90, 93, 101, 102, 110, 111, 112, 114, 121, 123, 125]"

Norman,L100,short,32,13,19,4,0.7576,132,"[9, 11, 17, 18, 21, 29, 31, 40, 48, 49, 51, 59, 60, 61, 68, 69, 70, 71, 72, 73, 82, 83, 93, 101, 102, 103, 104, 113, 114, 121, 122, 125]"

Norman,L100,short,30,15,15,8,0.7692,130,"[10, 19, 26, 27, 28, 29, 37, 39, 47, 48, 51, 59, 66, 67, 68, 69, 79, 81, 88, 89, 91, 98, 99, 100, 101, 109, 110, 114, 121, 123]"

Norman,L100,short,34,26,8,2,0.7463,134,"[4, 9, 10, 11, 20, 21, 30, 32, 40, 41, 49, 50, 53, 61, 63, 71, 72, 74, 75, 83, 84, 85, 86, 87, 88, 96, 98, 108, 115, 116, 118, 126, 127, 128]"

Norman,L100,short,32,23,9,9,0.7576,132,"[5, 9, 10, 19, 20, 23, 32, 40, 41, 49, 50, 56, 63, 70, 71, 72, 79, 81, 82, 92, 93, 101, 102, 103, 110, 111, 112, 113, 114, 122, 123, 124]"

Norman,L100,short,28,12,16,14,0.7812,128,"[5, 9, 11, 22, 32, 39, 40, 47, 49, 53, 60, 62, 63, 70, 72, 76, 83, 84, 85, 93, 97, 104, 106, 114, 115, 118, 125, 126]"

Norman,L100,short,32,18,14,4,0.7576,132,"[5, 9, 18, 19, 20, 28, 29, 30, 38, 41, 49, 50, 52, 60, 61, 69, 72, 74, 83, 91, 92, 93, 94, 95, 103, 104, 105, 106, 107, 117, 126, 128]"

Norman,L100,short,31,21,10,5,0.7634,131,"[6, 9, 19, 20, 21, 22, 24, 33, 34, 42, 44, 55, 62, 65, 74, 81, 82, 84, 91, 92, 93, 94, 95, 96, 104, 109, 116, 124, 125, 126, 127]"

Norman,L100,short,34,26,8,2,0.7463,134,"[8, 9, 14, 15, 18, 19, 29, 37, 38, 39, 40, 43, 52, 60, 62, 63, 65, 66, 74, 75, 77, 85, 86, 96, 104, 105, 106, 108, 109, 110, 119, 120, 128, 130]"

Norman,L100,short,35,22,13,4,0.7407,135,"[9, 12, 18, 19, 21, 30, 38, 40, 48, 50, 58, 59, 60, 67, 69, 70, 78, 79, 80, 88, 89, 90, 92, 100, 101, 109, 111, 118, 119, 121, 122, 123, 131, 132, 133]"

Norman,L100,short,30,24,6,5,0.7692,130,"[9, 11, 17, 18, 20, 22, 24, 32, 33, 34, 43, 45, 53, 54, 62, 64, 72, 73, 75, 83, 84, 92, 94, 103, 105, 113, 114, 116, 124, 126]"

Norman,L100,short,32,21,11,4,0.7576,132,"[6, 9, 10, 11, 20, 21, 22, 23, 32, 33, 35, 43, 44, 57, 65, 66, 74, 75, 78, 86, 87, 95, 96, 97, 105, 107, 114, 116, 117, 126, 127, 128]"

Norman,L100,short,30,19,11,6,0.7692,130,"[8, 9, 14, 15, 16, 20, 29, 31, 43, 50, 51, 59, 63, 70, 73, 74, 82, 83, 84, 92, 93, 94, 102, 103, 105, 113, 114, 122, 123, 125]"

Norman,L100,short,31,20,11,3,0.7634,131,"[8, 9, 10, 12, 18, 19, 21, 22, 31, 32, 33, 43, 52, 53, 62, 63, 65, 74, 76, 84, 85, 94, 95, 104, 105, 112, 114, 117, 124, 125, 128]"

Norman,L100,short,30,12,18,10,0.7692,130,"[4, 10, 19, 20, 21, 25, 33, 41, 45, 53, 60, 61, 62, 63, 66, 74, 75, 76, 85, 86, 93, 94, 97, 105, 108, 115, 116, 117, 119, 128]"

Norman,L100,short,29,13,16,7,0.7752,129,"[7, 10, 19, 22, 30, 33, 41, 43, 52, 54, 61, 62, 63, 70, 72, 73, 85, 92, 93, 100, 105, 113, 114, 115, 122, 123, 124, 125, 126]"

Norman,L100,short,28,10,18,10,0.7812,128,"[8, 11, 17, 18, 20, 29, 37, 38, 39, 47, 48, 49, 52, 60, 62, 65, 74, 83, 92, 94, 102, 104, 111, 112, 113, 115, 123, 124]"

Norman,L100,short,29,13,16,1,0.7752,129,"[8, 10, 15, 16, 17, 18, 20, 29, 30, 40, 49, 50, 59, 60, 61, 69, 71, 72, 82, 90, 91, 92, 104, 111, 113, 114, 123, 124, 125]"

Norman,L100,short,28,20,8,10,0.7812,128,"[8, 14, 21, 28, 30, 38, 39, 40, 41, 50, 52, 61, 68, 70, 72, 73, 87, 94, 101, 103, 104, 113, 114, 120, 121, 122, 123, 124]"

Norman,L100,short,31,13,18,10,0.7634,131,"[5, 9, 10, 19, 20, 28, 29, 32, 41, 49, 50, 57, 59, 60, 68, 69, 71, 81, 88, 89, 93, 100, 101, 102, 103, 110, 113, 121, 122, 125, 128]"

Norman,L100,short,33,20,13,8,0.7519,133,"[9, 14, 15, 16, 17, 18, 19, 28, 29, 33, 43, 51, 59, 60, 63, 71, 72, 74, 82, 83, 84, 92, 94, 102, 103, 104, 105, 114, 115, 123, 124, 125, 126]"

Norman,L100,short,30,15,15,3,0.7692,130,"[9, 15, 16, 17, 19, 27, 28, 29, 38, 42, 52, 61, 62, 63, 64, 72, 73, 74, 82, 85, 93, 94, 95, 103, 104, 106, 115, 123, 125, 127]"

Norman,L100,short,25,14,11,5,0.8,125,"[9, 10, 17, 18, 19, 21, 30, 32, 41, 42, 50, 51, 52, 62, 63, 66, 74, 83, 85, 94, 95, 104, 106, 113, 117]"

Norman,L100,short,33,20,13,2,0.7519,133,"[8, 9, 14, 15, 16, 17, 18, 19, 29, 39, 47, 48, 49, 58, 61, 69, 78, 79, 87, 89, 97, 98, 99, 100, 108, 110, 117, 118, 119, 120, 121, 129, 131]"

Norman,L100,short,29,17,12,4,0.7752,129,"[6, 9, 10, 19, 20, 28, 30, 40, 41, 49, 50, 51, 60, 61, 72, 81, 83, 91, 94, 101, 102, 103, 110, 111, 112, 113, 120, 122, 123]"

Norman,L100,short,28,16,12,11,0.7812,128,"[8, 9, 15, 16, 17, 19, 34, 42, 49, 51, 58, 59, 60, 67, 70, 79, 82, 91, 98, 99, 101, 108, 109, 110, 111, 118, 120, 121]"

Norman,L100,short,35,20,15,8,0.7407,135,"[9, 16, 18, 20, 28, 30, 38, 39, 40, 48, 50, 52, 60, 61, 68, 69, 71, 73, 81, 82, 90, 91, 92, 94, 103, 106, 115, 116, 118, 119, 120, 127, 128, 129, 131]"

Norman,L100,short,26,21,5,9,0.7937,126,"[4, 9, 10, 20, 28, 30, 31, 39, 40, 42, 50, 51, 52, 62, 63, 66, 74, 78, 87, 96, 97, 104, 105, 108, 112, 120]"

Norman,L100,short,33,29,4,2,0.7519,133,"[5, 9, 10, 19, 21, 29, 32, 39, 40, 41, 51, 60, 61, 69, 71, 79, 81, 82, 83, 84, 85, 87, 96, 104, 105, 106, 107, 114, 116, 117, 126, 127, 128]"

Norman,L100,short,31,14,17,8,0.7634,131,"[6, 11, 19, 20, 22, 30, 31, 41, 54, 61, 64, 71, 73, 74, 77, 84, 87, 88, 95, 97, 98, 101, 108, 109, 117, 118, 119, 126, 127, 128, 129]"

Norman,L100,short,30,12,18,1,0.7692,130,"[9, 10, 11, 17, 18, 19, 21, 30, 31, 40, 43, 44, 52, 55, 65, 74, 75, 83, 85, 95, 102, 103, 104, 105, 113, 114, 116, 123, 124, 126]"

Norman,L100,short,30,10,20,8,0.7692,130,"[10, 15, 17, 18, 21, 29, 30, 38, 40, 48, 49, 51, 60, 61, 68, 69, 71, 72, 80, 81, 82, 91, 94, 102, 110, 111, 113, 120, 121, 124]"

Norman,L100,short,27,12,15,10,0.7874,127,"[9, 15, 16, 18, 19, 27, 30, 38, 40, 48, 50, 58, 59, 66, 68, 69, 77, 78, 82, 90, 97, 100, 107, 110, 117, 118, 120]"

Norman,L100,short,24,18,6,5,0.8065,124,"[5, 9, 18, 19, 21, 30, 31, 40, 41, 43, 51, 52, 54, 62, 64, 65, 73, 74, 79, 87, 97, 104, 107, 117]"

Norman,L100,short,28,9,19,13,0.7812,128,"[5, 10, 17, 26, 35, 37, 44, 45, 47, 50, 58, 65, 67, 68, 76, 78, 79, 87, 89, 90, 97, 98, 99, 101, 112, 119, 120, 121]"

Norman,L100,short,30,8,22,9,0.7692,130,"[8, 9, 11, 17, 18, 19, 21, 29, 30, 32, 42, 50, 51, 52, 53, 62, 67, 75, 83, 90, 91, 93, 101, 102, 105, 112, 113, 115, 123, 124]"

Norman,L100,short,34,8,26,4,0.7463,134,"[4, 10, 11, 12, 21, 22, 32, 33, 42, 43, 44, 46, 54, 57, 65, 66, 67, 75, 76, 77, 86, 87, 97, 98, 99, 101, 109, 110, 111, 120, 121, 129, 130, 132]"

Norman,L100,short,29,21,8,9,0.7752,129,"[5, 9, 18, 19, 20, 28, 30, 31, 40, 41, 49, 50, 51, 53, 61, 63, 72, 81, 83, 93, 101, 102, 103, 104, 111, 113, 114, 119, 127]"

Norman,L100,short,29,12,17,12,0.7752,129,"[5, 10, 19, 22, 30, 32, 40, 42, 50, 53, 63, 70, 71, 73, 80, 81, 82, 83, 90, 91, 92, 97, 106, 116, 123, 124, 125, 126, 127]"

Norman,L100,short,31,19,12,3,0.7634,131,"[9, 14, 19, 27, 28, 29, 37, 38, 40, 48, 49, 57, 58, 59, 67, 68, 69, 70, 78, 79, 80, 89, 90, 91, 99, 100, 101, 109, 111, 113, 123]"

Norman,L100,short,28,15,13,9,0.7812,128,"[8, 10, 15, 16, 17, 18, 19, 21, 30, 39, 43, 51, 59, 61, 62, 63, 71, 72, 73, 81, 83, 91, 92, 95, 103, 112, 114, 123]"

Norman,L100,short,37,21,16,9,0.7299,137,"[5, 10, 18, 22, 31, 38, 39, 40, 42, 50, 52, 59, 61, 62, 63, 71, 73, 76, 84, 91, 92, 93, 95, 103, 104, 105, 113, 114, 115, 116, 117, 118, 126, 127, 128, 129, 132]"

Norman,L100,short,30,12,18,5,0.7692,130,"[8, 9, 10, 15, 16, 17, 18, 21, 31, 42, 50, 59, 60, 68, 69, 70, 79, 80, 90, 97, 98, 99, 101, 109, 110, 111, 113, 121, 122, 123]"

Norman,L100,short,28,18,10,8,0.7812,128,"[11, 17, 18, 19, 21, 29, 33, 42, 50, 53, 61, 68, 69, 72, 82, 90, 91, 98, 99, 100, 101, 103, 110, 112, 114, 121, 122, 124]"

Norman,L100,short,32,12,20,10,0.7576,132,"[8, 9, 12, 18, 19, 20, 28, 30, 32, 41, 42, 45, 54, 63, 71, 72, 74, 75, 84, 85, 86, 88, 96, 98, 110, 117, 118, 124, 125, 126, 128, 129]"

Norman,L100,short,30,11,19,5,0.7692,130,"[9, 15, 16, 17, 18, 19, 28, 29, 30, 39, 40, 48, 49, 51, 60, 68, 69, 70, 78, 81, 89, 91, 99, 100, 102, 110, 112, 113, 115, 124]"

Norman,L100,short,27,14,13,7,0.7874,127,"[4, 11, 20, 28, 29, 30, 39, 41, 51, 58, 59, 60, 69, 71, 78, 80, 87, 88, 92, 99, 101, 108, 109, 110, 117, 119, 121]"

Norman,L100,short,32,16,16,6,0.7576,132,"[6, 9, 18, 20, 28, 30, 38, 39, 48, 50, 57, 58, 59, 60, 70, 78, 79, 80, 87, 89, 91, 99, 100, 101, 108, 109, 110, 111, 119, 120, 121, 124]"

Norman,L100,short,29,19,10,8,0.7752,129,"[4, 9, 10, 19, 20, 28, 29, 30, 42, 51, 58, 59, 60, 70, 72, 80, 81, 82, 83, 84, 92, 95, 103, 104, 111, 112, 113, 116, 125]"

Norman,L100,short,31,24,7,5,0.7634,131,"[4, 9, 11, 12, 20, 22, 23, 32, 33, 42, 43, 52, 53, 61, 63, 64, 72, 74, 83, 84, 93, 94, 101, 102, 103, 105, 112, 114, 115, 118, 129]"

Norman,L100,short,25,13,12,14,0.8,125,"[9, 14, 15, 16, 17, 20, 28, 32, 44, 53, 61, 62, 69, 70, 72, 80, 82, 92, 99, 102, 103, 104, 105, 111, 119]"

Norman,L100,short,32,9,23,2,0.7576,132,"[4, 9, 10, 19, 20, 28, 29, 30, 38, 39, 40, 49, 51, 59, 61, 69, 70, 71, 73, 81, 82, 83, 91, 92, 94, 103, 104, 105, 113, 114, 116, 125]"

Norman,L100,short,26,17,9,12,0.7937,126,"[4, 11, 19, 20, 23, 31, 32, 39, 40, 41, 43, 52, 53, 61, 62, 66, 77, 84, 91, 92, 94, 102, 104, 112, 117, 124]"

Norman,L100,short,30,18,12,14,0.7692,130,"[9, 14, 15, 16, 18, 21, 29, 31, 40, 42, 44, 46, 54, 55, 63, 64, 66, 75, 79, 87, 95, 96, 103, 104, 105, 110, 117, 124, 125, 127]"

Norman,L100,short,28,19,9,5,0.7812,128,"[8, 9, 14, 15, 17, 18, 19, 28, 29, 38, 39, 40, 48, 50, 63, 71, 79, 80, 81, 83, 91, 93, 102, 109, 111, 112, 121, 122]"

Norman,L100,short,34,21,13,7,0.7463,134,"[4, 9, 18, 20, 28, 30, 31, 32, 40, 41, 42, 44, 53, 56, 64, 65, 66, 67, 69, 78, 86, 87, 88, 96, 97, 98, 101, 109, 116, 117, 118, 119, 128, 132]"

Norman,L100,short,35,24,11,5,0.7407,135,"[4, 9, 10, 20, 29, 30, 32, 39, 40, 42, 43, 51, 52, 56, 64, 74, 75, 76, 77, 85, 86, 87, 95, 96, 97, 106, 107, 109, 117, 118, 119, 127, 128, 129, 130]"

Norman,L100,short,32,16,16,1,0.7576,132,"[4, 9, 18, 20, 28, 29, 30, 31, 40, 42, 50, 51, 59, 61, 69, 70, 71, 72, 80, 81, 83, 91, 92, 95, 103, 105, 112, 113, 114, 115, 123, 125]"

Norman,L100,short,35,24,11,5,0.7407,135,"[11, 17, 21, 29, 30, 38, 39, 40, 48, 49, 50, 52, 60, 61, 68, 69, 70, 71, 79, 80, 81, 91, 92, 93, 101, 102, 103, 104, 105, 114, 115, 116, 124, 125, 126]"

Norman,L100,short,28,13,15,7,0.7812,128,"[4, 9, 20, 28, 30, 37, 39, 41, 50, 51, 59, 60, 63, 70, 72, 82, 92, 99, 100, 102, 103, 104, 111, 112, 113, 114, 121, 125]"

Norman,L100,short,33,21,12,7,0.7519,133,"[5, 12, 20, 21, 23, 31, 34, 36, 44, 46, 54, 55, 63, 65, 66, 74, 75, 78, 87, 95, 96, 97, 105, 106, 107, 114, 115, 116, 117, 118, 126, 127, 130]"

Norman,L100,short,29,8,21,10,0.7752,129,"[10, 15, 16, 17, 20, 28, 29, 30, 39, 44, 52, 61, 68, 69, 70, 71, 79, 80, 82, 90, 91, 99, 101, 102, 103, 104, 113, 116, 124]"

Norman,L100,short,30,18,12,8,0.7692,130,"[8, 10, 15, 16, 18, 19, 28, 29, 30, 39, 41, 49, 50, 58, 59, 60, 62, 71, 79, 80, 84, 92, 94, 96, 104, 105, 114, 116, 124, 125]"

Norman,L100,short,33,21,12,2,0.7519,133,"[4, 9, 10, 19, 20, 30, 31, 42, 50, 51, 52, 59, 60, 62, 63, 65, 73, 74, 75, 83, 84, 86, 94, 95, 103, 105, 106, 113, 114, 116, 124, 125, 126]"

Norman,L100,short,28,18,10,7,0.7812,128,"[10, 17, 18, 19, 20, 21, 30, 32, 41, 44, 51, 53, 54, 55, 63, 65, 67, 76, 77, 78, 89, 97, 98, 107, 108, 110, 118, 120]"

Norman,L100,short,34,31,3,2,0.7463,134,"[5, 9, 18, 19, 28, 29, 30, 31, 32, 33, 44, 52, 53, 61, 63, 71, 73, 82, 83, 84, 85, 86, 94, 95, 96, 98, 109, 116, 117, 118, 119, 120, 129, 132]"

Norman,L100,short,34,15,19,2,0.7463,134,"[5, 9, 18, 19, 27, 28, 29, 37, 38, 39, 47, 48, 49, 57, 60, 69, 77, 78, 79, 87, 88, 89, 97, 98, 99, 107, 108, 110, 112, 120, 121, 122, 130, 132]"

Norman,L100,short,32,11,21,4,0.7576,132,"[4, 10, 18, 19, 27, 28, 29, 39, 47, 48, 49, 56, 57, 60, 62, 70, 71, 73, 82, 90, 91, 92, 100, 101, 102, 103, 104, 112, 114, 116, 124, 125]"

Norman,L100,short,32,24,8,3,0.7576,132,"[5, 9, 18, 19, 28, 30, 38, 40, 50, 57, 59, 61, 62, 63, 71, 72, 74, 82, 84, 91, 92, 93, 94, 103, 104, 112, 113, 116, 124, 125, 126, 128]"

Norman,L100,short,35,18,17,6,0.7407,135,"[4, 9, 18, 20, 21, 29, 30, 32, 40, 41, 42, 50, 52, 60, 61, 63, 71, 72, 73, 82, 83, 84, 92, 93, 94, 103, 104, 112, 113, 114, 118, 126, 127, 128, 131]"

Norman,L100,short,30,24,6,4,0.7692,130,"[8, 9, 14, 16, 18, 19, 28, 32, 33, 34, 38, 47, 56, 58, 66, 67, 69, 77, 78, 79, 90, 98, 99, 100, 107, 108, 111, 119, 120, 122]"

Norman,L100,short,31,20,11,10,0.7634,131,"[8, 11, 17, 20, 28, 29, 30, 31, 32, 41, 42, 50, 52, 53, 57, 66, 75, 83, 85, 93, 95, 102, 104, 112, 113, 114, 115, 123, 124, 125, 126]"

Norman,L100,short,31,18,13,5,0.7634,131,"[8, 9, 14, 16, 18, 19, 28, 29, 39, 46, 47, 48, 49, 58, 60, 71, 80, 89, 96, 97, 98, 100, 107, 108, 110, 111, 118, 119, 120, 121, 129]"

Norman,L100,short,28,7,21,7,0.7812,128,"[8, 10, 16, 17, 18, 19, 21, 29, 31, 40, 41, 49, 51, 61, 64, 65, 74, 76, 85, 87, 95, 96, 97, 99, 107, 109, 118, 121]"

Norman,L100,short,23,19,4,20,0.813,123,"[4, 9, 10, 12, 21, 22, 32, 39, 40, 41, 42, 44, 53, 61, 62, 63, 75, 83, 91, 92, 100, 109, 117]"

Norman,L100,short,33,15,18,4,0.7519,133,"[6, 9, 10, 19, 20, 29, 30, 31, 40, 41, 50, 53, 61, 69, 71, 79, 83, 84, 85, 92, 94, 96, 104, 105, 106, 107, 109, 117, 118, 119, 120, 129, 131]"

Norman,L100,short,28,21,7,5,0.7812,128,"[4, 9, 19, 28, 29, 37, 40, 48, 49, 50, 51, 60, 61, 63, 71, 72, 74, 82, 83, 84, 92, 93, 96, 105, 106, 109, 117, 124]"

Norman,L100,short,32,9,23,1,0.7576,132,"[4, 9, 19, 29, 30, 37, 39, 40, 49, 50, 51, 58, 59, 60, 61, 69, 71, 79, 80, 81, 90, 92, 93, 101, 102, 103, 104, 106, 114, 116, 124, 126]"

Norman,L100,short,30,21,9,5,0.7692,130,"[8, 9, 14, 16, 21, 30, 38, 39, 48, 49, 57, 58, 60, 69, 77, 79, 86, 88, 89, 90, 91, 93, 95, 103, 104, 105, 113, 116, 124, 125]"

Norman,L100,short,30,13,17,3,0.7692,130,"[4, 9, 10, 11, 21, 22, 23, 33, 34, 42, 44, 52, 53, 55, 56, 57, 66, 67, 76, 77, 81, 90, 93, 101, 103, 112, 113, 122, 123, 125]"

Norman,L100,short,30,19,11,9,0.7692,130,"[8, 9, 10, 15, 16, 17, 18, 20, 21, 31, 34, 43, 51, 52, 61, 62, 70, 73, 81, 84, 92, 95, 103, 104, 111, 112, 115, 118, 125, 126]"

Norman,L100,short,36,4,32,4,0.7353,136,"[9, 14, 16, 17, 18, 19, 28, 29, 38, 40, 48, 49, 57, 59, 68, 69, 71, 79, 80, 81, 82, 83, 84, 93, 95, 103, 104, 105, 114, 115, 117, 118, 119, 127, 128, 132]"

Norman,L100,short,31,17,14,3,0.7634,131,"[9, 14, 16, 18, 21, 30, 39, 47, 48, 49, 58, 59, 60, 67, 68, 69, 70, 78, 80, 88, 89, 91, 99, 100, 102, 103, 113, 114, 121, 123, 124]"

Norman,L100,short,30,14,16,6,0.7692,130,"[8, 10, 17, 19, 20, 24, 33, 34, 42, 44, 51, 54, 62, 65, 72, 73, 74, 83, 86, 93, 94, 101, 102, 103, 104, 112, 116, 123, 124, 125]"

Norman,L100,short,33,13,20,3,0.7519,133,"[4, 9, 20, 22, 30, 31, 32, 39, 41, 42, 43, 51, 52, 53, 61, 62, 63, 71, 72, 73, 83, 91, 93, 101, 102, 103, 104, 112, 113, 114, 116, 119, 127]"

Norman,L100,short,29,15,14,2,0.7752,129,"[9, 10, 11, 12, 13, 14, 21, 22, 23, 24, 25, 26, 35, 36, 37, 47, 56, 58, 68, 77, 78, 88, 90, 99, 109, 110, 112, 120, 121]"

Norman,L100,short,29,17,12,12,0.7752,129,"[9, 11, 19, 24, 32, 34, 42, 44, 52, 53, 54, 62, 69, 76, 84, 85, 92, 96, 97, 98, 99, 100, 102, 109, 111, 118, 119, 120, 121]"

Norman,L100,short,30,17,13,6,0.7692,130,"[4, 9, 10, 11, 20, 22, 31, 32, 42, 43, 52, 53, 54, 62, 63, 64, 72, 73, 76, 84, 85, 94, 96, 97, 98, 99, 108, 111, 119, 123]"

Norman,L100,short,31,17,14,10,0.7634,131,"[4, 10, 18, 19, 20, 22, 33, 40, 42, 50, 51, 54, 61, 62, 66, 74, 83, 84, 85, 88, 96, 97, 98, 106, 107, 108, 110, 117, 118, 119, 128]"

Norman,L100,short,30,19,11,5,0.7692,130,"[5, 9, 11, 21, 22, 32, 39, 40, 41, 43, 51, 53, 61, 62, 70, 71, 72, 73, 81, 82, 83, 91, 94, 97, 106, 113, 114, 116, 125, 126]"

Norman,L100,short,35,22,13,5,0.7407,135,"[4, 9, 19, 27, 29, 37, 39, 47, 49, 50, 53, 54, 57, 64, 65, 66, 67, 75, 76, 77, 86, 87, 95, 96, 97, 98, 99, 100, 109, 110, 111, 113, 114, 118, 126]"

Norman,L100,short,30,14,16,9,0.7692,130,"[4, 10, 19, 21, 31, 38, 40, 41, 49, 50, 54, 61, 69, 70, 71, 72, 79, 80, 81, 84, 92, 99, 101, 102, 104, 111, 113, 121, 122, 124]"

Norman,L100,short,33,22,11,8,0.7519,133,"[4, 9, 10, 20, 23, 31, 38, 39, 40, 41, 42, 43, 52, 53, 63, 65, 73, 74, 82, 83, 84, 85, 90, 98, 106, 107, 109, 116, 117, 119, 128, 129, 130]"

Norman,L100,short,34,13,21,4,0.7463,134,"[4, 9, 18, 19, 20, 32, 39, 40, 43, 51, 52, 53, 60, 61, 64, 73, 74, 85, 92, 93, 95, 103, 105, 106, 114, 115, 116, 117, 118, 126, 127, 128, 130, 132]"

Norman,L100,short,27,18,9,4,0.7874,127,"[8, 9, 15, 18, 21, 29, 39, 41, 50, 59, 61, 68, 70, 78, 80, 88, 90, 98, 99, 101, 109, 110, 111, 112, 120, 122, 123]"

Norman,L100,short,32,15,17,12,0.7576,132,"[9, 10, 15, 16, 18, 19, 21, 31, 33, 42, 51, 55, 65, 72, 73, 74, 78, 85, 92, 93, 94, 95, 96, 98, 106, 107, 108, 116, 118, 126, 127, 128]"

Norman,L100,short,29,11,18,6,0.7752,129,"[4, 11, 19, 21, 30, 31, 39, 41, 43, 52, 61, 63, 71, 73, 82, 84, 85, 92, 95, 102, 103, 104, 105, 112, 114, 115, 119, 126, 127]"

Norman,L100,short,27,15,12,12,0.7874,127,"[8, 9, 14, 18, 19, 30, 38, 39, 40, 41, 49, 51, 59, 60, 61, 63, 72, 75, 84, 86, 94, 95, 102, 103, 104, 111, 119]"

Norman,L100,short,30,21,9,6,0.7692,130,"[4, 9, 20, 30, 37, 38, 40, 41, 49, 51, 58, 59, 60, 62, 74, 81, 84, 85, 87, 94, 97, 99, 107, 108, 109, 110, 111, 119, 120, 124]"

Norman,L100,short,38,23,15,7,0.7246,138,"[8, 13, 21, 29, 31, 38, 41, 48, 49, 51, 52, 53, 54, 55, 63, 64, 65, 67, 76, 84, 85, 86, 87, 95, 96, 97, 105, 107, 115, 117, 119, 127, 128, 129, 131, 132, 134, 135]"

Norman,L100,short,30,18,12,9,0.7692,130,"[8, 9, 10, 15, 16, 17, 21, 30, 39, 42, 50, 58, 60, 61, 69, 70, 73, 81, 82, 83, 91, 92, 94, 102, 104, 112, 113, 115, 124, 128]"

Norman,L100,short,31,15,16,8,0.7634,131,"[4, 11, 19, 21, 29, 31, 38, 39, 40, 48, 49, 51, 59, 60, 61, 62, 70, 73, 82, 83, 92, 93, 101, 102, 107, 114, 121, 122, 123, 125, 127]"

Norman,L100,short,30,8,22,10,0.7692,130,"[7, 12, 20, 21, 23, 24, 25, 34, 35, 36, 40, 49, 57, 61, 68, 76, 78, 79, 88, 90, 97, 98, 101, 109, 110, 111, 112, 119, 120, 122]"

Norman,L100,short,34,18,16,8,0.7463,134,"[8, 9, 14, 15, 16, 17, 18, 20, 29, 30, 39, 40, 48, 49, 53, 62, 72, 73, 81, 82, 83, 84, 92, 93, 94, 95, 96, 104, 105, 108, 116, 117, 126, 127]"

Norman,L100,short,29,11,18,2,0.7752,129,"[5, 10, 18, 19, 20, 21, 29, 30, 31, 32, 42, 44, 54, 64, 65, 73, 74, 75, 84, 85, 94, 95, 96, 104, 105, 107, 116, 117, 120]"

Norman,L100,short,29,16,13,10,0.7752,129,"[5, 11, 21, 29, 31, 33, 41, 42, 50, 52, 59, 60, 62, 69, 71, 72, 73, 81, 82, 83, 97, 104, 111, 112, 113, 114, 117, 125, 126]"

Norman,L100,short,30,21,9,10,0.7692,130,"[4, 9, 10, 12, 21, 29, 31, 33, 41, 42, 44, 52, 54, 62, 63, 75, 82, 83, 90, 91, 95, 103, 104, 111, 112, 113, 114, 115, 117, 128]"

Norman,L100,short,33,9,24,7,0.7519,133,"[8, 9, 11, 18, 19, 21, 29, 31, 35, 43, 44, 45, 47, 55, 56, 65, 66, 75, 76, 77, 85, 86, 88, 97, 99, 107, 108, 111, 119, 121, 129, 130, 131]"

Norman,L100,short,29,19,10,1,0.7752,129,"[4, 9, 20, 21, 29, 31, 38, 40, 41, 51, 58, 59, 61, 69, 70, 71, 78, 79, 80, 81, 89, 90, 91, 100, 102, 111, 119, 120, 121]"

Norman,L100,short,31,23,8,6,0.7634,131,"[4, 10, 19, 20, 23, 32, 39, 41, 42, 52, 59, 60, 61, 62, 70, 71, 73, 74, 82, 84, 88, 96, 105, 112, 113, 115, 122, 123, 124, 125, 126]"

Norman,L100,short,31,12,19,5,0.7634,131,"[10, 15, 16, 17, 18, 19, 31, 39, 40, 41, 42, 50, 52, 53, 63, 67, 75, 83, 84, 85, 86, 94, 97, 105, 106, 114, 115, 118, 119, 128, 129]"

Norman,L100,short,34,19,15,5,0.7463,134,"[9, 15, 16, 17, 19, 21, 22, 23, 32, 33, 45, 53, 54, 55, 63, 64, 65, 73, 78, 86, 87, 88, 96, 97, 98, 106, 107, 108, 109, 118, 119, 127, 128, 132]"

Norman,L100,short,29,15,14,9,0.7752,129,"[4, 11, 19, 27, 28, 29, 37, 38, 39, 47, 53, 60, 69, 71, 78, 80, 81, 89, 90, 91, 98, 100, 103, 110, 111, 118, 120, 121, 122]"

Norman,L100,short,29,18,11,6,0.7752,129,"[8, 11, 18, 19, 22, 31, 40, 41, 42, 43, 50, 51, 52, 54, 63, 64, 72, 74, 84, 92, 93, 95, 103, 104, 106, 114, 116, 124, 125]"

Norman,L100,short,27,20,7,5,0.7874,127,"[7, 12, 20, 28, 29, 39, 46, 47, 48, 49, 50, 58, 60, 61, 62, 72, 80, 81, 82, 90, 92, 94, 103, 110, 113, 121, 123]"

Norman,L100,short,27,20,7,7,0.7874,127,"[4, 11, 19, 20, 21, 29, 30, 31, 42, 50, 51, 59, 61, 70, 72, 82, 89, 91, 98, 99, 101, 108, 110, 112, 120, 121, 124]"

Norman,L100,short,28,9,19,4,0.7812,128,"[5, 9, 19, 30, 31, 39, 41, 42, 50, 51, 52, 54, 59, 66, 75, 76, 79, 87, 89, 98, 99, 106, 107, 109, 110, 117, 120, 122]"

Norman,L100,short,31,22,9,5,0.7634,131,"[4, 11, 19, 20, 28, 29, 31, 39, 40, 48, 52, 60, 69, 70, 72, 80, 82, 83, 90, 91, 92, 93, 103, 104, 111, 112, 113, 115, 116, 125, 126]"

Norman,L100,short,30,16,14,10,0.7692,130,"[9, 10, 15, 16, 17, 18, 19, 20, 21, 31, 40, 43, 51, 53, 61, 62, 67, 75, 85, 93, 95, 102, 104, 111, 112, 113, 114, 122, 123, 124]"

Norman,L100,short,31,19,12,4,0.7634,131,"[4, 9, 20, 29, 36, 37, 38, 39, 41, 49, 50, 51, 59, 61, 62, 70, 71, 72, 80, 81, 82, 83, 91, 92, 93, 102, 103, 111, 114, 122, 124]"

Norman,L100,short,28,17,11,4,0.7812,128,"[8, 10, 16, 19, 21, 30, 39, 41, 48, 50, 51, 62, 69, 70, 72, 81, 82, 92, 93, 94, 101, 102, 104, 111, 113, 116, 123, 124]"

Norman,L100,short,33,22,11,3,0.7519,133,"[10, 15, 19, 27, 29, 37, 38, 39, 47, 50, 60, 62, 69, 70, 72, 80, 81, 83, 84, 92, 93, 94, 95, 103, 104, 105, 113, 114, 115, 122, 123, 124, 125]"

Norman,L100,short,33,28,5,2,0.7519,133,"[4, 9, 11, 19, 20, 21, 22, 32, 41, 42, 43, 44, 53, 54, 55, 64, 65, 75, 84, 86, 93, 94, 96, 104, 106, 114, 115, 116, 124, 125, 126, 127, 129]"

Norman,L100,short,27,12,15,7,0.7874,127,"[4, 9, 18, 19, 27, 28, 30, 38, 40, 48, 50, 57, 58, 61, 69, 77, 78, 80, 87, 88, 90, 93, 101, 108, 111, 119, 121]"

Norman,L100,short,33,21,12,4,0.7519,133,"[10, 16, 18, 20, 21, 29, 32, 40, 42, 49, 50, 51, 52, 61, 62, 70, 71, 72, 80, 83, 84, 85, 86, 94, 96, 108, 116, 117, 124, 125, 127, 128, 129]"

Norman,L100,short,32,15,17,6,0.7576,132,"[9, 11, 17, 19, 20, 21, 22, 24, 33, 34, 43, 44, 45, 46, 55, 56, 65, 68, 77, 85, 86, 88, 97, 98, 99, 107, 109, 117, 118, 120, 128, 129]"

Norman,L100,short,30,15,15,4,0.7692,130,"[4, 9, 10, 20, 21, 29, 32, 39, 40, 41, 50, 54, 61, 62, 71, 72, 79, 80, 81, 82, 90, 91, 92, 93, 103, 111, 112, 115, 123, 124]"

Norman,L100,short,32,16,16,7,0.7576,132,"[8, 10, 15, 17, 18, 19, 22, 30, 31, 32, 41, 42, 43, 52, 53, 54, 55, 57, 66, 74, 75, 77, 87, 96, 105, 106, 114, 116, 117, 125, 126, 129]"

Norman,L100,short,27,17,10,8,0.7874,127,"[6, 10, 18, 19, 28, 29, 37, 38, 39, 40, 50, 57, 61, 69, 70, 78, 79, 80, 87, 88, 89, 94, 102, 111, 119, 121, 122]"

Norman,L100,short,32,16,16,7,0.7576,132,"[10, 17, 18, 19, 20, 28, 29, 32, 33, 34, 36, 46, 54, 55, 57, 65, 66, 71, 79, 87, 94, 95, 96, 97, 105, 107, 115, 116, 117, 125, 126, 128]"

Norman,L100,short,31,15,16,3,0.7634,131,"[8, 9, 11, 17, 19, 20, 28, 31, 43, 44, 52, 53, 54, 62, 64, 72, 73, 75, 83, 85, 93, 94, 102, 103, 104, 112, 113, 114, 121, 122, 124]"

Norman,L100,short,33,14,19,5,0.7519,133,"[8, 10, 11, 12, 19, 20, 21, 23, 32, 35, 44, 53, 61, 63, 73, 81, 82, 84, 93, 95, 102, 103, 104, 105, 106, 107, 115, 116, 118, 125, 126, 127, 128]"

Norman,L100,short,31,10,21,13,0.7634,131,"[8, 9, 14, 15, 18, 19, 20, 22, 31, 40, 41, 50, 51, 52, 61, 62, 63, 64, 65, 66, 77, 85, 89, 101, 108, 115, 116, 118, 125, 126, 127]"

Norman,L100,short,32,11,21,1,0.7576,132,"[9, 10, 15, 17, 18, 20, 28, 30, 31, 41, 49, 51, 61, 68, 69, 70, 71, 72, 80, 83, 91, 92, 93, 101, 102, 103, 104, 114, 121, 122, 123, 124]"

Norman,L100,short,34,18,16,2,0.7463,134,"[4, 9, 10, 11, 20, 23, 32, 33, 34, 35, 44, 45, 55, 63, 64, 65, 66, 74, 75, 76, 85, 86, 87, 95, 96, 97, 105, 107, 108, 116, 117, 118, 120, 129]"

Norman,L100,short,30,10,20,10,0.7692,130,"[9, 14, 15, 17, 19, 27, 29, 30, 39, 40, 48, 49, 51, 59, 60, 61, 62, 63, 67, 68, 71, 81, 82, 90, 91, 97, 105, 113, 121, 122]"

Norman,L100,short,34,24,10,2,0.7463,134,"[4, 9, 11, 19, 20, 21, 29, 31, 40, 41, 42, 51, 52, 62, 70, 71, 72, 82, 90, 91, 92, 93, 102, 103, 111, 112, 113, 114, 115, 116, 124, 125, 128, 131]"

Norman,L100,short,31,15,16,2,0.7634,131,"[9, 14, 15, 16, 18, 19, 28, 29, 40, 51, 58, 59, 61, 62, 63, 72, 74, 83, 84, 87, 94, 95, 96, 98, 108, 109, 116, 118, 119, 126, 129]"

Norman,L100,short,28,10,18,13,0.7812,128,"[8, 10, 15, 18, 19, 27, 29, 37, 38, 39, 49, 57, 59, 66, 67, 68, 70, 78, 81, 91, 98, 100, 102, 109, 110, 113, 120, 125]"

Norman,L100,short,32,12,20,2,0.7576,132,"[9, 10, 16, 17, 18, 20, 28, 29, 30, 39, 40, 41, 49, 50, 51, 52, 63, 72, 73, 74, 75, 84, 85, 93, 95, 105, 106, 115, 116, 117, 125, 128]"

Norman,L100,short,33,18,15,9,0.7519,133,"[8, 9, 10, 15, 16, 17, 18, 19, 20, 23, 32, 43, 51, 52, 56, 66, 75, 84, 92, 93, 95, 102, 103, 104, 105, 112, 113, 114, 115, 122, 123, 124, 125]"

Norman,L100,short,27,16,11,6,0.7874,127,"[8, 10, 15, 16, 17, 20, 29, 37, 38, 39, 40, 41, 49, 50, 51, 63, 72, 81, 82, 90, 91, 94, 102, 109, 110, 113, 122]"

Norman,L100,short,33,17,16,3,0.7519,133,"[8, 10, 15, 16, 17, 18, 20, 30, 32, 41, 49, 50, 51, 52, 61, 62, 71, 73, 81, 84, 92, 93, 94, 102, 104, 112, 114, 116, 125, 127, 128, 129, 130]"

Norman,L100,short,33,17,16,10,0.7519,133,"[9, 14, 16, 17, 18, 19, 25, 33, 41, 49, 50, 51, 59, 60, 62, 63, 64, 65, 67, 77, 85, 86, 89, 97, 100, 108, 109, 117, 118, 119, 126, 127, 129]"

Norman,L100,short,24,10,14,8,0.8065,124,"[8, 11, 17, 18, 22, 31, 39, 41, 50, 52, 61, 69, 71, 80, 81, 88, 89, 90, 91, 100, 101, 109, 111, 117]"

Norman,L100,short,28,20,8,4,0.7812,128,"[8, 9, 16, 18, 19, 28, 31, 39, 42, 49, 50, 58, 60, 70, 71, 79, 81, 89, 91, 98, 100, 101, 102, 111, 113, 120, 122, 123]"

Norman,L100,short,28,13,15,7,0.7812,128,"[7, 10, 19, 21, 29, 31, 39, 40, 42, 52, 59, 60, 63, 73, 83, 90, 91, 93, 94, 102, 103, 104, 105, 114, 116, 118, 125, 126]"

Norman,L100,short,28,19,9,4,0.7812,128,"[5, 9, 12, 20, 21, 22, 31, 33, 41, 44, 52, 60, 61, 62, 71, 72, 80, 82, 91, 92, 100, 101, 102, 110, 111, 112, 121, 122]"

Norman,L100,short,30,16,14,3,0.7692,130,"[5, 9, 10, 19, 20, 29, 31, 40, 41, 51, 59, 60, 61, 69, 71, 78, 79, 80, 81, 90, 91, 92, 93, 101, 102, 103, 111, 112, 115, 123]"

Norman,L100,short,27,10,17,14,0.7874,127,"[9, 10, 16, 17, 18, 19, 22, 34, 42, 54, 62, 73, 81, 82, 88, 90, 91, 92, 93, 101, 103, 110, 112, 114, 120, 122, 124]"

Norman,L100,short,32,20,12,3,0.7576,132,"[8, 9, 14, 15, 16, 18, 19, 29, 31, 32, 33, 34, 35, 45, 56, 67, 75, 76, 84, 85, 86, 94, 95, 96, 97, 105, 106, 108, 117, 125, 126, 127]"

Norman,L100,short,32,18,14,10,0.7576,132,"[5, 9, 10, 19, 20, 21, 24, 33, 41, 44, 52, 56, 63, 64, 71, 72, 73, 74, 82, 83, 84, 85, 93, 94, 95, 104, 105, 106, 114, 115, 118, 127]"

Norman,L100,short,29,19,10,8,0.7752,129,"[8, 9, 16, 18, 19, 23, 31, 39, 41, 42, 43, 44, 45, 53, 54, 56, 65, 66, 75, 76, 78, 87, 90, 99, 107, 108, 109, 118, 121]"

Norman,L100,short,32,20,12,11,0.7576,132,"[8, 9, 10, 11, 16, 17, 18, 20, 21, 32, 41, 43, 51, 52, 55, 67, 76, 84, 92, 93, 94, 96, 103, 104, 105, 106, 114, 115, 116, 124, 125, 126]"

Norman,L100,short,32,12,20,3,0.7576,132,"[4, 9, 18, 19, 27, 28, 30, 39, 47, 48, 49, 52, 60, 68, 69, 70, 79, 80, 87, 89, 90, 91, 92, 101, 102, 103, 104, 113, 114, 122, 123, 124]"

Norman,L100,short,28,18,10,5,0.7812,128,"[4, 9, 19, 28, 29, 37, 38, 41, 50, 57, 60, 67, 68, 71, 78, 81, 88, 90, 100, 107, 109, 111, 117, 118, 119, 121, 122, 123]"

Norman,L100,short,32,15,17,8,0.7576,132,"[4, 9, 18, 19, 20, 28, 29, 32, 40, 42, 50, 51, 59, 60, 61, 69, 71, 75, 83, 85, 92, 94, 101, 102, 103, 104, 112, 113, 114, 122, 123, 125]"

Norman,L100,short,28,15,13,18,0.7812,128,"[11, 18, 19, 20, 28, 29, 33, 45, 54, 64, 70, 71, 78, 79, 80, 81, 88, 89, 90, 91, 101, 109, 110, 111, 118, 119, 120, 121]"

Norman,L100,short,33,12,21,8,0.7519,133,"[4, 9, 10, 19, 20, 28, 30, 39, 40, 48, 49, 50, 61, 69, 70, 77, 78, 79, 80, 82, 90, 94, 101, 102, 103, 104, 112, 113, 114, 115, 116, 121, 131]"

Norman,L100,short,31,15,16,3,0.7634,131,"[8, 10, 15, 16, 17, 18, 19, 20, 22, 23, 32, 33, 43, 52, 53, 62, 63, 71, 72, 73, 83, 84, 86, 96, 105, 106, 114, 115, 116, 124, 128]"

Norman,L100,short,27,13,14,4,0.7874,127,"[4, 9, 20, 21, 22, 23, 32, 34, 35, 36, 37, 46, 47, 48, 59, 67, 69, 78, 86, 88, 96, 97, 98, 106, 107, 109, 119]"

Norman,L100,short,29,18,11,8,0.7752,129,"[6, 9, 19, 27, 29, 37, 40, 47, 48, 49, 50, 51, 60, 64, 71, 78, 79, 80, 81, 89, 95, 103, 110, 113, 120, 121, 122, 123, 124]"

Norman,L100,short,30,14,16,7,0.7692,130,"[8, 9, 10, 20, 30, 31, 33, 42, 50, 54, 62, 69, 70, 72, 73, 81, 82, 83, 91, 93, 94, 101, 102, 103, 106, 114, 117, 124, 125, 126]"

Norman,L100,short,32,17,15,10,0.7576,132,"[8, 9, 14, 15, 16, 18, 20, 29, 32, 41, 49, 50, 59, 60, 68, 69, 71, 79, 83, 90, 95, 102, 103, 104, 105, 106, 116, 117, 124, 125, 126, 129]"

Norman,L100,short,31,18,13,8,0.7634,131,"[9, 14, 16, 17, 18, 20, 21, 23, 32, 33, 42, 44, 54, 62, 63, 64, 65, 67, 75, 78, 87, 95, 98, 105, 106, 114, 115, 117, 125, 126, 127]"

Norman,L100,short,30,12,18,2,0.7692,130,"[4, 9, 18, 19, 21, 22, 25, 35, 36, 37, 45, 46, 47, 48, 57, 58, 67, 68, 76, 77, 78, 87, 88, 96, 99, 108, 110, 117, 119, 122]"

Norman,L100,short,29,11,18,6,0.7752,129,"[9, 15, 19, 28, 31, 39, 50, 57, 58, 59, 65, 66, 67, 68, 69, 77, 81, 88, 89, 91, 98, 99, 100, 108, 110, 118, 119, 120, 125]"

Norman,L100,short,31,20,11,9,0.7634,131,"[9, 14, 17, 20, 28, 29, 30, 38, 39, 40, 41, 49, 50, 52, 62, 72, 73, 81, 86, 93, 100, 101, 103, 104, 105, 113, 114, 115, 116, 124, 125]"

Norman,L100,short,31,21,10,8,0.7634,131,"[5, 9, 18, 19, 27, 29, 37, 39, 47, 48, 51, 58, 59, 66, 67, 68, 69, 78, 82, 90, 98, 99, 106, 107, 110, 117, 118, 119, 120, 121, 123]"

Norman,L100,short,30,14,16,4,0.7692,130,"[9, 10, 15, 16, 17, 18, 19, 20, 30, 40, 41, 49, 51, 59, 60, 63, 65, 66, 77, 85, 88, 96, 97, 98, 106, 107, 108, 111, 120, 128]"

Norman,L100,short,31,19,12,7,0.7634,131,"[5, 10, 19, 27, 28, 31, 38, 39, 42, 51, 58, 62, 69, 71, 72, 80, 81, 82, 83, 91, 94, 95, 103, 104, 105, 112, 113, 114, 116, 124, 126]"

Norman,L100,short,35,8,27,3,0.7407,135,"[4, 9, 10, 19, 23, 31, 38, 39, 40, 41, 49, 50, 51, 52, 60, 62, 70, 71, 72, 73, 74, 83, 84, 93, 94, 104, 113, 114, 122, 123, 124, 126, 127, 128, 129]"

Norman,L100,short,29,15,14,3,0.7752,129,"[9, 10, 15, 16, 18, 19, 20, 29, 30, 40, 48, 49, 50, 59, 61, 69, 72, 81, 82, 85, 93, 102, 103, 105, 113, 114, 122, 123, 124]"

Norman,L100,short,30,13,17,12,0.7692,130,"[5, 10, 13, 23, 32, 40, 43, 51, 57, 58, 60, 61, 69, 70, 71, 78, 79, 80, 81, 89, 90, 91, 94, 103, 110, 111, 112, 114, 122, 124]"

Norman,L100,short,28,11,17,8,0.7812,128,"[8, 9, 15, 16, 19, 29, 37, 38, 40, 48, 49, 50, 58, 59, 61, 62, 63, 71, 72, 74, 83, 84, 93, 96, 104, 105, 106, 120]"

Norman,L100,short,30,24,6,12,0.7692,130,"[4, 9, 18, 27, 35, 42, 44, 46, 53, 54, 55, 58, 65, 66, 75, 76, 77, 85, 86, 87, 88, 90, 100, 108, 109, 110, 112, 119, 120, 121]"

Norman,L100,short,33,10,23,3,0.7519,133,"[9, 15, 17, 18, 20, 22, 30, 32, 41, 43, 44, 45, 48, 56, 57, 65, 66, 67, 77, 85, 86, 87, 88, 89, 99, 107, 108, 109, 118, 119, 126, 128, 129]"

Norman,L100,short,29,25,4,6,0.7752,129,"[4, 9, 11, 20, 22, 30, 31, 33, 41, 42, 43, 51, 52, 53, 54, 63, 64, 66, 74, 77, 86, 94, 95, 103, 104, 106, 114, 116, 125]"

Norman,L100,short,33,22,11,6,0.7519,133,"[8, 9, 14, 15, 19, 28, 29, 31, 41, 51, 58, 59, 60, 62, 70, 71, 79, 80, 82, 91, 92, 95, 96, 97, 105, 106, 107, 115, 118, 125, 126, 127, 130]"

Norman,L100,short,33,16,17,3,0.7519,133,"[9, 14, 16, 17, 18, 19, 28, 29, 38, 39, 47, 48, 49, 58, 60, 69, 77, 78, 80, 88, 89, 97, 99, 108, 109, 116, 118, 119, 126, 127, 128, 129, 131]"

Norman,L100,short,32,17,15,9,0.7576,132,"[8, 13, 20, 27, 28, 30, 38, 39, 40, 43, 51, 52, 53, 61, 62, 63, 71, 72, 73, 81, 82, 85, 93, 102, 103, 104, 112, 113, 114, 121, 122, 125]"

Norman,L100,short,28,16,12,9,0.7812,128,"[9, 14, 15, 16, 17, 19, 20, 29, 30, 31, 32, 35, 45, 54, 62, 63, 65, 73, 74, 76, 86, 95, 97, 98, 102, 111, 119, 123]"

Norman,L100,short,32,19,13,8,0.7576,132,"[9, 14, 15, 17, 18, 19, 31, 39, 40, 48, 49, 51, 52, 60, 62, 63, 71, 72, 76, 84, 92, 93, 101, 102, 105, 112, 113, 120, 121, 122, 123, 124]"

Norman,L100,short,31,16,15,9,0.7634,131,"[8, 9, 14, 15, 17, 18, 21, 29, 39, 41, 49, 50, 54, 62, 70, 71, 72, 80, 82, 90, 91, 92, 100, 101, 102, 110, 112, 119, 120, 121, 125]"

Norman,L100,short,30,23,7,2,0.7692,130,"[8, 9, 10, 11, 12, 18, 21, 22, 32, 41, 42, 43, 51, 53, 54, 63, 65, 73, 74, 82, 83, 84, 92, 96, 104, 106, 114, 115, 117, 126]"

Norman,L100,short,30,8,22,3,0.7692,130,"[8, 9, 14, 16, 17, 18, 20, 29, 31, 40, 41, 42, 50, 51, 52, 53, 62, 63, 72, 73, 82, 83, 94, 102, 103, 111, 112, 115, 123, 124]"

Norman,L100,short,37,27,10,4,0.7299,137,"[8, 10, 12, 18, 19, 20, 21, 22, 31, 34, 43, 52, 53, 54, 55, 56, 57, 66, 67, 76, 77, 85, 87, 96, 97, 98, 106, 107, 108, 109, 110, 111, 120, 121, 124, 133, 134]"

Norman,L100,short,32,17,15,3,0.7576,132,"[8, 9, 15, 16, 17, 19, 20, 29, 30, 31, 32, 33, 43, 53, 61, 62, 64, 65, 74, 75, 83, 85, 94, 95, 96, 104, 106, 114, 115, 118, 126, 129]"

Norman,L100,short,32,18,14,6,0.7576,132,"[8, 9, 10, 13, 19, 21, 23, 33, 41, 42, 44, 52, 55, 57, 59, 67, 69, 77, 78, 86, 89, 91, 94, 102, 104, 111, 112, 114, 115, 116, 124, 127]"

Norman,L100,short,30,11,19,10,0.7692,130,"[4, 9, 13, 22, 30, 31, 35, 43, 51, 52, 54, 61, 62, 63, 64, 65, 73, 74, 77, 85, 93, 95, 97, 108, 115, 116, 123, 124, 126, 127]"

Norman,L100,short,24,17,7,18,0.8065,124,"[5, 11, 19, 20, 25, 36, 47, 54, 60, 61, 62, 63, 66, 73, 80, 87, 97, 105, 106, 107, 113, 115, 117, 119]"

Norman,L100,short,34,18,16,1,0.7463,134,"[8, 10, 11, 17, 19, 20, 21, 29, 31, 42, 52, 60, 62, 69, 70, 71, 72, 80, 82, 84, 92, 93, 94, 103, 104, 105, 106, 114, 115, 116, 117, 118, 126, 128]"

Norman,L100,short,30,20,10,11,0.7692,130,"[8, 12, 18, 19, 20, 29, 30, 39, 40, 48, 50, 51, 56, 64, 71, 73, 81, 82, 90, 92, 93, 101, 102, 103, 111, 112, 113, 121, 122, 124]"

Norman,L100,short,29,26,3,8,0.7752,129,"[4, 9, 10, 11, 21, 23, 32, 39, 40, 42, 43, 51, 53, 57, 58, 66, 69, 78, 86, 87, 88, 90, 98, 99, 100, 101, 103, 116, 124]"

Norman,L100,short,26,15,11,10,0.7937,126,"[5, 9, 11, 19, 20, 28, 29, 30, 38, 41, 52, 59, 60, 62, 71, 72, 73, 75, 83, 86, 94, 95, 103, 107, 115, 119]"

Norman,L100,short,27,19,8,5,0.7874,127,"[4, 9, 18, 20, 28, 30, 38, 39, 41, 49, 50, 57, 59, 61, 72, 80, 81, 89, 90, 91, 98, 100, 102, 110, 112, 119, 121]"

Norman,L100,short,29,18,11,10,0.7752,129,"[4, 9, 12, 21, 29, 34, 43, 51, 52, 58, 62, 64, 72, 75, 82, 84, 91, 92, 94, 102, 105, 112, 113, 114, 115, 122, 123, 124, 126]"

Norman,L100,short,33,13,20,6,0.7519,133,"[4, 9, 10, 13, 16, 25, 34, 42, 43, 44, 52, 53, 55, 58, 66, 75, 77, 84, 85, 86, 94, 95, 96, 104, 105, 106, 113, 114, 115, 116, 124, 125, 126]"

Norman,L100,short,33,17,16,5,0.7519,133,"[4, 9, 19, 20, 21, 23, 33, 40, 41, 44, 52, 53, 55, 63, 64, 65, 73, 74, 75, 83, 87, 96, 104, 106, 107, 114, 115, 116, 117, 125, 126, 129, 130]"

Norman,L100,short,30,10,20,11,0.7692,130,"[8, 13, 22, 29, 31, 40, 42, 43, 50, 52, 55, 65, 72, 73, 81, 82, 83, 84, 85, 94, 95, 103, 104, 105, 114, 115, 117, 124, 125, 128]"

Norman,L100,short,33,8,25,4,0.7519,133,"[9, 14, 15, 16, 18, 20, 28, 29, 32, 41, 49, 50, 51, 59, 60, 61, 63, 71, 72, 74, 82, 83, 92, 93, 94, 103, 104, 105, 114, 115, 123, 124, 126]"

Norman,L100,short,29,11,18,4,0.7752,129,"[10, 11, 14, 21, 22, 23, 31, 32, 34, 43, 46, 54, 55, 56, 66, 73, 76, 87, 94, 95, 97, 104, 105, 106, 107, 116, 118, 124, 127]"

Norman,L100,short,28,15,13,3,0.7812,128,"[8, 9, 14, 16, 17, 19, 21, 30, 31, 40, 42, 50, 51, 61, 62, 70, 73, 82, 89, 90, 92, 101, 103, 111, 112, 119, 120, 122]"

Norman,L100,short,32,17,15,2,0.7576,132,"[8, 9, 10, 16, 17, 18, 19, 20, 21, 22, 32, 41, 42, 50, 51, 52, 53, 62, 63, 64, 74, 83, 84, 86, 95, 103, 105, 114, 115, 123, 124, 126]"

Norman,L100,short,30,19,11,1,0.7692,130,"[10, 16, 17, 20, 28, 30, 38, 39, 41, 49, 51, 53, 61, 63, 70, 71, 72, 73, 82, 83, 92, 93, 101, 102, 104, 113, 120, 121, 122, 123]"

Norman,L100,short,29,20,9,6,0.7752,129,"[4, 9, 10, 20, 24, 32, 39, 40, 41, 42, 51, 52, 60, 61, 62, 70, 71, 74, 82, 83, 91, 92, 94, 103, 111, 112, 113, 121, 125]"

Norman,L100,short,32,19,13,5,0.7576,132,"[6, 10, 19, 20, 28, 30, 32, 39, 40, 41, 43, 44, 54, 62, 63, 64, 65, 67, 75, 78, 86, 87, 88, 90, 91, 101, 109, 110, 111, 114, 123, 124]"

Norman,L100,short,32,22,10,2,0.7576,132,"[4, 9, 18, 19, 27, 28, 29, 31, 39, 40, 48, 49, 50, 58, 59, 60, 68, 70, 79, 80, 81, 89, 90, 91, 100, 101, 102, 110, 111, 113, 122, 124]"

Norman,L100,short,26,16,10,16,0.7937,126,"[8, 9, 10, 15, 16, 17, 19, 20, 29, 30, 31, 41, 50, 51, 60, 61, 62, 70, 71, 72, 82, 88, 97, 105, 113, 118]"

Norman,L100,short,30,12,18,3,0.7692,130,"[9, 10, 15, 16, 17, 19, 20, 29, 30, 39, 40, 48, 49, 50, 51, 60, 62, 72, 82, 90, 91, 100, 101, 109, 110, 111, 112, 113, 120, 123]"

Norman,L100,short,29,20,9,5,0.7752,129,"[4, 9, 19, 27, 28, 29, 37, 39, 41, 51, 58, 59, 60, 69, 71, 78, 79, 80, 83, 92, 93, 94, 101, 104, 111, 112, 114, 115, 126]"

Norman,L100,short,31,20,11,6,0.7634,131,"[4, 9, 10, 19, 23, 31, 32, 40, 41, 42, 43, 51, 52, 53, 54, 57, 65, 68, 77, 79, 81, 82, 91, 94, 102, 103, 113, 120, 121, 122, 125]"

Norman,L100,short,29,20,9,4,0.7752,129,"[8, 13, 20, 21, 29, 30, 31, 39, 41, 50, 52, 60, 62, 69, 71, 79, 80, 81, 88, 89, 90, 91, 99, 100, 101, 109, 111, 118, 121]"

Norman,L100,short,29,22,7,8,0.7752,129,"[4, 9, 11, 19, 20, 28, 32, 39, 40, 41, 43, 52, 61, 62, 70, 71, 74, 82, 84, 92, 96, 103, 105, 112, 113, 114, 116, 124, 125]"

Norman,L100,short,28,13,15,6,0.7812,128,"[9, 14, 15, 16, 17, 18, 20, 29, 38, 39, 40, 49, 51, 59, 62, 70, 72, 83, 92, 99, 100, 101, 102, 110, 113, 120, 121, 122]"

Norman,L100,short,32,10,22,13,0.7576,132,"[8, 9, 11, 17, 18, 19, 21, 29, 30, 32, 41, 50, 51, 52, 61, 63, 71, 72, 80, 81, 82, 84, 92, 93, 94, 102, 103, 104, 113, 114, 119, 129]"

Norman,L100,short,26,14,12,8,0.7937,126,"[9, 14, 17, 18, 20, 28, 31, 34, 42, 49, 52, 60, 62, 71, 72, 80, 81, 83, 92, 99, 100, 102, 109, 111, 116, 122]"

Norman,L100,short,31,21,10,4,0.7634,131,"[8, 10, 15, 16, 17, 18, 19, 20, 29, 30, 39, 40, 49, 50, 60, 61, 70, 72, 74, 83, 91, 92, 94, 103, 104, 112, 113, 114, 121, 123, 126]"

Norman,L100,short,28,18,10,11,0.7812,128,"[9, 11, 17, 18, 20, 28, 29, 31, 32, 41, 42, 51, 52, 60, 61, 64, 72, 74, 82, 84, 86, 94, 97, 106, 113, 114, 118, 124]"

Norman,L100,short,33,30,3,2,0.7519,133,"[5, 9, 18, 19, 21, 29, 30, 38, 39, 41, 42, 43, 53, 55, 63, 64, 65, 73, 74, 75, 76, 77, 78, 87, 88, 97, 98, 107, 108, 117, 118, 120, 129]"

Norman,L100,short,31,20,11,10,0.7634,131,"[8, 9, 14, 15, 17, 19, 28, 32, 42, 50, 51, 52, 53, 61, 62, 63, 71, 72, 76, 86, 94, 95, 102, 104, 105, 107, 115, 116, 124, 125, 128]"

Norman,L100,short,31,24,7,3,0.7634,131,"[5, 9, 10, 19, 20, 28, 29, 31, 39, 41, 42, 43, 44, 45, 55, 57, 65, 67, 75, 76, 77, 78, 87, 88, 97, 98, 109, 116, 117, 118, 120]"

Norman,L100,short,31,19,12,5,0.7634,131,"[4, 10, 19, 20, 21, 29, 30, 32, 34, 35, 43, 44, 45, 54, 57, 65, 66, 74, 76, 84, 85, 87, 96, 97, 105, 106, 107, 111, 118, 120, 128]"

Norman,L100,short,30,13,17,8,0.7692,130,"[8, 11, 17, 18, 19, 27, 29, 37, 38, 40, 42, 43, 51, 53, 55, 64, 72, 75, 83, 84, 85, 88, 96, 104, 105, 108, 116, 119, 127, 128]"

Norman,L100,short,29,14,15,2,0.7752,129,"[9, 14, 15, 16, 17, 19, 20, 22, 31, 32, 41, 42, 43, 44, 54, 63, 64, 73, 75, 83, 84, 86, 97, 107, 114, 115, 117, 126, 127]"

Norman,L100,short,30,18,12,3,0.7692,130,"[5, 9, 10, 19, 21, 22, 32, 40, 41, 42, 43, 53, 54, 55, 63, 64, 65, 66, 74, 76, 78, 87, 89, 97, 98, 99, 108, 112, 119, 122]"

Norman,L100,short,34,23,11,2,0.7463,134,"[9, 14, 16, 17, 18, 20, 28, 29, 30, 39, 41, 42, 43, 53, 54, 63, 65, 73, 74, 75, 76, 85, 86, 95, 96, 98, 107, 115, 117, 125, 126, 127, 128, 129]"

Norman,L100,short,32,6,26,6,0.7576,132,"[5, 9, 18, 19, 27, 28, 29, 30, 31, 39, 41, 49, 50, 51, 60, 61, 62, 63, 73, 81, 82, 84, 85, 86, 94, 95, 96, 98, 108, 112, 122, 130]"

Norman,L100,short,32,22,10,4,0.7576,132,"[8, 9, 14, 16, 17, 18, 19, 28, 29, 39, 47, 49, 58, 59, 68, 69, 77, 78, 79, 82, 91, 98, 99, 100, 101, 110, 111, 113, 120, 121, 123, 126]"

Norman,L100,short,31,18,13,5,0.7634,131,"[7, 10, 19, 21, 29, 30, 31, 39, 40, 41, 49, 50, 51, 59, 60, 64, 72, 82, 89, 90, 91, 94, 101, 103, 105, 112, 114, 115, 124, 125, 128]"

Norman,L100,short,29,22,7,11,0.7752,129,"[4, 10, 18, 19, 20, 21, 22, 31, 32, 40, 41, 43, 45, 46, 55, 58, 66, 74, 75, 76, 79, 87, 91, 99, 102, 110, 111, 120, 125]"

Norman,L100,short,31,9,22,4,0.7634,131,"[4, 10, 18, 19, 27, 28, 29, 38, 39, 41, 49, 50, 58, 59, 61, 69, 70, 71, 72, 73, 82, 84, 85, 94, 95, 97, 105, 106, 116, 125, 126]"

Norman,L100,short,34,20,14,5,0.7463,134,"[4, 10, 22, 29, 30, 31, 38, 41, 49, 50, 51, 52, 53, 61, 62, 67, 75, 83, 84, 91, 92, 93, 95, 103, 104, 105, 106, 113, 114, 115, 116, 126, 127, 128]"

Norman,L100,short,29,19,10,7,0.7752,129,"[8, 9, 10, 11, 12, 13, 24, 32, 33, 34, 43, 46, 49, 57, 65, 66, 67, 69, 70, 78, 83, 91, 99, 102, 109, 110, 111, 113, 124]"

Norman,L100,short,28,10,18,4,0.7812,128,"[5, 9, 21, 29, 30, 37, 38, 39, 40, 48, 49, 50, 60, 68, 70, 78, 79, 80, 81, 90, 91, 100, 101, 109, 110, 113, 121, 123]"

Norman,L100,short,34,2,32,12,0.7463,134,"[10, 11, 12, 13, 14, 15, 18, 20, 30, 32, 41, 49, 50, 51, 53, 54, 63, 64, 73, 74, 75, 84, 85, 93, 94, 95, 104, 105, 107, 115, 116, 117, 126, 127]"

Norman,L100,short,28,12,16,2,0.7812,128,"[9, 14, 15, 16, 18, 19, 29, 37, 38, 39, 48, 50, 58, 59, 68, 69, 77, 79, 87, 89, 90, 97, 99, 100, 108, 110, 118, 121]"

Norman,L100,short,32,11,21,13,0.7576,132,"[9, 14, 16, 17, 18, 20, 28, 29, 38, 39, 42, 50, 51, 60, 65, 76, 84, 91, 92, 95, 102, 104, 111, 112, 114, 121, 123, 124, 126, 127, 128, 130]"

Norman,L100,short,36,14,22,4,0.7353,136,"[8, 9, 14, 15, 16, 17, 18, 19, 20, 30, 39, 42, 50, 52, 61, 63, 71, 72, 73, 81, 83, 84, 86, 94, 95, 97, 105, 106, 107, 115, 116, 118, 126, 127, 129, 130]"

Norman,L100,short,31,18,13,7,0.7634,131,"[9, 17, 18, 19, 20, 29, 30, 31, 41, 42, 50, 51, 54, 64, 71, 73, 82, 90, 91, 92, 99, 100, 101, 104, 111, 113, 120, 121, 122, 123, 124]"

Norman,L100,short,30,14,16,4,0.7692,130,"[10, 15, 16, 17, 18, 19, 20, 21, 30, 33, 35, 44, 52, 54, 62, 63, 67, 75, 85, 95, 103, 105, 106, 113, 114, 116, 123, 124, 125, 126]"

Norman,L100,short,26,13,13,14,0.7937,126,"[8, 14, 21, 32, 42, 43, 45, 51, 53, 56, 66, 67, 74, 76, 77, 80, 87, 91, 102, 109, 111, 112, 119, 120, 121, 122]"

Norman,L100,short,32,12,20,1,0.7576,132,"[4, 9, 18, 19, 28, 29, 38, 39, 48, 49, 57, 58, 59, 60, 68, 69, 70, 71, 72, 82, 90, 91, 92, 102, 103, 110, 111, 113, 115, 123, 124, 125]"

Norman,L100,short,32,18,14,5,0.7576,132,"[8, 9, 14, 15, 16, 18, 19, 28, 30, 39, 40, 48, 50, 52, 62, 70, 72, 80, 81, 82, 90, 91, 92, 100, 102, 110, 111, 112, 113, 115, 122, 124]"

Norman,L100,short,31,13,18,3,0.7634,131,"[8, 9, 15, 17, 18, 19, 20, 29, 30, 39, 40, 48, 49, 50, 60, 61, 62, 63, 73, 74, 82, 83, 84, 88, 97, 106, 107, 116, 118, 126, 127]"

Norman,L100,short,28,21,7,7,0.7812,128,"[4, 11, 21, 31, 37, 38, 39, 49, 56, 57, 58, 59, 69, 77, 79, 86, 88, 90, 92, 100, 101, 102, 109, 111, 113, 120, 122, 123]"

Norman,L100,short,32,24,8,6,0.7576,132,"[8, 9, 10, 11, 17, 21, 22, 31, 32, 41, 42, 44, 52, 53, 54, 63, 67, 75, 84, 92, 95, 102, 103, 104, 111, 112, 113, 114, 121, 122, 123, 124]"

Norman,L100,short,26,14,12,6,0.7937,126,"[5, 10, 18, 20, 29, 30, 39, 40, 51, 52, 60, 63, 71, 72, 73, 80, 83, 84, 91, 93, 95, 99, 108, 116, 117, 118]"

Norman,L100,short,30,10,20,7,0.7692,130,"[5, 10, 18, 19, 20, 28, 29, 31, 39, 40, 42, 50, 52, 60, 61, 69, 70, 71, 81, 89, 90, 91, 92, 101, 103, 110, 111, 114, 122, 123]"

Norman,L100,short,31,21,10,10,0.7634,131,"[8, 10, 11, 19, 24, 32, 40, 41, 45, 52, 59, 60, 61, 62, 70, 71, 74, 82, 83, 84, 87, 95, 102, 103, 105, 112, 113, 115, 123, 125, 126]"

Norman,L100,short,30,15,15,5,0.7692,130,"[8, 9, 14, 15, 17, 20, 28, 29, 38, 39, 47, 49, 57, 58, 59, 67, 68, 69, 77, 78, 80, 83, 92, 100, 102, 111, 112, 113, 120, 123]"

Norman,L100,short,32,11,21,5,0.7576,132,"[4, 9, 18, 19, 29, 30, 32, 39, 40, 43, 51, 58, 59, 60, 62, 70, 71, 80, 82, 90, 91, 92, 93, 101, 102, 104, 112, 113, 115, 123, 124, 125]"

Norman,L100,short,22,12,10,10,0.8197,122,"[8, 9, 14, 15, 17, 19, 20, 21, 32, 41, 49, 50, 52, 65, 74, 82, 83, 90, 93, 101, 107, 114]"

Norman,L100,short,29,19,10,5,0.7752,129,"[4, 9, 10, 21, 22, 30, 31, 32, 41, 42, 43, 51, 55, 63, 65, 66, 74, 77, 86, 89, 96, 97, 98, 99, 100, 101, 110, 114, 122]"

Norman,L100,short,30,15,15,6,0.7692,130,"[9, 14, 15, 16, 18, 19, 28, 29, 31, 40, 49, 50, 51, 52, 53, 62, 64, 72, 73, 76, 85, 94, 102, 104, 111, 113, 115, 123, 124, 126]"

Norman,L100,short,32,24,8,8,0.7576,132,"[8, 10, 16, 18, 19, 22, 31, 40, 43, 50, 51, 54, 62, 69, 70, 72, 73, 81, 82, 84, 92, 93, 101, 103, 104, 115, 122, 123, 125, 126, 127, 128]"

Norman,L100,short,29,12,17,13,0.7752,129,"[10, 15, 17, 18, 19, 27, 33, 41, 48, 49, 54, 62, 69, 70, 71, 72, 80, 81, 82, 90, 92, 100, 103, 110, 111, 112, 120, 121, 123]"

Norman,L100,short,27,18,9,11,0.7874,127,"[4, 9, 19, 20, 28, 29, 31, 39, 40, 43, 51, 53, 60, 63, 71, 72, 80, 81, 83, 93, 102, 106, 113, 114, 116, 123, 124]"

Norman,L100,short,28,13,15,6,0.7812,128,"[5, 9, 18, 20, 28, 29, 30, 38, 39, 40, 48, 50, 51, 60, 61, 69, 70, 71, 79, 80, 81, 94, 101, 103, 111, 113, 121, 122]"

Norman,L100,short,25,16,9,6,0.8,125,"[5, 9, 10, 22, 30, 31, 34, 42, 52, 53, 61, 63, 71, 73, 76, 83, 85, 87, 94, 95, 97, 106, 107, 111, 118]"

Norman,L100,short,28,12,16,15,0.7812,128,"[8, 9, 16, 17, 18, 19, 20, 22, 31, 32, 35, 44, 57, 65, 72, 74, 83, 85, 92, 93, 94, 101, 106, 114, 115, 117, 123, 124]"

Norman,L100,short,32,23,9,6,0.7576,132,"[8, 9, 16, 18, 20, 29, 31, 34, 42, 49, 50, 51, 52, 53, 61, 62, 64, 72, 75, 83, 85, 94, 95, 103, 104, 105, 114, 115, 116, 124, 125, 127]"

Norman,L100,short,26,11,15,9,0.7937,126,"[4, 11, 19, 28, 29, 39, 46, 48, 51, 59, 61, 69, 70, 77, 78, 81, 84, 85, 92, 94, 95, 103, 104, 107, 115, 119]"

Norman,L100,short,30,15,15,10,0.7692,130,"[4, 9, 18, 19, 20, 21, 29, 30, 31, 39, 41, 42, 45, 54, 62, 63, 71, 72, 74, 83, 87, 95, 103, 105, 112, 115, 118, 125, 126, 128]"

Norman,L100,short,33,12,21,11,0.7519,133,"[7, 10, 18, 19, 28, 29, 37, 38, 39, 40, 48, 49, 53, 61, 63, 67, 75, 83, 84, 85, 86, 87, 88, 89, 91, 102, 110, 111, 118, 119, 120, 122, 131]"

Norman,L100,short,33,13,20,5,0.7519,133,"[9, 14, 15, 16, 17, 19, 28, 29, 38, 42, 51, 59, 61, 68, 69, 70, 78, 80, 83, 90, 91, 92, 93, 103, 104, 105, 113, 114, 115, 116, 117, 126, 127]"

Norman,L100,short,28,18,10,3,0.7812,128,"[4, 11, 19, 27, 28, 29, 38, 39, 47, 49, 58, 59, 68, 69, 76, 78, 79, 80, 87, 88, 89, 90, 91, 101, 102, 113, 121, 122]"

Norman,L100,short,25,15,10,16,0.8,125,"[5, 9, 18, 23, 31, 38, 40, 41, 51, 59, 61, 68, 73, 80, 81, 88, 89, 90, 92, 99, 100, 102, 103, 111, 119]"

Norman,L100,short,31,17,14,6,0.7634,131,"[8, 10, 11, 17, 18, 20, 21, 22, 32, 42, 50, 52, 53, 61, 63, 72, 73, 81, 83, 90, 91, 92, 93, 94, 95, 97, 108, 116, 118, 126, 128]"

Norman,L100,short,29,9,20,8,0.7752,129,"[10, 15, 16, 17, 19, 27, 28, 29, 39, 46, 48, 49, 53, 61, 71, 79, 80, 87, 88, 91, 98, 99, 100, 102, 110, 111, 118, 120, 122]"

Norman,L100,short,30,23,7,9,0.7692,130,"[4, 9, 18, 21, 30, 37, 38, 39, 40, 41, 50, 51, 53, 54, 62, 63, 65, 78, 86, 94, 101, 102, 104, 111, 112, 113, 114, 122, 123, 124]"

Norman,L100,short,22,16,6,13,0.8197,122,"[4, 9, 11, 20, 28, 30, 32, 39, 40, 42, 50, 51, 52, 60, 65, 75, 84, 93, 106, 113, 115, 116]"

Norman,L100,short,27,16,11,10,0.7874,127,"[8, 10, 16, 17, 18, 20, 21, 22, 31, 32, 34, 44, 52, 53, 62, 63, 64, 74, 75, 76, 77, 78, 88, 97, 101, 113, 120]"

Norman,L100,short,30,21,9,8,0.7692,130,"[8, 10, 16, 18, 19, 21, 31, 39, 41, 42, 43, 52, 56, 65, 73, 80, 81, 82, 84, 93, 100, 101, 103, 104, 106, 114, 117, 124, 125, 127]"

Norman,L100,short,31,18,13,6,0.7634,131,"[4, 9, 18, 19, 30, 37, 38, 39, 40, 48, 49, 52, 60, 62, 71, 72, 80, 81, 82, 83, 91, 94, 101, 102, 103, 104, 112, 113, 114, 123, 125]"

Norman,L100,short,31,18,13,7,0.7634,131,"[4, 9, 18, 22, 30, 37, 39, 40, 48, 49, 52, 59, 60, 62, 70, 71, 78, 79, 82, 90, 91, 100, 101, 102, 103, 110, 112, 113, 121, 122, 123]"

Norman,L100,short,28,15,13,3,0.7812,128,"[8, 9, 10, 15, 18, 19, 20, 30, 40, 48, 51, 59, 62, 69, 70, 71, 73, 83, 91, 92, 99, 100, 101, 102, 112, 119, 120, 123]"

Norman,L100,short,32,26,6,7,0.7576,132,"[4, 9, 10, 19, 22, 30, 38, 40, 41, 50, 51, 52, 53, 64, 71, 72, 73, 81, 82, 83, 91, 92, 93, 96, 104, 106, 114, 115, 116, 117, 125, 128]"

Norman,L100,short,28,18,10,7,0.7812,128,"[4, 9, 10, 11, 20, 21, 25, 34, 42, 43, 44, 52, 55, 64, 65, 76, 85, 93, 94, 95, 96, 97, 98, 100, 109, 116, 117, 120]"

Norman,L100,short,31,20,11,5,0.7634,131,"[4, 10, 18, 19, 20, 28, 30, 33, 41, 45, 55, 64, 72, 74, 82, 83, 84, 91, 92, 94, 101, 104, 111, 114, 115, 122, 123, 124, 126, 127, 129]"

Norman,L100,short,31,15,16,3,0.7634,131,"[8, 9, 10, 15, 17, 18, 20, 29, 30, 31, 32, 33, 43, 53, 55, 64, 65, 73, 74, 75, 86, 94, 97, 105, 107, 115, 116, 118, 120, 128, 129]"

Norman,L100,short,33,17,16,1,0.7519,133,"[9, 17, 18, 19, 27, 28, 30, 39, 40, 48, 49, 50, 58, 59, 60, 61, 70, 71, 81, 84, 85, 94, 95, 96, 97, 105, 106, 107, 115, 116, 118, 126, 127]"

Norman,L100,short,28,15,13,2,0.7812,128,"[4, 9, 10, 19, 21, 29, 36, 43, 44, 45, 46, 54, 57, 65, 66, 74, 75, 78, 80, 81, 91, 100, 101, 110, 111, 118, 120, 121]"

Norman,L100,short,28,17,11,9,0.7812,128,"[4, 11, 19, 28, 29, 30, 31, 40, 41, 50, 51, 59, 60, 61, 69, 71, 78, 80, 82, 90, 95, 103, 110, 111, 118, 119, 120, 121]"

Norman,L100,short,33,22,11,10,0.7519,133,"[4, 9, 10, 12, 20, 21, 23, 36, 44, 52, 59, 60, 61, 62, 72, 81, 82, 89, 90, 91, 92, 93, 94, 102, 103, 104, 106, 113, 114, 115, 123, 124, 126]"

Norman,L100,short,34,12,22,5,0.7463,134,"[6, 12, 20, 21, 22, 30, 32, 40, 42, 50, 51, 54, 61, 62, 71, 73, 83, 90, 91, 92, 93, 100, 101, 103, 110, 111, 112, 114, 115, 116, 117, 125, 126, 127]"

Norman,L100,short,31,16,15,5,0.7634,131,"[8, 11, 17, 18, 19, 21, 30, 32, 41, 51, 58, 59, 60, 61, 62, 70, 71, 75, 83, 90, 91, 92, 93, 101, 102, 103, 111, 112, 113, 121, 123]"

Norman,L100,short,31,14,17,5,0.7634,131,"[4, 10, 11, 12, 13, 22, 23, 24, 26, 36, 44, 45, 46, 47, 56, 57, 65, 66, 67, 78, 86, 87, 98, 106, 107, 109, 116, 119, 126, 127, 128]"

Norman,L100,short,31,17,14,5,0.7634,131,"[11, 17, 18, 19, 20, 21, 22, 30, 32, 41, 42, 45, 54, 62, 64, 72, 75, 83, 84, 86, 94, 97, 104, 105, 106, 114, 115, 117, 124, 126, 127]"

Norman,L100,short,30,19,11,11,0.7692,130,"[4, 9, 11, 19, 22, 31, 38, 39, 40, 41, 42, 50, 51, 55, 63, 71, 72, 80, 82, 91, 92, 94, 97, 105, 106, 113, 114, 115, 119, 127]"

Norman,L100,short,32,16,16,4,0.7576,132,"[8, 11, 17, 18, 20, 21, 30, 32, 42, 45, 53, 61, 63, 70, 71, 72, 74, 82, 84, 85, 93, 95, 103, 105, 106, 115, 116, 117, 124, 125, 126, 127]"

Norman,L100,short,29,21,8,5,0.7752,129,"[9, 14, 15, 17, 19, 30, 38, 39, 40, 42, 50, 51, 54, 62, 70, 71, 72, 80, 81, 83, 91, 93, 103, 111, 112, 113, 121, 122, 125]"

Norman,L100,short,29,12,17,10,0.7752,129,"[9, 14, 15, 16, 18, 20, 28, 29, 31, 40, 42, 50, 51, 52, 61, 62, 70, 71, 74, 87, 94, 101, 102, 103, 106, 114, 116, 124, 127]"

Norman,L100,short,32,16,16,2,0.7576,132,"[4, 9, 18, 19, 20, 29, 30, 39, 41, 49, 51, 61, 68, 69, 70, 71, 78, 79, 81, 89, 90, 92, 101, 103, 110, 111, 112, 113, 114, 115, 124, 125]"

Norman,L100,short,31,20,11,5,0.7634,131,"[8, 9, 14, 16, 19, 27, 29, 39, 40, 41, 42, 50, 51, 52, 54, 63, 67, 75, 83, 84, 93, 94, 102, 103, 104, 113, 114, 115, 123, 124, 125]"

Norman,L100,short,27,19,8,6,0.7874,127,"[5, 9, 20, 23, 33, 40, 41, 48, 49, 50, 51, 58, 59, 61, 69, 71, 72, 82, 92, 99, 100, 101, 104, 111, 112, 113, 123]"

Norman,L100,short,34,14,20,7,0.7463,134,"[8, 9, 13, 21, 22, 31, 34, 42, 49, 51, 52, 53, 55, 64, 71, 76, 84, 85, 86, 94, 96, 103, 104, 105, 106, 107, 116, 117, 118, 119, 126, 127, 128, 129]"

Norman,L100,short,30,17,13,3,0.7692,130,"[4, 9, 10, 19, 20, 29, 30, 38, 39, 40, 41, 49, 50, 51, 59, 60, 62, 70, 72, 74, 82, 85, 94, 97, 105, 113, 115, 122, 124, 125]"

Norman,L100,short,31,16,15,6,0.7634,131,"[4, 9, 18, 22, 31, 34, 42, 43, 52, 53, 60, 63, 71, 72, 74, 81, 82, 84, 85, 92, 93, 94, 96, 97, 105, 106, 108, 116, 119, 127, 128]"

Norman,L100,short,29,18,11,7,0.7752,129,"[4, 10, 20, 29, 31, 38, 39, 41, 50, 57, 59, 60, 68, 69, 71, 72, 74, 82, 84, 91, 92, 93, 101, 102, 105, 112, 113, 115, 125]"

Norman,L100,short,27,14,13,2,0.7874,127,"[4, 10, 18, 20, 28, 30, 31, 43, 51, 53, 60, 62, 64, 72, 73, 81, 83, 91, 93, 100, 103, 110, 112, 113, 121, 122, 124]"

Norman,L100,short,33,15,18,2,0.7519,133,"[7, 10, 18, 19, 29, 30, 38, 40, 48, 49, 50, 58, 60, 62, 70, 71, 78, 79, 81, 82, 83, 91, 93, 94, 102, 103, 104, 112, 114, 116, 125, 126, 127]"

Norman,L100,short,28,9,19,13,0.7812,128,"[4, 9, 18, 19, 27, 28, 29, 30, 31, 32, 41, 42, 43, 44, 53, 55, 63, 65, 80, 88, 96, 103, 104, 106, 115, 122, 124, 125]"

Norman,L100,short,30,20,10,5,0.7692,130,"[4, 10, 13, 21, 29, 30, 31, 40, 43, 51, 59, 61, 68, 69, 70, 72, 73, 74, 83, 84, 96, 103, 104, 105, 106, 113, 115, 117, 125, 126]"

Norman,L100,short,28,14,14,11,0.7812,128,"[4, 9, 19, 21, 29, 32, 39, 42, 51, 53, 60, 61, 63, 70, 71, 72, 73, 76, 84, 85, 86, 94, 97, 98, 100, 109, 114, 122]"

Norman,L100,short,31,26,5,4,0.7634,131,"[8, 9, 14, 15, 16, 22, 30, 32, 41, 50, 51, 60, 61, 62, 63, 64, 65, 73, 74, 75, 84, 85, 95, 105, 108, 116, 117, 118, 125, 126, 129]"

Norman,L100,short,33,14,19,11,0.7519,133,"[8, 10, 15, 16, 17, 18, 19, 29, 39, 40, 41, 42, 43, 44, 45, 46, 55, 58, 67, 76, 77, 78, 79, 89, 90, 91, 100, 101, 102, 103, 113, 119, 127]"

Norman,L100,short,27,13,14,4,0.7874,127,"[9, 14, 15, 16, 17, 18, 19, 30, 39, 40, 50, 59, 60, 61, 68, 69, 70, 72, 80, 81, 89, 90, 92, 102, 110, 112, 121]"

Norman,L100,short,31,18,13,6,0.7634,131,"[5, 10, 19, 20, 29, 30, 31, 39, 41, 42, 52, 56, 64, 72, 74, 81, 82, 83, 84, 87, 96, 98, 105, 106, 107, 114, 115, 118, 126, 127, 128]"

Norman,L100,short,30,15,15,4,0.7692,130,"[8, 11, 18, 19, 22, 30, 31, 32, 42, 49, 50, 52, 60, 62, 69, 70, 72, 80, 81, 82, 90, 91, 93, 102, 110, 111, 112, 120, 121, 126]"

Norman,L100,short,36,17,19,7,0.7353,136,"[5, 10, 18, 19, 28, 29, 38, 41, 50, 57, 59, 62, 71, 72, 79, 80, 81, 82, 90, 91, 93, 100, 101, 102, 103, 104, 106, 113, 114, 115, 116, 125, 126, 127, 128, 129]"

Norman,L100,short,31,14,17,8,0.7634,131,"[9, 10, 11, 14, 21, 23, 32, 42, 49, 50, 51, 53, 61, 64, 72, 80, 82, 83, 92, 93, 100, 101, 102, 104, 111, 112, 114, 122, 123, 124, 125]"

Norman,L100,short,26,14,12,8,0.7937,126,"[6, 12, 20, 28, 29, 30, 38, 39, 40, 49, 53, 60, 69, 70, 80, 87, 91, 101, 107, 109, 110, 111, 113, 120, 122, 123]"

Norman,L100,short,30,16,14,5,0.7692,130,"[4, 9, 18, 20, 28, 30, 31, 32, 34, 36, 37, 38, 47, 48, 60, 68, 76, 78, 79, 80, 89, 92, 100, 101, 103, 111, 114, 122, 123, 126]"

Norman,L100,short,37,15,22,10,0.7299,137,"[10, 16, 17, 19, 28, 29, 30, 31, 34, 43, 53, 54, 62, 64, 70, 77, 85, 92, 93, 94, 95, 96, 104, 105, 106, 107, 108, 109, 117, 118, 119, 127, 128, 129, 131, 132, 134]"

Norman,L100,short,27,8,19,6,0.7874,127,"[8, 10, 11, 17, 18, 19, 20, 21, 30, 31, 41, 49, 52, 60, 64, 73, 82, 91, 93, 102, 110, 111, 112, 119, 120, 121, 123]"

Norman,L100,short,32,25,7,8,0.7576,132,"[4, 9, 10, 19, 20, 28, 29, 30, 34, 42, 50, 51, 55, 63, 71, 72, 73, 74, 82, 83, 84, 85, 95, 96, 105, 107, 114, 115, 117, 118, 127, 128]"

Norman,L100,short,34,25,9,3,0.7463,134,"[4, 10, 11, 12, 21, 23, 32, 39, 40, 41, 42, 52, 60, 61, 63, 71, 72, 81, 83, 91, 92, 93, 94, 98, 106, 107, 110, 117, 118, 119, 120, 128, 129, 130]"

Norman,L100,short,30,17,13,8,0.7692,130,"[4, 9, 10, 19, 20, 28, 33, 40, 48, 50, 51, 58, 61, 62, 71, 72, 79, 80, 81, 83, 92, 99, 100, 101, 105, 112, 120, 122, 123, 125]"

Norman,L100,short,29,20,9,1,0.7752,129,"[8, 9, 14, 15, 17, 18, 19, 22, 24, 25, 26, 35, 36, 46, 47, 56, 57, 67, 76, 77, 81, 89, 91, 100, 102, 112, 120, 121, 123]"

Norman,L100,short,29,17,12,9,0.7752,129,"[4, 10, 18, 20, 21, 29, 30, 31, 39, 40, 41, 48, 56, 65, 73, 74, 82, 84, 91, 92, 93, 94, 95, 106, 116, 123, 124, 125, 127]"

Norman,L100,short,27,17,10,7,0.7874,127,"[8, 13, 20, 28, 29, 30, 32, 41, 48, 49, 50, 52, 60, 61, 68, 69, 70, 71, 79, 80, 81, 91, 99, 100, 101, 112, 121]"

Norman,L100,short,32,10,22,9,0.7576,132,"[7, 12, 20, 30, 31, 32, 40, 41, 43, 51, 52, 56, 63, 70, 71, 72, 73, 74, 83, 84, 92, 95, 96, 97, 98, 100, 108, 109, 116, 120, 128, 129]"

Norman,L100,short,31,18,13,3,0.7634,131,"[4, 10, 18, 19, 21, 29, 30, 31, 40, 42, 50, 51, 59, 60, 61, 71, 73, 81, 82, 83, 91, 92, 93, 101, 103, 104, 113, 114, 115, 123, 126]"

Norman,L100,short,30,16,14,3,0.7692,130,"[5, 9, 18, 20, 28, 29, 37, 39, 48, 49, 57, 58, 59, 66, 67, 69, 72, 80, 81, 82, 91, 92, 100, 101, 102, 111, 114, 115, 124, 126]"

Norman,L100,short,29,22,7,8,0.7752,129,"[5, 9, 18, 19, 30, 37, 38, 39, 44, 52, 59, 60, 62, 69, 70, 72, 73, 74, 82, 83, 84, 87, 96, 104, 105, 106, 115, 117, 126]"

Norman,L100,short,29,13,16,7,0.7752,129,"[8, 9, 10, 15, 17, 19, 20, 29, 30, 31, 40, 43, 55, 63, 65, 67, 75, 77, 86, 87, 95, 97, 98, 106, 107, 109, 116, 117, 119]"

Norman,L100,short,30,12,18,12,0.7692,130,"[10, 12, 13, 14, 17, 18, 19, 28, 29, 38, 40, 50, 58, 59, 60, 61, 69, 70, 73, 82, 91, 92, 100, 101, 102, 110, 111, 112, 121, 123]"

Norman,L100,short,33,16,17,6,0.7519,133,"[12, 13, 20, 21, 22, 23, 26, 34, 46, 53, 54, 62, 63, 65, 74, 76, 85, 86, 87, 94, 95, 96, 97, 98, 108, 115, 117, 118, 119, 126, 127, 128, 129]"

Norman,L100,short,30,20,10,7,0.7692,130,"[5, 10, 18, 19, 27, 28, 29, 32, 40, 41, 42, 51, 52, 62, 63, 71, 74, 76, 84, 85, 92, 93, 94, 95, 97, 107, 114, 115, 118, 128]"

Norman,L100,short,30,14,16,3,0.7692,130,"[4, 9, 18, 19, 27, 29, 30, 39, 40, 48, 50, 57, 58, 60, 62, 71, 73, 81, 84, 91, 94, 104, 112, 113, 114, 115, 116, 118, 126, 128]"

Norman,L100,short,33,26,7,1,0.7519,133,"[8, 9, 14, 15, 16, 17, 18, 19, 20, 21, 22, 32, 43, 46, 55, 56, 66, 75, 76, 84, 85, 86, 87, 96, 97, 105, 106, 108, 116, 117, 125, 126, 127]"

Norman,L100,short,29,20,9,9,0.7752,129,"[9, 14, 15, 16, 17, 18, 20, 33, 41, 49, 51, 60, 68, 69, 70, 72, 81, 91, 101, 102, 103, 104, 105, 112, 113, 114, 115, 116, 118]"

Norman,L100,short,30,17,13,4,0.7692,130,"[7, 10, 18, 19, 20, 29, 30, 38, 39, 41, 50, 57, 59, 60, 71, 78, 79, 80, 87, 89, 90, 98, 99, 100, 108, 109, 110, 118, 119, 122]"

Norman,L100,short,31,15,16,2,0.7634,131,"[8, 9, 14, 17, 19, 27, 29, 30, 31, 41, 49, 52, 54, 63, 64, 72, 73, 74, 82, 86, 96, 103, 104, 105, 113, 114, 116, 117, 124, 126, 127]"

Norman,L100,short,32,14,18,9,0.7576,132,"[9, 15, 16, 18, 22, 30, 38, 39, 40, 42, 50, 51, 52, 54, 62, 63, 71, 72, 73, 81, 82, 83, 94, 97, 105, 112, 113, 114, 115, 123, 124, 126]"

Norman,L100,short,32,16,16,3,0.7576,132,"[5, 9, 18, 19, 27, 28, 29, 37, 39, 41, 49, 52, 53, 61, 62, 63, 71, 75, 83, 85, 92, 93, 94, 95, 97, 99, 109, 117, 118, 120, 128, 129]"

Norman,L100,short,30,18,12,9,0.7692,130,"[4, 9, 18, 22, 31, 38, 39, 41, 50, 57, 58, 59, 62, 63, 64, 72, 74, 82, 83, 85, 92, 94, 101, 102, 104, 107, 115, 116, 124, 126]"

Norman,L100,short,25,16,9,15,0.8,125,"[5, 9, 18, 19, 27, 28, 31, 40, 48, 49, 57, 58, 59, 66, 67, 75, 82, 89, 91, 99, 101, 108, 111, 118, 122]"

Norman,L100,short,35,21,14,5,0.7407,135,"[4, 9, 11, 20, 28, 30, 31, 39, 40, 41, 50, 51, 53, 61, 63, 71, 72, 73, 81, 82, 84, 92, 94, 102, 103, 104, 106, 113, 115, 116, 117, 125, 127, 128, 129]"

Norman,L100,short,29,16,13,3,0.7752,129,"[4, 9, 18, 19, 27, 28, 29, 40, 48, 51, 58, 59, 60, 68, 70, 77, 80, 87, 88, 89, 90, 98, 100, 101, 108, 109, 110, 112, 123]"

Norman,L100,short,31,22,9,8,0.7634,131,"[4, 9, 18, 20, 29, 31, 38, 39, 41, 49, 50, 51, 61, 69, 71, 72, 74, 82, 83, 85, 93, 94, 101, 103, 105, 112, 113, 114, 122, 123, 127]"

Norman,L100,short,27,14,13,7,0.7874,127,"[4, 9, 19, 22, 30, 31, 32, 39, 40, 42, 50, 54, 62, 63, 71, 72, 74, 84, 91, 93, 101, 104, 111, 112, 116, 124, 125]"

Norman,L100,short,30,17,13,3,0.7692,130,"[8, 9, 11, 12, 13, 19, 23, 32, 33, 45, 53, 54, 55, 56, 57, 58, 68, 76, 77, 78, 86, 89, 91, 101, 108, 109, 110, 112, 121, 123]"

Norman,L100,short,30,19,11,4,0.7692,130,"[8, 9, 10, 15, 18, 19, 21, 31, 40, 41, 51, 52, 53, 64, 71, 73, 81, 82, 83, 84, 92, 93, 94, 102, 103, 104, 112, 113, 115, 126]"

Norman,L100,short,26,13,13,7,0.7937,126,"[11, 17, 18, 19, 20, 28, 29, 30, 33, 43, 50, 52, 53, 54, 56, 58, 67, 77, 87, 89, 97, 100, 108, 110, 117, 120]"

Norman,L100,short,23,13,10,13,0.813,123,"[4, 9, 20, 28, 29, 37, 46, 54, 62, 71, 72, 80, 81, 82, 89, 90, 92, 100, 103, 110, 112, 113, 120]"

Norman,L100,short,32,23,9,7,0.7576,132,"[8, 9, 12, 20, 29, 30, 38, 39, 41, 49, 51, 59, 60, 64, 71, 72, 81, 82, 89, 90, 92, 100, 102, 110, 111, 112, 119, 120, 121, 122, 123, 125]"

Norman,L100,short,27,12,15,13,0.7874,127,"[9, 15, 16, 17, 18, 21, 29, 37, 44, 51, 58, 59, 67, 69, 70, 78, 82, 90, 91, 92, 93, 95, 96, 105, 106, 108, 119]"

Norman,L100,short,34,12,22,5,0.7463,134,"[9, 10, 15, 16, 17, 18, 19, 21, 30, 31, 32, 41, 42, 50, 52, 61, 62, 63, 72, 73, 74, 75, 76, 85, 86, 88, 97, 99, 107, 108, 110, 118, 121, 129]"

Norman,L100,short,31,14,17,7,0.7634,131,"[8, 10, 15, 16, 19, 20, 22, 33, 34, 35, 45, 53, 54, 56, 64, 65, 73, 74, 75, 76, 84, 86, 99, 106, 107, 109, 116, 117, 120, 128, 129]"

Norman,L100,short,27,10,17,6,0.7874,127,"[4, 9, 10, 13, 22, 25, 34, 42, 43, 45, 54, 61, 62, 63, 65, 73, 75, 83, 84, 87, 96, 103, 104, 105, 107, 114, 117]"

Norman,L100,short,30,10,20,2,0.7692,130,"[4, 9, 18, 21, 30, 37, 38, 40, 48, 49, 50, 58, 59, 60, 61, 62, 63, 64, 73, 74, 82, 83, 84, 93, 95, 104, 114, 122, 123, 124]"

Norman,L100,short,30,28,2,5,0.7692,130,"[9, 12, 18, 20, 21, 29, 30, 32, 41, 42, 51, 52, 60, 62, 63, 71, 72, 73, 75, 83, 84, 93, 94, 104, 112, 113, 114, 115, 116, 128]"

Norman,L100,short,32,13,19,11,0.7576,132,"[8, 10, 15, 17, 20, 28, 29, 30, 31, 32, 33, 34, 36, 46, 54, 57, 66, 67, 68, 77, 78, 86, 87, 91, 99, 107, 108, 116, 119, 126, 127, 130]"

Norman,L100,short,32,30,2,3,0.7576,132,"[4, 9, 10, 11, 21, 31, 33, 40, 41, 42, 43, 51, 53, 54, 67, 75, 77, 78, 86, 88, 89, 97, 99, 107, 108, 110, 118, 119, 120, 121, 122, 124]"

Norman,L100,short,31,20,11,5,0.7634,131,"[4, 10, 18, 20, 21, 22, 31, 32, 40, 41, 42, 45, 54, 62, 63, 64, 73, 75, 83, 84, 94, 95, 103, 105, 106, 109, 116, 117, 120, 128, 129]"

Norman,L100,short,28,16,12,6,0.7812,128,"[4, 9, 10, 12, 21, 29, 30, 33, 41, 42, 44, 52, 54, 63, 71, 72, 73, 83, 84, 91, 93, 94, 101, 102, 103, 104, 116, 125]"

Norman,L100,short,33,13,20,3,0.7519,133,"[8, 10, 15, 18, 20, 29, 32, 42, 50, 51, 53, 61, 62, 69, 70, 71, 72, 84, 92, 93, 94, 96, 97, 98, 106, 107, 108, 116, 117, 118, 126, 129, 130]"

Norman,L100,short,30,19,11,3,0.7692,130,"[4, 10, 18, 19, 20, 21, 22, 23, 32, 33, 42, 43, 52, 53, 63, 64, 73, 74, 75, 85, 86, 95, 97, 105, 106, 116, 124, 125, 126, 128]"

Norman,L100,short,28,16,12,9,0.7812,128,"[8, 9, 10, 11, 16, 19, 20, 21, 22, 32, 42, 44, 52, 53, 61, 63, 64, 72, 73, 77, 86, 94, 102, 105, 113, 114, 123, 126]"

Norman,L100,short,32,21,11,2,0.7576,132,"[8, 9, 10, 15, 16, 17, 18, 19, 20, 30, 31, 32, 33, 34, 44, 53, 55, 64, 72, 73, 74, 76, 86, 87, 98, 99, 107, 108, 109, 118, 119, 129]"

Norman,L100,short,33,24,9,5,0.7519,133,"[4, 9, 10, 20, 21, 30, 31, 39, 40, 41, 52, 59, 60, 62, 70, 71, 78, 82, 84, 91, 92, 93, 95, 103, 104, 106, 113, 114, 115, 116, 118, 126, 127]"

Norman,L100,short,33,21,12,6,0.7519,133,"[6, 9, 20, 28, 29, 30, 31, 39, 40, 41, 51, 53, 61, 63, 71, 72, 74, 82, 83, 84, 86, 94, 95, 98, 106, 107, 114, 116, 118, 126, 127, 129, 130]"

Norman,L100,short,34,20,14,5,0.7463,134,"[8, 11, 17, 23, 30, 32, 40, 41, 48, 49, 51, 59, 60, 61, 62, 63, 65, 75, 83, 85, 86, 95, 96, 105, 106, 107, 115, 116, 117, 118, 126, 127, 128, 129]"

Norman,L100,short,31,17,14,1,0.7634,131,"[9, 15, 16, 17, 19, 28, 29, 30, 32, 42, 51, 52, 61, 62, 63, 66, 75, 76, 84, 85, 87, 96, 103, 104, 105, 106, 114, 115, 116, 125, 126]"

Norman,L100,short,32,18,14,9,0.7576,132,"[8, 9, 14, 17, 18, 23, 31, 40, 49, 57, 58, 59, 68, 70, 78, 79, 80, 87, 89, 90, 92, 100, 101, 102, 110, 111, 112, 113, 120, 121, 122, 126]"

Norman,L100,short,30,18,12,4,0.7692,130,"[8, 9, 14, 15, 17, 18, 19, 28, 29, 30, 40, 49, 50, 60, 68, 69, 71, 79, 80, 81, 89, 90, 92, 100, 101, 102, 113, 120, 121, 125]"

Norman,L100,short,36,17,19,4,0.7353,136,"[4, 9, 10, 12, 21, 22, 32, 39, 40, 42, 43, 44, 45, 47, 56, 64, 65, 66, 67, 77, 86, 88, 89, 98, 99, 107, 108, 112, 119, 120, 128, 129, 130, 131, 132, 133]"

Norman,L100,short,29,13,16,1,0.7752,129,"[5, 9, 19, 29, 30, 37, 38, 40, 50, 51, 52, 59, 60, 61, 62, 63, 71, 73, 81, 82, 84, 92, 93, 101, 102, 103, 112, 113, 123]"

Norman,L100,short,35,13,22,6,0.7407,135,"[4, 9, 10, 19, 23, 32, 39, 41, 50, 58, 59, 60, 68, 69, 70, 77, 78, 80, 81, 90, 91, 92, 93, 94, 95, 103, 104, 105, 113, 114, 116, 117, 118, 127, 128]"

Norman,L100,short,32,24,8,3,0.7576,132,"[6, 10, 19, 28, 29, 37, 38, 40, 48, 49, 56, 57, 59, 66, 67, 68, 69, 70, 78, 79, 80, 89, 90, 99, 101, 109, 110, 118, 119, 120, 127, 130]"

Norman,L100,short,25,13,12,7,0.8,125,"[9, 10, 11, 12, 13, 19, 24, 32, 33, 34, 43, 46, 55, 63, 65, 73, 76, 84, 89, 97, 105, 106, 110, 117, 118]"

Norman,L100,short,33,25,8,4,0.7519,133,"[4, 10, 18, 19, 27, 28, 29, 37, 38, 39, 47, 48, 53, 61, 63, 72, 73, 74, 75, 76, 77, 78, 87, 88, 97, 98, 108, 115, 118, 126, 127, 128, 129]"

Norman,L100,short,34,27,7,4,0.7463,134,"[8, 9, 14, 15, 16, 17, 18, 19, 29, 32, 41, 42, 52, 60, 62, 64, 72, 74, 83, 90, 91, 93, 94, 96, 106, 114, 115, 116, 117, 118, 119, 120, 128, 130]"

Norman,L100,short,27,20,7,8,0.7874,127,"[8, 9, 14, 15, 17, 18, 19, 28, 30, 33, 43, 51, 52, 53, 55, 65, 77, 85, 86, 87, 94, 95, 97, 98, 110, 117, 119]"

Norman,L100,short,33,19,14,2,0.7519,133,"[8, 9, 14, 16, 17, 19, 28, 29, 38, 39, 40, 49, 50, 58, 59, 60, 68, 69, 71, 81, 89, 91, 99, 100, 101, 109, 110, 111, 119, 120, 122, 130, 131]"

Norman,L100,short,32,16,16,5,0.7576,132,"[8, 9, 10, 14, 22, 31, 39, 41, 49, 50, 51, 59, 60, 62, 63, 71, 72, 73, 74, 82, 83, 85, 93, 94, 102, 104, 113, 114, 122, 123, 124, 125]"

Norman,L100,short,33,17,16,5,0.7519,133,"[4, 11, 19, 20, 28, 30, 32, 41, 49, 50, 51, 58, 62, 71, 72, 75, 78, 86, 87, 94, 95, 96, 97, 98, 106, 107, 108, 116, 117, 118, 119, 128, 129]"

Norman,L100,short,30,16,14,6,0.7692,130,"[4, 10, 18, 19, 27, 30, 38, 39, 40, 48, 49, 50, 58, 59, 61, 71, 82, 90, 93, 94, 101, 102, 103, 104, 111, 112, 113, 114, 116, 126]"

Norman,L100,short,31,10,21,9,0.7634,131,"[4, 9, 10, 12, 20, 23, 33, 40, 43, 52, 60, 61, 69, 70, 71, 78, 79, 82, 89, 90, 91, 99, 100, 101, 111, 112, 113, 114, 122, 123, 124]"

Norman,L100,short,34,16,18,1,0.7463,134,"[8, 9, 14, 15, 16, 18, 19, 28, 30, 39, 40, 48, 50, 51, 62, 71, 79, 80, 81, 82, 90, 91, 92, 100, 101, 102, 110, 112, 119, 120, 121, 122, 130, 132]"

Norman,L100,short,33,16,17,4,0.7519,133,"[4, 9, 19, 28, 29, 37, 39, 48, 49, 56, 57, 58, 63, 70, 77, 80, 87, 89, 90, 97, 98, 100, 101, 109, 111, 118, 119, 120, 122, 123, 124, 125, 126]"

Norman,L100,short,33,25,8,4,0.7519,133,"[5, 9, 19, 27, 28, 29, 30, 38, 40, 41, 50, 51, 52, 54, 63, 71, 72, 73, 81, 82, 83, 91, 92, 93, 95, 97, 107, 116, 117, 118, 126, 127, 129]"

Norman,L100,short,28,10,18,5,0.7812,128,"[9, 10, 16, 17, 18, 19, 20, 21, 30, 31, 40, 41, 49, 50, 53, 58, 67, 76, 80, 88, 89, 90, 91, 101, 108, 109, 112, 121]"

Norman,L100,short,28,18,10,5,0.7812,128,"[4, 9, 11, 21, 23, 31, 32, 33, 41, 42, 43, 44, 53, 55, 64, 72, 73, 74, 75, 84, 85, 94, 95, 96, 99, 108, 119, 126]"

Norman,L100,short,29,16,13,1,0.7752,129,"[4, 9, 10, 12, 21, 29, 30, 31, 39, 40, 41, 49, 50, 51, 59, 60, 61, 71, 72, 81, 82, 92, 102, 109, 112, 113, 121, 123, 124]"

Norman,L100,short,32,22,10,3,0.7576,132,"[4, 9, 10, 11, 12, 13, 22, 23, 32, 33, 42, 43, 44, 45, 46, 48, 58, 67, 77, 78, 81, 90, 98, 100, 108, 110, 117, 118, 119, 120, 129, 130]"

Norman,L100,short,33,21,12,3,0.7519,133,"[9, 14, 15, 16, 17, 18, 19, 28, 29, 30, 31, 41, 49, 50, 51, 60, 61, 73, 81, 83, 91, 92, 100, 101, 102, 110, 111, 112, 119, 120, 121, 122, 131]"

Norman,L100,short,32,21,11,8,0.7576,132,"[9, 12, 18, 19, 20, 21, 29, 30, 31, 33, 34, 35, 36, 46, 54, 56, 65, 66, 74, 76, 79, 87, 88, 98, 106, 110, 117, 118, 125, 126, 127, 128]"

Norman,L100,short,33,25,8,12,0.7519,133,"[8, 10, 13, 20, 21, 22, 30, 31, 32, 33, 35, 45, 53, 54, 63, 64, 65, 73, 74, 75, 77, 85, 89, 98, 106, 115, 116, 123, 124, 125, 126, 127, 130]"

Norman,L100,short,34,21,13,6,0.7463,134,"[8, 9, 14, 15, 17, 18, 19, 28, 30, 41, 49, 50, 51, 52, 53, 54, 57, 67, 76, 85, 93, 94, 95, 96, 104, 105, 106, 114, 115, 116, 123, 124, 125, 126]"

Norman,L100,short,31,15,16,8,0.7634,131,"[8, 9, 12, 19, 20, 21, 29, 30, 34, 43, 50, 51, 59, 60, 61, 71, 79, 80, 81, 91, 92, 93, 101, 102, 103, 104, 107, 115, 116, 124, 127]"

Norman,L100,short,30,22,8,7,0.7692,130,"[4, 9, 11, 19, 20, 21, 22, 23, 36, 44, 45, 46, 49, 58, 66, 67, 69, 77, 78, 80, 91, 98, 100, 101, 102, 110, 111, 112, 121, 123]"

Norman,L100,short,30,9,21,4,0.7692,130,"[8, 12, 18, 19, 20, 28, 29, 30, 39, 40, 41, 49, 52, 60, 62, 71, 79, 80, 81, 89, 90, 92, 93, 102, 103, 111, 112, 113, 121, 125]"

Norman,L100,short,29,15,14,8,0.7752,129,"[8, 9, 14, 15, 16, 20, 28, 33, 41, 49, 52, 61, 69, 71, 79, 80, 81, 88, 89, 91, 98, 99, 100, 101, 110, 111, 119, 120, 121]"

Norman,L100,short,28,16,12,8,0.7812,128,"[9, 15, 16, 19, 27, 28, 29, 30, 40, 42, 50, 51, 60, 62, 69, 70, 72, 80, 81, 87, 94, 101, 102, 106, 113, 114, 122, 124]"

Norman,L100,short,32,19,13,4,0.7576,132,"[8, 9, 14, 16, 17, 18, 19, 21, 30, 31, 40, 41, 49, 50, 51, 60, 61, 64, 72, 82, 90, 91, 92, 93, 101, 102, 103, 112, 113, 122, 124, 128]"

Norman,L100,short,31,16,15,9,0.7634,131,"[8, 9, 10, 15, 16, 17, 18, 19, 23, 32, 41, 49, 50, 51, 60, 61, 70, 71, 79, 80, 82, 91, 100, 101, 109, 110, 113, 120, 121, 122, 123]"

Norman,L100,short,33,18,15,6,0.7519,133,"[8, 9, 14, 15, 16, 17, 18, 19, 20, 21, 23, 33, 43, 44, 45, 46, 55, 56, 65, 68, 77, 85, 86, 87, 88, 90, 101, 109, 111, 119, 120, 129, 130]"

Norman,L100,short,31,16,15,9,0.7634,131,"[4, 9, 11, 19, 21, 22, 32, 33, 42, 47, 56, 64, 72, 74, 81, 83, 90, 91, 92, 93, 101, 102, 103, 111, 112, 113, 120, 122, 123, 124, 125]"

Norman,L100,short,34,21,13,1,0.7463,134,"[4, 9, 11, 21, 22, 30, 31, 32, 40, 41, 42, 50, 52, 54, 55, 56, 64, 66, 67, 77, 79, 80, 90, 98, 100, 101, 110, 111, 119, 120, 121, 122, 123, 131]"

Norman,L100,short,29,22,7,6,0.7752,129,"[4, 10, 19, 28, 29, 37, 38, 39, 48, 50, 57, 58, 59, 66, 67, 68, 69, 77, 78, 79, 80, 90, 93, 102, 111, 118, 119, 120, 122]"

Norman,L100,short,24,12,12,9,0.8065,124,"[11, 18, 22, 31, 38, 40, 41, 50, 53, 61, 62, 70, 74, 81, 85, 92, 94, 96, 103, 105, 107, 113, 114, 116]"

Norman,L100,short,29,16,13,9,0.7752,129,"[8, 10, 12, 23, 30, 34, 35, 37, 45, 49, 58, 66, 67, 75, 76, 77, 78, 80, 87, 88, 89, 91, 100, 107, 108, 109, 111, 118, 120]"

Norman,L100,short,28,21,7,17,0.7812,128,"[4, 9, 18, 20, 30, 37, 38, 39, 41, 49, 50, 52, 61, 64, 71, 72, 80, 81, 82, 91, 93, 100, 101, 102, 105, 112, 113, 120]"

Norman,L100,short,30,17,13,5,0.7692,130,"[4, 9, 18, 20, 28, 29, 31, 40, 49, 50, 52, 59, 60, 61, 69, 70, 71, 79, 81, 90, 92, 99, 101, 102, 103, 107, 115, 122, 124, 125]"

Norman,L100,short,29,15,14,5,0.7752,129,"[9, 14, 15, 16, 17, 18, 19, 29, 38, 40, 42, 51, 60, 61, 69, 70, 71, 79, 80, 82, 90, 91, 99, 100, 102, 110, 111, 114, 122]"

Norman,L100,short,33,16,17,4,0.7519,133,"[5, 10, 11, 12, 13, 14, 16, 25, 29, 40, 41, 42, 43, 44, 54, 63, 64, 72, 73, 74, 82, 84, 95, 103, 105, 107, 108, 110, 118, 119, 126, 127, 129]"

Norman,L100,short,29,16,13,4,0.7752,129,"[5, 9, 19, 28, 30, 37, 38, 39, 47, 50, 60, 67, 70, 77, 78, 79, 80, 81, 88, 89, 90, 91, 92, 101, 102, 111, 114, 121, 124]"

Norman,L100,short,33,26,7,3,0.7519,133,"[4, 10, 18, 19, 21, 30, 39, 41, 49, 50, 51, 52, 60, 61, 63, 73, 74, 82, 83, 84, 85, 94, 95, 104, 105, 106, 107, 117, 125, 126, 128, 129, 131]"

Norman,L100,short,28,8,20,6,0.7812,128,"[8, 10, 16, 18, 19, 27, 29, 37, 38, 39, 47, 48, 51, 59, 67, 70, 79, 87, 88, 90, 97, 98, 100, 102, 112, 119, 120, 121]"

Norman,L100,short,29,21,8,6,0.7752,129,"[4, 10, 19, 20, 21, 30, 31, 39, 40, 42, 43, 51, 52, 53, 62, 63, 64, 72, 73, 75, 83, 84, 85, 93, 94, 98, 107, 119, 126]"

Norman,L100,short,31,19,12,5,0.7634,131,"[4, 9, 18, 19, 28, 30, 38, 40, 50, 53, 62, 69, 72, 73, 74, 81, 82, 85, 92, 93, 94, 95, 103, 104, 106, 113, 114, 117, 118, 126, 128]"

Norman,L100,short,31,16,15,6,0.7634,131,"[9, 15, 16, 18, 21, 29, 30, 39, 40, 42, 50, 52, 61, 62, 69, 71, 74, 82, 91, 92, 99, 100, 101, 102, 110, 111, 112, 113, 122, 123, 127]"

Norman,L100,short,31,12,19,3,0.7634,131,"[4, 9, 10, 11, 22, 30, 31, 40, 42, 51, 53, 62, 64, 74, 82, 83, 84, 91, 92, 93, 94, 95, 96, 97, 98, 99, 108, 110, 119, 120, 129]"

Norman,L100,short,30,14,16,7,0.7692,130,"[4, 9, 18, 19, 27, 29, 30, 38, 40, 48, 50, 51, 52, 61, 63, 73, 75, 83, 84, 85, 87, 99, 107, 114, 115, 116, 117, 124, 126, 128]"

Norman,L100,short,31,20,11,8,0.7634,131,"[10, 16, 17, 18, 21, 29, 30, 31, 32, 35, 44, 52, 54, 62, 63, 71, 72, 73, 82, 83, 91, 94, 102, 103, 111, 112, 113, 115, 124, 125, 126]"

Norman,L100,short,31,17,14,11,0.7634,131,"[9, 14, 15, 16, 17, 20, 28, 29, 38, 40, 48, 49, 57, 58, 59, 61, 69, 74, 82, 91, 98, 99, 100, 101, 109, 110, 112, 120, 121, 122, 125]"

Norman,L0,middle,15,10,5,0,0.8696,115,"[9, 18, 19, 37, 39, 40, 57, 59, 60, 77, 78, 80, 81, 98, 101]"

Norman,L0,middle,16,2,14,2,0.8621,116,"[11, 19, 21, 22, 39, 40, 41, 44, 62, 78, 80, 81, 82, 100, 101, 102]"

Norman,L0,middle,16,5,11,2,0.8621,116,"[9, 17, 20, 21, 22, 39, 40, 41, 42, 43, 44, 65, 83, 85, 103, 104]"

Norman,L0,middle,16,8,8,0,0.8621,116,"[18, 19, 31, 32, 33, 34, 35, 37, 38, 39, 57, 58, 59, 78, 79, 99]"

Norman,L0,middle,16,8,8,5,0.8621,116,"[18, 19, 20, 33, 35, 37, 38, 39, 40, 58, 59, 60, 79, 83, 100, 103]"

Norman,L0,middle,19,10,9,4,0.8403,119,"[18, 19, 31, 32, 33, 34, 36, 37, 39, 40, 41, 59, 60, 61, 62, 65, 84, 102, 104]"

Norman,L0,middle,17,13,4,4,0.8547,117,"[9, 17, 18, 19, 20, 38, 39, 40, 58, 59, 60, 79, 80, 81, 82, 86, 104]"

Norman,L0,middle,17,11,6,0,0.8547,117,"[9, 17, 18, 19, 37, 38, 39, 57, 59, 60, 61, 62, 80, 81, 84, 103, 104]"

Norman,L0,middle,16,10,6,0,0.8621,116,"[9, 18, 19, 20, 21, 39, 41, 42, 59, 61, 62, 80, 81, 82, 101, 102]"

Norman,L0,middle,17,9,8,0,0.8547,117,"[10, 19, 36, 38, 40, 57, 61, 77, 80, 81, 98, 99, 100, 101, 102, 105, 106]"

Norman,L0,middle,18,8,10,1,0.8475,118,"[18, 19, 32, 33, 35, 38, 39, 41, 42, 43, 62, 63, 81, 82, 84, 101, 104, 106]"

Norman,L0,middle,14,5,9,3,0.8772,114,"[18, 20, 32, 34, 35, 37, 39, 56, 57, 59, 61, 81, 97, 100]"

Norman,L0,middle,14,7,7,1,0.8772,114,"[10, 20, 37, 39, 40, 41, 59, 61, 77, 79, 81, 98, 100, 101]"

Norman,L0,middle,18,6,12,1,0.8475,118,"[18, 19, 31, 32, 34, 35, 36, 37, 39, 57, 58, 60, 78, 79, 80, 81, 98, 101]"

Norman,L0,middle,15,10,5,1,0.8696,115,"[10, 18, 19, 38, 40, 57, 58, 59, 60, 61, 78, 79, 82, 100, 101]"

Norman,L0,middle,16,6,10,1,0.8621,116,"[9, 18, 19, 37, 38, 39, 56, 57, 58, 59, 77, 80, 97, 98, 100, 102]"

Norman,L0,middle,19,13,6,4,0.8403,119,"[10, 18, 19, 20, 38, 39, 42, 60, 61, 78, 79, 80, 81, 82, 99, 101, 103, 106, 109]"

Norman,L0,middle,14,12,2,1,0.8772,114,"[9, 17, 19, 37, 40, 57, 58, 59, 60, 61, 79, 80, 82, 101]"

Norman,L0,middle,16,6,10,4,0.8621,116,"[18, 19, 21, 37, 39, 42, 59, 62, 79, 81, 82, 83, 99, 100, 104, 107]"

Norman,L0,middle,16,10,6,3,0.8621,116,"[9, 17, 18, 19, 22, 40, 59, 61, 78, 79, 80, 96, 97, 98, 99, 100]"

Norman,L0,middle,22,5,17,2,0.8197,122,"[18, 19, 20, 21, 35, 36, 39, 40, 42, 60, 61, 62, 63, 66, 68, 86, 87, 88, 89, 91, 109, 112]"

Norman,L0,middle,12,7,5,1,0.8929,112,"[9, 17, 19, 38, 39, 56, 58, 59, 78, 80, 98, 99]"

Norman,L0,middle,16,12,4,1,0.8621,116,"[10, 18, 19, 39, 40, 44, 61, 63, 79, 81, 83, 99, 100, 101, 102, 103]"

Norman,L0,middle,17,4,13,1,0.8547,117,"[11, 19, 20, 37, 38, 40, 41, 58, 59, 60, 61, 62, 81, 82, 99, 100, 103]"

Norman,L0,middle,17,4,13,3,0.8547,117,"[18, 19, 32, 33, 34, 35, 36, 38, 40, 58, 59, 77, 78, 79, 97, 98, 101]"

Norman,L0,middle,14,3,11,5,0.8772,114,"[18, 20, 32, 35, 36, 39, 56, 58, 59, 60, 64, 82, 85, 103]"

Norman,L0,middle,16,5,11,1,0.8621,116,"[18, 19, 20, 21, 35, 36, 37, 39, 40, 42, 61, 79, 81, 99, 100, 101]"

Norman,L0,middle,12,10,2,1,0.8929,112,"[9, 20, 41, 59, 61, 62, 79, 80, 84, 102, 103, 104]"

Norman,L0,middle,17,8,9,1,0.8547,117,"[18, 19, 20, 33, 35, 37, 38, 39, 40, 59, 62, 63, 81, 82, 84, 102, 103]"

Norman,L0,middle,16,4,12,3,0.8621,116,"[18, 19, 20, 33, 34, 35, 36, 37, 38, 39, 41, 60, 79, 82, 99, 100]"

Norman,L0,middle,16,4,12,2,0.8621,116,"[18, 20, 32, 36, 37, 38, 40, 57, 58, 60, 80, 81, 97, 99, 100, 102]"

Norman,L0,middle,16,9,7,1,0.8621,116,"[18, 19, 34, 35, 37, 38, 40, 57, 58, 59, 77, 79, 96, 97, 98, 99]"

Norman,L0,middle,15,10,5,5,0.8696,115,"[9, 18, 19, 37, 38, 41, 60, 76, 77, 78, 80, 96, 97, 98, 100]"

Norman,L0,middle,18,10,8,0,0.8475,118,"[18, 19, 31, 32, 33, 34, 35, 38, 39, 57, 58, 59, 60, 79, 80, 97, 99, 101]"

Norman,L0,middle,15,10,5,1,0.8696,115,"[18, 20, 32, 35, 36, 37, 38, 39, 56, 58, 59, 77, 79, 98, 99]"

Norman,L0,middle,17,14,3,4,0.8547,117,"[9, 17, 19, 37, 39, 41, 58, 59, 60, 61, 62, 64, 81, 84, 102, 103, 105]"

Norman,L0,middle,17,11,6,2,0.8547,117,"[9, 17, 18, 21, 39, 40, 57, 59, 60, 77, 78, 79, 80, 81, 98, 101, 103]"

Norman,L0,middle,15,11,4,2,0.8696,115,"[9, 17, 18, 19, 37, 38, 39, 40, 59, 60, 63, 80, 82, 102, 104]"

Norman,L0,middle,16,9,7,0,0.8621,116,"[9, 17, 19, 38, 40, 57, 59, 60, 78, 79, 80, 82, 99, 100, 102, 103]"

Norman,L0,middle,15,6,9,3,0.8696,115,"[19, 32, 33, 34, 35, 38, 39, 56, 57, 59, 77, 78, 80, 99, 102]"

Norman,L0,middle,16,4,12,1,0.8621,116,"[19, 20, 22, 36, 37, 39, 40, 41, 59, 60, 61, 81, 97, 99, 101, 102]"

Norman,L0,middle,16,10,6,2,0.8621,116,"[9, 17, 18, 20, 23, 41, 43, 61, 63, 64, 81, 83, 85, 101, 103, 105]"

Norman,L0,middle,17,8,9,2,0.8547,117,"[9, 17, 20, 37, 38, 39, 40, 57, 59, 60, 62, 79, 80, 81, 99, 100, 102]"

Norman,L0,middle,12,6,6,7,0.8929,112,"[18, 19, 31, 34, 36, 41, 58, 59, 63, 84, 99, 101]"

Norman,L0,middle,15,12,3,2,0.8696,115,"[9, 17, 20, 37, 40, 58, 59, 75, 76, 77, 79, 96, 97, 98, 100]"

Norman,L0,middle,16,11,5,3,0.8621,116,"[9, 17, 18, 19, 20, 38, 39, 41, 59, 60, 77, 79, 80, 97, 98, 102]"

Norman,L0,middle,15,8,7,3,0.8696,115,"[10, 19, 37, 38, 40, 57, 58, 60, 76, 77, 78, 81, 98, 101, 105]"

Norman,L0,middle,16,6,10,5,0.8621,116,"[9, 21, 38, 41, 59, 74, 76, 77, 78, 79, 95, 97, 98, 100, 101, 103]"

Norman,L0,middle,12,2,10,7,0.8929,112,"[11, 20, 36, 37, 38, 39, 57, 58, 63, 81, 99, 101]"

Norman,L0,middle,19,7,12,0,0.8403,119,"[10, 19, 20, 21, 38, 39, 40, 41, 58, 60, 61, 62, 80, 81, 82, 83, 100, 101, 103]"

Norman,L0,middle,19,12,7,0,0.8403,119,"[10, 18, 19, 37, 39, 57, 59, 75, 76, 77, 78, 79, 96, 97, 98, 101, 102, 103, 104]"

Norman,L0,middle,16,9,7,4,0.8621,116,"[19, 22, 38, 39, 40, 57, 58, 61, 79, 80, 83, 85, 101, 102, 104, 105]"

Norman,L0,middle,16,11,5,5,0.8621,116,"[9, 17, 18, 19, 21, 39, 40, 42, 59, 61, 62, 65, 84, 101, 102, 104]"

Norman,L0,middle,14,9,5,2,0.8772,114,"[20, 34, 35, 37, 39, 57, 58, 60, 78, 80, 81, 99, 101, 102]"

Norman,L0,middle,14,13,1,7,0.8772,114,"[9, 17, 18, 23, 39, 57, 62, 79, 80, 82, 98, 99, 100, 102]"

Norman,L0,middle,14,13,1,3,0.8772,114,"[9, 17, 18, 19, 37, 38, 39, 58, 60, 78, 82, 100, 101, 102]"

Norman,L0,middle,17,5,12,0,0.8547,117,"[18, 19, 20, 33, 34, 37, 38, 39, 40, 61, 80, 82, 98, 99, 100, 102, 103]"

Norman,L0,middle,18,11,7,2,0.8475,118,"[20, 33, 34, 36, 38, 39, 40, 57, 58, 60, 61, 79, 80, 82, 99, 100, 101, 102]"

Norman,L0,middle,17,8,9,1,0.8547,117,"[18, 20, 32, 34, 35, 36, 38, 41, 59, 60, 78, 79, 80, 97, 98, 99, 100]"

Norman,L0,middle,15,7,8,1,0.8696,115,"[9, 18, 20, 21, 39, 43, 61, 62, 81, 82, 83, 100, 101, 103, 104]"

Norman,L0,middle,18,12,6,1,0.8475,118,"[18, 19, 31, 32, 33, 34, 35, 37, 38, 39, 41, 60, 80, 97, 98, 99, 100, 101]"

Norman,L0,middle,13,7,6,2,0.885,113,"[9, 17, 18, 19, 38, 39, 56, 61, 79, 80, 98, 99, 100]"

Norman,L0,middle,18,11,7,3,0.8475,118,"[18, 19, 34, 35, 36, 37, 38, 39, 56, 57, 58, 60, 79, 96, 97, 98, 99, 102]"

Norman,L0,middle,17,10,7,7,0.8547,117,"[18, 20, 34, 35, 39, 40, 58, 60, 65, 82, 97, 99, 100, 101, 103, 105, 107]"

Norman,L0,middle,16,10,6,1,0.8621,116,"[9, 17, 19, 37, 38, 39, 56, 57, 59, 77, 78, 79, 96, 97, 98, 100]"

Norman,L0,middle,17,14,3,5,0.8547,117,"[18, 21, 34, 35, 36, 38, 39, 40, 57, 58, 61, 79, 80, 97, 98, 99, 102]"

Norman,L0,middle,19,13,6,4,0.8403,119,"[10, 18, 22, 23, 39, 41, 42, 43, 45, 46, 47, 65, 66, 67, 69, 87, 89, 106, 110]"

Norman,L0,middle,17,8,9,7,0.8547,117,"[9, 17, 19, 37, 38, 39, 56, 57, 58, 59, 63, 80, 97, 98, 99, 102, 107]"

Norman,L0,middle,15,9,6,1,0.8696,115,"[19, 35, 36, 37, 40, 58, 59, 76, 77, 78, 79, 80, 81, 99, 101]"

Norman,L0,middle,17,5,12,1,0.8547,117,"[19, 20, 21, 34, 36, 38, 39, 40, 41, 59, 60, 61, 79, 80, 81, 98, 102]"

Norman,L0,middle,14,6,8,0,0.8772,114,"[9, 17, 19, 39, 40, 59, 60, 61, 77, 80, 81, 82, 99, 104]"

Norman,L0,middle,15,8,7,3,0.8696,115,"[18, 19, 20, 21, 35, 37, 38, 40, 41, 42, 60, 63, 81, 84, 103]"

Norman,L0,middle,16,11,5,0,0.8621,116,"[18, 21, 34, 35, 36, 37, 38, 39, 40, 41, 60, 62, 80, 82, 100, 102]"

Norman,L0,middle,17,9,8,4,0.8547,117,"[18, 20, 32, 34, 36, 37, 38, 41, 59, 60, 61, 80, 81, 97, 99, 100, 104]"

Norman,L0,middle,17,12,5,3,0.8547,117,"[9, 17, 18, 20, 21, 41, 42, 43, 61, 63, 80, 82, 83, 101, 102, 103, 107]"

Norman,L0,middle,18,7,11,1,0.8475,118,"[18, 19, 31, 32, 34, 35, 36, 37, 39, 40, 58, 59, 60, 80, 97, 98, 100, 102]"

Norman,L0,middle,17,5,12,1,0.8547,117,"[18, 19, 31, 32, 34, 35, 36, 37, 38, 39, 57, 61, 79, 80, 98, 99, 100]"

Norman,L0,middle,14,9,5,3,0.8772,114,"[10, 18, 19, 21, 41, 58, 59, 61, 77, 79, 80, 83, 100, 101]"

Norman,L0,middle,19,7,12,4,0.8403,119,"[10, 22, 40, 41, 58, 59, 60, 61, 62, 63, 64, 65, 82, 85, 86, 103, 104, 105, 107]"

Norman,L0,middle,13,9,4,10,0.885,113,"[19, 33, 34, 36, 37, 41, 58, 59, 60, 66, 85, 101, 102]"

Norman,L0,middle,16,8,8,4,0.8621,116,"[19, 20, 22, 36, 37, 39, 41, 42, 43, 62, 63, 64, 82, 85, 102, 106]"

Norman,L0,middle,19,10,9,2,0.8403,119,"[19, 23, 37, 38, 39, 40, 41, 43, 60, 61, 65, 85, 101, 102, 103, 104, 105, 106, 107]"

Norman,L0,middle,16,12,4,4,0.8621,116,"[22, 36, 39, 56, 57, 60, 61, 79, 80, 81, 83, 99, 100, 101, 102, 103]"

Norman,L0,middle,10,4,6,11,0.9091,110,"[10, 19, 36, 37, 39, 65, 81, 99, 101, 106]"

Norman,L0,middle,18,7,11,4,0.8475,118,"[18, 20, 33, 34, 35, 36, 38, 39, 41, 42, 60, 61, 62, 64, 83, 100, 102, 106]"

Norman,L0,middle,12,2,10,7,0.8929,112,"[18, 22, 36, 37, 38, 39, 56, 58, 61, 84, 100, 102]"

Norman,L0,middle,14,6,8,3,0.8772,114,"[19, 31, 33, 35, 36, 37, 38, 40, 58, 59, 77, 80, 98, 100]"

Norman,L0,middle,12,8,4,4,0.8929,112,"[9, 17, 20, 38, 41, 58, 59, 76, 77, 81, 100, 101]"

Norman,L0,middle,14,9,5,4,0.8772,114,"[9, 17, 19, 20, 39, 40, 57, 58, 59, 61, 78, 79, 81, 102]"

Norman,L0,middle,17,7,10,1,0.8547,117,"[10, 18, 19, 37, 39, 56, 57, 58, 59, 60, 61, 64, 81, 84, 102, 104, 105]"

Norman,L0,middle,18,9,9,3,0.8475,118,"[19, 31, 33, 36, 37, 38, 39, 40, 41, 59, 60, 61, 62, 64, 83, 100, 102, 106]"

Norman,L0,middle,15,7,8,1,0.8696,115,"[9, 17, 20, 37, 38, 39, 57, 59, 76, 77, 79, 96, 98, 99, 100]"

Norman,L0,middle,12,8,4,6,0.8929,112,"[9, 17, 18, 20, 38, 42, 59, 61, 78, 79, 83, 100]"

Norman,L0,middle,19,11,8,1,0.8403,119,"[18, 19, 20, 33, 34, 36, 38, 39, 40, 41, 59, 60, 61, 79, 82, 83, 101, 102, 104]"

Norman,L0,middle,18,9,9,3,0.8475,118,"[18, 20, 32, 34, 36, 37, 39, 42, 60, 78, 79, 80, 81, 82, 84, 101, 102, 103]"

Norman,L0,middle,19,9,10,1,0.8403,119,"[11, 19, 37, 38, 39, 56, 57, 59, 76, 79, 80, 96, 97, 98, 99, 100, 101, 102, 104]"

Norman,L0,middle,18,9,9,1,0.8475,118,"[9, 17, 19, 37, 38, 39, 40, 57, 59, 60, 77, 79, 80, 81, 83, 100, 101, 103]"

Norman,L0,middle,17,6,11,1,0.8547,117,"[19, 31, 35, 36, 39, 56, 57, 59, 60, 78, 79, 81, 98, 99, 100, 101, 103]"

Norman,L0,middle,15,9,6,3,0.8696,115,"[18, 19, 34, 35, 36, 37, 38, 39, 40, 59, 62, 81, 97, 99, 100]"

Norman,L0,middle,20,15,5,2,0.8333,120,"[9, 17, 18, 19, 38, 39, 57, 58, 60, 78, 79, 80, 97, 98, 99, 100, 101, 102, 103, 105]"

Norman,L0,middle,14,6,8,1,0.8772,114,"[9, 18, 20, 38, 39, 40, 57, 58, 59, 61, 79, 80, 82, 102]"

Norman,L0,middle,18,13,5,2,0.8475,118,"[9, 17, 18, 20, 38, 39, 41, 59, 60, 78, 79, 80, 81, 82, 99, 100, 102, 103]"

Norman,L0,middle,16,5,11,1,0.8621,116,"[19, 20, 32, 34, 35, 36, 37, 39, 40, 58, 59, 61, 79, 80, 97, 100]"

Norman,L0,middle,13,4,9,2,0.885,113,"[18, 19, 21, 34, 36, 39, 40, 58, 61, 80, 97, 100, 101]"

Norman,L0,middle,13,9,4,3,0.885,113,"[10, 18, 19, 20, 40, 44, 62, 79, 80, 81, 82, 101, 102]"

Norman,L0,middle,15,12,3,0,0.8696,115,"[9, 17, 18, 19, 37, 38, 39, 57, 59, 76, 79, 96, 97, 98, 99]"

Norman,L0,middle,16,8,8,2,0.8621,116,"[18, 19, 32, 35, 37, 40, 57, 58, 59, 76, 78, 79, 96, 97, 98, 100]"

Norman,L0,middle,16,10,6,3,0.8621,116,"[20, 34, 36, 37, 40, 42, 58, 61, 62, 79, 83, 100, 101, 102, 103, 106]"

Norman,L0,middle,16,9,7,1,0.8621,116,"[18, 19, 33, 34, 35, 37, 38, 40, 59, 76, 78, 79, 80, 97, 99, 100]"

Norman,L0,middle,17,11,6,1,0.8547,117,"[10, 19, 36, 40, 42, 59, 60, 63, 64, 65, 82, 84, 85, 101, 102, 104, 105]"

Norman,L0,middle,16,8,8,2,0.8621,116,"[9, 17, 18, 20, 21, 39, 40, 41, 42, 59, 61, 64, 81, 83, 101, 103]"

Norman,L0,middle,15,7,8,3,0.8696,115,"[9, 17, 18, 19, 22, 40, 41, 58, 61, 78, 81, 98, 99, 100, 102]"

Norman,L0,middle,15,6,9,4,0.8696,115,"[9, 17, 18, 19, 39, 40, 57, 58, 59, 60, 79, 80, 82, 100, 104]"

Norman,L0,middle,15,11,4,2,0.8696,115,"[10, 19, 22, 39, 40, 57, 58, 59, 60, 61, 78, 79, 82, 100, 102]"

Norman,L0,middle,17,5,12,4,0.8547,117,"[10, 18, 21, 37, 38, 40, 42, 60, 61, 62, 80, 81, 82, 100, 101, 102, 106]"

Norman,L0,middle,16,11,5,2,0.8621,116,"[19, 33, 35, 36, 37, 38, 39, 40, 42, 60, 61, 79, 81, 98, 99, 102]"

Norman,L0,middle,13,2,11,3,0.885,113,"[18, 19, 36, 37, 38, 40, 57, 58, 59, 78, 79, 97, 102]"

Norman,L0,middle,21,15,6,0,0.8264,121,"[18, 20, 21, 34, 37, 38, 39, 40, 41, 42, 43, 62, 63, 81, 82, 83, 84, 85, 102, 104, 105]"

Norman,L0,middle,14,5,9,4,0.8772,114,"[18, 22, 36, 37, 40, 58, 59, 76, 78, 79, 96, 97, 98, 99]"

Norman,L0,middle,16,7,9,1,0.8621,116,"[9, 17, 18, 19, 20, 38, 40, 57, 58, 59, 60, 61, 79, 83, 101, 104]"

Norman,L0,middle,18,8,10,5,0.8475,118,"[19, 31, 33, 34, 35, 38, 39, 41, 47, 65, 83, 84, 85, 86, 88, 104, 106, 107]"

Norman,L0,middle,18,16,2,1,0.8475,118,"[9, 17, 18, 19, 37, 38, 39, 57, 59, 61, 78, 79, 81, 98, 99, 100, 101, 102]"

Norman,L0,middle,19,8,11,2,0.8403,119,"[18, 19, 20, 21, 34, 35, 36, 38, 40, 43, 61, 62, 80, 81, 82, 99, 101, 102, 103]"

Norman,L0,middle,17,3,14,1,0.8547,117,"[18, 19, 32, 33, 34, 35, 36, 37, 38, 39, 57, 59, 60, 79, 81, 98, 100]"

Norman,L0,middle,12,3,9,3,0.8929,112,"[9, 19, 36, 37, 38, 40, 58, 62, 80, 99, 100, 101]"

Norman,L0,middle,16,5,11,2,0.8621,116,"[10, 18, 19, 37, 38, 39, 56, 57, 59, 60, 78, 81, 82, 84, 102, 104]"

Norman,L0,middle,15,10,5,1,0.8696,115,"[10, 18, 19, 39, 58, 59, 75, 77, 78, 82, 98, 99, 100, 101, 102]"

Norman,L0,middle,16,9,7,0,0.8621,116,"[9, 18, 19, 38, 41, 58, 61, 77, 79, 80, 81, 98, 100, 101, 102, 103]"

Norman,L0,middle,14,8,6,2,0.8772,114,"[12, 20, 37, 38, 40, 58, 61, 62, 79, 81, 83, 99, 101, 102]"

Norman,L0,middle,14,7,7,3,0.8772,114,"[18, 19, 34, 35, 36, 37, 40, 57, 58, 61, 79, 81, 99, 101]"

Norman,L0,middle,16,5,11,1,0.8621,116,"[10, 18, 20, 22, 38, 42, 59, 60, 61, 64, 84, 101, 102, 103, 104, 105]"

Norman,L0,middle,15,9,6,1,0.8696,115,"[9, 19, 38, 39, 40, 57, 61, 77, 81, 82, 84, 100, 101, 103, 104]"

Norman,L0,middle,14,6,8,1,0.8772,114,"[9, 19, 20, 37, 38, 41, 58, 60, 62, 78, 80, 81, 99, 101]"

Norman,L0,middle,11,5,6,5,0.9009,111,"[11, 22, 39, 40, 58, 59, 60, 76, 79, 81, 101]"

Norman,L0,middle,17,7,10,2,0.8547,117,"[18, 19, 32, 34, 35, 36, 37, 38, 40, 58, 60, 78, 81, 97, 99, 100, 101]"

Norman,L0,middle,15,12,3,3,0.8696,115,"[9, 17, 18, 20, 21, 39, 40, 42, 64, 81, 83, 99, 100, 102, 103]"

Norman,L0,middle,10,6,4,7,0.9091,110,"[11, 20, 36, 39, 40, 57, 59, 62, 84, 102]"

Norman,L0,middle,15,6,9,1,0.8696,115,"[10, 19, 37, 38, 39, 56, 57, 59, 76, 77, 79, 96, 97, 99, 101]"

Norman,L0,middle,18,4,14,2,0.8475,118,"[18, 19, 31, 32, 35, 36, 37, 38, 39, 41, 59, 61, 79, 80, 97, 98, 99, 100]"

Norman,L0,middle,18,13,5,3,0.8475,118,"[9, 17, 18, 19, 20, 23, 45, 62, 63, 64, 82, 83, 84, 85, 102, 103, 104, 105]"

Norman,L0,middle,16,9,7,1,0.8621,116,"[9, 18, 20, 37, 38, 39, 56, 57, 59, 61, 78, 80, 81, 82, 99, 103]"

Norman,L0,middle,14,7,7,1,0.8772,114,"[9, 19, 20, 38, 40, 57, 58, 59, 60, 78, 81, 98, 99, 100]"

Norman,L0,middle,15,7,8,3,0.8696,115,"[18, 19, 22, 36, 40, 41, 58, 59, 62, 79, 81, 82, 98, 100, 102]"

Norman,L0,middle,15,7,8,1,0.8696,115,"[10, 18, 20, 38, 39, 40, 42, 60, 61, 62, 80, 82, 83, 101, 103]"

Norman,L0,middle,14,5,9,8,0.8772,114,"[18, 20, 32, 35, 37, 39, 40, 45, 63, 83, 99, 100, 101, 104]"

Norman,L0,middle,16,4,12,2,0.8621,116,"[10, 18, 19, 37, 38, 40, 57, 58, 60, 79, 80, 97, 98, 99, 100, 103]"

Norman,L0,middle,16,6,10,3,0.8621,116,"[18, 19, 20, 21, 34, 36, 38, 39, 42, 61, 62, 81, 83, 99, 102, 104]"

Norman,L0,middle,14,7,7,7,0.8772,114,"[9, 18, 19, 37, 39, 40, 57, 58, 59, 60, 66, 83, 100, 101]"

Norman,L0,middle,18,8,10,1,0.8475,118,"[19, 20, 32, 34, 35, 36, 37, 40, 41, 59, 60, 62, 80, 81, 98, 100, 101, 102]"

Norman,L0,middle,14,7,7,6,0.8772,114,"[9, 18, 19, 37, 39, 40, 41, 42, 47, 65, 82, 83, 100, 103]"

Norman,L0,middle,14,9,5,4,0.8772,114,"[18, 21, 36, 40, 56, 57, 58, 60, 78, 79, 95, 96, 97, 99]"

Norman,L0,middle,13,9,4,7,0.885,113,"[9, 17, 18, 20, 43, 60, 76, 78, 81, 97, 98, 99, 100]"

Norman,L0,middle,18,9,9,2,0.8475,118,"[18, 19, 20, 21, 34, 35, 37, 39, 40, 42, 60, 62, 81, 97, 99, 100, 101, 102]"

Norman,L0,middle,14,3,11,2,0.8772,114,"[12, 21, 40, 57, 58, 59, 61, 62, 63, 80, 81, 84, 103, 104]"

Norman,L0,middle,16,13,3,3,0.8621,116,"[21, 22, 24, 39, 40, 42, 43, 46, 64, 82, 83, 84, 100, 102, 103, 105]"

Norman,L0,middle,18,13,5,1,0.8475,118,"[10, 18, 19, 39, 41, 58, 59, 60, 61, 62, 79, 80, 81, 82, 100, 101, 102, 103]"

Norman,L0,middle,18,7,11,4,0.8475,118,"[18, 19, 20, 33, 35, 37, 38, 39, 40, 58, 59, 61, 62, 66, 84, 101, 102, 103]"

Norman,L0,middle,17,6,11,7,0.8547,117,"[18, 19, 20, 33, 34, 35, 37, 38, 39, 40, 42, 60, 63, 82, 99, 100, 104]"

Norman,L0,middle,13,3,10,10,0.885,113,"[19, 31, 33, 34, 35, 36, 37, 38, 43, 61, 79, 87, 103]"

Norman,L0,middle,16,4,12,0,0.8621,116,"[18, 19, 20, 35, 37, 39, 41, 58, 59, 61, 79, 81, 99, 100, 101, 102]"

Norman,L0,middle,15,8,7,1,0.8696,115,"[9, 17, 19, 37, 38, 41, 58, 59, 60, 77, 81, 98, 99, 100, 101]"

Norman,L0,middle,17,10,7,9,0.8547,117,"[9, 17, 18, 21, 38, 39, 40, 57, 59, 61, 79, 80, 81, 82, 84, 88, 108]"

Norman,L0,middle,19,6,13,4,0.8403,119,"[18, 20, 32, 34, 35, 36, 37, 38, 39, 40, 41, 59, 60, 62, 81, 99, 100, 101, 104]"

Norman,L0,middle,17,9,8,3,0.8547,117,"[9, 19, 20, 22, 23, 42, 43, 62, 63, 80, 81, 83, 85, 101, 103, 104, 108]"

Norman,L0,middle,16,9,7,0,0.8621,116,"[9, 18, 19, 37, 39, 56, 57, 59, 76, 77, 79, 80, 81, 99, 100, 101]"

Norman,L0,middle,20,5,15,5,0.8333,120,"[18, 19, 32, 33, 34, 35, 36, 38, 39, 40, 42, 60, 62, 80, 81, 82, 83, 101, 102, 108]"

Norman,L0,middle,17,8,9,5,0.8547,117,"[18, 19, 31, 33, 35, 36, 37, 38, 40, 58, 60, 78, 80, 97, 98, 100, 104]"

Norman,L0,middle,15,7,8,2,0.8696,115,"[19, 33, 34, 35, 37, 39, 56, 57, 58, 59, 77, 78, 80, 98, 102]"

Norman,L0,middle,19,16,3,3,0.8403,119,"[9, 17, 18, 19, 37, 38, 39, 42, 59, 61, 78, 79, 81, 98, 99, 100, 101, 102, 104]"

Norman,L0,middle,18,12,6,0,0.8475,118,"[18, 19, 32, 33, 36, 37, 39, 40, 57, 58, 59, 60, 61, 79, 81, 99, 100, 101]"

Norman,L0,middle,16,8,8,1,0.8621,116,"[9, 17, 18, 21, 38, 40, 58, 61, 62, 78, 81, 82, 83, 102, 103, 104]"

Norman,L0,middle,17,4,13,2,0.8547,117,"[19, 32, 33, 34, 35, 36, 37, 38, 39, 57, 58, 60, 78, 79, 80, 100, 102]"

Norman,L0,middle,14,4,10,1,0.8772,114,"[18, 19, 31, 33, 35, 37, 40, 57, 59, 76, 78, 79, 98, 99]"

Norman,L0,middle,14,6,8,2,0.8772,114,"[9, 18, 19, 37, 39, 56, 57, 58, 59, 76, 78, 80, 97, 100]"

Norman,L0,middle,16,12,4,1,0.8621,116,"[20, 33, 34, 35, 36, 37, 38, 39, 40, 58, 60, 78, 80, 98, 100, 101]"

Norman,L0,middle,16,9,7,0,0.8621,116,"[9, 18, 19, 38, 39, 56, 57, 58, 59, 76, 78, 79, 80, 97, 98, 100]"

Norman,L0,middle,18,13,5,1,0.8475,118,"[9, 18, 19, 37, 39, 56, 57, 59, 76, 77, 78, 79, 80, 97, 98, 100, 101, 103]"

Norman,L0,middle,14,7,7,6,0.8772,114,"[10, 18, 20, 37, 39, 44, 61, 77, 80, 81, 82, 99, 101, 102]"

Norman,L0,middle,18,10,8,1,0.8475,118,"[9, 18, 19, 37, 38, 40, 57, 58, 59, 60, 61, 79, 80, 82, 99, 100, 101, 102]"

Norman,L0,middle,15,8,7,0,0.8696,115,"[10, 18, 19, 37, 39, 56, 57, 58, 59, 77, 78, 79, 97, 98, 99]"

Norman,L0,middle,14,3,11,4,0.8772,114,"[10, 19, 20, 37, 38, 40, 57, 58, 59, 62, 79, 81, 98, 101]"

Norman,L0,middle,14,9,5,7,0.8772,114,"[9, 17, 18, 19, 24, 42, 59, 60, 62, 78, 80, 81, 98, 103]"

Norman,L0,middle,15,5,10,2,0.8696,115,"[9, 17, 18, 20, 38, 39, 56, 57, 58, 59, 77, 78, 79, 97, 100]"

Norman,L0,middle,18,9,9,1,0.8475,118,"[19, 31, 33, 34, 35, 37, 38, 39, 56, 57, 58, 59, 60, 79, 80, 97, 99, 101]"

Norman,L0,middle,15,2,13,1,0.8696,115,"[18, 20, 32, 37, 38, 39, 56, 57, 58, 59, 78, 79, 98, 99, 100]"

Norman,L0,middle,19,9,10,3,0.8403,119,"[18, 19, 20, 33, 36, 37, 38, 39, 41, 59, 61, 80, 81, 97, 100, 102, 103, 104, 106]"

Norman,L0,middle,15,10,5,0,0.8696,115,"[9, 17, 18, 19, 39, 56, 57, 58, 59, 77, 78, 79, 80, 97, 103]"

Norman,L0,middle,18,5,13,1,0.8475,118,"[18, 19, 31, 33, 34, 36, 37, 39, 41, 59, 60, 78, 79, 80, 81, 98, 100, 101]"

Norman,L0,middle,15,5,10,3,0.8696,115,"[10, 18, 21, 37, 38, 39, 57, 58, 59, 62, 79, 80, 81, 99, 101]"

Norman,L0,middle,17,7,10,5,0.8547,117,"[9, 19, 21, 37, 38, 39, 40, 41, 42, 59, 61, 63, 80, 82, 99, 100, 105]"

Norman,L0,middle,12,8,4,4,0.8929,112,"[9, 17, 18, 23, 39, 40, 57, 59, 61, 80, 98, 100]"

Norman,L0,middle,18,4,14,1,0.8475,118,"[18, 19, 20, 21, 34, 35, 36, 37, 38, 39, 40, 41, 60, 61, 65, 84, 101, 104]"

Norman,L0,middle,16,6,10,0,0.8621,116,"[18, 19, 31, 33, 34, 35, 37, 38, 39, 57, 58, 59, 77, 79, 96, 99]"

Norman,L0,middle,19,8,11,2,0.8403,119,"[18, 19, 20, 21, 22, 25, 40, 41, 43, 44, 62, 65, 84, 86, 102, 104, 105, 106, 108]"

Norman,L0,middle,18,8,10,1,0.8475,118,"[9, 18, 19, 37, 38, 39, 41, 42, 43, 60, 62, 63, 80, 82, 83, 85, 103, 104]"

Norman,L0,middle,17,15,2,1,0.8547,117,"[9, 17, 19, 37, 40, 58, 59, 60, 78, 81, 98, 99, 100, 101, 102, 103, 104]"

Norman,L0,middle,16,6,10,3,0.8621,116,"[9, 21, 37, 38, 39, 40, 57, 58, 59, 60, 77, 80, 97, 98, 99, 102]"

Norman,L0,middle,22,6,16,0,0.8197,122,"[18, 19, 31, 32, 34, 35, 36, 37, 38, 39, 40, 58, 59, 60, 61, 62, 81, 82, 83, 101, 103, 105]"

Norman,L0,middle,15,8,7,1,0.8696,115,"[9, 17, 19, 37, 38, 39, 41, 42, 62, 78, 81, 83, 100, 101, 102]"

Norman,L0,middle,13,4,9,2,0.885,113,"[9, 18, 19, 37, 38, 39, 56, 57, 58, 59, 78, 81, 99]"

Norman,L0,middle,16,10,6,0,0.8621,116,"[9, 17, 18, 20, 21, 22, 41, 43, 62, 63, 80, 82, 83, 101, 102, 103]"

Norman,L0,middle,15,4,11,0,0.8696,115,"[10, 18, 19, 37, 38, 39, 56, 57, 58, 59, 77, 78, 79, 97, 99]"

Norman,L0,middle,20,9,11,4,0.8333,120,"[10, 19, 20, 21, 38, 39, 40, 43, 61, 67, 84, 85, 101, 102, 103, 104, 105, 106, 107, 109]"

Norman,L0,middle,16,9,7,1,0.8621,116,"[19, 32, 33, 35, 36, 38, 39, 40, 60, 61, 80, 81, 97, 99, 100, 103]"

Norman,L0,middle,16,7,9,0,0.8621,116,"[9, 17, 18, 19, 38, 39, 56, 57, 58, 59, 77, 78, 79, 97, 98, 99]"

Norman,L0,middle,16,14,2,0,0.8621,116,"[9, 18, 19, 37, 39, 57, 59, 75, 76, 77, 79, 96, 97, 98, 99, 100]"

Norman,L0,middle,13,5,8,2,0.885,113,"[10, 18, 19, 37, 38, 39, 56, 57, 58, 61, 78, 79, 99]"

Norman,L0,middle,16,10,6,3,0.8621,116,"[18, 20, 33, 34, 35, 37, 38, 39, 57, 58, 61, 79, 96, 97, 98, 99]"

Norman,L0,middle,15,6,9,2,0.8696,115,"[10, 18, 20, 22, 41, 58, 59, 61, 78, 79, 80, 81, 83, 101, 102]"

Norman,L0,middle,20,5,15,0,0.8333,120,"[18, 19, 20, 33, 35, 36, 37, 38, 39, 40, 42, 60, 62, 80, 81, 82, 99, 101, 102, 103]"

Norman,L0,middle,16,14,2,3,0.8621,116,"[9, 20, 36, 40, 57, 58, 59, 60, 77, 78, 79, 80, 97, 98, 99, 103]"

Norman,L0,middle,16,11,5,0,0.8621,116,"[9, 17, 18, 19, 38, 40, 58, 60, 61, 77, 79, 80, 81, 99, 100, 101]"

Norman,L0,middle,13,12,1,9,0.885,113,"[9, 17, 23, 42, 61, 77, 78, 79, 80, 97, 98, 99, 100]"

Norman,L0,middle,17,7,10,2,0.8547,117,"[18, 19, 31, 32, 34, 36, 37, 38, 39, 58, 59, 77, 79, 97, 98, 100, 103]"

Norman,L0,middle,14,8,6,1,0.8772,114,"[19, 32, 35, 36, 37, 40, 57, 59, 77, 78, 80, 81, 97, 101]"

Norman,L0,middle,14,9,5,4,0.8772,114,"[18, 21, 35, 36, 37, 38, 39, 58, 60, 78, 82, 98, 99, 100]"

Norman,L0,middle,16,12,4,0,0.8621,116,"[9, 18, 19, 20, 38, 40, 57, 60, 76, 77, 78, 80, 99, 101, 102, 104]"

Norman,L0,middle,17,13,4,0,0.8547,117,"[9, 17, 18, 19, 37, 38, 39, 57, 58, 59, 60, 79, 80, 97, 98, 100, 101]"

Norman,L0,middle,15,9,6,2,0.8696,115,"[9, 18, 21, 38, 39, 40, 41, 59, 64, 82, 83, 84, 87, 105, 106]"

Norman,L0,middle,18,8,10,2,0.8475,118,"[20, 33, 34, 36, 38, 39, 41, 58, 59, 60, 61, 62, 80, 81, 83, 100, 102, 103]"

Norman,L0,middle,15,8,7,2,0.8696,115,"[11, 20, 36, 37, 40, 57, 58, 59, 77, 78, 79, 96, 98, 99, 100]"

Norman,L0,middle,18,10,8,3,0.8475,118,"[19, 22, 36, 41, 57, 59, 60, 61, 78, 82, 84, 99, 101, 102, 103, 104, 105, 106]"

Norman,L0,middle,15,10,5,2,0.8696,115,"[9, 18, 19, 37, 38, 40, 58, 59, 61, 77, 81, 98, 100, 101, 102]"

Norman,L0,middle,14,9,5,1,0.8772,114,"[9, 17, 18, 20, 38, 39, 42, 61, 77, 80, 81, 99, 100, 101]"

Norman,L0,middle,18,13,5,1,0.8475,118,"[20, 33, 34, 35, 36, 37, 38, 39, 56, 57, 58, 59, 60, 79, 80, 97, 99, 100]"

Norman,L0,middle,13,4,9,7,0.885,113,"[19, 32, 33, 34, 36, 37, 38, 41, 59, 62, 80, 85, 102]"

Norman,L0,middle,19,15,4,1,0.8403,119,"[9, 17, 18, 19, 37, 38, 39, 40, 41, 43, 61, 62, 63, 81, 82, 83, 100, 101, 103]"

Norman,L0,middle,15,6,9,5,0.8696,115,"[18, 19, 22, 37, 38, 39, 41, 59, 61, 80, 81, 98, 100, 101, 103]"

Norman,L0,middle,16,2,14,2,0.8621,116,"[18, 20, 33, 37, 38, 39, 56, 58, 59, 61, 80, 96, 98, 99, 100, 102]"

Norman,L0,middle,16,11,5,2,0.8621,116,"[19, 31, 34, 36, 37, 38, 39, 56, 59, 60, 78, 80, 81, 98, 100, 103]"

Norman,L0,middle,17,4,13,2,0.8547,117,"[18, 20, 32, 34, 35, 36, 37, 40, 58, 59, 60, 78, 79, 81, 98, 100, 102]"

Norman,L0,middle,12,7,5,11,0.8929,112,"[18, 22, 36, 37, 39, 57, 58, 64, 81, 96, 98, 100]"

Norman,L0,middle,16,13,3,6,0.8621,116,"[9, 17, 18, 19, 21, 23, 40, 43, 64, 82, 83, 100, 101, 102, 103, 106]"

Norman,L0,middle,15,5,10,0,0.8696,115,"[9, 18, 19, 37, 38, 39, 40, 57, 58, 59, 60, 79, 80, 99, 101]"

Norman,L0,middle,11,8,3,4,0.9009,111,"[12, 22, 39, 56, 58, 60, 76, 79, 96, 97, 99]"

Norman,L0,middle,17,8,9,1,0.8547,117,"[9, 17, 18, 19, 20, 39, 40, 41, 58, 60, 61, 63, 81, 82, 100, 101, 102]"

Norman,L0,middle,14,6,8,4,0.8772,114,"[18, 19, 22, 37, 39, 41, 60, 61, 79, 80, 82, 99, 100, 101]"

Norman,L0,middle,18,11,7,2,0.8475,118,"[18, 20, 32, 35, 36, 37, 38, 39, 56, 57, 58, 59, 60, 80, 97, 98, 99, 101]"

Norman,L0,middle,15,7,8,1,0.8696,115,"[9, 17, 18, 20, 38, 39, 56, 57, 59, 60, 77, 79, 80, 98, 100]"

Norman,L0,middle,20,8,12,4,0.8333,120,"[18, 20, 33, 34, 35, 36, 37, 38, 42, 60, 78, 79, 80, 83, 86, 102, 104, 105, 106, 107]"

Norman,L0,middle,19,9,10,2,0.8403,119,"[9, 17, 18, 19, 20, 38, 39, 40, 58, 59, 60, 61, 62, 63, 81, 83, 86, 104, 105]"

Norman,L0,middle,19,7,12,1,0.8403,119,"[19, 20, 21, 22, 23, 24, 38, 40, 41, 42, 43, 45, 64, 82, 84, 101, 102, 103, 104]"

Norman,L0,middle,14,7,7,4,0.8772,114,"[9, 17, 20, 37, 38, 40, 57, 58, 61, 78, 79, 96, 97, 99]"

Norman,L0,middle,16,8,8,3,0.8621,116,"[18, 20, 32, 34, 36, 38, 41, 58, 60, 61, 79, 80, 81, 97, 100, 101]"

Norman,L0,middle,21,8,13,0,0.8264,121,"[9, 17, 18, 20, 38, 39, 40, 57, 58, 59, 60, 78, 79, 80, 81, 82, 83, 101, 102, 104, 105]"

Norman,L0,middle,15,9,6,4,0.8696,115,"[9, 17, 18, 19, 20, 38, 39, 40, 42, 59, 61, 65, 82, 85, 105]"

Norman,L0,middle,17,11,6,2,0.8547,117,"[9, 18, 19, 20, 40, 42, 59, 61, 63, 80, 82, 83, 101, 102, 104, 105, 107]"

Norman,L0,middle,14,11,3,3,0.8772,114,"[10, 18, 19, 38, 40, 57, 58, 60, 76, 77, 78, 80, 99, 101]"

Norman,L0,middle,16,9,7,5,0.8621,116,"[18, 19, 24, 38, 40, 41, 42, 63, 64, 65, 83, 84, 86, 102, 104, 105]"

Norman,L0,middle,14,9,5,7,0.8772,114,"[9, 17, 20, 37, 39, 40, 42, 60, 61, 77, 79, 80, 86, 102]"

Norman,L0,middle,14,6,8,9,0.8772,114,"[11, 25, 44, 62, 63, 64, 65, 81, 83, 85, 103, 104, 105, 106]"

Norman,L0,middle,15,4,11,5,0.8696,115,"[18, 23, 37, 38, 39, 56, 57, 59, 77, 78, 80, 96, 98, 99, 100]"

Norman,L0,middle,14,8,6,3,0.8772,114,"[9, 17, 18, 20, 38, 40, 59, 75, 76, 79, 96, 97, 99, 102]"

Norman,L0,middle,16,6,10,3,0.8621,116,"[19, 31, 33, 35, 36, 37, 39, 41, 59, 60, 78, 80, 83, 99, 101, 102]"

Norman,L0,middle,16,8,8,5,0.8621,116,"[10, 19, 20, 21, 22, 23, 42, 43, 61, 64, 81, 84, 101, 102, 103, 107]"

Norman,L0,middle,15,5,10,2,0.8696,115,"[18, 19, 31, 32, 35, 36, 37, 38, 39, 41, 61, 79, 80, 99, 100]"

Norman,L0,middle,15,5,10,1,0.8696,115,"[9, 19, 36, 37, 39, 56, 57, 58, 59, 76, 79, 80, 81, 100, 102]"

Norman,L0,middle,15,11,4,2,0.8696,115,"[9, 17, 19, 37, 40, 58, 59, 60, 76, 77, 78, 79, 82, 100, 101]"

Norman,L0,middle,18,4,14,0,0.8475,118,"[18, 19, 31, 33, 34, 36, 37, 38, 39, 57, 60, 78, 79, 80, 97, 98, 100, 101]"

Norman,L0,middle,20,6,14,2,0.8333,120,"[9, 18, 20, 37, 38, 39, 40, 41, 58, 60, 61, 62, 81, 82, 83, 85, 86, 104, 105, 108]"

Norman,L0,middle,19,3,16,1,0.8403,119,"[18, 19, 20, 21, 34, 35, 37, 38, 39, 40, 41, 43, 44, 65, 84, 101, 102, 103, 105]"

Norman,L0,middle,18,4,14,2,0.8475,118,"[18, 20, 32, 34, 35, 36, 37, 38, 39, 57, 58, 60, 78, 79, 80, 98, 99, 101]"

Norman,L0,middle,15,7,8,3,0.8696,115,"[9, 17, 19, 37, 38, 39, 42, 60, 61, 77, 80, 82, 99, 100, 104]"

Norman,L0,middle,14,10,4,5,0.8772,114,"[9, 18, 19, 20, 38, 40, 57, 58, 60, 78, 79, 84, 100, 102]"

Norman,L0,middle,14,7,7,1,0.8772,114,"[10, 18, 20, 37, 40, 57, 59, 61, 77, 80, 81, 98, 100, 102]"

Norman,L0,middle,14,8,6,5,0.8772,114,"[18, 19, 24, 38, 40, 41, 58, 60, 62, 79, 82, 99, 100, 101]"

Norman,L0,middle,16,9,7,0,0.8621,116,"[9, 17, 19, 20, 38, 39, 40, 57, 58, 60, 77, 79, 80, 97, 98, 100]"

Norman,L0,middle,14,5,9,7,0.8772,114,"[9, 18, 20, 21, 26, 43, 60, 61, 63, 80, 83, 100, 101, 103]"

Norman,L0,middle,17,13,4,4,0.8547,117,"[9, 17, 18, 20, 38, 41, 58, 61, 77, 79, 80, 96, 97, 98, 99, 100, 101]"

Norman,L0,middle,15,5,10,7,0.8696,115,"[18, 19, 32, 34, 36, 38, 43, 60, 78, 80, 96, 97, 98, 99, 102]"

Norman,L0,middle,14,8,6,4,0.8772,114,"[9, 17, 18, 19, 20, 38, 39, 41, 58, 60, 64, 81, 99, 101]"

Norman,L0,middle,14,7,7,2,0.8772,114,"[10, 18, 19, 41, 59, 74, 77, 78, 79, 81, 82, 83, 101, 103]"

Norman,L0,middle,17,6,11,3,0.8547,117,"[18, 19, 21, 23, 27, 43, 45, 46, 49, 67, 85, 87, 102, 106, 107, 108, 110]"

Norman,L0,middle,16,8,8,2,0.8621,116,"[9, 20, 36, 37, 38, 39, 59, 60, 76, 77, 78, 79, 80, 99, 100, 102]"

Norman,L0,middle,15,5,10,6,0.8696,115,"[18, 20, 32, 34, 35, 38, 39, 44, 61, 79, 80, 96, 98, 99, 101]"

Norman,L0,middle,15,3,12,1,0.8696,115,"[19, 31, 35, 37, 38, 39, 59, 77, 79, 80, 81, 97, 98, 100, 102]"

Norman,L0,middle,7,3,4,17,0.9346,107,"[15, 26, 44, 62, 81, 98, 100]"

Norman,L0,middle,17,5,12,1,0.8547,117,"[18, 19, 20, 33, 34, 36, 37, 38, 39, 40, 58, 59, 60, 79, 81, 99, 100]"

Norman,L0,middle,14,12,2,2,0.8772,114,"[9, 18, 19, 37, 40, 57, 58, 59, 76, 77, 79, 96, 97, 100]"

Norman,L0,middle,18,10,8,3,0.8475,118,"[18, 19, 21, 34, 36, 37, 38, 39, 40, 41, 43, 61, 62, 80, 81, 83, 101, 102]"

Norman,L0,middle,13,6,7,4,0.885,113,"[9, 17, 18, 20, 39, 40, 63, 81, 97, 99, 100, 102, 103]"

Norman,L0,middle,18,1,17,0,0.8475,118,"[18, 19, 31, 33, 34, 35, 36, 37, 38, 39, 40, 58, 59, 60, 80, 97, 99, 100]"

Norman,L0,middle,18,3,15,0,0.8475,118,"[18, 19, 20, 34, 35, 36, 37, 38, 39, 40, 41, 59, 62, 80, 81, 82, 101, 102]"

Norman,L0,middle,15,8,7,3,0.8696,115,"[18, 19, 31, 32, 34, 37, 39, 56, 57, 58, 61, 79, 82, 99, 100]"

Norman,L0,middle,18,5,13,1,0.8475,118,"[18, 20, 32, 38, 39, 40, 41, 58, 59, 62, 81, 82, 83, 85, 101, 103, 104, 105]"

Norman,L0,middle,14,11,3,2,0.8772,114,"[9, 17, 18, 19, 21, 40, 57, 59, 60, 79, 82, 99, 100, 101]"

Norman,L0,middle,16,9,7,4,0.8621,116,"[10, 18, 20, 38, 40, 57, 58, 59, 61, 78, 79, 80, 98, 99, 100, 102]"

Norman,L0,middle,16,12,4,2,0.8621,116,"[10, 18, 21, 37, 38, 41, 58, 59, 60, 78, 79, 80, 97, 98, 99, 100]"

Norman,L0,middle,16,5,11,2,0.8621,116,"[19, 32, 33, 34, 35, 37, 38, 39, 41, 59, 60, 78, 79, 80, 99, 101]"

Norman,L0,middle,15,8,7,4,0.8696,115,"[9, 19, 36, 37, 41, 58, 59, 60, 61, 62, 64, 82, 83, 101, 104]"

Norman,L0,middle,18,11,7,2,0.8475,118,"[10, 18, 19, 37, 38, 39, 56, 58, 60, 77, 78, 80, 97, 98, 99, 100, 101, 104]"

Norman,L0,middle,18,11,7,7,0.8475,118,"[9, 17, 18, 19, 20, 25, 43, 61, 62, 79, 80, 82, 99, 100, 102, 103, 104, 106]"

Norman,L0,middle,19,14,5,2,0.8403,119,"[20, 33, 34, 36, 37, 38, 39, 40, 41, 59, 60, 62, 80, 81, 82, 101, 103, 105, 106]"

Norman,L0,middle,17,6,11,3,0.8547,117,"[19, 31, 33, 34, 37, 38, 39, 41, 59, 60, 61, 62, 63, 67, 86, 103, 105]"

Norman,L0,middle,14,7,7,6,0.8772,114,"[18, 19, 21, 34, 36, 37, 38, 39, 40, 62, 81, 86, 101, 103]"

Norman,L0,middle,18,5,13,2,0.8475,118,"[18, 19, 20, 33, 34, 35, 38, 39, 42, 60, 62, 80, 81, 83, 84, 101, 102, 104]"

Norman,L0,middle,18,7,11,5,0.8475,118,"[18, 19, 21, 35, 36, 38, 39, 42, 60, 62, 80, 81, 82, 83, 85, 102, 103, 106]"

Norman,L0,middle,17,12,5,3,0.8547,117,"[9, 21, 22, 24, 41, 42, 43, 44, 62, 64, 65, 83, 84, 87, 103, 104, 106]"

Norman,L0,middle,17,13,4,1,0.8547,117,"[9, 17, 18, 20, 38, 39, 56, 59, 76, 77, 78, 79, 96, 97, 98, 99, 115]"

Norman,L0,middle,12,4,8,4,0.8929,112,"[9, 17, 19, 41, 58, 60, 62, 78, 83, 100, 101, 102]"

Norman,L0,middle,18,13,5,1,0.8475,118,"[18, 19, 31, 32, 33, 35, 38, 39, 40, 58, 59, 60, 81, 97, 99, 100, 102, 103]"

Norman,L0,middle,17,3,14,5,0.8547,117,"[18, 20, 22, 36, 38, 39, 40, 42, 61, 64, 81, 85, 102, 103, 104, 105, 106]"

Norman,L0,middle,13,9,4,4,0.885,113,"[18, 21, 34, 36, 39, 41, 59, 60, 79, 80, 82, 100, 101]"

Norman,L0,middle,16,4,12,6,0.8621,116,"[18, 19, 31, 34, 35, 36, 37, 38, 39, 57, 58, 60, 78, 79, 85, 102]"

Norman,L0,middle,15,6,9,1,0.8696,115,"[10, 18, 20, 21, 38, 40, 42, 60, 61, 77, 79, 81, 98, 100, 101]"

Norman,L0,middle,14,7,7,2,0.8772,114,"[10, 18, 19, 20, 40, 58, 59, 61, 78, 79, 80, 81, 98, 102]"

Norman,L0,middle,15,10,5,5,0.8696,115,"[9, 17, 19, 37, 38, 41, 58, 59, 62, 78, 80, 96, 97, 99, 102]"

Norman,L0,middle,17,13,4,1,0.8547,117,"[18, 19, 31, 32, 33, 34, 35, 36, 37, 39, 57, 59, 77, 78, 79, 96, 100]"

Norman,L0,middle,16,10,6,2,0.8621,116,"[9, 18, 19, 21, 38, 39, 41, 59, 60, 79, 80, 96, 97, 98, 99, 100]"

Norman,L0,middle,15,5,10,3,0.8696,115,"[9, 17, 18, 21, 38, 39, 40, 61, 78, 79, 80, 82, 99, 101, 102]"

Norman,L0,middle,15,8,7,3,0.8696,115,"[11, 21, 38, 40, 41, 43, 60, 61, 62, 64, 83, 99, 100, 101, 104]"

Norman,L0,middle,13,5,8,5,0.885,113,"[18, 19, 31, 32, 33, 35, 41, 58, 60, 81, 97, 98, 99]"

Norman,L0,middle,11,5,6,5,0.9009,111,"[9, 17, 19, 38, 40, 59, 61, 77, 82, 98, 101]"

Norman,L0,middle,16,6,10,4,0.8621,116,"[9, 20, 36, 37, 38, 39, 40, 58, 59, 62, 65, 82, 84, 101, 102, 104]"

Norman,L0,middle,17,13,4,0,0.8547,117,"[9, 17, 18, 19, 37, 38, 39, 58, 59, 60, 77, 79, 80, 97, 98, 99, 100]"

Norman,L0,middle,15,6,9,2,0.8696,115,"[18, 19, 20, 22, 36, 37, 38, 41, 59, 60, 62, 80, 81, 99, 101]"

Norman,L0,middle,15,14,1,4,0.8696,115,"[9, 17, 18, 20, 39, 57, 59, 75, 77, 78, 79, 96, 97, 98, 102]"

Norman,L0,middle,14,5,9,0,0.8772,114,"[19, 31, 33, 36, 39, 57, 58, 59, 79, 94, 96, 97, 98, 99]"

Norman,L0,middle,17,8,9,3,0.8547,117,"[18, 19, 31, 33, 36, 39, 56, 57, 58, 60, 78, 79, 97, 98, 99, 100, 103]"

Norman,L0,middle,20,13,7,2,0.8333,120,"[18, 19, 31, 32, 33, 34, 35, 36, 38, 40, 58, 59, 77, 78, 79, 96, 98, 99, 115, 118]"

Norman,L0,middle,18,7,11,3,0.8475,118,"[18, 19, 20, 21, 22, 35, 38, 39, 40, 42, 61, 62, 82, 84, 85, 103, 105, 109]"

Norman,L0,middle,16,8,8,2,0.8621,116,"[9, 20, 21, 37, 38, 40, 41, 59, 62, 78, 81, 84, 100, 101, 102, 104]"

Norman,L0,middle,16,11,5,4,0.8621,116,"[18, 19, 31, 36, 37, 38, 39, 40, 42, 60, 61, 79, 81, 85, 102, 103]"

Norman,L0,middle,20,11,9,0,0.8333,120,"[18, 19, 20, 34, 35, 38, 39, 40, 41, 59, 60, 62, 63, 81, 82, 83, 84, 101, 103, 104]"

Norman,L0,middle,16,12,4,0,0.8621,116,"[19, 31, 34, 38, 39, 58, 59, 76, 77, 78, 79, 80, 96, 98, 99, 100]"

Norman,L0,middle,17,7,10,1,0.8547,117,"[18, 19, 21, 34, 37, 38, 42, 60, 61, 62, 80, 81, 82, 83, 99, 101, 103]"

Norman,L0,middle,10,7,3,6,0.9091,110,"[9, 20, 38, 40, 57, 59, 64, 83, 100, 101]"

Norman,L0,middle,15,8,7,1,0.8696,115,"[19, 31, 33, 34, 35, 36, 38, 39, 56, 57, 59, 78, 80, 98, 99]"

Norman,L0,middle,17,11,6,3,0.8547,117,"[20, 33, 34, 37, 38, 42, 59, 60, 61, 62, 80, 81, 82, 98, 101, 103, 104]"

Norman,L0,middle,15,7,8,3,0.8696,115,"[19, 21, 34, 36, 37, 39, 40, 57, 59, 61, 79, 81, 97, 99, 100]"

Norman,L0,middle,20,10,10,2,0.8333,120,"[9, 19, 20, 21, 23, 24, 27, 28, 29, 49, 50, 51, 70, 71, 72, 75, 93, 95, 111, 114]"

Norman,L0,middle,14,7,7,3,0.8772,114,"[10, 19, 37, 38, 41, 58, 60, 76, 77, 78, 80, 82, 100, 101]"

Norman,L0,middle,16,9,7,3,0.8621,116,"[9, 17, 19, 37, 38, 40, 57, 58, 59, 77, 78, 79, 96, 97, 98, 101]"

Norman,L0,middle,17,11,6,1,0.8547,117,"[9, 18, 19, 37, 40, 60, 77, 78, 79, 80, 82, 99, 100, 101, 103, 104, 105]"

Norman,L0,middle,16,10,6,3,0.8621,116,"[9, 17, 18, 19, 37, 40, 57, 58, 59, 61, 65, 82, 84, 101, 102, 103]"

Norman,L0,middle,16,9,7,3,0.8621,116,"[19, 20, 21, 34, 36, 37, 39, 40, 41, 59, 60, 63, 82, 85, 102, 104]"

Norman,L0,middle,15,8,7,3,0.8696,115,"[18, 19, 31, 32, 33, 34, 36, 37, 39, 57, 59, 77, 80, 98, 101]"

Norman,L0,middle,14,4,10,1,0.8772,114,"[11, 19, 36, 38, 39, 40, 59, 61, 62, 78, 83, 102, 103, 105]"

Norman,L0,middle,14,9,5,3,0.8772,114,"[12, 20, 36, 40, 43, 60, 62, 78, 81, 97, 98, 99, 100, 101]"

Norman,L0,middle,13,5,8,6,0.885,113,"[9, 17, 18, 23, 39, 56, 57, 58, 59, 77, 81, 98, 99]"

Norman,L0,middle,18,5,13,1,0.8475,118,"[18, 19, 31, 33, 34, 35, 37, 38, 39, 40, 41, 59, 61, 79, 81, 83, 102, 105]"

Norman,L0,middle,16,1,15,3,0.8621,116,"[11, 19, 20, 37, 38, 43, 60, 76, 78, 79, 80, 81, 82, 100, 101, 102]"

Norman,L0,middle,13,8,5,4,0.885,113,"[9, 18, 20, 21, 38, 44, 62, 78, 81, 98, 99, 100, 101]"

Norman,L0,middle,17,12,5,0,0.8547,117,"[19, 32, 33, 35, 36, 37, 38, 39, 40, 58, 59, 60, 79, 80, 98, 99, 100]"

Norman,L0,middle,17,8,9,3,0.8547,117,"[19, 31, 33, 35, 36, 37, 38, 39, 40, 41, 44, 62, 81, 84, 100, 102, 103]"

Norman,L0,middle,19,13,6,5,0.8403,119,"[19, 21, 34, 35, 36, 37, 38, 39, 40, 41, 42, 60, 61, 63, 66, 85, 102, 103, 105]"

Norman,L0,middle,18,7,11,0,0.8475,118,"[9, 17, 18, 20, 38, 39, 40, 41, 42, 43, 61, 63, 80, 82, 84, 102, 103, 104]"

Norman,L0,middle,16,12,4,2,0.8621,116,"[9, 17, 18, 19, 37, 38, 39, 40, 59, 61, 78, 79, 81, 99, 100, 101]"

Norman,L0,middle,15,10,5,2,0.8696,115,"[9, 17, 18, 19, 20, 38, 39, 40, 58, 61, 80, 81, 99, 100, 102]"

Norman,L0,middle,18,8,10,4,0.8475,118,"[18, 19, 31, 32, 33, 34, 35, 37, 38, 41, 59, 77, 78, 79, 80, 97, 100, 103]"

Norman,L0,middle,15,4,11,4,0.8696,115,"[18, 19, 31, 33, 34, 35, 36, 39, 42, 62, 80, 96, 98, 100, 101]"

Norman,L0,middle,16,9,7,3,0.8621,116,"[19, 20, 32, 35, 37, 38, 39, 40, 57, 58, 61, 79, 80, 84, 100, 102]"

Norman,L0,middle,12,5,7,5,0.8929,112,"[18, 19, 33, 34, 35, 37, 40, 59, 61, 79, 83, 100]"

Norman,L0,middle,14,2,12,2,0.8772,114,"[18, 19, 20, 38, 42, 58, 60, 77, 79, 80, 96, 97, 98, 101]"

Norman,L0,middle,18,9,9,5,0.8475,118,"[18, 19, 31, 32, 33, 34, 38, 43, 60, 78, 79, 81, 98, 99, 100, 101, 102, 103]"

Norman,L0,middle,17,9,8,0,0.8547,117,"[18, 19, 31, 33, 34, 35, 36, 39, 59, 77, 78, 79, 97, 98, 99, 100, 102]"

Norman,L0,middle,15,9,6,3,0.8696,115,"[9, 18, 19, 21, 40, 41, 58, 61, 77, 79, 81, 98, 100, 101, 105]"

Norman,L0,middle,17,11,6,2,0.8547,117,"[18, 22, 36, 38, 40, 41, 58, 59, 60, 61, 62, 80, 81, 82, 100, 101, 103]"

Norman,L0,middle,16,8,8,3,0.8621,116,"[9, 19, 20, 21, 38, 39, 41, 58, 60, 61, 78, 80, 81, 98, 100, 104]"

Norman,L0,middle,16,3,13,1,0.8621,116,"[11, 19, 20, 21, 22, 39, 41, 42, 61, 63, 80, 84, 85, 103, 104, 105]"

Norman,L0,middle,14,11,3,2,0.8772,114,"[9, 18, 19, 39, 40, 57, 58, 59, 60, 62, 80, 81, 98, 102]"

Norman,L0,middle,14,7,7,4,0.8772,114,"[18, 20, 32, 34, 35, 36, 38, 40, 57, 61, 79, 95, 97, 100]"

Norman,L0,middle,14,8,6,8,0.8772,114,"[20, 34, 35, 36, 38, 40, 41, 42, 60, 61, 67, 87, 103, 104]"

Norman,L0,middle,13,4,9,3,0.885,113,"[9, 17, 18, 19, 38, 39, 57, 62, 79, 96, 97, 98, 99]"

Norman,L0,middle,15,8,7,10,0.8696,115,"[9, 18, 20, 21, 38, 40, 41, 42, 59, 66, 83, 99, 100, 101, 107]"

Norman,L0,middle,14,9,5,1,0.8772,114,"[9, 17, 18, 20, 38, 39, 57, 59, 76, 78, 79, 81, 98, 101]"

Norman,L0,middle,12,7,5,2,0.8929,112,"[9, 17, 18, 20, 39, 58, 59, 77, 79, 96, 97, 100]"

Norman,L0,middle,15,10,5,5,0.8696,115,"[9, 17, 18, 20, 38, 39, 56, 57, 61, 77, 79, 96, 97, 98, 101]"

Norman,L0,middle,17,12,5,4,0.8547,117,"[18, 21, 34, 35, 37, 38, 40, 43, 60, 61, 62, 80, 81, 83, 99, 101, 103]"

Norman,L0,middle,13,8,5,2,0.885,113,"[18, 20, 32, 38, 40, 57, 58, 59, 60, 78, 79, 81, 101]"

Norman,L0,middle,14,10,4,1,0.8772,114,"[9, 17, 18, 19, 38, 39, 57, 60, 76, 78, 79, 96, 97, 100]"

Norman,L0,middle,11,5,6,4,0.9009,111,"[10, 20, 36, 37, 38, 40, 58, 59, 81, 97, 99]"

Norman,L0,middle,13,11,2,3,0.885,113,"[9, 17, 18, 19, 37, 38, 39, 40, 41, 64, 81, 99, 101]"

Norman,L0,middle,15,8,7,2,0.8696,115,"[10, 19, 36, 37, 40, 57, 59, 75, 76, 77, 79, 81, 99, 100, 102]"

Norman,L0,middle,18,3,15,3,0.8475,118,"[18, 19, 20, 21, 34, 35, 36, 38, 39, 40, 43, 61, 81, 83, 100, 101, 102, 105]"

Norman,L0,middle,17,12,5,0,0.8547,117,"[9, 17, 18, 19, 38, 39, 56, 58, 59, 77, 78, 79, 96, 97, 98, 99, 100]"

Norman,L0,middle,16,4,12,1,0.8621,116,"[18, 19, 20, 33, 34, 36, 38, 39, 41, 59, 60, 61, 62, 80, 83, 102]"

Norman,L0,middle,19,11,8,1,0.8403,119,"[20, 33, 34, 36, 37, 39, 41, 58, 59, 60, 61, 62, 63, 81, 82, 83, 100, 102, 103]"

Norman,L0,middle,15,10,5,3,0.8696,115,"[18, 20, 34, 35, 37, 38, 39, 56, 57, 60, 78, 79, 82, 98, 100]"

Norman,L0,middle,15,6,9,1,0.8696,115,"[18, 19, 31, 32, 33, 34, 35, 38, 39, 59, 77, 78, 79, 98, 100]"

Norman,L0,middle,19,13,6,0,0.8403,119,"[18, 19, 31, 32, 33, 34, 35, 37, 39, 40, 42, 43, 61, 63, 82, 83, 100, 102, 103]"

Norman,L0,middle,12,7,5,8,0.8929,112,"[12, 21, 37, 41, 58, 61, 77, 79, 81, 98, 99, 102]"

Norman,L0,middle,18,10,8,1,0.8475,118,"[9, 17, 18, 19, 37, 38, 39, 40, 58, 59, 60, 62, 81, 82, 100, 101, 102, 103]"

Norman,L0,middle,15,6,9,3,0.8696,115,"[19, 20, 32, 34, 36, 37, 39, 40, 43, 62, 80, 81, 97, 99, 101]"

Norman,L0,middle,21,9,12,0,0.8264,121,"[18, 19, 31, 32, 35, 39, 57, 58, 59, 61, 62, 63, 81, 82, 83, 100, 102, 104, 105, 106, 107]"

Norman,L0,middle,15,6,9,0,0.8696,115,"[10, 18, 19, 20, 38, 39, 40, 58, 61, 77, 80, 81, 98, 100, 102]"

Norman,L0,middle,16,13,3,0,0.8621,116,"[9, 17, 19, 37, 39, 57, 58, 59, 76, 77, 78, 79, 96, 97, 98, 102]"

Norman,L0,middle,16,8,8,2,0.8621,116,"[9, 17, 18, 19, 37, 38, 40, 57, 58, 59, 77, 78, 80, 98, 100, 101]"

Norman,L0,middle,20,8,12,2,0.8333,120,"[19, 32, 34, 35, 37, 38, 39, 57, 58, 59, 60, 61, 62, 63, 81, 82, 86, 105, 106, 107]"

Norman,L0,middle,20,15,5,1,0.8333,120,"[9, 17, 18, 20, 38, 39, 41, 58, 59, 61, 62, 79, 81, 82, 83, 84, 101, 102, 103, 104]"

Norman,L0,middle,15,5,10,4,0.8696,115,"[9, 17, 18, 21, 38, 39, 40, 41, 58, 62, 81, 98, 99, 100, 103]"

Norman,L0,middle,15,11,4,4,0.8696,115,"[19, 33, 37, 38, 39, 41, 59, 63, 80, 81, 82, 99, 100, 101, 102]"

Norman,L0,middle,17,12,5,1,0.8547,117,"[9, 17, 18, 20, 21, 39, 41, 42, 44, 64, 81, 83, 85, 101, 102, 103, 104]"

Norman,L0,middle,18,9,9,3,0.8475,118,"[10, 19, 36, 38, 39, 41, 58, 59, 61, 62, 63, 80, 81, 83, 84, 85, 104, 108]"

Norman,L0,middle,15,6,9,1,0.8696,115,"[10, 18, 19, 20, 38, 39, 40, 41, 61, 78, 80, 81, 98, 100, 102]"

Norman,L0,middle,15,12,3,4,0.8696,115,"[19, 33, 34, 35, 37, 38, 39, 56, 57, 58, 61, 80, 96, 98, 100]"

Norman,L0,middle,17,8,9,6,0.8547,117,"[19, 31, 33, 34, 35, 36, 37, 39, 56, 57, 58, 59, 60, 63, 81, 84, 104]"

Norman,L0,middle,18,7,11,4,0.8475,118,"[18, 19, 21, 34, 37, 38, 39, 40, 41, 42, 44, 62, 63, 65, 85, 102, 103, 104]"

Norman,L0,middle,15,9,6,3,0.8696,115,"[9, 17, 18, 20, 38, 40, 57, 59, 76, 77, 78, 79, 82, 100, 101]"

Norman,L0,middle,13,7,6,3,0.885,113,"[18, 22, 36, 37, 40, 58, 59, 61, 80, 81, 97, 100, 102]"

Norman,L0,middle,13,10,3,5,0.885,113,"[9, 17, 18, 19, 20, 40, 58, 60, 61, 77, 81, 86, 105]"

Norman,L0,middle,17,2,15,2,0.8547,117,"[19, 20, 21, 34, 37, 38, 40, 41, 59, 60, 64, 82, 98, 99, 100, 101, 102]"

Norman,L0,middle,18,10,8,3,0.8475,118,"[20, 33, 34, 36, 39, 40, 57, 58, 59, 64, 81, 83, 84, 85, 101, 103, 104, 105]"

Norman,L0,middle,13,7,6,3,0.885,113,"[9, 20, 36, 37, 39, 42, 59, 60, 61, 63, 84, 103, 104]"

Norman,L0,middle,15,4,11,4,0.8696,115,"[10, 18, 19, 37, 38, 40, 58, 61, 77, 80, 97, 98, 99, 100, 101]"

Norman,L0,middle,13,3,10,3,0.885,113,"[10, 19, 36, 37, 39, 56, 58, 61, 77, 80, 97, 98, 100]"

Norman,L0,middle,18,17,1,5,0.8475,118,"[20, 21, 34, 35, 36, 37, 38, 39, 40, 41, 59, 60, 63, 81, 82, 84, 101, 106]"

Norman,L0,middle,15,8,7,2,0.8696,115,"[20, 33, 36, 37, 39, 56, 57, 58, 59, 77, 78, 80, 96, 98, 99]"

Norman,L0,middle,17,12,5,0,0.8547,117,"[18, 19, 33, 36, 37, 38, 39, 40, 41, 60, 61, 79, 81, 97, 99, 100, 101]"

Norman,L0,middle,17,10,7,3,0.8547,117,"[9, 17, 18, 19, 20, 23, 40, 41, 59, 60, 61, 79, 80, 81, 98, 99, 102]"

Norman,L0,middle,21,14,7,1,0.8264,121,"[9, 17, 18, 19, 37, 40, 41, 42, 44, 62, 64, 66, 67, 85, 86, 87, 88, 89, 106, 107, 110]"

Norman,L0,middle,15,9,6,3,0.8696,115,"[10, 18, 20, 38, 39, 56, 59, 76, 77, 78, 79, 96, 97, 98, 101]"

Norman,L0,middle,13,12,1,11,0.885,113,"[13, 25, 42, 59, 60, 77, 78, 79, 80, 83, 99, 100, 101]"

Norman,L0,middle,16,13,3,0,0.8621,116,"[11, 20, 38, 40, 57, 58, 59, 60, 76, 77, 78, 79, 80, 97, 99, 101]"

Norman,L0,middle,15,6,9,0,0.8696,115,"[9, 18, 19, 37, 39, 56, 57, 59, 60, 77, 81, 98, 99, 100, 101]"

Norman,L0,middle,14,7,7,1,0.8772,114,"[18, 19, 33, 35, 37, 39, 60, 77, 80, 81, 97, 99, 100, 102]"

Norman,L0,middle,21,11,10,0,0.8264,121,"[19, 31, 34, 35, 36, 37, 39, 56, 57, 58, 59, 77, 78, 79, 80, 81, 82, 84, 85, 103, 105]"

Norman,L0,middle,15,9,6,0,0.8696,115,"[19, 31, 33, 35, 36, 37, 38, 40, 57, 61, 79, 81, 97, 99, 101]"

Norman,L0,middle,15,5,10,0,0.8696,115,"[18, 19, 20, 34, 35, 36, 37, 40, 57, 59, 60, 79, 80, 98, 100]"

Norman,L0,middle,14,6,8,1,0.8772,114,"[18, 19, 33, 34, 37, 38, 39, 60, 79, 80, 82, 98, 99, 102]"

Norman,L0,middle,15,6,9,1,0.8696,115,"[18, 19, 32, 35, 36, 38, 39, 56, 58, 59, 60, 61, 82, 98, 101]"

Norman,L0,middle,12,6,6,4,0.8929,112,"[19, 32, 33, 35, 37, 39, 57, 58, 60, 78, 82, 99]"

Norman,L0,middle,15,11,4,4,0.8696,115,"[18, 21, 34, 35, 37, 38, 40, 59, 61, 63, 82, 84, 100, 102, 105]"

Norman,L0,middle,14,3,11,2,0.8772,114,"[19, 31, 33, 34, 38, 41, 58, 60, 79, 80, 96, 97, 99, 100]"

Norman,L0,middle,17,11,6,0,0.8547,117,"[18, 19, 31, 32, 33, 35, 39, 56, 57, 58, 59, 60, 78, 79, 80, 99, 100]"

Norman,L0,middle,13,5,8,2,0.885,113,"[9, 19, 21, 38, 41, 42, 60, 61, 62, 82, 100, 101, 104]"

Norman,L0,middle,18,10,8,3,0.8475,118,"[18, 19, 31, 33, 35, 36, 37, 39, 40, 58, 61, 79, 80, 82, 99, 100, 101, 104]"

Norman,L0,middle,18,9,9,2,0.8475,118,"[18, 22, 36, 37, 39, 41, 58, 60, 62, 79, 81, 82, 84, 100, 102, 104, 105, 106]"

Norman,L0,middle,13,6,7,9,0.885,113,"[21, 34, 35, 37, 38, 39, 56, 58, 59, 76, 78, 84, 101]"

Norman,L0,middle,16,8,8,4,0.8621,116,"[18, 22, 36, 37, 39, 57, 58, 59, 61, 80, 81, 97, 99, 101, 102, 104]"

Norman,L0,middle,14,7,7,6,0.8772,114,"[9, 17, 19, 38, 42, 59, 77, 78, 79, 81, 98, 99, 100, 104]"

Norman,L0,middle,15,7,8,4,0.8696,115,"[12, 20, 36, 37, 38, 40, 57, 60, 76, 77, 80, 96, 97, 98, 100]"

Norman,L0,middle,18,10,8,2,0.8475,118,"[9, 17, 18, 21, 38, 39, 40, 57, 58, 60, 77, 79, 80, 81, 82, 100, 101, 102]"

Norman,L0,middle,12,7,5,4,0.8929,112,"[20, 33, 35, 38, 39, 41, 58, 59, 61, 84, 100, 102]"

Norman,L0,middle,11,4,7,7,0.9009,111,"[18, 24, 40, 58, 59, 77, 79, 94, 97, 98, 100]"

Norman,L0,middle,17,6,11,5,0.8547,117,"[12, 20, 36, 37, 38, 39, 40, 58, 60, 77, 78, 80, 81, 83, 101, 102, 106]"

Norman,L0,middle,17,7,10,0,0.8547,117,"[18, 19, 31, 32, 33, 35, 36, 38, 39, 58, 59, 78, 79, 96, 97, 99, 100]"

Norman,L0,middle,15,6,9,1,0.8696,115,"[18, 21, 36, 37, 38, 39, 40, 58, 59, 60, 78, 79, 80, 82, 102]"

Norman,L0,middle,13,7,6,1,0.885,113,"[9, 17, 18, 19, 37, 40, 57, 58, 59, 76, 79, 96, 99]"

Norman,L0,middle,14,3,11,5,0.8772,114,"[10, 20, 36, 37, 39, 41, 61, 77, 79, 80, 81, 83, 101, 104]"

Norman,L0,middle,17,14,3,5,0.8547,117,"[9, 17, 18, 20, 39, 56, 58, 60, 76, 77, 78, 80, 97, 98, 99, 100, 103]"

Norman,L0,middle,15,14,1,0,0.8696,115,"[9, 17, 18, 19, 39, 57, 58, 59, 76, 77, 78, 79, 97, 98, 99]"

Norman,L0,middle,14,6,8,7,0.8772,114,"[9, 17, 18, 20, 38, 39, 56, 57, 58, 60, 78, 79, 82, 103]"

Norman,L0,middle,18,10,8,4,0.8475,118,"[18, 19, 31, 33, 35, 37, 40, 58, 59, 61, 79, 80, 81, 82, 99, 100, 101, 104]"

Norman,L0,middle,15,7,8,5,0.8696,115,"[18, 19, 31, 32, 33, 36, 39, 56, 57, 62, 81, 98, 99, 100, 101]"

Norman,L0,middle,16,5,11,2,0.8621,116,"[10, 20, 37, 40, 59, 74, 76, 77, 78, 79, 95, 96, 97, 99, 100, 102]"

Norman,L0,middle,15,9,6,3,0.8696,115,"[19, 31, 34, 38, 41, 57, 58, 59, 78, 79, 95, 96, 97, 98, 100]"

Norman,L0,middle,15,12,3,1,0.8696,115,"[19, 21, 34, 35, 36, 37, 38, 39, 40, 60, 79, 80, 96, 98, 100]"

Norman,L0,middle,17,1,16,2,0.8547,117,"[18, 19, 32, 34, 38, 39, 56, 58, 59, 60, 61, 62, 63, 83, 100, 102, 105]"

Norman,L0,middle,14,4,10,3,0.8772,114,"[19, 31, 33, 34, 37, 39, 56, 57, 62, 79, 97, 99, 100, 101]"

Norman,L0,middle,19,7,12,2,0.8403,119,"[18, 20, 32, 34, 35, 36, 37, 39, 40, 58, 60, 62, 81, 82, 99, 102, 103, 104, 106]"

Norman,L0,middle,14,2,12,2,0.8772,114,"[10, 18, 21, 38, 40, 60, 61, 62, 63, 80, 81, 82, 83, 103]"

Norman,L0,middle,16,5,11,5,0.8621,116,"[18, 19, 20, 33, 34, 35, 38, 41, 59, 60, 63, 83, 99, 100, 102, 104]"

Norman,L0,middle,17,8,9,0,0.8547,117,"[9, 17, 18, 20, 38, 39, 40, 59, 60, 61, 79, 81, 82, 100, 101, 102, 103]"

Norman,L0,middle,13,8,5,6,0.885,113,"[11, 22, 39, 56, 57, 58, 59, 76, 78, 80, 97, 98, 101]"

Norman,L0,middle,16,5,11,3,0.8621,116,"[18, 19, 33, 34, 35, 36, 37, 38, 39, 57, 58, 60, 78, 80, 98, 100]"

Norman,L0,middle,18,13,5,7,0.8475,118,"[10, 18, 19, 20, 21, 24, 41, 43, 61, 62, 63, 80, 81, 82, 83, 84, 87, 107]"

Norman,L0,middle,16,9,7,1,0.8621,116,"[18, 20, 32, 34, 35, 38, 39, 56, 57, 58, 59, 77, 79, 97, 98, 99]"

Norman,L0,middle,16,11,5,4,0.8621,116,"[9, 17, 20, 38, 40, 57, 58, 59, 61, 77, 79, 80, 81, 99, 100, 102]"

Norman,L0,middle,17,2,15,4,0.8547,117,"[18, 19, 20, 33, 34, 35, 36, 37, 38, 39, 41, 42, 63, 81, 84, 102, 104]"

Norman,L0,middle,16,5,11,8,0.8621,116,"[18, 19, 21, 35, 36, 38, 39, 40, 42, 60, 64, 85, 102, 103, 104, 105]"

Norman,L0,middle,18,8,10,0,0.8475,118,"[19, 20, 33, 35, 37, 38, 39, 41, 61, 62, 80, 81, 82, 83, 84, 102, 105, 106]"

Norman,L0,middle,15,9,6,1,0.8696,115,"[20, 36, 37, 38, 39, 56, 58, 59, 77, 79, 95, 96, 97, 98, 99]"

Norman,L0,middle,15,6,9,2,0.8696,115,"[18, 19, 32, 33, 34, 35, 36, 38, 39, 57, 58, 60, 80, 82, 102]"

Norman,L0,middle,18,8,10,2,0.8475,118,"[18, 20, 21, 36, 37, 39, 40, 41, 59, 60, 61, 79, 80, 82, 99, 100, 102, 105]"

Norman,L0,middle,13,5,8,2,0.885,113,"[10, 18, 19, 37, 39, 40, 58, 61, 77, 79, 81, 98, 100]"

Norman,L0,middle,15,8,7,2,0.8696,115,"[18, 19, 31, 32, 33, 34, 35, 36, 38, 40, 60, 79, 80, 99, 100]"

Norman,L0,middle,15,8,7,6,0.8696,115,"[9, 18, 19, 22, 38, 40, 41, 42, 59, 65, 83, 100, 101, 102, 104]"

Norman,L0,middle,15,10,5,2,0.8696,115,"[18, 20, 32, 34, 37, 38, 39, 56, 57, 58, 59, 78, 80, 97, 99]"

Norman,L0,middle,15,10,5,1,0.8696,115,"[9, 17, 18, 19, 38, 41, 60, 61, 62, 78, 81, 83, 100, 101, 102]"

Norman,L0,middle,15,6,9,2,0.8696,115,"[18, 20, 33, 38, 40, 57, 58, 59, 78, 79, 95, 96, 98, 99, 100]"

Norman,L0,middle,17,6,11,1,0.8547,117,"[19, 20, 35, 36, 37, 39, 40, 57, 58, 59, 60, 78, 79, 80, 82, 100, 101]"

Norman,L0,middle,17,8,9,0,0.8547,117,"[9, 17, 18, 19, 38, 39, 56, 57, 58, 59, 77, 78, 79, 97, 98, 99, 100]"

Norman,L0,middle,14,11,3,5,0.8772,114,"[9, 18, 19, 23, 39, 41, 58, 59, 61, 77, 79, 80, 99, 100]"

Norman,L0,middle,18,10,8,0,0.8475,118,"[18, 19, 31, 32, 33, 36, 37, 38, 39, 57, 58, 59, 60, 80, 81, 99, 100, 101]"

Norman,L0,middle,11,10,1,6,0.9009,111,"[12, 22, 39, 56, 57, 58, 59, 80, 96, 98, 101]"

Norman,L0,middle,13,7,6,5,0.885,113,"[18, 22, 37, 38, 40, 58, 59, 60, 78, 81, 97, 98, 100]"

Norman,L0,middle,18,12,6,3,0.8475,118,"[18, 19, 31, 32, 33, 34, 35, 36, 39, 57, 58, 59, 77, 78, 81, 98, 100, 104]"

Norman,L0,middle,16,11,5,3,0.8621,116,"[9, 17, 18, 20, 40, 42, 59, 60, 63, 80, 81, 82, 83, 101, 103, 104]"

Norman,L0,middle,18,14,4,2,0.8475,118,"[20, 33, 34, 35, 36, 37, 38, 39, 40, 58, 59, 60, 61, 79, 80, 81, 101, 103]"

Norman,L0,middle,15,7,8,2,0.8696,115,"[18, 19, 32, 34, 35, 37, 38, 40, 41, 60, 62, 81, 82, 98, 103]"

Norman,L0,middle,18,12,6,8,0.8475,118,"[18, 22, 36, 38, 40, 43, 59, 60, 66, 83, 98, 100, 101, 102, 103, 104, 105, 106]"

Norman,L0,middle,16,9,7,4,0.8621,116,"[10, 19, 20, 21, 24, 44, 61, 63, 65, 81, 83, 84, 101, 102, 103, 105]"

Norman,L0,middle,16,8,8,6,0.8621,116,"[9, 17, 20, 21, 24, 42, 43, 45, 46, 48, 68, 85, 90, 106, 107, 108]"

Norman,L0,middle,17,13,4,1,0.8547,117,"[9, 17, 18, 19, 38, 39, 57, 60, 76, 77, 78, 79, 96, 97, 98, 99, 115]"

Norman,L0,middle,15,4,11,1,0.8696,115,"[9, 18, 19, 21, 38, 39, 40, 57, 58, 59, 60, 80, 98, 100, 101]"

Norman,L0,middle,19,4,15,0,0.8403,119,"[18, 19, 31, 32, 34, 35, 36, 38, 39, 40, 41, 60, 61, 79, 80, 81, 99, 100, 101]"

Norman,L0,middle,17,13,4,1,0.8547,117,"[18, 19, 31, 33, 36, 37, 38, 40, 57, 58, 59, 77, 80, 97, 98, 99, 100]"

Norman,L0,middle,18,10,8,1,0.8475,118,"[19, 20, 32, 34, 35, 36, 37, 39, 40, 58, 59, 60, 80, 81, 83, 100, 102, 106]"

Norman,L0,middle,20,10,10,2,0.8333,120,"[18, 20, 32, 35, 37, 38, 39, 56, 57, 58, 61, 62, 63, 66, 84, 85, 86, 104, 106, 107]"

Norman,L0,middle,18,6,12,2,0.8475,118,"[10, 20, 37, 38, 39, 56, 57, 58, 59, 60, 61, 79, 80, 81, 82, 100, 101, 104]"

Norman,L0,middle,18,13,5,1,0.8475,118,"[9, 17, 18, 19, 20, 38, 40, 41, 58, 60, 61, 63, 80, 82, 99, 100, 101, 102]"

Norman,L0,middle,16,5,11,1,0.8621,116,"[18, 20, 32, 34, 36, 37, 38, 39, 41, 59, 61, 82, 99, 100, 101, 102]"

Norman,L0,middle,19,12,7,0,0.8403,119,"[19, 32, 33, 34, 36, 37, 38, 39, 56, 57, 58, 59, 77, 78, 79, 80, 99, 100, 101]"

Norman,L0,middle,14,11,3,3,0.8772,114,"[9, 18, 20, 39, 56, 57, 58, 60, 76, 77, 78, 81, 98, 102]"

Norman,L0,middle,15,9,6,4,0.8696,115,"[9, 17, 18, 19, 37, 39, 40, 41, 58, 60, 63, 80, 81, 100, 103]"

Norman,L0,middle,14,12,2,3,0.8772,114,"[19, 31, 34, 36, 37, 38, 39, 56, 57, 61, 79, 80, 97, 101]"

Norman,L0,middle,17,8,9,3,0.8547,117,"[9, 17, 18, 20, 21, 42, 59, 62, 79, 80, 81, 98, 99, 100, 101, 102, 104]"

Norman,L0,middle,17,10,7,0,0.8547,117,"[19, 32, 33, 34, 35, 36, 39, 40, 57, 58, 60, 79, 80, 97, 98, 100, 101]"

Norman,L0,middle,21,6,15,1,0.8264,121,"[18, 19, 20, 21, 35, 36, 37, 39, 40, 42, 60, 61, 62, 80, 81, 82, 84, 86, 87, 105, 107]"

Norman,L50,middle,15,13,2,2,0.8696,115,"[9, 17, 18, 19, 36, 37, 38, 39, 56, 57, 58, 61, 79, 98, 99]"

Norman,L50,middle,19,10,9,3,0.8403,119,"[20, 31, 33, 35, 36, 37, 38, 41, 58, 59, 60, 78, 80, 96, 97, 99, 100, 101, 103]"

Norman,L50,middle,17,5,12,3,0.8547,117,"[9, 17, 18, 22, 38, 39, 40, 41, 58, 59, 60, 61, 78, 80, 81, 100, 101]"

Norman,L50,middle,16,1,15,2,0.8621,116,"[18, 19, 32, 33, 39, 40, 41, 58, 59, 62, 80, 81, 98, 99, 100, 102]"

Norman,L50,middle,18,8,10,2,0.8475,118,"[18, 20, 32, 35, 36, 37, 40, 57, 58, 59, 61, 78, 81, 97, 98, 100, 101, 103]"

Norman,L50,middle,18,9,9,4,0.8475,118,"[10, 19, 20, 36, 37, 38, 43, 60, 61, 78, 79, 81, 82, 99, 101, 102, 103, 105]"

Norman,L50,middle,21,9,12,0,0.8264,121,"[18, 19, 30, 34, 35, 37, 39, 56, 57, 58, 59, 60, 61, 79, 80, 81, 98, 99, 100, 101, 119]"

Norman,L50,middle,17,13,4,3,0.8547,117,"[19, 20, 33, 35, 36, 37, 39, 40, 43, 61, 78, 79, 80, 82, 98, 100, 101]"

Norman,L50,middle,19,11,8,1,0.8403,119,"[9, 18, 20, 36, 37, 38, 41, 58, 59, 60, 61, 78, 79, 81, 82, 99, 100, 101, 102]"

Norman,L50,middle,18,10,8,4,0.8475,118,"[19, 20, 35, 36, 38, 40, 57, 59, 63, 80, 82, 83, 84, 101, 102, 103, 104, 107]"

Norman,L50,middle,17,9,8,3,0.8547,117,"[18, 19, 30, 31, 33, 34, 35, 36, 37, 38, 39, 57, 62, 79, 96, 97, 99]"

Norman,L50,middle,16,4,12,4,0.8621,116,"[11, 20, 36, 37, 38, 39, 40, 57, 58, 59, 63, 81, 84, 101, 102, 106]"

Norman,L50,middle,16,7,9,1,0.8621,116,"[10, 18, 19, 20, 40, 41, 42, 43, 63, 79, 80, 81, 83, 84, 85, 106]"

Norman,L50,middle,25,11,14,0,0.8,125,"[18, 19, 21, 22, 34, 37, 38, 40, 41, 42, 43, 44, 63, 64, 65, 66, 67, 68, 70, 71, 72, 91, 92, 110, 112]"

Norman,L50,middle,17,12,5,2,0.8547,117,"[9, 17, 20, 36, 39, 41, 58, 60, 76, 77, 78, 80, 96, 97, 101, 102, 103]"

Norman,L50,middle,17,9,8,2,0.8547,117,"[9, 18, 19, 36, 37, 38, 39, 56, 57, 59, 61, 78, 79, 80, 81, 98, 103]"

Norman,L50,middle,13,5,8,4,0.885,113,"[9, 18, 21, 37, 41, 42, 44, 61, 63, 82, 85, 101, 103]"

Norman,L50,middle,15,9,6,2,0.8696,115,"[9, 17, 18, 20, 37, 38, 39, 57, 60, 76, 77, 79, 98, 99, 100]"

Norman,L50,middle,16,7,9,1,0.8621,116,"[10, 20, 36, 37, 39, 40, 57, 58, 59, 61, 78, 79, 80, 97, 98, 100]"

Norman,L50,middle,17,8,9,1,0.8547,117,"[13, 20, 36, 37, 38, 39, 40, 42, 59, 61, 78, 79, 80, 82, 98, 100, 102]"

Norman,L50,middle,15,6,9,4,0.8696,115,"[10, 19, 20, 38, 41, 42, 59, 61, 63, 79, 80, 83, 99, 102, 106]"

Norman,L50,middle,15,9,6,4,0.8696,115,"[18, 21, 35, 37, 38, 39, 55, 58, 60, 77, 79, 96, 97, 98, 100]"

Norman,L50,middle,18,12,6,3,0.8475,118,"[9, 17, 18, 19, 36, 37, 38, 39, 56, 58, 60, 61, 78, 79, 80, 81, 85, 102]"

Norman,L50,middle,19,12,7,2,0.8403,119,"[9, 17, 18, 20, 37, 38, 39, 56, 57, 58, 60, 61, 62, 79, 81, 82, 99, 101, 103]"

Norman,L50,middle,16,6,10,0,0.8621,116,"[18, 19, 30, 31, 33, 36, 37, 38, 39, 58, 59, 77, 79, 95, 96, 99]"

Norman,L50,middle,17,13,4,1,0.8547,117,"[20, 32, 35, 36, 39, 57, 59, 60, 77, 79, 80, 96, 97, 98, 99, 100, 101]"

Norman,L50,middle,17,13,4,0,0.8547,117,"[19, 30, 31, 32, 35, 36, 39, 56, 57, 59, 79, 95, 96, 97, 98, 99, 100]"

Norman,L50,middle,14,12,2,3,0.8772,114,"[11, 22, 38, 40, 41, 42, 61, 64, 80, 81, 83, 100, 101, 102]"

Norman,L50,middle,15,4,11,2,0.8696,115,"[9, 18, 19, 36, 38, 39, 56, 57, 58, 59, 64, 82, 83, 84, 104]"

Norman,L50,middle,18,4,14,2,0.8475,118,"[18, 20, 32, 33, 34, 35, 36, 37, 38, 39, 40, 60, 78, 79, 81, 99, 100, 101]"

Norman,L50,middle,20,5,15,1,0.8333,120,"[18, 20, 32, 33, 35, 36, 37, 38, 39, 40, 58, 59, 60, 78, 79, 81, 99, 100, 101, 118]"

Norman,L50,middle,15,5,10,1,0.8696,115,"[9, 18, 20, 37, 38, 40, 41, 62, 79, 80, 81, 82, 84, 102, 103]"

Norman,L50,middle,17,15,2,3,0.8547,117,"[9, 17, 19, 20, 21, 38, 40, 43, 60, 61, 78, 79, 82, 98, 99, 100, 101]"

Norman,L50,middle,18,6,12,3,0.8475,118,"[11, 20, 22, 38, 39, 40, 41, 42, 59, 60, 61, 62, 80, 81, 83, 100, 101, 103]"

Norman,L50,middle,16,11,5,3,0.8621,116,"[11, 19, 20, 36, 39, 41, 57, 59, 60, 61, 63, 80, 81, 85, 102, 104]"

Norman,L50,middle,15,7,8,4,0.8696,115,"[9, 17, 18, 19, 21, 24, 41, 42, 63, 80, 81, 82, 99, 101, 103]"

Norman,L50,middle,16,10,6,1,0.8621,116,"[9, 17, 18, 19, 37, 39, 56, 60, 61, 62, 79, 81, 82, 83, 100, 104]"

Norman,L50,middle,23,10,13,0,0.813,123,"[19, 30, 32, 33, 34, 35, 37, 38, 39, 57, 58, 59, 60, 78, 79, 80, 97, 99, 100, 116, 119, 120, 121]"

Norman,L50,middle,17,10,7,2,0.8547,117,"[9, 18, 19, 22, 38, 40, 56, 58, 60, 61, 63, 64, 81, 83, 84, 103, 104]"

Norman,L50,middle,15,5,10,0,0.8696,115,"[10, 18, 19, 38, 39, 56, 57, 58, 59, 60, 78, 80, 96, 99, 101]"

Norman,L50,middle,17,9,8,2,0.8547,117,"[9, 17, 18, 21, 38, 39, 40, 58, 60, 76, 77, 79, 80, 81, 99, 100, 102]"

Norman,L50,middle,17,12,5,0,0.8547,117,"[9, 17, 19, 37, 38, 39, 58, 59, 75, 76, 78, 79, 80, 97, 98, 99, 100]"

Norman,L50,middle,17,6,11,2,0.8547,117,"[9, 20, 38, 39, 55, 56, 57, 58, 60, 76, 77, 78, 79, 80, 97, 99, 100]"

Norman,L50,middle,23,7,16,6,0.813,123,"[10, 18, 21, 38, 39, 56, 57, 58, 59, 60, 61, 64, 81, 83, 84, 85, 86, 87, 89, 92, 109, 110, 111]"

Norman,L50,middle,17,5,12,2,0.8547,117,"[9, 17, 18, 20, 38, 39, 56, 57, 59, 75, 76, 77, 78, 79, 96, 98, 100]"

Norman,L50,middle,13,0,13,4,0.885,113,"[10, 20, 36, 37, 38, 40, 57, 61, 78, 79, 96, 98, 99]"

Norman,L50,middle,19,6,13,1,0.8403,119,"[18, 19, 31, 32, 34, 35, 36, 37, 40, 57, 59, 61, 78, 80, 81, 98, 99, 100, 102]"

Norman,L50,middle,19,13,6,0,0.8403,119,"[18, 19, 37, 39, 55, 56, 57, 59, 60, 77, 78, 79, 80, 81, 82, 99, 101, 102, 103]"

Norman,L50,middle,16,4,12,1,0.8621,116,"[18, 20, 32, 33, 34, 35, 36, 37, 38, 40, 41, 59, 61, 81, 97, 103]"

Norman,L50,middle,16,12,4,0,0.8621,116,"[9, 18, 19, 36, 40, 41, 57, 59, 61, 78, 79, 81, 97, 98, 100, 101]"

Norman,L50,middle,18,6,12,1,0.8475,118,"[18, 20, 32, 33, 36, 38, 39, 56, 57, 59, 77, 79, 95, 96, 97, 98, 99, 100]"

Norman,L50,middle,17,6,11,2,0.8547,117,"[18, 20, 32, 33, 34, 35, 37, 38, 39, 57, 58, 59, 77, 78, 80, 100, 102]"

Norman,L50,middle,18,10,8,3,0.8475,118,"[9, 19, 20, 36, 37, 38, 40, 41, 58, 60, 63, 80, 81, 82, 98, 100, 102, 104]"

Norman,L50,middle,16,11,5,2,0.8621,116,"[19, 30, 31, 35, 37, 38, 39, 56, 57, 59, 76, 81, 97, 98, 99, 101]"

Norman,L50,middle,16,6,10,5,0.8621,116,"[18, 20, 32, 33, 34, 35, 38, 39, 40, 57, 59, 61, 78, 80, 84, 103]"

Norman,L50,middle,17,9,8,3,0.8547,117,"[9, 17, 18, 19, 36, 37, 38, 41, 62, 80, 81, 82, 83, 84, 85, 104, 105]"

Norman,L50,middle,18,12,6,4,0.8475,118,"[9, 18, 20, 36, 37, 40, 41, 43, 44, 45, 63, 64, 67, 84, 85, 87, 105, 106]"

Norman,L50,middle,16,5,11,0,0.8621,116,"[19, 32, 33, 35, 37, 38, 39, 57, 58, 59, 76, 78, 79, 95, 97, 99]"

Norman,L50,middle,18,7,11,3,0.8475,118,"[9, 18, 19, 36, 37, 38, 40, 57, 58, 59, 60, 61, 79, 80, 81, 98, 101, 104]"

Norman,L50,middle,14,7,7,0,0.8772,114,"[18, 19, 30, 31, 32, 33, 37, 38, 39, 57, 60, 77, 81, 101]"

Norman,L50,middle,17,8,9,1,0.8547,117,"[9, 17, 18, 20, 37, 39, 40, 41, 59, 62, 63, 81, 82, 83, 99, 102, 103]"

Norman,L50,middle,14,10,4,2,0.8772,114,"[9, 18, 19, 21, 41, 58, 59, 60, 61, 62, 81, 82, 99, 102]"

Norman,L50,middle,18,10,8,1,0.8475,118,"[9, 18, 20, 36, 37, 38, 39, 40, 41, 42, 61, 62, 63, 80, 81, 82, 84, 104]"

Norman,L50,middle,21,7,14,2,0.8264,121,"[9, 17, 18, 21, 38, 39, 43, 60, 61, 62, 64, 81, 82, 83, 84, 85, 86, 87, 104, 106, 107]"

Norman,L50,middle,17,10,7,2,0.8547,117,"[20, 31, 33, 35, 36, 38, 39, 56, 60, 78, 79, 80, 82, 99, 100, 101, 102]"

Norman,L50,middle,16,10,6,2,0.8621,116,"[18, 21, 34, 35, 37, 40, 58, 60, 62, 64, 81, 83, 99, 101, 102, 103]"

Norman,L50,middle,22,12,10,2,0.8197,122,"[18, 22, 35, 39, 41, 57, 58, 60, 61, 62, 79, 80, 82, 83, 84, 85, 86, 88, 89, 106, 109, 111]"

Norman,L50,middle,19,16,3,1,0.8403,119,"[9, 17, 18, 20, 39, 55, 57, 59, 76, 77, 78, 79, 80, 81, 99, 100, 101, 102, 103]"

Norman,L50,middle,21,4,17,3,0.8264,121,"[10, 19, 20, 37, 38, 39, 41, 58, 59, 60, 77, 78, 79, 82, 98, 100, 101, 104, 105, 106, 107]"

Norman,L50,middle,15,7,8,1,0.8696,115,"[12, 20, 36, 38, 40, 56, 58, 60, 78, 79, 80, 96, 97, 98, 100]"

Norman,L50,middle,20,4,16,1,0.8333,120,"[9, 19, 20, 21, 22, 24, 41, 42, 43, 44, 61, 62, 64, 66, 84, 85, 86, 87, 104, 107]"

Norman,L50,middle,16,6,10,4,0.8621,116,"[9, 19, 36, 37, 38, 40, 56, 59, 61, 80, 81, 97, 100, 101, 102, 105]"

Norman,L50,middle,16,3,13,2,0.8621,116,"[11, 20, 37, 40, 58, 59, 60, 61, 62, 78, 80, 81, 82, 84, 101, 103]"

Norman,L50,middle,20,9,11,0,0.8333,120,"[19, 30, 31, 32, 33, 34, 35, 37, 38, 39, 57, 59, 77, 79, 80, 97, 98, 99, 100, 116]"

Norman,L50,middle,19,6,13,0,0.8403,119,"[19, 30, 31, 32, 34, 35, 36, 37, 39, 57, 59, 60, 78, 80, 96, 98, 99, 100, 117]"

Norman,L50,middle,12,7,5,9,0.8929,112,"[9, 18, 19, 36, 37, 40, 56, 58, 60, 84, 99, 102]"

Norman,L50,middle,19,9,10,4,0.8403,119,"[9, 17, 22, 39, 55, 56, 57, 58, 60, 62, 64, 65, 66, 67, 84, 88, 104, 106, 109]"

Norman,L50,middle,17,9,8,5,0.8547,117,"[19, 30, 31, 34, 35, 36, 37, 42, 60, 77, 78, 79, 80, 81, 83, 101, 102]"

Norman,L50,middle,16,11,5,1,0.8621,116,"[9, 18, 19, 36, 39, 55, 58, 59, 75, 76, 77, 79, 96, 97, 98, 100]"

Norman,L50,middle,19,12,7,3,0.8403,119,"[18, 19, 22, 34, 36, 37, 38, 40, 57, 60, 62, 63, 80, 82, 83, 101, 102, 103, 106]"

Norman,L50,middle,22,14,8,2,0.8197,122,"[20, 31, 33, 34, 35, 37, 38, 39, 57, 58, 59, 60, 61, 62, 63, 81, 83, 84, 86, 104, 105, 107]"

Norman,L50,middle,18,5,13,2,0.8475,118,"[18, 19, 20, 21, 34, 36, 37, 38, 39, 40, 41, 43, 45, 64, 81, 83, 85, 105]"

Norman,L50,middle,16,12,4,1,0.8621,116,"[10, 18, 19, 20, 40, 56, 58, 61, 77, 78, 80, 96, 100, 102, 103, 104]"

Norman,L50,middle,19,9,10,1,0.8403,119,"[10, 18, 19, 20, 21, 38, 39, 40, 42, 59, 60, 61, 79, 80, 81, 82, 99, 101, 103]"

Norman,L50,middle,16,8,8,0,0.8621,116,"[19, 20, 21, 22, 37, 38, 41, 43, 61, 63, 82, 84, 85, 102, 104, 105]"

Norman,L50,middle,14,9,5,5,0.8772,114,"[9, 20, 36, 38, 41, 58, 61, 65, 81, 82, 98, 99, 101, 102]"

Norman,L50,middle,16,9,7,1,0.8621,116,"[11, 19, 20, 38, 39, 41, 59, 60, 61, 78, 79, 80, 81, 83, 99, 102]"

Norman,L50,middle,22,11,11,0,0.8197,122,"[18, 19, 30, 31, 32, 33, 34, 36, 37, 38, 39, 57, 58, 59, 60, 78, 79, 80, 82, 100, 103, 120]"

Norman,L50,middle,16,9,7,5,0.8621,116,"[18, 21, 34, 35, 36, 37, 38, 39, 43, 62, 79, 82, 98, 100, 101, 102]"

Norman,L50,middle,20,1,19,3,0.8333,120,"[18, 20, 33, 34, 35, 39, 41, 58, 62, 79, 81, 82, 83, 84, 100, 101, 102, 104, 105, 107]"

Norman,L50,middle,16,6,10,1,0.8621,116,"[9, 18, 19, 37, 38, 39, 56, 58, 59, 60, 61, 78, 81, 82, 84, 103]"

Norman,L50,middle,18,10,8,3,0.8475,118,"[18, 19, 30, 31, 32, 33, 35, 36, 38, 40, 41, 44, 62, 79, 81, 83, 100, 102]"

Norman,L50,middle,22,5,17,4,0.8197,122,"[18, 19, 21, 33, 34, 35, 36, 37, 38, 39, 40, 41, 43, 45, 64, 65, 83, 85, 102, 104, 105, 108]"

Norman,L50,middle,17,13,4,4,0.8547,117,"[9, 17, 19, 20, 21, 38, 39, 43, 60, 63, 64, 82, 84, 101, 102, 103, 106]"

Norman,L50,middle,13,2,11,1,0.885,113,"[18, 20, 33, 35, 39, 56, 57, 58, 59, 76, 79, 97, 99]"

Norman,L50,middle,18,13,5,3,0.8475,118,"[9, 17, 18, 19, 21, 38, 39, 40, 59, 60, 61, 78, 80, 81, 98, 99, 100, 103]"

Norman,L50,middle,15,1,14,3,0.8696,115,"[19, 20, 34, 37, 38, 39, 40, 58, 62, 79, 81, 97, 98, 99, 101]"

Norman,L50,middle,15,11,4,2,0.8696,115,"[9, 17, 18, 20, 39, 55, 57, 59, 77, 78, 79, 95, 96, 97, 100]"

Norman,L50,middle,20,9,11,0,0.8333,120,"[18, 19, 30, 33, 34, 35, 36, 38, 39, 57, 58, 59, 77, 78, 79, 96, 98, 99, 100, 116]"

Norman,L50,middle,17,8,9,2,0.8547,117,"[18, 22, 35, 36, 37, 38, 39, 40, 58, 59, 60, 77, 79, 80, 97, 98, 100]"

Norman,L50,middle,14,9,5,3,0.8772,114,"[10, 19, 35, 37, 41, 58, 61, 77, 80, 81, 83, 99, 101, 102]"

Norman,L50,middle,20,14,6,2,0.8333,120,"[20, 31, 33, 34, 36, 37, 39, 56, 57, 58, 61, 78, 80, 81, 97, 99, 100, 101, 102, 103]"

Norman,L50,middle,15,11,4,6,0.8696,115,"[10, 18, 23, 39, 40, 57, 58, 59, 60, 76, 78, 79, 83, 100, 102]"

Norman,L50,middle,18,9,9,4,0.8475,118,"[20, 31, 33, 34, 35, 37, 39, 41, 58, 59, 61, 63, 80, 81, 83, 100, 101, 103]"

Norman,L50,middle,18,10,8,1,0.8475,118,"[20, 32, 34, 35, 37, 38, 40, 57, 59, 60, 77, 79, 80, 96, 97, 99, 100, 102]"

Norman,L50,middle,20,13,7,0,0.8333,120,"[18, 19, 31, 32, 33, 35, 36, 37, 38, 41, 42, 62, 80, 81, 82, 83, 100, 101, 102, 103]"

Norman,L50,middle,17,4,13,1,0.8547,117,"[10, 18, 20, 36, 38, 39, 40, 57, 58, 60, 77, 78, 79, 80, 97, 99, 100]"

Norman,L50,middle,16,10,6,7,0.8621,116,"[18, 21, 34, 35, 36, 37, 38, 41, 59, 62, 79, 80, 82, 98, 100, 102]"

Norman,L50,middle,16,7,9,4,0.8621,116,"[18, 20, 21, 22, 36, 37, 38, 39, 41, 45, 63, 82, 98, 99, 100, 102]"

Norman,L50,middle,19,1,18,1,0.8403,119,"[20, 31, 33, 34, 35, 39, 56, 57, 58, 59, 76, 78, 79, 80, 96, 98, 99, 100, 117]"

Norman,L50,middle,17,14,3,3,0.8547,117,"[9, 17, 18, 19, 36, 37, 38, 41, 61, 78, 79, 80, 81, 98, 99, 101, 103]"

Norman,L50,middle,19,9,10,2,0.8403,119,"[18, 19, 20, 36, 37, 38, 39, 40, 42, 43, 47, 65, 66, 83, 85, 87, 88, 105, 108]"

Norman,L50,middle,16,5,11,3,0.8621,116,"[20, 31, 34, 37, 38, 39, 55, 58, 59, 62, 79, 81, 83, 100, 101, 102]"

Norman,L50,middle,18,6,12,0,0.8475,118,"[10, 18, 19, 21, 22, 39, 41, 42, 43, 60, 61, 63, 64, 82, 84, 101, 103, 105]"

Norman,L50,middle,15,8,7,1,0.8696,115,"[11, 19, 35, 36, 37, 38, 39, 58, 59, 75, 77, 78, 80, 97, 99]"

Norman,L50,middle,16,6,10,6,0.8621,116,"[20, 32, 33, 34, 35, 36, 37, 39, 41, 61, 63, 80, 83, 99, 100, 105]"

Norman,L50,middle,17,10,7,2,0.8547,117,"[20, 33, 34, 35, 37, 39, 43, 59, 61, 62, 79, 81, 83, 99, 100, 101, 103]"

Norman,L50,middle,15,7,8,5,0.8696,115,"[13, 21, 37, 38, 39, 55, 57, 61, 77, 78, 80, 96, 97, 98, 100]"

Norman,L50,middle,18,8,10,1,0.8475,118,"[18, 19, 30, 31, 32, 35, 36, 38, 41, 42, 43, 61, 62, 63, 81, 83, 101, 104]"

Norman,L50,middle,17,8,9,6,0.8547,117,"[9, 17, 18, 21, 39, 40, 57, 58, 59, 60, 62, 79, 81, 82, 85, 102, 104]"

Norman,L50,middle,18,13,5,7,0.8475,118,"[9, 17, 18, 19, 36, 37, 39, 40, 45, 63, 81, 82, 83, 84, 87, 103, 104, 105]"

Norman,L50,middle,18,11,7,1,0.8475,118,"[19, 32, 33, 34, 36, 37, 39, 56, 57, 58, 60, 77, 79, 81, 98, 99, 100, 102]"

Norman,L50,middle,14,10,4,3,0.8772,114,"[12, 19, 35, 39, 41, 58, 59, 60, 61, 79, 80, 83, 99, 101]"

Norman,L50,middle,17,9,8,4,0.8547,117,"[18, 19, 30, 31, 32, 33, 36, 38, 39, 41, 59, 60, 78, 79, 82, 99, 102]"

Norman,L50,middle,16,8,8,0,0.8621,116,"[19, 20, 32, 33, 35, 36, 37, 40, 57, 58, 59, 60, 80, 96, 98, 100]"

Norman,L50,middle,22,5,17,0,0.8197,122,"[18, 19, 20, 21, 33, 35, 38, 40, 41, 58, 60, 61, 62, 63, 80, 82, 83, 100, 101, 102, 103, 120]"

Norman,L50,middle,17,11,6,4,0.8547,117,"[18, 19, 30, 31, 32, 33, 35, 36, 37, 38, 41, 60, 81, 83, 99, 101, 102]"

Norman,L50,middle,14,8,6,1,0.8772,114,"[18, 19, 34, 35, 37, 38, 39, 56, 61, 79, 80, 82, 98, 101]"

Norman,L50,middle,16,5,11,3,0.8621,116,"[19, 30, 32, 33, 34, 35, 37, 38, 41, 58, 61, 78, 80, 96, 99, 101]"

Norman,L50,middle,14,5,9,4,0.8772,114,"[9, 17, 19, 21, 38, 39, 40, 41, 58, 60, 62, 81, 100, 104]"

Norman,L50,middle,15,10,5,1,0.8696,115,"[18, 19, 32, 33, 36, 38, 40, 59, 76, 77, 79, 95, 96, 98, 99]"

Norman,L50,middle,20,5,15,5,0.8333,120,"[18, 20, 32, 33, 34, 35, 36, 38, 39, 58, 60, 78, 79, 80, 96, 99, 100, 101, 102, 106]"

Norman,L50,middle,15,5,10,14,0.8696,115,"[18, 20, 33, 34, 37, 38, 39, 46, 63, 80, 95, 96, 99, 100, 105]"

Norman,L50,middle,18,7,11,4,0.8475,118,"[18, 19, 31, 32, 33, 34, 36, 41, 58, 59, 76, 78, 79, 80, 82, 99, 101, 103]"

Norman,L50,middle,18,6,12,11,0.8475,118,"[10, 18, 27, 43, 60, 61, 76, 77, 78, 79, 80, 81, 97, 100, 101, 102, 103, 104]"

Norman,L50,middle,17,9,8,5,0.8547,117,"[18, 19, 30, 31, 33, 34, 35, 36, 37, 39, 57, 58, 59, 76, 78, 83, 102]"

Norman,L50,middle,18,12,6,0,0.8475,118,"[18, 19, 31, 32, 33, 34, 36, 37, 39, 57, 59, 76, 78, 81, 98, 99, 100, 102]"

Norman,L50,middle,14,5,9,8,0.8772,114,"[18, 19, 32, 33, 34, 37, 38, 39, 42, 62, 79, 82, 99, 104]"

Norman,L50,middle,16,11,5,4,0.8621,116,"[9, 17, 19, 23, 41, 59, 60, 62, 78, 81, 82, 98, 100, 101, 102, 103]"

Norman,L50,middle,19,8,11,2,0.8403,119,"[18, 19, 31, 33, 34, 37, 41, 59, 76, 77, 78, 79, 80, 96, 97, 98, 99, 100, 117]"

Norman,L50,middle,16,6,10,4,0.8621,116,"[18, 23, 36, 38, 41, 58, 60, 61, 63, 80, 82, 83, 85, 101, 104, 105]"

Norman,L50,middle,14,8,6,8,0.8772,114,"[19, 31, 32, 33, 35, 37, 38, 39, 56, 58, 61, 79, 85, 101]"

Norman,L50,middle,18,6,12,0,0.8475,118,"[9, 19, 36, 37, 38, 39, 40, 41, 58, 59, 61, 62, 79, 81, 82, 100, 101, 102]"

Norman,L50,middle,18,12,6,3,0.8475,118,"[18, 19, 30, 31, 33, 34, 36, 38, 39, 57, 58, 59, 60, 78, 79, 83, 100, 103]"

Norman,L50,middle,16,11,5,0,0.8621,116,"[19, 30, 31, 32, 33, 37, 39, 56, 58, 59, 78, 79, 95, 96, 98, 100]"

Norman,L50,middle,15,6,9,2,0.8696,115,"[11, 19, 20, 21, 39, 42, 59, 60, 61, 78, 80, 81, 99, 101, 104]"

Norman,L50,middle,18,10,8,1,0.8475,118,"[10, 19, 20, 36, 38, 42, 43, 45, 64, 65, 67, 84, 85, 86, 88, 104, 107, 108]"

Norman,L50,middle,16,6,10,3,0.8621,116,"[9, 19, 21, 37, 39, 41, 57, 60, 62, 79, 80, 81, 83, 101, 102, 104]"

Norman,L50,middle,15,10,5,6,0.8696,115,"[18, 21, 33, 36, 37, 41, 58, 60, 79, 80, 95, 96, 97, 98, 101]"

Norman,L50,middle,14,7,7,2,0.8772,114,"[11, 19, 38, 39, 41, 58, 60, 76, 77, 79, 80, 82, 99, 102]"

Norman,L50,middle,15,2,13,0,0.8696,115,"[10, 19, 37, 39, 55, 56, 57, 58, 59, 75, 77, 78, 79, 96, 99]"

Norman,L50,middle,16,4,12,5,0.8621,116,"[10, 18, 20, 36, 37, 38, 40, 57, 58, 59, 76, 77, 78, 79, 96, 102]"

Norman,L50,middle,12,9,3,3,0.8929,112,"[10, 20, 38, 40, 57, 58, 60, 76, 77, 78, 83, 100]"

Norman,L50,middle,16,10,6,1,0.8621,116,"[19, 32, 33, 35, 36, 37, 38, 39, 57, 58, 59, 77, 80, 96, 97, 99]"

Norman,L50,middle,22,8,14,2,0.8197,122,"[18, 19, 30, 31, 32, 33, 34, 35, 36, 38, 40, 58, 59, 76, 80, 81, 98, 99, 100, 101, 118, 120]"

Norman,L50,middle,15,7,8,0,0.8696,115,"[9, 17, 20, 36, 37, 39, 40, 60, 77, 79, 80, 96, 99, 100, 101]"

Norman,L50,middle,16,11,5,0,0.8621,116,"[19, 31, 32, 33, 37, 38, 39, 60, 61, 62, 79, 80, 82, 98, 99, 103]"

Norman,L50,middle,10,4,6,8,0.9091,110,"[11, 19, 35, 40, 57, 62, 77, 78, 79, 103]"

Norman,L50,middle,17,4,13,1,0.8547,117,"[18, 19, 20, 33, 34, 35, 37, 38, 39, 40, 58, 59, 61, 80, 97, 98, 100]"

Norman,L50,middle,19,14,5,0,0.8403,119,"[10, 18, 19, 20, 21, 38, 39, 40, 41, 60, 61, 78, 80, 81, 99, 100, 101, 102, 104]"

Norman,L50,middle,17,4,13,2,0.8547,117,"[11, 20, 37, 38, 39, 40, 56, 58, 59, 60, 61, 78, 81, 82, 98, 101, 104]"

Norman,L50,middle,17,9,8,3,0.8547,117,"[19, 30, 32, 34, 36, 37, 38, 42, 59, 76, 78, 79, 95, 96, 98, 99, 100]"

Norman,L50,middle,17,12,5,2,0.8547,117,"[9, 17, 18, 19, 20, 37, 40, 57, 58, 59, 61, 79, 80, 82, 98, 100, 101]"

Norman,L50,middle,15,11,4,6,0.8696,115,"[9, 17, 18, 23, 40, 56, 59, 60, 76, 79, 80, 81, 85, 101, 102]"

Norman,L50,middle,11,8,3,8,0.9009,111,"[21, 33, 36, 37, 40, 57, 59, 77, 81, 98, 102]"

Norman,L50,middle,20,18,2,0,0.8333,120,"[9, 18, 20, 36, 37, 38, 39, 40, 58, 61, 62, 63, 80, 82, 83, 84, 101, 102, 103, 104]"

Norman,L50,middle,18,11,7,3,0.8475,118,"[10, 20, 22, 39, 40, 41, 42, 44, 61, 62, 63, 64, 82, 83, 84, 101, 103, 105]"

Norman,L50,middle,16,7,9,0,0.8621,116,"[18, 19, 30, 31, 33, 34, 37, 39, 40, 58, 60, 77, 79, 80, 96, 101]"

Norman,L50,middle,18,6,12,3,0.8475,118,"[18, 20, 32, 33, 34, 35, 36, 37, 38, 39, 57, 58, 60, 78, 79, 96, 100, 102]"

Norman,L50,middle,18,14,4,1,0.8475,118,"[9, 17, 18, 19, 20, 37, 40, 58, 59, 61, 78, 79, 81, 98, 99, 100, 101, 103]"

Norman,L50,middle,15,7,8,4,0.8696,115,"[19, 31, 33, 34, 35, 43, 59, 76, 78, 79, 95, 96, 97, 98, 99]"

Norman,L50,middle,15,6,9,5,0.8696,115,"[19, 34, 35, 38, 39, 58, 62, 78, 80, 96, 97, 98, 99, 100, 102]"

Norman,L50,middle,17,8,9,3,0.8547,117,"[9, 17, 20, 38, 39, 41, 44, 61, 62, 64, 81, 82, 85, 101, 102, 103, 105]"

Norman,L50,middle,19,7,12,1,0.8403,119,"[19, 20, 21, 33, 34, 37, 38, 41, 43, 61, 62, 79, 80, 83, 99, 101, 102, 103, 104]"

Norman,L50,middle,19,1,18,2,0.8403,119,"[18, 20, 32, 33, 34, 35, 36, 37, 39, 40, 59, 61, 78, 80, 96, 98, 99, 100, 117]"

Norman,L50,middle,16,13,3,1,0.8621,116,"[19, 30, 31, 32, 37, 38, 39, 56, 59, 76, 79, 95, 96, 97, 98, 100]"

Norman,L50,middle,18,15,3,3,0.8475,118,"[18, 20, 22, 34, 36, 37, 38, 39, 40, 41, 63, 80, 81, 97, 99, 100, 101, 102]"

Norman,L50,middle,18,4,14,2,0.8475,118,"[18, 20, 32, 33, 34, 35, 36, 37, 39, 40, 58, 59, 61, 79, 80, 82, 99, 101]"

Norman,L50,middle,18,7,11,3,0.8475,118,"[18, 19, 30, 31, 34, 35, 37, 39, 56, 57, 61, 78, 80, 96, 97, 98, 100, 104]"

Norman,L50,middle,15,9,6,3,0.8696,115,"[9, 19, 35, 36, 39, 55, 57, 58, 61, 78, 80, 96, 97, 98, 99]"

Norman,L50,middle,17,11,6,2,0.8547,117,"[9, 18, 19, 20, 37, 39, 40, 42, 60, 64, 80, 85, 101, 102, 103, 104, 105]"

Norman,L50,middle,19,13,6,3,0.8403,119,"[19, 30, 31, 32, 34, 36, 38, 39, 40, 57, 59, 60, 62, 81, 82, 84, 102, 103, 107]"

Norman,L50,middle,17,6,11,2,0.8547,117,"[9, 17, 20, 36, 37, 38, 40, 57, 58, 59, 60, 61, 62, 63, 64, 86, 104]"

Norman,L50,middle,17,13,4,3,0.8547,117,"[9, 17, 19, 20, 37, 38, 40, 57, 58, 59, 63, 80, 96, 97, 98, 99, 100]"

Norman,L50,middle,13,9,4,3,0.885,113,"[18, 20, 34, 35, 37, 38, 40, 60, 79, 94, 95, 100, 101]"

Norman,L50,middle,19,13,6,8,0.8403,119,"[19, 20, 23, 36, 37, 38, 39, 40, 41, 45, 62, 64, 81, 82, 83, 85, 102, 103, 105]"

Norman,L50,middle,16,11,5,1,0.8621,116,"[9, 17, 18, 20, 37, 38, 39, 42, 60, 61, 63, 81, 82, 84, 101, 103]"

Norman,L50,middle,19,6,13,1,0.8403,119,"[19, 31, 33, 35, 36, 37, 38, 40, 57, 59, 76, 78, 79, 95, 96, 98, 99, 100, 117]"

Norman,L50,middle,20,10,10,1,0.8333,120,"[18, 19, 30, 31, 34, 37, 38, 40, 57, 58, 59, 60, 61, 79, 80, 81, 99, 100, 101, 118]"

Norman,L50,middle,16,6,10,0,0.8621,116,"[18, 19, 30, 34, 35, 36, 37, 39, 56, 58, 60, 77, 80, 96, 97, 100]"

Norman,L50,middle,19,6,13,2,0.8403,119,"[18, 20, 32, 34, 35, 36, 38, 39, 56, 57, 59, 60, 78, 79, 81, 98, 99, 100, 117]"

Norman,L50,middle,15,8,7,5,0.8696,115,"[19, 32, 33, 35, 36, 40, 58, 62, 78, 80, 95, 96, 97, 98, 99]"

Norman,L50,middle,16,5,11,3,0.8621,116,"[9, 17, 20, 22, 38, 39, 40, 41, 59, 61, 64, 81, 86, 102, 103, 105]"

Norman,L50,middle,14,5,9,1,0.8772,114,"[18, 19, 30, 32, 35, 37, 38, 40, 58, 59, 76, 78, 79, 100]"

Norman,L50,middle,22,13,9,1,0.8197,122,"[18, 20, 32, 33, 34, 37, 38, 39, 56, 57, 58, 59, 77, 78, 79, 96, 98, 99, 115, 116, 118, 119]"

Norman,L50,middle,21,14,7,2,0.8264,121,"[9, 17, 21, 38, 39, 40, 41, 43, 60, 61, 63, 80, 81, 82, 83, 85, 102, 105, 106, 107, 108]"

Norman,L50,middle,18,8,10,0,0.8475,118,"[9, 17, 18, 19, 37, 39, 56, 57, 59, 60, 77, 78, 79, 80, 97, 99, 100, 101]"

Norman,L50,middle,14,5,9,3,0.8772,114,"[9, 17, 19, 21, 39, 42, 60, 77, 78, 80, 81, 82, 98, 102]"

Norman,L50,middle,18,6,12,0,0.8475,118,"[18, 19, 21, 33, 35, 36, 37, 38, 41, 58, 60, 61, 79, 81, 97, 99, 100, 101]"

Norman,L50,middle,17,15,2,3,0.8547,117,"[9, 17, 18, 19, 21, 38, 39, 40, 41, 42, 62, 79, 80, 84, 101, 103, 105]"

Norman,L50,middle,17,10,7,4,0.8547,117,"[18, 21, 34, 35, 36, 37, 39, 40, 58, 59, 61, 78, 80, 96, 97, 99, 101]"

Norman,L50,middle,18,7,11,2,0.8475,118,"[18, 19, 20, 21, 22, 34, 35, 39, 41, 43, 44, 62, 64, 82, 85, 102, 103, 105]"

Norman,L50,middle,17,10,7,3,0.8547,117,"[18, 19, 33, 34, 36, 37, 38, 40, 57, 58, 59, 62, 79, 81, 97, 99, 100]"

Norman,L50,middle,18,7,11,1,0.8475,118,"[18, 19, 20, 32, 33, 34, 35, 37, 38, 39, 40, 58, 59, 60, 78, 80, 98, 101]"

Norman,L50,middle,19,10,9,7,0.8403,119,"[18, 22, 35, 36, 37, 39, 42, 61, 78, 79, 82, 83, 84, 85, 101, 102, 103, 104, 106]"

Norman,L50,middle,16,6,10,3,0.8621,116,"[10, 18, 19, 37, 38, 40, 56, 58, 59, 75, 77, 79, 97, 98, 99, 102]"

Norman,L50,middle,14,7,7,1,0.8772,114,"[9, 18, 19, 20, 38, 39, 40, 58, 59, 60, 78, 79, 81, 100]"

Norman,L50,middle,17,10,7,5,0.8547,117,"[10, 19, 35, 36, 37, 38, 39, 44, 62, 78, 80, 81, 97, 98, 99, 101, 102]"

Norman,L50,middle,15,10,5,4,0.8696,115,"[9, 17, 19, 22, 40, 57, 58, 59, 61, 63, 80, 81, 83, 101, 102]"

Norman,L50,middle,15,6,9,10,0.8696,115,"[9, 17, 20, 22, 39, 40, 41, 42, 48, 65, 81, 82, 84, 102, 104]"

Norman,L50,middle,20,11,9,1,0.8333,120,"[9, 19, 20, 36, 37, 38, 40, 57, 58, 59, 60, 78, 79, 81, 83, 100, 101, 102, 103, 104]"

Norman,L50,middle,19,8,11,0,0.8403,119,"[18, 20, 32, 33, 36, 37, 39, 40, 41, 60, 61, 64, 81, 82, 84, 101, 103, 104, 105]"

Norman,L50,middle,20,10,10,4,0.8333,120,"[9, 19, 21, 37, 38, 39, 40, 57, 58, 59, 60, 63, 68, 86, 102, 103, 104, 105, 106, 107]"

Norman,L50,middle,18,15,3,3,0.8475,118,"[19, 21, 33, 35, 36, 37, 42, 59, 60, 61, 78, 79, 80, 81, 97, 99, 100, 101]"

Norman,L50,middle,16,9,7,1,0.8621,116,"[18, 20, 34, 35, 36, 38, 39, 57, 58, 59, 60, 77, 80, 97, 99, 100]"

Norman,L50,middle,17,5,12,2,0.8547,117,"[10, 18, 19, 36, 37, 39, 56, 57, 58, 59, 76, 77, 78, 79, 81, 98, 101]"

Norman,L50,middle,15,6,9,3,0.8696,115,"[10, 18, 19, 20, 37, 39, 40, 58, 59, 60, 61, 80, 83, 100, 102]"

Norman,L50,middle,14,8,6,3,0.8772,114,"[9, 18, 19, 36, 41, 58, 60, 77, 78, 79, 85, 101, 104, 105]"

Norman,L50,middle,19,5,14,4,0.8403,119,"[22, 35, 36, 38, 40, 41, 59, 60, 61, 79, 80, 82, 98, 99, 100, 101, 102, 103, 105]"

Norman,L50,middle,21,7,14,2,0.8264,121,"[18, 20, 32, 33, 34, 36, 37, 38, 39, 40, 41, 59, 60, 63, 80, 83, 100, 102, 103, 104, 106]"

Norman,L50,middle,12,8,4,6,0.8929,112,"[9, 18, 19, 38, 41, 58, 59, 77, 82, 98, 99, 101]"

Norman,L50,middle,14,4,10,1,0.8772,114,"[19, 21, 33, 36, 42, 58, 61, 62, 78, 80, 83, 98, 102, 103]"

Norman,L50,middle,15,8,7,5,0.8696,115,"[18, 21, 34, 35, 38, 39, 43, 59, 63, 80, 82, 97, 99, 101, 102]"

Norman,L50,middle,18,9,9,4,0.8475,118,"[9, 17, 18, 19, 36, 38, 41, 58, 59, 60, 77, 78, 79, 80, 98, 99, 100, 103]"

Norman,L50,middle,13,8,5,2,0.885,113,"[13, 21, 37, 38, 40, 56, 58, 60, 76, 81, 97, 99, 102]"

Norman,L50,middle,16,6,10,5,0.8621,116,"[19, 30, 31, 32, 33, 35, 36, 37, 38, 42, 60, 77, 79, 96, 97, 100]"

Norman,L50,middle,19,12,7,5,0.8403,119,"[19, 20, 32, 35, 36, 39, 42, 60, 61, 80, 81, 86, 101, 102, 103, 104, 105, 106, 107]"

Norman,L50,middle,17,14,3,3,0.8547,117,"[9, 17, 18, 20, 38, 39, 42, 43, 60, 61, 62, 63, 64, 82, 83, 86, 108]"

Norman,L50,middle,14,5,9,4,0.8772,114,"[10, 18, 20, 36, 38, 41, 59, 62, 78, 79, 81, 97, 99, 101]"

Norman,L50,middle,13,8,5,4,0.885,113,"[18, 22, 35, 36, 38, 39, 55, 57, 59, 77, 79, 96, 100]"

Norman,L50,middle,16,9,7,3,0.8621,116,"[18, 21, 33, 36, 39, 56, 57, 58, 60, 77, 78, 79, 95, 97, 98, 99]"

Norman,L50,middle,18,12,6,2,0.8475,118,"[20, 31, 34, 35, 36, 37, 39, 56, 57, 58, 59, 76, 79, 96, 97, 98, 99, 101]"

Norman,L50,middle,14,4,10,1,0.8772,114,"[19, 30, 35, 38, 39, 56, 59, 77, 79, 82, 97, 98, 99, 103]"

Norman,L50,middle,17,12,5,2,0.8547,117,"[9, 17, 18, 21, 39, 40, 56, 58, 60, 77, 78, 80, 96, 97, 98, 99, 101]"

Norman,L50,middle,16,3,13,2,0.8621,116,"[18, 19, 31, 33, 34, 36, 38, 41, 58, 59, 77, 78, 79, 80, 96, 100]"

Norman,L50,middle,17,5,12,1,0.8547,117,"[9, 17, 19, 20, 37, 39, 40, 41, 58, 59, 60, 62, 79, 80, 81, 101, 102]"

Norman,L50,middle,17,6,11,3,0.8547,117,"[10, 18, 19, 36, 37, 39, 57, 58, 59, 60, 64, 81, 82, 98, 99, 101, 102]"

Norman,L50,middle,21,9,12,0,0.8264,121,"[18, 19, 20, 32, 33, 34, 35, 36, 37, 39, 40, 41, 42, 61, 62, 80, 82, 87, 105, 106, 107]"

Norman,L50,middle,17,11,6,3,0.8547,117,"[9, 17, 18, 19, 20, 37, 38, 39, 42, 59, 60, 78, 79, 80, 98, 99, 101]"

Norman,L50,middle,16,8,8,0,0.8621,116,"[18, 19, 30, 31, 33, 34, 35, 36, 38, 39, 58, 59, 79, 80, 81, 101]"

Norman,L50,middle,20,12,8,4,0.8333,120,"[19, 30, 31, 32, 33, 36, 37, 39, 40, 41, 42, 43, 61, 63, 65, 82, 84, 87, 104, 107]"

Norman,L50,middle,23,10,13,7,0.813,123,"[18, 19, 20, 21, 22, 26, 42, 43, 60, 61, 62, 63, 64, 83, 85, 101, 103, 104, 106, 109, 110, 111, 115]"

Norman,L50,middle,17,7,10,2,0.8547,117,"[18, 19, 31, 33, 34, 35, 38, 42, 60, 77, 79, 80, 96, 99, 100, 101, 102]"

Norman,L50,middle,15,4,11,3,0.8696,115,"[21, 35, 37, 38, 39, 40, 59, 61, 78, 80, 82, 97, 99, 100, 102]"

Norman,L50,middle,18,10,8,1,0.8475,118,"[18, 19, 30, 32, 33, 35, 36, 37, 40, 58, 59, 60, 61, 79, 80, 81, 100, 101]"

Norman,L50,middle,21,16,5,1,0.8264,121,"[9, 17, 19, 20, 21, 41, 43, 60, 61, 63, 66, 67, 68, 70, 87, 89, 90, 91, 93, 111, 112]"

Norman,L50,middle,16,5,11,5,0.8621,116,"[18, 20, 32, 33, 34, 35, 36, 38, 39, 58, 59, 62, 79, 82, 99, 100]"

Norman,L50,middle,16,8,8,0,0.8621,116,"[10, 18, 19, 20, 37, 39, 40, 58, 59, 60, 61, 79, 80, 81, 98, 101]"

Norman,L50,middle,19,10,9,6,0.8403,119,"[9, 18, 19, 23, 39, 40, 41, 42, 59, 61, 62, 63, 65, 82, 84, 86, 103, 106, 109]"

Norman,L50,middle,16,10,6,4,0.8621,116,"[9, 17, 18, 19, 20, 37, 39, 40, 41, 58, 60, 61, 78, 79, 84, 102]"

Norman,L50,middle,20,9,11,0,0.8333,120,"[18, 19, 30, 33, 34, 35, 36, 37, 39, 58, 59, 76, 77, 78, 79, 80, 97, 99, 101, 118]"

Norman,L50,middle,13,3,10,7,0.885,113,"[20, 31, 36, 37, 39, 56, 57, 62, 78, 81, 97, 98, 100]"

Norman,L50,middle,21,4,17,2,0.8264,121,"[19, 31, 32, 34, 35, 36, 37, 38, 40, 41, 59, 61, 62, 63, 64, 82, 83, 84, 101, 103, 107]"

Norman,L50,middle,20,3,17,1,0.8333,120,"[9, 17, 20, 36, 39, 55, 57, 58, 59, 75, 76, 77, 78, 79, 96, 98, 99, 116, 117, 118]"

Norman,L50,middle,14,11,3,6,0.8772,114,"[9, 17, 18, 19, 36, 37, 38, 39, 60, 76, 78, 79, 86, 103]"

Norman,L50,middle,14,5,9,3,0.8772,114,"[9, 17, 19, 37, 38, 39, 56, 57, 60, 76, 78, 81, 98, 100]"

Norman,L50,middle,16,7,9,3,0.8621,116,"[9, 19, 21, 37, 38, 42, 59, 61, 62, 78, 81, 82, 98, 101, 102, 103]"

Norman,L50,middle,22,11,11,2,0.8197,122,"[18, 19, 30, 31, 32, 33, 35, 36, 37, 39, 40, 58, 60, 78, 79, 81, 98, 100, 101, 102, 103, 105]"

Norman,L50,middle,19,12,7,3,0.8403,119,"[9, 17, 18, 20, 21, 22, 41, 42, 59, 60, 61, 63, 80, 82, 83, 100, 102, 103, 106]"

Norman,L50,middle,17,8,9,2,0.8547,117,"[10, 18, 19, 36, 37, 39, 56, 57, 58, 60, 77, 78, 79, 81, 98, 100, 101]"

Norman,L50,middle,17,9,8,1,0.8547,117,"[19, 20, 21, 33, 34, 37, 39, 42, 60, 61, 78, 80, 81, 82, 98, 101, 102]"

Norman,L50,middle,18,14,4,3,0.8475,118,"[21, 33, 34, 35, 36, 37, 39, 40, 41, 58, 60, 61, 78, 80, 82, 99, 100, 101]"

Norman,L50,middle,16,13,3,1,0.8621,116,"[9, 17, 19, 36, 37, 38, 40, 59, 75, 76, 78, 79, 80, 98, 99, 100]"

Norman,L50,middle,17,8,9,4,0.8547,117,"[18, 19, 20, 22, 36, 37, 38, 40, 41, 58, 61, 78, 81, 85, 101, 102, 103]"

Norman,L50,middle,19,13,6,0,0.8403,119,"[18, 19, 30, 31, 32, 34, 35, 36, 37, 38, 39, 58, 59, 77, 79, 80, 97, 100, 117]"

Norman,L50,middle,21,17,4,1,0.8264,121,"[9, 17, 19, 36, 37, 38, 39, 56, 57, 58, 59, 60, 77, 79, 81, 82, 84, 102, 103, 104, 106]"

Norman,L50,middle,17,16,1,7,0.8547,117,"[9, 17, 18, 19, 20, 37, 39, 40, 41, 58, 59, 60, 61, 65, 85, 103, 105]"

Norman,L50,middle,23,8,15,2,0.813,123,"[18, 20, 32, 33, 35, 36, 37, 39, 56, 57, 59, 76, 77, 78, 80, 97, 98, 99, 100, 116, 119, 120, 121]"

Norman,L50,middle,16,5,11,5,0.8621,116,"[18, 19, 31, 34, 35, 36, 38, 41, 58, 59, 76, 78, 82, 98, 99, 100]"

Norman,L50,middle,19,5,14,1,0.8403,119,"[19, 30, 31, 32, 34, 35, 36, 37, 38, 39, 57, 59, 61, 79, 80, 98, 99, 100, 117]"

Norman,L50,middle,18,7,11,0,0.8475,118,"[18, 19, 32, 34, 35, 36, 37, 38, 40, 57, 61, 78, 80, 81, 97, 99, 100, 101]"

Norman,L50,middle,18,5,13,2,0.8475,118,"[9, 20, 36, 37, 38, 39, 56, 58, 59, 75, 76, 77, 78, 79, 82, 99, 100, 102]"

Norman,L50,middle,16,8,8,0,0.8621,116,"[9, 18, 19, 36, 37, 39, 56, 57, 58, 59, 76, 77, 79, 97, 99, 100]"

Norman,L50,middle,20,10,10,1,0.8333,120,"[18, 19, 30, 31, 32, 34, 36, 37, 38, 39, 40, 42, 61, 62, 81, 82, 84, 101, 103, 104]"

Norman,L50,middle,16,8,8,0,0.8621,116,"[18, 19, 32, 35, 36, 39, 57, 58, 59, 76, 78, 79, 80, 98, 99, 100]"

Norman,L50,middle,19,6,13,0,0.8403,119,"[18, 19, 30, 31, 33, 34, 36, 38, 39, 40, 58, 60, 79, 80, 96, 98, 99, 100, 117]"

Norman,L50,middle,14,7,7,11,0.8772,114,"[19, 30, 31, 33, 34, 35, 39, 42, 60, 61, 63, 81, 88, 104]"

Norman,L50,middle,17,13,4,3,0.8547,117,"[9, 19, 20, 36, 37, 39, 42, 59, 60, 76, 78, 80, 96, 97, 98, 99, 101]"

Norman,L50,middle,20,13,7,4,0.8333,120,"[18, 21, 33, 36, 38, 39, 40, 41, 44, 61, 62, 80, 81, 82, 98, 101, 104, 105, 106, 108]"

Norman,L50,middle,16,5,11,2,0.8621,116,"[18, 19, 30, 31, 32, 36, 37, 38, 39, 42, 60, 77, 79, 80, 96, 100]"

Norman,L50,middle,13,8,5,1,0.885,113,"[10, 19, 35, 36, 38, 40, 57, 59, 77, 78, 79, 95, 100]"

Norman,L50,middle,10,4,6,17,0.9091,110,"[14, 23, 39, 41, 58, 69, 85, 100, 101, 104]"

Norman,L50,middle,19,9,10,0,0.8403,119,"[19, 34, 35, 39, 55, 56, 58, 59, 76, 77, 78, 79, 95, 96, 97, 98, 99, 100, 117]"

Norman,L50,middle,17,9,8,2,0.8547,117,"[20, 32, 33, 34, 36, 37, 39, 56, 57, 59, 76, 78, 79, 80, 82, 99, 101]"

Norman,L50,middle,16,9,7,4,0.8621,116,"[18, 20, 33, 34, 35, 36, 38, 39, 57, 58, 59, 76, 77, 81, 97, 100]"

Norman,L50,middle,17,4,13,3,0.8547,117,"[18, 20, 32, 33, 34, 35, 36, 37, 41, 58, 61, 78, 80, 96, 97, 98, 100]"

Norman,L50,middle,15,7,8,4,0.8696,115,"[18, 19, 30, 31, 35, 36, 38, 41, 58, 61, 78, 79, 95, 96, 99]"

Norman,L50,middle,15,8,7,4,0.8696,115,"[18, 20, 34, 38, 39, 40, 58, 63, 79, 81, 82, 97, 100, 101, 103]"

Norman,L50,middle,16,9,7,3,0.8621,116,"[18, 19, 30, 31, 33, 34, 36, 37, 38, 41, 59, 76, 77, 79, 81, 100]"

Norman,L50,middle,16,8,8,3,0.8621,116,"[10, 19, 20, 39, 41, 42, 43, 61, 62, 63, 67, 84, 85, 101, 104, 105]"

Norman,L50,middle,15,7,8,0,0.8696,115,"[10, 20, 21, 37, 40, 41, 57, 59, 60, 62, 79, 82, 83, 102, 104]"

Norman,L50,middle,13,8,5,8,0.885,113,"[9, 17, 19, 36, 37, 38, 44, 62, 78, 79, 95, 96, 99]"

Norman,L50,middle,21,9,12,0,0.8264,121,"[18, 19, 30, 36, 37, 38, 40, 57, 58, 59, 60, 61, 62, 79, 83, 100, 101, 102, 103, 105, 106]"

Norman,L50,middle,18,9,9,2,0.8475,118,"[9, 17, 18, 19, 37, 38, 39, 40, 57, 59, 61, 78, 79, 80, 81, 82, 99, 103]"

Norman,L50,middle,12,7,5,4,0.8929,112,"[10, 19, 35, 38, 41, 61, 76, 77, 80, 97, 99, 100]"

Norman,L50,middle,18,9,9,3,0.8475,118,"[20, 31, 34, 35, 36, 37, 38, 39, 42, 60, 62, 81, 82, 83, 99, 101, 102, 104]"

Norman,L50,middle,19,4,15,1,0.8403,119,"[19, 30, 31, 33, 35, 36, 37, 38, 39, 57, 59, 61, 78, 80, 96, 98, 99, 100, 117]"

Norman,L50,middle,17,10,7,1,0.8547,117,"[9, 18, 20, 36, 37, 39, 40, 42, 61, 62, 63, 65, 83, 84, 102, 103, 104]"

Norman,L50,middle,13,6,7,5,0.885,113,"[18, 21, 34, 35, 37, 38, 40, 57, 59, 61, 80, 82, 103]"

Norman,L50,middle,17,7,10,4,0.8547,117,"[9, 17, 18, 19, 36, 37, 38, 41, 58, 59, 60, 77, 78, 79, 80, 81, 103]"

Norman,L50,middle,15,7,8,3,0.8696,115,"[18, 19, 20, 34, 35, 37, 38, 40, 41, 61, 78, 82, 98, 100, 103]"

Norman,L50,middle,14,8,6,2,0.8772,114,"[9, 18, 22, 38, 40, 60, 77, 78, 79, 81, 82, 98, 101, 102]"

Norman,L50,middle,15,10,5,0,0.8696,115,"[9, 18, 19, 20, 41, 58, 59, 60, 62, 79, 80, 82, 98, 101, 102]"

Norman,L50,middle,17,13,4,0,0.8547,117,"[9, 18, 19, 36, 37, 39, 40, 57, 60, 61, 78, 79, 80, 81, 99, 100, 102]"

Norman,L50,middle,15,6,9,3,0.8696,115,"[10, 18, 20, 36, 37, 38, 39, 58, 60, 76, 77, 81, 98, 100, 101]"

Norman,L50,middle,14,6,8,1,0.8772,114,"[12, 19, 35, 37, 39, 55, 57, 58, 60, 77, 78, 81, 97, 100]"

Norman,L50,middle,15,8,7,0,0.8696,115,"[18, 19, 31, 32, 33, 39, 56, 57, 59, 76, 78, 79, 96, 97, 99]"

Norman,L50,middle,18,12,6,6,0.8475,118,"[21, 34, 35, 36, 38, 40, 57, 58, 59, 61, 78, 80, 81, 97, 98, 99, 101, 104]"

Norman,L50,middle,14,9,5,1,0.8772,114,"[10, 19, 36, 38, 40, 58, 59, 75, 77, 81, 97, 99, 100, 101]"

Norman,L50,middle,15,10,5,2,0.8696,115,"[9, 19, 35, 36, 37, 39, 57, 58, 60, 76, 78, 80, 96, 98, 99]"

Norman,L50,middle,21,10,11,3,0.8264,121,"[18, 19, 20, 22, 35, 37, 38, 39, 40, 41, 42, 60, 61, 62, 64, 82, 83, 100, 101, 102, 105]"

Norman,L50,middle,18,8,10,1,0.8475,118,"[9, 18, 19, 20, 37, 39, 40, 41, 43, 60, 61, 62, 65, 82, 84, 86, 103, 105]"

Norman,L50,middle,21,6,15,1,0.8264,121,"[18, 19, 30, 31, 32, 34, 36, 37, 38, 40, 59, 77, 78, 79, 96, 97, 98, 99, 115, 118, 119]"

Norman,L50,middle,20,11,9,3,0.8333,120,"[18, 19, 30, 31, 32, 33, 35, 36, 37, 38, 39, 40, 42, 62, 80, 81, 83, 100, 101, 102]"

Norman,L50,middle,17,6,11,0,0.8547,117,"[18, 20, 32, 33, 34, 35, 39, 40, 57, 60, 77, 79, 80, 96, 97, 98, 100]"

Norman,L50,middle,17,11,6,2,0.8547,117,"[9, 17, 19, 20, 21, 38, 39, 41, 45, 63, 65, 83, 84, 102, 104, 105, 106]"

Norman,L50,middle,16,14,2,3,0.8621,116,"[21, 33, 34, 35, 36, 37, 38, 39, 56, 57, 59, 76, 79, 81, 97, 100]"

Norman,L50,middle,19,9,10,2,0.8403,119,"[18, 19, 30, 32, 33, 34, 35, 36, 37, 39, 57, 58, 60, 79, 80, 81, 98, 99, 102]"

Norman,L50,middle,19,10,9,4,0.8403,119,"[19, 30, 31, 32, 33, 34, 36, 37, 38, 39, 57, 58, 59, 61, 79, 83, 100, 101, 105]"

Norman,L50,middle,17,13,4,2,0.8547,117,"[20, 33, 35, 36, 37, 40, 57, 58, 61, 78, 79, 80, 81, 97, 98, 100, 102]"

Norman,L50,middle,18,5,13,2,0.8475,118,"[19, 31, 32, 33, 34, 37, 38, 39, 41, 58, 60, 77, 79, 80, 81, 82, 99, 103]"

Norman,L50,middle,17,11,6,3,0.8547,117,"[9, 17, 18, 19, 20, 22, 41, 42, 60, 61, 64, 81, 82, 98, 99, 100, 103]"

Norman,L50,middle,18,7,11,1,0.8475,118,"[9, 17, 19, 36, 37, 39, 40, 42, 59, 60, 61, 64, 81, 83, 84, 101, 103, 104]"

Norman,L50,middle,12,2,10,11,0.8929,112,"[10, 18, 25, 42, 58, 60, 76, 77, 79, 81, 97, 102]"

Norman,L50,middle,19,3,16,2,0.8403,119,"[18, 20, 32, 33, 35, 36, 40, 57, 58, 59, 60, 61, 63, 65, 83, 84, 102, 104, 105]"

Norman,L50,middle,18,8,10,3,0.8475,118,"[18, 19, 20, 21, 25, 39, 42, 44, 61, 63, 64, 66, 83, 85, 86, 102, 105, 106]"

Norman,L50,middle,17,14,3,3,0.8547,117,"[9, 18, 19, 36, 37, 38, 40, 43, 60, 61, 62, 63, 81, 82, 85, 102, 104]"

Norman,L50,middle,20,9,11,1,0.8333,120,"[18, 19, 20, 21, 23, 35, 38, 39, 40, 41, 42, 43, 62, 63, 64, 81, 85, 86, 103, 106]"

Norman,L50,middle,18,10,8,1,0.8475,118,"[18, 19, 22, 34, 36, 37, 38, 41, 58, 61, 78, 79, 80, 81, 82, 101, 102, 104]"

Norman,L50,middle,18,12,6,3,0.8475,118,"[19, 20, 21, 35, 36, 38, 39, 40, 41, 42, 44, 62, 64, 82, 84, 88, 105, 106]"

Norman,L50,middle,15,8,7,6,0.8696,115,"[9, 17, 18, 20, 38, 40, 58, 59, 75, 76, 77, 79, 83, 100, 102]"

Norman,L50,middle,16,7,9,1,0.8621,116,"[18, 20, 32, 33, 35, 37, 39, 56, 58, 59, 76, 78, 80, 98, 99, 100]"

Norman,L50,middle,21,11,10,3,0.8264,121,"[10, 18, 19, 36, 38, 39, 40, 41, 43, 44, 61, 62, 63, 65, 83, 84, 85, 86, 103, 104, 108]"

Norman,L50,middle,14,11,3,1,0.8772,114,"[9, 17, 18, 19, 37, 39, 59, 75, 76, 77, 80, 96, 97, 99]"

Norman,L50,middle,18,6,12,4,0.8475,118,"[18, 20, 21, 34, 35, 36, 37, 39, 40, 42, 61, 63, 80, 82, 84, 101, 102, 104]"

Norman,L50,middle,16,7,9,6,0.8621,116,"[18, 19, 21, 33, 34, 35, 37, 39, 42, 61, 78, 79, 80, 96, 99, 103]"

Norman,L50,middle,19,18,1,0,0.8403,119,"[9, 17, 18, 19, 36, 37, 39, 56, 57, 58, 59, 76, 77, 78, 79, 96, 97, 98, 100]"

Norman,L50,middle,17,11,6,1,0.8547,117,"[9, 18, 19, 36, 37, 39, 57, 59, 60, 76, 77, 78, 79, 81, 98, 99, 100]"

Norman,L50,middle,17,10,7,3,0.8547,117,"[18, 21, 33, 36, 37, 39, 55, 58, 59, 60, 62, 79, 80, 81, 97, 99, 101]"

Norman,L50,middle,14,6,8,3,0.8772,114,"[10, 18, 20, 36, 37, 39, 41, 58, 59, 62, 79, 82, 98, 101]"

Norman,L50,middle,15,6,9,6,0.8696,115,"[19, 30, 31, 32, 33, 35, 36, 38, 42, 61, 81, 97, 98, 100, 103]"

Norman,L50,middle,12,2,10,7,0.8929,112,"[10, 21, 37, 41, 59, 75, 77, 78, 79, 95, 98, 102]"

Norman,L50,middle,18,12,6,1,0.8475,118,"[18, 19, 30, 31, 33, 34, 36, 38, 40, 41, 59, 61, 79, 82, 98, 100, 101, 102]"

Norman,L50,middle,15,9,6,4,0.8696,115,"[18, 19, 31, 32, 34, 37, 38, 39, 56, 57, 61, 79, 82, 98, 101]"

Norman,L50,middle,15,8,7,5,0.8696,115,"[18, 21, 34, 35, 36, 37, 38, 40, 43, 63, 80, 82, 98, 100, 102]"

Norman,L50,middle,23,2,21,0,0.813,123,"[18, 19, 20, 33, 35, 36, 37, 38, 39, 40, 58, 60, 78, 79, 81, 82, 99, 100, 101, 102, 103, 104, 121]"

Norman,L50,middle,14,2,12,1,0.8772,114,"[18, 20, 32, 34, 35, 39, 41, 59, 62, 80, 81, 97, 98, 101]"

Norman,L50,middle,15,3,12,12,0.8696,115,"[18, 19, 21, 34, 38, 40, 57, 58, 59, 60, 69, 86, 101, 102, 103]"

Norman,L50,middle,15,10,5,3,0.8696,115,"[21, 34, 36, 37, 40, 58, 59, 61, 63, 81, 82, 98, 100, 101, 102]"

Norman,L50,middle,19,16,3,1,0.8403,119,"[10, 19, 35, 36, 37, 38, 39, 40, 60, 61, 62, 63, 64, 65, 83, 84, 85, 87, 106]"

Norman,L50,middle,14,3,11,5,0.8772,114,"[10, 18, 19, 36, 38, 39, 56, 57, 58, 59, 76, 78, 83, 100]"

Norman,L50,middle,19,3,16,1,0.8403,119,"[18, 19, 21, 34, 35, 36, 37, 38, 40, 42, 60, 61, 78, 80, 81, 82, 99, 100, 103]"

Norman,L50,middle,16,11,5,5,0.8621,116,"[9, 17, 19, 23, 39, 40, 56, 59, 62, 78, 80, 96, 97, 98, 99, 100]"

Norman,L50,middle,18,12,6,3,0.8475,118,"[18, 19, 30, 31, 33, 36, 37, 39, 40, 58, 60, 63, 80, 81, 83, 100, 101, 103]"

Norman,L50,middle,15,5,10,3,0.8696,115,"[10, 19, 35, 36, 37, 38, 40, 57, 58, 60, 78, 81, 83, 100, 104]"

Norman,L50,middle,21,8,13,2,0.8264,121,"[9, 17, 18, 19, 37, 38, 39, 57, 58, 59, 60, 77, 78, 79, 80, 81, 82, 83, 101, 104, 107]"

Norman,L50,middle,14,12,2,4,0.8772,114,"[9, 17, 18, 19, 36, 37, 39, 42, 60, 76, 78, 79, 80, 102]"

Norman,L50,middle,17,6,11,2,0.8547,117,"[19, 30, 32, 33, 35, 36, 37, 38, 41, 58, 60, 78, 80, 96, 97, 99, 100]"

Norman,L50,middle,17,6,11,0,0.8547,117,"[11, 19, 35, 36, 37, 38, 39, 58, 59, 75, 76, 77, 79, 80, 81, 98, 101]"

Norman,L50,middle,17,9,8,4,0.8547,117,"[19, 21, 33, 35, 36, 37, 38, 41, 58, 59, 60, 77, 80, 82, 99, 100, 102]"

Norman,L50,middle,18,11,7,3,0.8475,118,"[10, 18, 19, 36, 38, 39, 41, 58, 59, 61, 78, 79, 81, 97, 98, 100, 101, 103]"

Norman,L50,middle,16,2,14,3,0.8621,116,"[12, 20, 36, 37, 38, 39, 56, 58, 59, 76, 81, 97, 99, 100, 101, 103]"

Norman,L50,middle,16,6,10,4,0.8621,116,"[18, 19, 30, 33, 34, 35, 37, 38, 40, 57, 59, 60, 78, 79, 82, 101]"

Norman,L50,middle,16,12,4,5,0.8621,116,"[18, 19, 30, 34, 35, 38, 43, 59, 61, 78, 79, 80, 96, 97, 98, 100]"

Norman,L50,middle,19,15,4,0,0.8403,119,"[9, 18, 19, 20, 37, 38, 39, 40, 41, 59, 60, 61, 79, 81, 82, 99, 100, 101, 103]"

Norman,L50,middle,17,10,7,3,0.8547,117,"[18, 20, 32, 33, 36, 41, 44, 61, 62, 65, 82, 83, 85, 101, 102, 103, 105]"

Norman,L50,middle,14,9,5,3,0.8772,114,"[11, 22, 38, 40, 57, 58, 60, 61, 79, 80, 82, 99, 101, 102]"

Norman,L50,middle,13,12,1,4,0.885,113,"[9, 18, 19, 36, 37, 41, 58, 59, 76, 79, 95, 96, 101]"

Norman,L50,middle,17,10,7,0,0.8547,117,"[9, 17, 19, 37, 40, 57, 58, 59, 60, 76, 77, 78, 79, 80, 97, 99, 100]"

Norman,L50,middle,16,12,4,0,0.8621,116,"[9, 17, 18, 19, 36, 37, 38, 39, 40, 57, 60, 77, 81, 99, 101, 103]"

Norman,L50,middle,15,7,8,2,0.8696,115,"[12, 19, 36, 37, 38, 39, 56, 57, 58, 61, 78, 79, 96, 98, 99]"

Norman,L50,middle,18,4,14,1,0.8475,118,"[10, 18, 19, 39, 55, 56, 57, 58, 59, 75, 76, 77, 78, 79, 80, 82, 100, 103]"

Norman,L50,middle,14,5,9,1,0.8772,114,"[11, 19, 35, 40, 57, 58, 60, 77, 78, 79, 80, 97, 99, 101]"

Norman,L50,middle,15,10,5,4,0.8696,115,"[18, 19, 31, 32, 33, 34, 35, 38, 42, 60, 78, 79, 96, 97, 99]"

Norman,L50,middle,19,12,7,2,0.8403,119,"[18, 19, 30, 31, 32, 34, 35, 36, 37, 38, 39, 57, 58, 60, 78, 80, 97, 99, 116]"

Norman,L50,middle,18,11,7,1,0.8475,118,"[9, 17, 18, 19, 36, 37, 39, 56, 58, 60, 77, 78, 79, 80, 97, 99, 100, 101]"

Norman,L50,middle,16,7,9,4,0.8621,116,"[18, 19, 20, 32, 33, 34, 36, 38, 39, 41, 59, 60, 61, 84, 101, 102]"

Norman,L50,middle,17,9,8,4,0.8547,117,"[19, 21, 33, 35, 36, 37, 39, 41, 59, 60, 61, 78, 81, 98, 99, 100, 103]"

Norman,L50,middle,18,12,6,1,0.8475,118,"[18, 19, 31, 35, 38, 40, 58, 59, 60, 77, 78, 79, 81, 98, 99, 101, 103, 105]"

Norman,L50,middle,14,6,8,2,0.8772,114,"[10, 19, 35, 36, 37, 38, 41, 58, 59, 61, 64, 82, 98, 102]"

Norman,L50,middle,14,13,1,4,0.8772,114,"[9, 18, 19, 20, 37, 38, 39, 40, 57, 58, 59, 60, 83, 101]"

Norman,L50,middle,26,7,19,0,0.7937,126,"[18, 19, 20, 32, 33, 36, 37, 39, 40, 57, 59, 60, 78, 79, 80, 81, 98, 99, 100, 101, 118, 120, 121, 122, 123, 124]"

Norman,L50,middle,16,9,7,4,0.8621,116,"[9, 18, 21, 37, 39, 40, 41, 59, 60, 61, 63, 82, 84, 102, 103, 105]"

Norman,L50,middle,20,6,14,0,0.8333,120,"[18, 19, 31, 32, 33, 34, 35, 37, 38, 39, 40, 59, 62, 79, 81, 82, 99, 100, 101, 102]"

Norman,L50,middle,17,8,9,1,0.8547,117,"[18, 20, 32, 33, 35, 38, 39, 40, 57, 59, 61, 78, 80, 96, 98, 99, 100]"

Norman,L50,middle,20,4,16,0,0.8333,120,"[18, 19, 31, 32, 34, 35, 36, 37, 39, 40, 59, 60, 78, 79, 80, 97, 98, 100, 101, 118]"

Norman,L50,middle,23,7,16,0,0.813,123,"[9, 19, 20, 21, 38, 39, 40, 41, 58, 59, 60, 61, 62, 79, 80, 81, 83, 85, 102, 103, 104, 105, 106]"

Norman,L50,middle,19,11,8,0,0.8403,119,"[9, 17, 18, 19, 36, 37, 40, 57, 59, 60, 77, 78, 79, 80, 98, 99, 100, 101, 102]"

Norman,L50,middle,14,5,9,3,0.8772,114,"[9, 17, 19, 37, 38, 39, 40, 59, 62, 79, 80, 82, 98, 101]"

Norman,L50,middle,14,11,3,7,0.8772,114,"[9, 17, 18, 19, 20, 25, 43, 60, 62, 78, 80, 81, 97, 101]"

Norman,L50,middle,19,9,10,1,0.8403,119,"[18, 19, 30, 32, 34, 35, 36, 38, 39, 58, 59, 61, 78, 80, 82, 99, 101, 102, 103]"

Norman,L50,middle,15,9,6,0,0.8696,115,"[18, 19, 20, 35, 36, 37, 38, 39, 40, 57, 59, 60, 78, 80, 100]"

Norman,L50,middle,19,16,3,4,0.8403,119,"[9, 17, 18, 19, 36, 37, 38, 39, 56, 57, 58, 59, 78, 80, 98, 99, 100, 101, 105]"

Norman,L50,middle,16,3,13,5,0.8621,116,"[11, 19, 22, 38, 39, 40, 41, 42, 59, 60, 61, 62, 80, 81, 85, 102]"

Norman,L50,middle,14,7,7,3,0.8772,114,"[18, 20, 32, 36, 37, 41, 58, 59, 60, 78, 80, 81, 83, 103]"

Norman,L50,middle,15,6,9,5,0.8696,115,"[10, 21, 37, 38, 39, 41, 57, 60, 76, 80, 81, 82, 100, 101, 105]"

Norman,L50,middle,17,8,9,1,0.8547,117,"[18, 19, 31, 32, 34, 35, 36, 39, 60, 77, 78, 79, 95, 96, 97, 98, 100]"

Norman,L50,middle,17,5,12,4,0.8547,117,"[18, 19, 23, 36, 38, 39, 40, 41, 59, 60, 61, 64, 81, 82, 100, 101, 102]"

Norman,L50,middle,17,10,7,5,0.8547,117,"[9, 19, 20, 37, 39, 42, 59, 60, 61, 62, 65, 82, 85, 101, 102, 103, 106]"

Norman,L50,middle,15,8,7,3,0.8696,115,"[19, 30, 31, 32, 33, 34, 36, 37, 38, 39, 58, 59, 80, 96, 101]"

Norman,L50,middle,18,14,4,2,0.8475,118,"[18, 20, 33, 35, 37, 38, 39, 40, 41, 58, 60, 63, 80, 81, 82, 100, 101, 102]"

Norman,L50,middle,16,13,3,1,0.8621,116,"[9, 17, 19, 36, 37, 38, 39, 41, 59, 61, 78, 79, 80, 81, 99, 102]"

Norman,L50,middle,20,8,12,3,0.8333,120,"[9, 17, 18, 19, 20, 37, 39, 41, 58, 59, 60, 61, 78, 79, 80, 81, 98, 100, 101, 104]"

Norman,L50,middle,14,4,10,1,0.8772,114,"[11, 19, 35, 36, 38, 39, 56, 57, 58, 60, 77, 80, 96, 100]"

Norman,L50,middle,20,11,9,0,0.8333,120,"[18, 19, 31, 32, 34, 35, 36, 38, 39, 57, 58, 59, 60, 78, 79, 80, 97, 99, 100, 116]"

Norman,L50,middle,18,8,10,8,0.8475,118,"[18, 22, 35, 36, 37, 40, 41, 58, 59, 60, 63, 80, 81, 84, 100, 101, 102, 105]"

Norman,L50,middle,14,2,12,6,0.8772,114,"[11, 19, 35, 37, 38, 39, 40, 57, 59, 60, 77, 79, 83, 103]"

Norman,L50,middle,14,8,6,6,0.8772,114,"[18, 21, 33, 35, 36, 37, 38, 42, 59, 76, 78, 79, 95, 101]"

Norman,L50,middle,16,10,6,4,0.8621,116,"[9, 17, 18, 20, 23, 40, 41, 43, 60, 61, 63, 80, 82, 84, 101, 103]"

Norman,L50,middle,17,7,10,3,0.8547,117,"[18, 19, 22, 34, 36, 37, 38, 40, 59, 60, 62, 80, 82, 99, 100, 101, 103]"

Norman,L50,middle,18,7,11,3,0.8475,118,"[9, 17, 19, 20, 38, 39, 40, 42, 46, 63, 80, 81, 82, 83, 99, 100, 101, 103]"

Norman,L50,middle,18,8,10,3,0.8475,118,"[18, 20, 32, 33, 34, 36, 37, 38, 39, 57, 59, 76, 77, 79, 82, 99, 100, 101]"

Norman,L50,middle,19,5,14,0,0.8403,119,"[18, 19, 30, 32, 33, 34, 37, 38, 39, 59, 60, 77, 79, 80, 96, 98, 99, 100, 102]"

Norman,L50,middle,17,7,10,3,0.8547,117,"[10, 19, 20, 37, 38, 39, 40, 57, 58, 59, 62, 79, 81, 97, 98, 99, 100]"

Norman,L50,middle,16,8,8,1,0.8621,116,"[10, 18, 19, 20, 37, 38, 40, 57, 58, 59, 60, 79, 81, 97, 100, 101]"

Norman,L50,middle,13,7,6,10,0.885,113,"[20, 32, 33, 34, 38, 40, 46, 64, 82, 97, 98, 99, 101]"

Norman,L50,middle,17,8,9,3,0.8547,117,"[12, 19, 21, 37, 38, 39, 40, 44, 61, 78, 80, 82, 98, 101, 102, 104, 105]"

Norman,L50,middle,16,6,10,0,0.8621,116,"[10, 18, 19, 20, 38, 39, 40, 59, 60, 76, 77, 78, 79, 80, 97, 100]"

Norman,L50,middle,13,6,7,6,0.885,113,"[18, 23, 37, 38, 39, 57, 58, 60, 77, 78, 80, 96, 99]"

Norman,L50,middle,18,11,7,2,0.8475,118,"[9, 17, 18, 19, 36, 39, 40, 58, 59, 60, 61, 79, 80, 83, 99, 100, 101, 102]"

Norman,L50,middle,15,9,6,0,0.8696,115,"[9, 17, 19, 36, 37, 39, 56, 58, 60, 61, 80, 82, 98, 101, 102]"

Norman,L50,middle,16,9,7,0,0.8621,116,"[9, 17, 18, 19, 37, 38, 39, 58, 59, 75, 77, 78, 79, 96, 98, 99]"

Norman,L50,middle,18,12,6,2,0.8475,118,"[18, 19, 32, 38, 41, 57, 58, 59, 76, 77, 78, 79, 97, 98, 99, 100, 102, 103]"

Norman,L50,middle,19,9,10,3,0.8403,119,"[19, 20, 32, 33, 34, 35, 37, 39, 40, 42, 60, 62, 79, 81, 98, 99, 100, 101, 103]"

Norman,L50,middle,17,8,9,3,0.8547,117,"[19, 30, 31, 32, 33, 34, 36, 38, 39, 59, 77, 78, 79, 82, 99, 100, 102]"

Norman,L50,middle,16,6,10,4,0.8621,116,"[9, 17, 22, 39, 55, 56, 57, 58, 59, 75, 76, 77, 79, 96, 98, 100]"

Norman,L50,middle,16,9,7,0,0.8621,116,"[9, 18, 20, 36, 38, 39, 40, 57, 58, 60, 79, 80, 96, 98, 99, 100]"

Norman,L50,middle,19,14,5,3,0.8403,119,"[19, 20, 24, 41, 57, 58, 59, 60, 61, 78, 79, 81, 97, 98, 99, 100, 101, 102, 103]"

Norman,L50,middle,18,15,3,4,0.8475,118,"[22, 38, 40, 55, 56, 59, 75, 76, 77, 78, 79, 80, 96, 97, 98, 99, 100, 101]"

Norman,L50,middle,17,12,5,3,0.8547,117,"[18, 21, 33, 35, 37, 38, 39, 56, 57, 58, 59, 60, 78, 79, 81, 99, 100]"

Norman,L50,middle,18,7,11,0,0.8475,118,"[19, 30, 31, 32, 34, 35, 36, 38, 39, 58, 59, 76, 77, 79, 80, 97, 98, 100]"

Norman,L50,middle,20,10,10,2,0.8333,120,"[18, 19, 20, 21, 22, 35, 36, 39, 40, 41, 44, 62, 79, 81, 82, 99, 100, 102, 103, 104]"

Norman,L50,middle,14,9,5,4,0.8772,114,"[9, 17, 18, 19, 36, 37, 39, 57, 61, 80, 96, 98, 99, 101]"

Norman,L50,middle,20,9,11,4,0.8333,120,"[20, 31, 33, 34, 35, 36, 37, 38, 39, 57, 58, 59, 60, 78, 80, 81, 84, 101, 102, 105]"

Norman,L50,middle,17,9,8,2,0.8547,117,"[18, 19, 30, 31, 33, 35, 36, 37, 39, 57, 58, 60, 80, 96, 97, 99, 101]"

Norman,L50,middle,14,7,7,2,0.8772,114,"[9, 17, 18, 19, 20, 21, 40, 41, 62, 79, 80, 81, 83, 102]"

Norman,L50,middle,17,13,4,0,0.8547,117,"[9, 17, 18, 19, 36, 39, 40, 58, 60, 76, 78, 79, 80, 97, 98, 99, 100]"

Norman,L50,middle,14,7,7,9,0.8772,114,"[22, 35, 36, 37, 42, 60, 67, 83, 97, 98, 99, 100, 101, 103]"

Norman,L50,middle,19,13,6,2,0.8403,119,"[9, 18, 19, 20, 21, 22, 23, 24, 43, 45, 65, 82, 83, 84, 101, 103, 104, 105, 106]"

Norman,L50,middle,15,6,9,1,0.8696,115,"[19, 21, 33, 35, 40, 41, 59, 61, 79, 80, 82, 97, 99, 100, 101]"

Norman,L50,middle,17,8,9,4,0.8547,117,"[19, 31, 33, 34, 35, 36, 37, 38, 40, 57, 62, 79, 81, 97, 99, 100, 102]"

Norman,L50,middle,19,10,9,1,0.8403,119,"[18, 19, 20, 32, 33, 34, 35, 41, 59, 60, 61, 62, 79, 81, 82, 100, 101, 102, 103]"

Norman,L50,middle,19,10,9,1,0.8403,119,"[9, 17, 20, 37, 39, 40, 57, 58, 59, 60, 77, 79, 80, 82, 98, 100, 101, 102, 103]"

Norman,L50,middle,20,3,17,0,0.8333,120,"[19, 20, 32, 34, 35, 36, 37, 38, 39, 40, 58, 59, 61, 80, 81, 98, 99, 100, 101, 118]"

Norman,L50,middle,20,4,16,3,0.8333,120,"[18, 20, 32, 33, 34, 35, 38, 40, 41, 43, 61, 62, 63, 64, 65, 68, 86, 103, 105, 106]"

Norman,L50,middle,23,11,12,3,0.813,123,"[9, 19, 35, 36, 37, 38, 40, 57, 58, 59, 61, 62, 79, 80, 81, 82, 84, 85, 87, 104, 105, 106, 108]"

Norman,L50,middle,18,9,9,0,0.8475,118,"[11, 20, 36, 37, 38, 39, 40, 57, 58, 61, 78, 79, 80, 81, 98, 99, 100, 101]"

Norman,L50,middle,14,5,9,1,0.8772,114,"[9, 20, 36, 37, 40, 41, 57, 62, 78, 80, 81, 97, 100, 101]"

Norman,L50,middle,15,7,8,5,0.8696,115,"[10, 18, 20, 21, 38, 40, 43, 60, 61, 62, 79, 80, 82, 100, 105]"

Norman,L50,middle,17,13,4,1,0.8547,117,"[9, 18, 20, 39, 40, 56, 58, 60, 76, 78, 79, 80, 81, 82, 98, 101, 102]"

Norman,L50,middle,16,8,8,0,0.8621,116,"[9, 17, 19, 37, 39, 40, 57, 58, 60, 61, 79, 80, 81, 99, 100, 102]"

Norman,L50,middle,18,10,8,5,0.8475,118,"[18, 19, 30, 31, 32, 33, 34, 35, 36, 37, 39, 59, 78, 80, 96, 98, 99, 104]"

Norman,L50,middle,13,10,3,5,0.885,113,"[9, 18, 20, 36, 42, 60, 63, 79, 81, 97, 99, 100, 101]"

Norman,L50,middle,13,5,8,4,0.885,113,"[9, 17, 19, 37, 38, 39, 41, 58, 62, 78, 81, 97, 100]"

Norman,L50,middle,19,12,7,0,0.8403,119,"[18, 19, 30, 31, 33, 35, 37, 39, 41, 42, 43, 61, 63, 80, 82, 83, 100, 102, 103]"

Norman,L50,middle,17,8,9,2,0.8547,117,"[10, 19, 21, 39, 42, 59, 60, 62, 78, 81, 83, 84, 100, 102, 103, 104, 106]"

Norman,L50,middle,14,3,11,8,0.8772,114,"[11, 20, 36, 37, 39, 40, 56, 58, 59, 61, 78, 80, 87, 103]"

Norman,L50,middle,19,11,8,0,0.8403,119,"[9, 17, 18, 21, 40, 41, 57, 59, 60, 62, 63, 64, 82, 83, 85, 86, 87, 105, 109]"

Norman,L50,middle,20,18,2,3,0.8333,120,"[18, 19, 23, 39, 40, 42, 58, 59, 60, 61, 62, 63, 81, 82, 83, 84, 101, 102, 103, 104]"

Norman,L50,middle,15,5,10,3,0.8696,115,"[10, 19, 20, 21, 23, 40, 41, 44, 61, 62, 63, 81, 83, 100, 103]"

Norman,L50,middle,17,14,3,2,0.8547,117,"[10, 18, 19, 36, 40, 56, 58, 61, 77, 78, 79, 80, 96, 97, 98, 99, 100]"

Norman,L50,middle,14,12,2,11,0.8772,114,"[11, 26, 42, 59, 61, 76, 78, 79, 81, 82, 98, 100, 101, 102]"

Norman,L50,middle,17,6,11,0,0.8547,117,"[10, 18, 19, 36, 37, 39, 40, 57, 60, 76, 77, 78, 79, 80, 97, 100, 102]"

Norman,L50,middle,17,8,9,1,0.8547,117,"[10, 18, 19, 38, 40, 56, 58, 59, 60, 76, 77, 78, 79, 80, 97, 99, 100]"

Norman,L50,middle,18,3,15,4,0.8475,118,"[9, 17, 18, 21, 38, 39, 40, 57, 58, 59, 60, 61, 78, 79, 84, 101, 103, 104]"

Norman,L50,middle,16,11,5,2,0.8621,116,"[9, 17, 18, 21, 40, 41, 57, 60, 61, 78, 79, 80, 81, 100, 101, 102]"

Norman,L50,middle,17,5,12,3,0.8547,117,"[18, 20, 32, 33, 34, 35, 36, 37, 38, 39, 58, 60, 79, 80, 83, 100, 101]"

Norman,L50,middle,13,9,4,10,0.885,113,"[9, 18, 21, 37, 38, 44, 62, 79, 96, 97, 98, 99, 100]"

Norman,L50,middle,15,6,9,4,0.8696,115,"[9, 19, 24, 42, 44, 65, 81, 82, 83, 84, 85, 101, 104, 105, 106]"

Norman,L50,middle,16,9,7,3,0.8621,116,"[15, 23, 39, 40, 41, 42, 59, 60, 61, 63, 80, 81, 83, 100, 102, 104]"

Norman,L50,middle,18,18,0,4,0.8475,118,"[9, 17, 18, 19, 20, 37, 38, 39, 41, 45, 63, 80, 81, 82, 98, 100, 101, 102]"

Norman,L50,middle,19,10,9,1,0.8403,119,"[9, 17, 19, 20, 37, 38, 40, 57, 58, 60, 61, 62, 79, 80, 81, 83, 100, 101, 102]"

Norman,L50,middle,16,5,11,1,0.8621,116,"[18, 20, 33, 34, 35, 36, 37, 38, 39, 57, 60, 79, 80, 96, 98, 100]"

Norman,L50,middle,15,10,5,2,0.8696,115,"[9, 17, 21, 37, 39, 56, 58, 59, 75, 78, 79, 95, 96, 97, 99]"

Norman,L50,middle,21,5,16,1,0.8264,121,"[19, 30, 32, 33, 34, 36, 37, 38, 39, 58, 59, 60, 78, 79, 80, 97, 98, 99, 100, 116, 119]"

Norman,L50,middle,21,7,14,1,0.8264,121,"[18, 19, 30, 31, 34, 35, 36, 38, 39, 40, 58, 59, 60, 78, 79, 81, 98, 99, 100, 102, 119]"

Norman,L50,middle,16,10,6,2,0.8621,116,"[20, 31, 33, 35, 36, 37, 38, 39, 58, 59, 76, 79, 80, 97, 99, 101]"

Norman,L50,middle,16,12,4,2,0.8621,116,"[13, 20, 36, 39, 40, 56, 59, 60, 76, 77, 78, 79, 80, 97, 99, 101]"

Norman,L50,middle,19,9,10,2,0.8403,119,"[10, 18, 21, 37, 38, 40, 56, 58, 59, 62, 79, 80, 81, 82, 83, 100, 101, 103, 105]"

Norman,L50,middle,17,16,1,3,0.8547,117,"[9, 17, 18, 19, 36, 37, 39, 56, 58, 61, 78, 80, 96, 97, 98, 99, 101]"

Norman,L50,middle,19,0,19,1,0.8403,119,"[18, 19, 20, 33, 34, 35, 36, 37, 38, 39, 40, 61, 78, 80, 97, 98, 99, 100, 117]"

Norman,L50,middle,18,12,6,2,0.8475,118,"[9, 17, 18, 19, 37, 38, 41, 58, 59, 60, 61, 63, 80, 82, 83, 100, 102, 105]"

Norman,L50,middle,17,8,9,3,0.8547,117,"[9, 17, 19, 36, 37, 39, 40, 41, 58, 59, 60, 61, 65, 83, 99, 102, 104]"

Norman,L50,middle,22,8,14,3,0.8197,122,"[18, 19, 21, 33, 35, 36, 37, 38, 39, 41, 59, 60, 61, 64, 81, 83, 84, 103, 105, 106, 108, 109]"

Norman,L50,middle,15,6,9,2,0.8696,115,"[9, 19, 37, 38, 40, 56, 58, 60, 61, 79, 80, 81, 83, 103, 106]"

Norman,L50,middle,15,13,2,8,0.8696,115,"[21, 33, 34, 35, 37, 38, 43, 59, 77, 78, 80, 96, 97, 98, 100]"

Norman,L50,middle,15,4,11,5,0.8696,115,"[11, 19, 35, 36, 38, 39, 40, 43, 64, 80, 81, 97, 99, 100, 101]"

Norman,L50,middle,17,10,7,0,0.8547,117,"[9, 18, 19, 36, 37, 40, 57, 58, 59, 60, 77, 78, 80, 97, 98, 99, 100]"

Norman,L50,middle,21,7,14,1,0.8264,121,"[18, 19, 20, 21, 22, 34, 35, 36, 40, 41, 44, 62, 63, 64, 81, 85, 87, 104, 105, 107, 108]"

Norman,L50,middle,16,3,13,5,0.8621,116,"[18, 19, 30, 33, 35, 36, 41, 58, 59, 60, 77, 79, 80, 84, 100, 101]"

Norman,L50,middle,14,9,5,3,0.8772,114,"[18, 19, 20, 36, 37, 38, 39, 41, 60, 77, 82, 97, 100, 101]"

Norman,L50,middle,16,9,7,2,0.8621,116,"[9, 17, 19, 20, 21, 22, 39, 42, 63, 79, 80, 81, 83, 100, 102, 104]"

Norman,L50,middle,16,14,2,1,0.8621,116,"[9, 17, 18, 19, 36, 37, 39, 56, 57, 59, 76, 80, 97, 98, 99, 100]"

Norman,L50,middle,18,9,9,2,0.8475,118,"[18, 19, 20, 23, 36, 37, 40, 41, 59, 60, 62, 79, 80, 82, 98, 100, 102, 103]"

Norman,L50,middle,18,7,11,2,0.8475,118,"[18, 19, 20, 22, 35, 36, 37, 38, 40, 41, 59, 61, 78, 80, 82, 99, 100, 101]"

Norman,L50,middle,18,9,9,1,0.8475,118,"[19, 31, 33, 34, 35, 37, 38, 39, 57, 58, 59, 60, 78, 80, 81, 99, 101, 103]"

Norman,L50,middle,19,10,9,2,0.8403,119,"[10, 19, 20, 21, 38, 40, 41, 59, 60, 62, 79, 80, 81, 82, 83, 84, 86, 103, 106]"

Norman,L50,middle,18,11,7,2,0.8475,118,"[9, 17, 18, 19, 36, 37, 38, 39, 41, 59, 60, 77, 79, 80, 81, 98, 100, 102]"

Norman,L50,middle,22,3,19,0,0.8197,122,"[18, 19, 31, 32, 35, 38, 40, 41, 58, 59, 60, 61, 78, 80, 81, 82, 99, 100, 101, 102, 103, 120]"

Norman,L50,middle,22,11,11,0,0.8197,122,"[19, 20, 21, 22, 34, 36, 37, 39, 40, 41, 42, 44, 62, 63, 64, 65, 84, 85, 102, 104, 105, 106]"

Norman,L100,middle,14,10,4,4,0.8772,114,"[11, 19, 23, 40, 56, 59, 60, 76, 81, 97, 98, 99, 100, 101]"

Norman,L100,middle,15,7,8,1,0.8696,115,"[9, 17, 18, 19, 38, 39, 40, 57, 59, 60, 78, 81, 97, 98, 100]"

Norman,L100,middle,14,4,10,3,0.8772,114,"[18, 20, 32, 33, 38, 39, 56, 57, 59, 77, 78, 80, 97, 100]"

Norman,L100,middle,20,11,9,2,0.8333,120,"[9, 18, 19, 20, 38, 40, 41, 58, 60, 61, 63, 64, 82, 83, 84, 85, 87, 105, 106, 108]"

Norman,L100,middle,12,9,3,9,0.8929,112,"[9, 17, 18, 19, 37, 38, 40, 58, 60, 76, 87, 103]"

Norman,L100,middle,14,4,10,2,0.8772,114,"[9, 18, 19, 37, 39, 56, 57, 58, 59, 76, 77, 78, 80, 100]"

Norman,L100,middle,14,9,5,7,0.8772,114,"[18, 19, 21, 35, 36, 37, 43, 60, 76, 77, 80, 81, 85, 102]"

Norman,L100,middle,16,10,6,2,0.8621,116,"[11, 19, 36, 39, 41, 58, 61, 77, 79, 81, 83, 99, 100, 101, 102, 104]"

Norman,L100,middle,16,10,6,3,0.8621,116,"[18, 19, 31, 32, 33, 34, 35, 36, 37, 40, 58, 61, 79, 82, 99, 101]"

Norman,L100,middle,16,4,12,0,0.8621,116,"[18, 19, 31, 33, 34, 35, 36, 37, 39, 56, 58, 59, 79, 95, 97, 99]"

Norman,L100,middle,15,9,6,6,0.8696,115,"[22, 38, 39, 40, 56, 59, 60, 61, 77, 78, 79, 80, 83, 99, 102]"

Norman,L100,middle,14,10,4,5,0.8772,114,"[9, 17, 19, 36, 37, 38, 41, 59, 75, 77, 78, 82, 99, 102]"

Norman,L100,middle,16,7,9,3,0.8621,116,"[9, 17, 18, 21, 39, 40, 41, 58, 61, 79, 80, 81, 98, 101, 102, 104]"

Norman,L100,middle,16,10,6,1,0.8621,116,"[18, 20, 32, 35, 36, 37, 38, 40, 57, 60, 61, 80, 82, 101, 102, 103]"

Norman,L100,middle,10,6,4,6,0.9091,110,"[10, 19, 38, 41, 57, 62, 77, 79, 97, 102]"

Norman,L100,middle,18,5,13,0,0.8475,118,"[10, 19, 36, 37, 38, 39, 56, 57, 58, 59, 76, 77, 80, 82, 83, 84, 101, 104]"

Norman,L100,middle,17,7,10,3,0.8547,117,"[9, 17, 18, 20, 38, 39, 40, 57, 58, 59, 60, 61, 62, 64, 82, 84, 105]"

Norman,L100,middle,16,4,12,0,0.8621,116,"[18, 19, 20, 33, 34, 35, 36, 39, 40, 60, 78, 80, 98, 99, 100, 101]"

Norman,L100,middle,17,7,10,1,0.8547,117,"[19, 20, 21, 22, 34, 36, 37, 40, 41, 42, 61, 62, 80, 81, 82, 102, 104]"

Norman,L100,middle,12,5,7,7,0.8929,112,"[20, 31, 33, 34, 38, 44, 62, 80, 83, 98, 100, 104]"

Norman,L100,middle,20,15,5,1,0.8333,120,"[9, 17, 18, 19, 20, 38, 40, 42, 44, 61, 62, 63, 64, 65, 66, 67, 86, 87, 107, 109]"

Norman,L100,middle,18,6,12,0,0.8475,118,"[9, 17, 18, 19, 37, 39, 56, 57, 58, 59, 60, 77, 78, 79, 80, 81, 99, 101]"

Norman,L100,middle,16,6,10,1,0.8621,116,"[18, 19, 20, 34, 36, 38, 39, 40, 58, 59, 60, 78, 80, 82, 100, 101]"

Norman,L100,middle,20,8,12,0,0.8333,120,"[18, 19, 20, 21, 34, 36, 39, 41, 42, 43, 61, 62, 63, 81, 82, 83, 101, 102, 103, 104]"

Norman,L100,middle,15,6,9,1,0.8696,115,"[18, 19, 31, 33, 34, 36, 39, 56, 57, 59, 77, 79, 95, 98, 100]"

Norman,L100,middle,16,7,9,2,0.8621,116,"[9, 17, 18, 20, 38, 39, 40, 58, 59, 61, 79, 80, 82, 100, 101, 102]"

Norman,L100,middle,16,5,11,2,0.8621,116,"[18, 19, 20, 33, 35, 39, 41, 58, 61, 78, 79, 81, 98, 99, 102, 103]"

Norman,L100,middle,16,8,8,4,0.8621,116,"[20, 32, 35, 36, 38, 39, 40, 57, 59, 60, 78, 79, 80, 96, 99, 103]"

Norman,L100,middle,16,6,10,1,0.8621,116,"[10, 21, 37, 38, 39, 40, 42, 59, 60, 61, 62, 81, 82, 100, 101, 102]"

Norman,L100,middle,16,6,10,0,0.8621,116,"[9, 19, 36, 37, 38, 39, 56, 58, 59, 75, 77, 79, 80, 97, 99, 100]"

Norman,L100,middle,16,5,11,2,0.8621,116,"[12, 19, 36, 37, 38, 39, 56, 57, 58, 60, 77, 78, 80, 97, 98, 99]"

Norman,L100,middle,17,8,9,0,0.8547,117,"[18, 19, 32, 33, 35, 36, 37, 39, 58, 60, 78, 80, 97, 98, 99, 100, 101]"

Norman,L100,middle,13,7,6,1,0.885,113,"[9, 19, 36, 38, 39, 57, 60, 77, 80, 97, 98, 99, 100]"

Norman,L100,middle,18,2,16,6,0.8475,118,"[18, 19, 20, 34, 35, 36, 37, 38, 39, 40, 41, 46, 64, 81, 84, 102, 103, 104]"

Norman,L100,middle,12,8,4,9,0.8929,112,"[19, 33, 34, 35, 36, 37, 38, 39, 44, 63, 84, 101]"

Norman,L100,middle,19,6,13,3,0.8403,119,"[9, 19, 20, 22, 38, 39, 40, 42, 59, 60, 61, 62, 79, 81, 82, 83, 100, 101, 104]"

Norman,L100,middle,16,8,8,1,0.8621,116,"[9, 20, 36, 37, 39, 40, 41, 58, 60, 62, 81, 83, 100, 101, 102, 103]"

Norman,L100,middle,16,13,3,1,0.8621,116,"[9, 17, 18, 19, 20, 38, 39, 40, 57, 59, 60, 80, 97, 98, 100, 103]"

Norman,L100,middle,17,15,2,2,0.8547,117,"[20, 21, 34, 35, 36, 37, 38, 40, 41, 60, 62, 79, 80, 81, 99, 100, 102]"

Norman,L100,middle,16,16,0,3,0.8621,116,"[9, 17, 18, 19, 20, 38, 43, 60, 80, 81, 83, 99, 100, 102, 103, 104]"

Norman,L100,middle,15,13,2,9,0.8696,115,"[10, 21, 38, 40, 56, 57, 58, 59, 60, 78, 79, 80, 96, 99, 106]"

Norman,L100,middle,12,5,7,1,0.8929,112,"[11, 20, 37, 38, 39, 56, 60, 76, 80, 97, 99, 100]"

Norman,L100,middle,15,7,8,3,0.8696,115,"[9, 18, 21, 37, 38, 39, 40, 41, 58, 59, 63, 83, 100, 101, 102]"

Norman,L100,middle,16,12,4,1,0.8621,116,"[18, 19, 31, 36, 37, 38, 39, 56, 58, 60, 79, 80, 97, 98, 99, 100]"

Norman,L100,middle,18,18,0,1,0.8475,118,"[9, 17, 19, 36, 40, 57, 58, 59, 64, 81, 82, 83, 84, 85, 102, 103, 104, 106]"

Norman,L100,middle,18,9,9,3,0.8475,118,"[18, 19, 31, 32, 33, 34, 36, 37, 38, 40, 60, 78, 80, 96, 98, 99, 100, 101]"

Norman,L100,middle,16,4,12,1,0.8621,116,"[18, 19, 31, 34, 35, 36, 37, 38, 39, 56, 59, 61, 79, 82, 99, 101]"

Norman,L100,middle,16,9,7,5,0.8621,116,"[18, 20, 32, 33, 36, 37, 38, 39, 56, 57, 58, 61, 80, 96, 98, 102]"

Norman,L100,middle,18,12,6,0,0.8475,118,"[18, 19, 31, 33, 37, 38, 40, 43, 44, 45, 46, 64, 65, 66, 84, 86, 105, 106]"

Norman,L100,middle,12,8,4,6,0.8929,112,"[12, 23, 39, 40, 41, 57, 58, 60, 63, 79, 81, 103]"

Norman,L100,middle,18,9,9,3,0.8475,118,"[9, 17, 18, 19, 23, 44, 61, 62, 63, 64, 65, 66, 83, 85, 86, 104, 105, 106]"

Norman,L100,middle,18,4,14,4,0.8475,118,"[18, 19, 31, 32, 35, 39, 40, 41, 59, 60, 61, 63, 82, 83, 85, 102, 104, 107]"

Norman,L100,middle,17,2,15,4,0.8547,117,"[18, 19, 32, 33, 34, 35, 36, 37, 38, 39, 41, 60, 61, 79, 81, 86, 103]"

Norman,L100,middle,14,5,9,6,0.8772,114,"[9, 17, 19, 21, 38, 39, 40, 41, 58, 60, 62, 80, 83, 103]"

Norman,L100,middle,14,4,10,4,0.8772,114,"[9, 17, 21, 37, 38, 39, 56, 57, 58, 59, 61, 79, 82, 102]"

Norman,L100,middle,12,9,3,0,0.8929,112,"[9, 17, 18, 20, 40, 57, 59, 60, 78, 80, 97, 100]"

Norman,L100,middle,13,9,4,3,0.885,113,"[9, 17, 18, 19, 21, 42, 60, 62, 78, 80, 83, 100, 104]"

Norman,L100,middle,17,10,7,4,0.8547,117,"[18, 19, 31, 34, 36, 37, 38, 40, 57, 58, 60, 62, 80, 81, 83, 101, 103]"

Norman,L100,middle,17,12,5,1,0.8547,117,"[19, 33, 34, 35, 36, 38, 39, 57, 58, 60, 78, 79, 95, 98, 99, 100, 101]"

Norman,L100,middle,16,9,7,3,0.8621,116,"[18, 19, 31, 32, 35, 36, 37, 39, 58, 61, 78, 79, 95, 97, 98, 100]"

Norman,L100,middle,16,1,15,4,0.8621,116,"[10, 20, 36, 37, 38, 39, 40, 42, 59, 60, 61, 62, 66, 83, 101, 103]"

Norman,L100,middle,17,10,7,2,0.8547,117,"[18, 20, 34, 35, 36, 37, 38, 40, 58, 59, 60, 78, 80, 81, 82, 100, 102]"

Norman,L100,middle,16,6,10,5,0.8621,116,"[18, 20, 34, 35, 36, 37, 40, 58, 59, 60, 64, 83, 99, 100, 101, 103]"

Norman,L100,middle,16,6,10,3,0.8621,116,"[19, 20, 21, 24, 38, 39, 40, 41, 42, 43, 46, 64, 81, 85, 101, 104]"

Norman,L100,middle,15,8,7,0,0.8696,115,"[9, 17, 18, 19, 37, 39, 56, 58, 59, 75, 78, 79, 80, 99, 100]"

Norman,L100,middle,17,6,11,1,0.8547,117,"[18, 20, 32, 33, 34, 36, 37, 39, 57, 58, 59, 76, 77, 79, 96, 98, 99]"

Norman,L100,middle,16,11,5,5,0.8621,116,"[9, 17, 18, 20, 38, 39, 41, 58, 61, 79, 82, 99, 100, 101, 103, 104]"

Norman,L100,middle,11,5,6,8,0.9009,111,"[11, 20, 37, 38, 43, 62, 77, 79, 96, 97, 99]"

Norman,L100,middle,11,5,6,3,0.9009,111,"[9, 19, 37, 41, 57, 59, 76, 79, 96, 98, 100]"

Norman,L100,middle,12,3,9,5,0.8929,112,"[18, 19, 23, 37, 38, 40, 57, 58, 62, 80, 99, 100]"

Norman,L100,middle,17,14,3,1,0.8547,117,"[20, 31, 38, 39, 41, 57, 59, 61, 77, 78, 79, 80, 81, 82, 103, 104, 106]"

Norman,L100,middle,19,8,11,0,0.8403,119,"[9, 17, 18, 19, 20, 39, 40, 41, 58, 60, 61, 78, 79, 80, 81, 82, 100, 101, 103]"

Norman,L100,middle,15,3,12,3,0.8696,115,"[18, 19, 31, 33, 34, 35, 40, 57, 59, 60, 79, 83, 99, 100, 101]"

Norman,L100,middle,19,13,6,1,0.8403,119,"[18, 19, 20, 23, 37, 38, 41, 43, 44, 62, 65, 83, 84, 85, 101, 103, 104, 106, 107]"

Norman,L100,middle,21,13,8,2,0.8264,121,"[9, 17, 20, 38, 40, 57, 58, 59, 60, 61, 78, 81, 82, 84, 102, 103, 104, 105, 108, 109, 110]"

Norman,L100,middle,18,7,11,1,0.8475,118,"[18, 19, 32, 33, 34, 35, 36, 38, 39, 56, 59, 60, 61, 79, 82, 83, 101, 106]"

Norman,L100,middle,14,4,10,2,0.8772,114,"[19, 31, 34, 36, 39, 59, 75, 78, 79, 95, 96, 97, 98, 101]"

Norman,L100,middle,16,8,8,3,0.8621,116,"[18, 19, 31, 33, 34, 35, 36, 40, 57, 58, 59, 61, 80, 97, 99, 101]"

Norman,L100,middle,15,10,5,3,0.8696,115,"[9, 21, 37, 39, 40, 41, 59, 62, 78, 80, 81, 83, 100, 101, 103]"

Norman,L100,middle,19,8,11,0,0.8403,119,"[19, 32, 33, 34, 35, 36, 37, 38, 39, 57, 59, 76, 77, 78, 79, 81, 82, 101, 102]"

Norman,L100,middle,15,8,7,2,0.8696,115,"[11, 19, 38, 40, 56, 57, 59, 61, 78, 79, 80, 82, 100, 101, 103]"

Norman,L100,middle,16,10,6,1,0.8621,116,"[19, 32, 33, 34, 36, 37, 38, 39, 41, 60, 78, 79, 80, 96, 99, 100]"

Norman,L100,middle,15,6,9,3,0.8696,115,"[9, 17, 19, 36, 38, 39, 41, 58, 59, 60, 63, 81, 82, 99, 102]"

Norman,L100,middle,17,6,11,1,0.8547,117,"[18, 19, 34, 38, 39, 55, 57, 58, 59, 61, 62, 80, 82, 99, 101, 103, 105]"

Norman,L100,middle,15,10,5,3,0.8696,115,"[18, 19, 31, 32, 33, 34, 35, 36, 38, 40, 58, 59, 78, 81, 99]"

Norman,L100,middle,16,9,7,2,0.8621,116,"[18, 20, 33, 35, 36, 37, 41, 58, 60, 61, 78, 79, 80, 81, 100, 102]"

Norman,L100,middle,14,5,9,7,0.8772,114,"[9, 17, 18, 19, 37, 39, 40, 57, 58, 59, 64, 81, 83, 104]"

Norman,L100,middle,15,3,12,2,0.8696,115,"[11, 20, 36, 37, 38, 39, 56, 57, 58, 59, 60, 79, 80, 82, 101]"

Norman,L100,middle,15,7,8,2,0.8696,115,"[10, 19, 20, 37, 38, 41, 58, 60, 61, 62, 79, 81, 83, 100, 102]"

Norman,L100,middle,15,3,12,3,0.8696,115,"[18, 19, 33, 34, 35, 41, 57, 60, 78, 80, 96, 97, 98, 99, 102]"

Norman,L100,middle,15,11,4,1,0.8696,115,"[9, 18, 19, 21, 38, 42, 59, 60, 61, 62, 79, 80, 82, 100, 103]"

Norman,L100,middle,18,14,4,4,0.8475,118,"[9, 17, 19, 36, 38, 39, 40, 42, 60, 61, 78, 79, 81, 98, 99, 100, 101, 105]"

Norman,L100,middle,17,11,6,3,0.8547,117,"[9, 19, 22, 38, 39, 40, 41, 59, 60, 64, 82, 84, 100, 101, 102, 104, 105]"

Norman,L100,middle,18,5,13,1,0.8475,118,"[18, 19, 31, 32, 34, 35, 36, 38, 39, 40, 58, 59, 61, 83, 84, 101, 102, 104]"

Norman,L100,middle,16,10,6,1,0.8621,116,"[18, 20, 32, 33, 36, 37, 39, 40, 57, 58, 59, 60, 61, 79, 82, 102]"

Norman,L100,middle,16,10,6,3,0.8621,116,"[9, 17, 18, 22, 39, 56, 57, 59, 75, 78, 79, 95, 96, 97, 98, 101]"

Norman,L100,middle,16,5,11,0,0.8621,116,"[18, 19, 20, 21, 34, 37, 39, 40, 41, 59, 60, 61, 79, 81, 100, 101]"

Norman,L100,middle,14,10,4,3,0.8772,114,"[9, 17, 20, 23, 39, 41, 61, 62, 80, 81, 83, 99, 101, 102]"

Norman,L100,middle,15,8,7,3,0.8696,115,"[9, 18, 19, 37, 38, 39, 40, 58, 59, 63, 82, 99, 100, 101, 102]"

Norman,L100,middle,16,13,3,1,0.8621,116,"[20, 31, 33, 35, 36, 37, 39, 40, 57, 58, 59, 61, 80, 98, 99, 100]"

Norman,L100,middle,14,6,8,4,0.8772,114,"[19, 21, 33, 35, 37, 40, 41, 42, 44, 63, 64, 83, 85, 107]"

Norman,L100,middle,12,6,6,3,0.8929,112,"[9, 19, 36, 37, 39, 58, 59, 62, 78, 81, 98, 100]"

Norman,L100,middle,17,11,6,1,0.8547,117,"[9, 17, 18, 19, 20, 38, 40, 58, 60, 76, 80, 81, 97, 98, 99, 100, 102]"

Norman,L100,middle,17,12,5,2,0.8547,117,"[9, 17, 18, 19, 20, 22, 40, 42, 59, 60, 62, 81, 84, 101, 102, 103, 104]"

Norman,L100,middle,13,3,10,5,0.885,113,"[10, 23, 41, 58, 60, 75, 77, 78, 79, 80, 97, 99, 101]"

Norman,L100,middle,21,8,13,0,0.8264,121,"[18, 19, 21, 33, 34, 35, 36, 37, 39, 40, 41, 59, 60, 61, 63, 64, 83, 84, 103, 104, 105]"

Norman,L100,middle,14,9,5,3,0.8772,114,"[9, 18, 19, 36, 37, 38, 40, 59, 61, 80, 81, 98, 100, 103]"

Norman,L100,middle,16,7,9,6,0.8621,116,"[9, 17, 18, 19, 37, 38, 40, 57, 58, 59, 76, 77, 78, 79, 83, 102]"

Norman,L100,middle,14,4,10,5,0.8772,114,"[19, 31, 32, 34, 35, 36, 37, 40, 57, 58, 60, 78, 81, 100]"

Norman,L100,middle,14,5,9,3,0.8772,114,"[18, 19, 20, 34, 38, 39, 40, 58, 59, 61, 63, 80, 84, 102]"

Norman,L100,middle,21,10,11,1,0.8264,121,"[18, 19, 20, 33, 34, 35, 36, 38, 40, 58, 59, 60, 77, 78, 79, 80, 98, 99, 100, 116, 117]"

Norman,L100,middle,17,9,8,1,0.8547,117,"[18, 19, 32, 34, 36, 37, 38, 40, 57, 58, 60, 62, 80, 81, 82, 101, 102]"

Norman,L100,middle,13,5,8,8,0.885,113,"[10, 19, 36, 37, 40, 57, 58, 62, 80, 99, 100, 101, 105]"

Norman,L100,middle,18,8,10,5,0.8475,118,"[18, 19, 33, 35, 36, 37, 38, 41, 58, 59, 60, 78, 79, 81, 99, 100, 101, 104]"

Norman,L100,middle,16,7,9,1,0.8621,116,"[12, 19, 38, 39, 40, 57, 61, 62, 79, 80, 81, 82, 99, 101, 103, 106]"

Norman,L100,middle,14,5,9,3,0.8772,114,"[11, 23, 39, 41, 57, 58, 60, 61, 79, 80, 82, 99, 102, 103]"

Norman,L100,middle,19,3,16,3,0.8403,119,"[19, 31, 32, 33, 34, 35, 36, 37, 38, 39, 40, 58, 59, 60, 63, 82, 100, 101, 105]"

Norman,L100,middle,12,3,9,0,0.8929,112,"[10, 19, 36, 38, 39, 57, 59, 75, 78, 80, 100, 101]"

Norman,L100,middle,15,3,12,4,0.8696,115,"[10, 19, 20, 22, 39, 40, 43, 60, 62, 79, 80, 81, 97, 100, 101]"

Norman,L100,middle,14,6,8,8,0.8772,114,"[10, 19, 36, 37, 38, 41, 59, 62, 78, 82, 99, 100, 101, 104]"

Norman,L100,middle,17,6,11,1,0.8547,117,"[9, 18, 19, 36, 37, 39, 40, 42, 61, 63, 80, 81, 82, 99, 101, 102, 103]"

Norman,L100,middle,19,9,10,2,0.8403,119,"[9, 17, 18, 20, 38, 40, 57, 58, 59, 60, 77, 78, 79, 80, 83, 100, 101, 102, 103]"

Norman,L100,middle,15,6,9,2,0.8696,115,"[10, 21, 37, 38, 39, 40, 57, 58, 60, 76, 78, 79, 80, 98, 100]"

Norman,L100,middle,14,4,10,2,0.8772,114,"[9, 21, 37, 38, 39, 40, 41, 58, 59, 60, 63, 81, 98, 101]"

Norman,L100,middle,16,11,5,6,0.8621,116,"[12, 20, 36, 37, 43, 61, 64, 80, 81, 82, 83, 99, 100, 101, 102, 103]"

Norman,L100,middle,14,10,4,1,0.8772,114,"[9, 17, 19, 20, 21, 22, 41, 42, 59, 60, 62, 83, 101, 102]"

Norman,L100,middle,17,5,12,1,0.8547,117,"[18, 19, 21, 33, 34, 35, 36, 38, 39, 41, 59, 60, 63, 81, 82, 101, 102]"

Norman,L100,middle,19,6,13,2,0.8403,119,"[18, 19, 20, 21, 34, 35, 38, 39, 40, 41, 60, 62, 81, 82, 100, 101, 102, 103, 105]"

Norman,L100,middle,17,9,8,2,0.8547,117,"[19, 22, 35, 36, 38, 40, 41, 42, 59, 61, 62, 79, 80, 81, 83, 101, 103]"

Norman,L100,middle,16,11,5,0,0.8621,116,"[19, 31, 34, 35, 36, 37, 38, 39, 57, 58, 60, 61, 81, 98, 99, 101]"

Norman,L100,middle,11,7,4,15,0.9009,111,"[9, 17, 18, 25, 43, 63, 79, 95, 96, 98, 100]"

Norman,L100,middle,16,7,9,6,0.8621,116,"[18, 19, 31, 32, 33, 34, 36, 37, 38, 39, 41, 59, 63, 82, 88, 107]"

Norman,L100,middle,15,5,10,1,0.8696,115,"[19, 20, 32, 34, 37, 39, 40, 58, 60, 61, 79, 80, 82, 99, 101]"

Norman,L100,middle,17,7,10,1,0.8547,117,"[18, 19, 20, 33, 34, 35, 36, 39, 40, 41, 59, 61, 80, 82, 99, 101, 103]"

Norman,L100,middle,15,8,7,0,0.8696,115,"[9, 17, 18, 19, 38, 39, 56, 58, 59, 76, 77, 79, 96, 98, 99]"

Norman,L100,middle,21,5,16,1,0.8264,121,"[18, 19, 20, 21, 34, 35, 36, 38, 39, 40, 41, 59, 60, 62, 80, 82, 83, 84, 101, 104, 105]"

Norman,L100,middle,17,10,7,4,0.8547,117,"[9, 18, 23, 40, 41, 42, 59, 60, 61, 63, 64, 81, 82, 83, 84, 102, 104]"

Norman,L100,middle,14,7,7,3,0.8772,114,"[9, 17, 20, 37, 39, 58, 61, 63, 79, 81, 85, 102, 104, 105]"

Norman,L100,middle,15,3,12,2,0.8696,115,"[9, 17, 20, 37, 38, 39, 56, 57, 58, 59, 76, 77, 78, 80, 99]"

Norman,L100,middle,20,10,10,1,0.8333,120,"[19, 20, 32, 34, 36, 37, 38, 39, 40, 42, 60, 61, 62, 63, 81, 83, 84, 86, 104, 107]"

Norman,L100,middle,18,11,7,1,0.8475,118,"[18, 19, 32, 33, 34, 35, 39, 56, 57, 58, 61, 79, 80, 81, 99, 100, 101, 102]"

Norman,L100,middle,16,11,5,3,0.8621,116,"[9, 17, 18, 19, 37, 38, 39, 40, 41, 43, 61, 63, 82, 99, 101, 103]"

Norman,L100,middle,12,5,7,2,0.8929,112,"[19, 32, 39, 55, 56, 57, 60, 77, 79, 95, 98, 101]"

Norman,L100,middle,17,10,7,1,0.8547,117,"[10, 19, 21, 37, 40, 41, 43, 44, 63, 64, 81, 83, 84, 101, 102, 103, 104]"

Norman,L100,middle,15,9,6,2,0.8696,115,"[12, 19, 36, 38, 39, 56, 58, 59, 76, 77, 78, 81, 97, 98, 99]"

Norman,L100,middle,18,15,3,3,0.8475,118,"[9, 17, 18, 19, 20, 21, 39, 40, 41, 58, 59, 60, 61, 79, 81, 99, 100, 104]"

Norman,L100,middle,19,6,13,2,0.8403,119,"[18, 20, 23, 38, 39, 40, 41, 42, 43, 44, 46, 48, 66, 67, 85, 87, 104, 106, 108]"

Norman,L100,middle,17,3,14,2,0.8547,117,"[9, 19, 20, 21, 38, 39, 40, 41, 42, 59, 60, 61, 62, 79, 83, 86, 104]"

Norman,L100,middle,16,6,10,4,0.8621,116,"[18, 19, 20, 21, 34, 35, 36, 38, 39, 41, 59, 60, 63, 81, 83, 103]"

Norman,L100,middle,16,5,11,1,0.8621,116,"[9, 17, 18, 20, 38, 39, 40, 57, 59, 60, 77, 78, 79, 80, 82, 101]"

Norman,L100,middle,19,7,12,4,0.8403,119,"[20, 21, 23, 37, 38, 40, 41, 42, 43, 44, 45, 47, 65, 66, 68, 86, 89, 107, 109]"

Norman,L100,middle,16,7,9,1,0.8621,116,"[19, 20, 32, 34, 35, 38, 39, 40, 41, 63, 81, 82, 84, 101, 102, 105]"

Norman,L100,middle,15,10,5,0,0.8696,115,"[9, 18, 19, 36, 37, 38, 39, 57, 59, 76, 79, 96, 97, 99, 100]"

Norman,L100,middle,14,12,2,5,0.8772,114,"[9, 17, 18, 19, 20, 21, 39, 40, 41, 42, 61, 63, 83, 105]"

Norman,L100,middle,15,8,7,1,0.8696,115,"[9, 17, 18, 19, 20, 22, 42, 59, 62, 63, 80, 82, 83, 84, 104]"

Norman,L100,middle,16,8,8,0,0.8621,116,"[18, 19, 20, 34, 35, 37, 38, 39, 40, 58, 60, 61, 80, 82, 99, 102]"

Norman,L100,middle,16,6,10,1,0.8621,116,"[18, 19, 34, 36, 38, 39, 57, 58, 59, 60, 61, 79, 80, 82, 99, 101]"

Norman,L100,middle,17,1,16,0,0.8547,117,"[19, 31, 33, 34, 38, 39, 56, 57, 58, 59, 77, 78, 79, 80, 97, 98, 100]"

Norman,L100,middle,15,6,9,0,0.8696,115,"[19, 32, 34, 35, 36, 37, 39, 58, 59, 79, 95, 97, 98, 99, 100]"

Norman,L100,middle,19,10,9,1,0.8403,119,"[18, 20, 32, 33, 34, 37, 38, 39, 57, 58, 59, 60, 61, 63, 83, 100, 102, 103, 104]"

Norman,L100,middle,20,12,8,1,0.8333,120,"[9, 18, 19, 20, 23, 40, 41, 42, 59, 61, 63, 64, 67, 84, 87, 88, 105, 106, 107, 109]"

Norman,L100,middle,13,8,5,1,0.885,113,"[9, 18, 19, 20, 39, 41, 60, 76, 78, 80, 97, 99, 100]"

Norman,L100,middle,17,5,12,2,0.8547,117,"[18, 20, 32, 34, 35, 38, 40, 57, 59, 78, 79, 80, 97, 99, 100, 101, 102]"

Norman,L100,middle,16,6,10,4,0.8621,116,"[19, 31, 32, 33, 34, 36, 37, 38, 40, 58, 59, 77, 78, 81, 98, 100]"

Norman,L100,middle,14,6,8,3,0.8772,114,"[18, 21, 33, 34, 35, 36, 39, 56, 58, 59, 78, 80, 97, 99]"

Norman,L100,middle,16,8,8,2,0.8621,116,"[19, 31, 33, 35, 36, 39, 56, 57, 58, 60, 78, 79, 81, 98, 99, 100]"

Norman,L100,middle,18,6,12,1,0.8475,118,"[9, 19, 36, 37, 38, 39, 40, 41, 58, 59, 60, 62, 81, 82, 99, 100, 101, 103]"

Norman,L100,middle,16,3,13,3,0.8621,116,"[18, 20, 32, 34, 35, 36, 37, 38, 39, 40, 58, 61, 79, 82, 99, 102]"

Norman,L100,middle,14,6,8,4,0.8772,114,"[19, 34, 35, 36, 37, 38, 41, 58, 61, 79, 96, 97, 98, 99]"

Norman,L100,middle,16,9,7,1,0.8621,116,"[9, 17, 18, 19, 20, 22, 40, 41, 59, 60, 61, 78, 80, 81, 98, 101]"

Norman,L100,middle,17,8,9,0,0.8547,117,"[10, 19, 36, 39, 56, 59, 60, 76, 78, 79, 80, 81, 97, 98, 99, 100, 101]"

Norman,L100,middle,14,7,7,5,0.8772,114,"[18, 20, 34, 36, 37, 38, 40, 57, 58, 60, 78, 79, 95, 101]"

Norman,L100,middle,16,7,9,2,0.8621,116,"[18, 19, 20, 21, 35, 36, 38, 39, 40, 42, 61, 64, 81, 82, 100, 102]"

Norman,L100,middle,20,11,9,1,0.8333,120,"[18, 19, 31, 32, 33, 34, 35, 38, 39, 56, 58, 59, 60, 61, 79, 80, 82, 99, 101, 102]"

Norman,L100,middle,16,0,16,2,0.8621,116,"[11, 19, 20, 21, 38, 39, 40, 41, 58, 59, 61, 62, 63, 64, 85, 105]"

Norman,L100,middle,15,0,15,0,0.8696,115,"[10, 19, 36, 37, 38, 40, 57, 58, 59, 60, 77, 78, 79, 80, 100]"

Norman,L100,middle,18,16,2,4,0.8475,118,"[9, 17, 18, 19, 38, 42, 59, 60, 77, 78, 79, 80, 81, 82, 99, 100, 101, 103]"

Norman,L100,middle,16,10,6,6,0.8621,116,"[9, 17, 18, 19, 37, 38, 40, 57, 58, 61, 80, 81, 84, 102, 103, 106]"

Norman,L100,middle,14,8,6,6,0.8772,114,"[18, 19, 31, 32, 33, 34, 35, 37, 40, 60, 82, 98, 99, 101]"

Norman,L100,middle,17,7,10,1,0.8547,117,"[20, 32, 33, 34, 35, 36, 37, 41, 59, 60, 78, 79, 80, 81, 98, 100, 102]"

Norman,L100,middle,15,9,6,4,0.8696,115,"[18, 20, 35, 36, 37, 38, 39, 40, 57, 58, 61, 81, 83, 99, 103]"

Norman,L100,middle,15,7,8,5,0.8696,115,"[18, 19, 23, 38, 39, 40, 57, 59, 61, 78, 79, 82, 99, 101, 103]"

Norman,L100,middle,16,6,10,3,0.8621,116,"[19, 31, 32, 33, 36, 37, 38, 39, 57, 58, 60, 78, 79, 95, 97, 101]"

Norman,L100,middle,14,10,4,8,0.8772,114,"[19, 22, 35, 36, 37, 38, 39, 41, 42, 61, 66, 84, 100, 104]"

Norman,L100,middle,17,10,7,1,0.8547,117,"[9, 17, 18, 21, 39, 40, 57, 58, 60, 76, 78, 80, 81, 82, 99, 100, 102]"

Norman,L100,middle,13,8,5,2,0.885,113,"[9, 18, 20, 37, 39, 57, 59, 75, 78, 80, 98, 100, 101]"

Norman,L100,middle,17,10,7,0,0.8547,117,"[10, 19, 36, 37, 39, 56, 58, 59, 60, 76, 78, 79, 80, 97, 98, 99, 100]"

Norman,L100,middle,16,3,13,4,0.8621,116,"[19, 21, 33, 34, 35, 36, 37, 38, 39, 42, 60, 62, 83, 99, 101, 103]"

Norman,L100,middle,21,9,12,2,0.8264,121,"[18, 19, 20, 21, 35, 36, 38, 39, 42, 59, 62, 79, 80, 81, 83, 84, 85, 103, 104, 105, 106]"

Norman,L100,middle,20,14,6,0,0.8333,120,"[18, 19, 21, 34, 35, 38, 39, 40, 41, 60, 62, 79, 80, 81, 82, 83, 101, 102, 103, 104]"

Norman,L100,middle,17,11,6,6,0.8547,117,"[9, 17, 19, 20, 22, 39, 40, 41, 58, 60, 66, 83, 100, 101, 102, 103, 104]"

Norman,L100,middle,16,10,6,0,0.8621,116,"[9, 17, 18, 19, 37, 38, 39, 56, 57, 59, 76, 77, 78, 79, 97, 99]"

Norman,L100,middle,22,13,9,7,0.8197,122,"[18, 19, 20, 21, 22, 35, 36, 39, 40, 41, 43, 44, 45, 46, 47, 48, 49, 68, 70, 88, 92, 112]"

Norman,L100,middle,15,3,12,3,0.8696,115,"[14, 23, 39, 41, 43, 60, 61, 62, 78, 80, 81, 82, 99, 101, 102]"

Norman,L100,middle,13,5,8,12,0.885,113,"[18, 20, 33, 34, 35, 36, 39, 40, 59, 60, 78, 88, 104]"

Norman,L100,middle,17,2,15,0,0.8547,117,"[10, 19, 36, 37, 38, 39, 40, 57, 58, 59, 60, 61, 78, 80, 81, 99, 101]"

Norman,L100,middle,14,8,6,2,0.8772,114,"[9, 18, 20, 37, 38, 42, 62, 78, 79, 82, 98, 99, 101, 103]"

Norman,L100,middle,18,12,6,1,0.8475,118,"[9, 17, 18, 20, 38, 40, 57, 58, 59, 60, 62, 80, 81, 82, 99, 100, 101, 102]"

Norman,L100,middle,15,8,7,4,0.8696,115,"[18, 20, 33, 34, 35, 37, 38, 39, 41, 59, 62, 79, 81, 98, 100]"

Norman,L100,middle,22,13,9,1,0.8197,122,"[18, 19, 31, 32, 33, 34, 35, 36, 37, 38, 40, 58, 59, 61, 79, 80, 81, 99, 100, 101, 102, 118]"

Norman,L100,middle,19,2,17,4,0.8403,119,"[18, 23, 36, 37, 38, 39, 41, 42, 59, 60, 61, 62, 64, 81, 84, 101, 102, 103, 104]"

Norman,L100,middle,18,3,15,1,0.8475,118,"[19, 20, 32, 33, 34, 36, 38, 39, 41, 59, 60, 78, 79, 80, 97, 98, 99, 100]"

Norman,L100,middle,15,8,7,8,0.8696,115,"[18, 19, 20, 22, 35, 36, 39, 40, 44, 65, 84, 100, 101, 105, 106]"

Norman,L100,middle,20,6,14,7,0.8333,120,"[18, 19, 20, 21, 23, 35, 37, 38, 39, 42, 43, 44, 63, 64, 66, 84, 85, 103, 104, 110]"

Norman,L100,middle,15,5,10,4,0.8696,115,"[19, 33, 34, 36, 37, 39, 40, 41, 58, 59, 60, 63, 83, 99, 101]"

Norman,L100,middle,14,3,11,7,0.8772,114,"[9, 19, 21, 37, 38, 39, 40, 58, 59, 65, 81, 98, 100, 103]"

Norman,L100,middle,19,9,10,2,0.8403,119,"[9, 17, 18, 19, 20, 21, 22, 41, 42, 59, 60, 61, 62, 79, 81, 82, 101, 102, 105]"

Norman,L100,middle,17,8,9,3,0.8547,117,"[9, 19, 36, 37, 38, 40, 58, 59, 60, 61, 80, 81, 83, 85, 102, 103, 106]"

Norman,L100,middle,19,11,8,2,0.8403,119,"[11, 19, 36, 37, 40, 41, 42, 60, 61, 62, 63, 82, 83, 86, 102, 103, 104, 108, 109]"

Norman,L100,middle,16,11,5,7,0.8621,116,"[10, 20, 36, 37, 41, 57, 58, 59, 76, 77, 80, 96, 97, 98, 99, 103]"

Norman,L100,middle,12,1,11,5,0.8929,112,"[10, 19, 37, 38, 39, 44, 61, 77, 78, 80, 97, 100]"

Norman,L100,middle,15,11,4,4,0.8696,115,"[9, 17, 18, 20, 40, 42, 59, 60, 61, 62, 79, 81, 82, 100, 104]"

Norman,L100,middle,16,3,13,5,0.8621,116,"[18, 20, 32, 33, 35, 36, 37, 38, 42, 59, 61, 79, 80, 96, 99, 101]"

Norman,L100,middle,14,10,4,4,0.8772,114,"[10, 19, 38, 40, 44, 62, 77, 80, 81, 98, 99, 100, 102, 105]"

Norman,L100,middle,15,11,4,2,0.8696,115,"[9, 17, 18, 19, 39, 40, 57, 59, 60, 61, 78, 80, 81, 84, 102]"

Norman,L100,middle,13,10,3,1,0.885,113,"[9, 17, 19, 20, 22, 41, 58, 59, 61, 79, 81, 99, 101]"

Norman,L100,middle,15,9,6,4,0.8696,115,"[9, 20, 38, 39, 40, 41, 43, 60, 61, 62, 64, 82, 83, 100, 104]"

Norman,L100,middle,14,6,8,4,0.8772,114,"[18, 20, 33, 36, 37, 39, 56, 58, 60, 77, 79, 97, 98, 101]"

Norman,L100,middle,15,9,6,3,0.8696,115,"[18, 19, 22, 36, 37, 38, 40, 57, 60, 62, 79, 80, 81, 100, 101]"

Norman,L100,middle,18,6,12,0,0.8475,118,"[18, 19, 20, 33, 34, 36, 37, 38, 39, 40, 59, 60, 78, 79, 82, 100, 101, 102]"

Norman,L100,middle,15,10,5,1,0.8696,115,"[10, 19, 36, 37, 40, 57, 58, 59, 61, 62, 79, 80, 83, 102, 103]"

Norman,L100,middle,18,10,8,4,0.8475,118,"[9, 18, 19, 20, 39, 43, 59, 60, 77, 78, 80, 81, 97, 98, 100, 101, 102, 104]"

Norman,L100,middle,14,9,5,2,0.8772,114,"[9, 17, 18, 19, 40, 57, 58, 59, 60, 79, 80, 97, 99, 103]"

Norman,L100,middle,15,9,6,3,0.8696,115,"[19, 32, 35, 41, 57, 59, 75, 79, 80, 95, 98, 99, 100, 101, 104]"

Norman,L100,middle,16,5,11,1,0.8621,116,"[18, 20, 21, 33, 35, 36, 37, 38, 40, 42, 60, 62, 81, 82, 99, 102]"

Norman,L100,middle,19,10,9,1,0.8403,119,"[19, 20, 21, 33, 34, 35, 37, 39, 40, 41, 59, 60, 61, 64, 82, 83, 84, 102, 104]"

Norman,L100,middle,17,7,10,1,0.8547,117,"[9, 17, 19, 36, 37, 39, 58, 60, 78, 79, 80, 81, 82, 99, 101, 102, 103]"

Norman,L100,middle,19,8,11,0,0.8403,119,"[19, 20, 21, 33, 34, 36, 39, 40, 41, 42, 61, 62, 80, 81, 83, 84, 102, 103, 104]"

Norman,L100,middle,15,5,10,2,0.8696,115,"[11, 20, 36, 37, 38, 39, 56, 58, 59, 77, 78, 80, 96, 98, 100]"

Norman,L100,middle,13,8,5,2,0.885,113,"[9, 17, 18, 20, 38, 42, 60, 76, 77, 80, 97, 100, 102]"

Norman,L100,middle,19,7,12,1,0.8403,119,"[18, 20, 34, 37, 42, 58, 60, 61, 62, 63, 82, 83, 84, 101, 102, 105, 106, 108, 109]"

Norman,L100,middle,15,8,7,1,0.8696,115,"[19, 34, 35, 38, 40, 56, 59, 60, 77, 78, 80, 96, 98, 100, 101]"

Norman,L100,middle,16,4,12,0,0.8621,116,"[18, 19, 20, 33, 34, 35, 36, 38, 39, 41, 59, 61, 79, 81, 98, 101]"

Norman,L100,middle,16,6,10,3,0.8621,116,"[19, 21, 33, 36, 37, 38, 40, 57, 58, 60, 61, 63, 80, 83, 100, 102]"

Norman,L100,middle,19,8,11,8,0.8403,119,"[10, 20, 36, 38, 39, 40, 46, 64, 81, 82, 84, 85, 86, 87, 103, 104, 105, 106, 109]"

Norman,L100,middle,16,5,11,4,0.8621,116,"[19, 31, 32, 33, 35, 36, 37, 38, 39, 56, 59, 76, 77, 78, 82, 101]"

Norman,L100,middle,15,6,9,1,0.8696,115,"[9, 17, 18, 19, 20, 39, 40, 41, 58, 59, 61, 81, 98, 100, 102]"

Norman,L100,middle,17,7,10,2,0.8547,117,"[19, 20, 33, 34, 37, 38, 39, 40, 41, 59, 60, 62, 63, 65, 84, 101, 105]"

Norman,L100,middle,20,8,12,2,0.8333,120,"[18, 19, 31, 33, 34, 35, 37, 38, 39, 41, 59, 60, 61, 79, 81, 98, 100, 101, 102, 105]"

Norman,L100,middle,17,14,3,2,0.8547,117,"[9, 17, 18, 20, 38, 39, 42, 59, 60, 62, 82, 83, 84, 85, 87, 103, 106]"

Norman,L100,middle,17,4,13,5,0.8547,117,"[9, 20, 36, 37, 38, 39, 40, 42, 59, 63, 80, 82, 83, 84, 102, 103, 105]"

Norman,L100,middle,16,8,8,4,0.8621,116,"[18, 19, 31, 33, 34, 37, 39, 56, 57, 59, 61, 80, 81, 98, 100, 105]"

Norman,L100,middle,13,6,7,3,0.885,113,"[9, 18, 20, 38, 39, 58, 60, 76, 77, 78, 80, 97, 99]"

Norman,L100,middle,18,11,7,6,0.8475,118,"[19, 23, 36, 37, 38, 40, 43, 60, 61, 78, 79, 80, 81, 98, 99, 100, 101, 104]"

Norman,L100,middle,17,13,4,2,0.8547,117,"[9, 17, 18, 19, 37, 39, 56, 57, 60, 76, 78, 79, 96, 97, 98, 99, 101]"

Norman,L100,middle,15,7,8,2,0.8696,115,"[10, 19, 36, 38, 39, 56, 58, 59, 63, 79, 83, 99, 100, 101, 102]"

Norman,L100,middle,13,7,6,2,0.885,113,"[11, 19, 36, 41, 57, 58, 59, 62, 78, 81, 99, 100, 101]"

Norman,L100,middle,18,5,13,2,0.8475,118,"[18, 19, 31, 32, 33, 35, 36, 38, 39, 40, 41, 59, 63, 81, 84, 102, 103, 104]"

Norman,L100,middle,17,11,6,0,0.8547,117,"[19, 20, 34, 35, 36, 39, 40, 58, 60, 77, 78, 79, 80, 96, 98, 99, 101]"

Norman,L100,middle,17,7,10,3,0.8547,117,"[18, 20, 21, 33, 34, 35, 39, 41, 43, 62, 79, 80, 81, 82, 100, 101, 104]"

Norman,L100,middle,18,15,3,1,0.8475,118,"[9, 17, 18, 19, 37, 38, 39, 56, 57, 58, 60, 77, 79, 82, 99, 100, 101, 102]"

Norman,L100,middle,15,8,7,2,0.8696,115,"[9, 17, 18, 19, 37, 39, 56, 58, 61, 80, 81, 98, 101, 102, 104]"

Norman,L100,middle,15,7,8,3,0.8696,115,"[19, 32, 35, 37, 38, 41, 57, 59, 76, 77, 78, 80, 98, 99, 100]"

Norman,L100,middle,15,4,11,3,0.8696,115,"[10, 19, 21, 37, 38, 39, 41, 42, 62, 63, 82, 84, 101, 102, 104]"

Norman,L100,middle,17,6,11,1,0.8547,117,"[18, 19, 31, 33, 34, 36, 37, 38, 39, 56, 60, 79, 80, 81, 82, 100, 102]"

Norman,L100,middle,16,11,5,1,0.8621,116,"[9, 20, 36, 38, 40, 58, 59, 60, 61, 78, 79, 80, 81, 98, 100, 101]"

Norman,L100,middle,16,6,10,9,0.8621,116,"[18, 20, 33, 34, 35, 36, 37, 38, 40, 41, 59, 60, 62, 80, 87, 104]"

Norman,L100,middle,16,5,11,1,0.8621,116,"[18, 19, 32, 34, 37, 39, 56, 58, 59, 62, 79, 80, 81, 99, 100, 101]"

Norman,L100,middle,19,7,12,2,0.8403,119,"[21, 35, 37, 38, 39, 56, 57, 58, 59, 60, 61, 62, 64, 65, 66, 86, 105, 106, 107]"

Norman,L100,middle,16,6,10,1,0.8621,116,"[18, 19, 32, 35, 36, 38, 41, 58, 59, 61, 62, 79, 82, 99, 100, 102]"

Norman,L100,middle,15,6,9,1,0.8696,115,"[19, 31, 34, 37, 39, 55, 57, 58, 59, 78, 79, 96, 97, 98, 100]"

Norman,L100,middle,11,6,5,0,0.9009,111,"[11, 19, 38, 39, 57, 58, 59, 77, 79, 96, 99]"

Norman,L100,middle,19,14,5,1,0.8403,119,"[9, 18, 19, 20, 21, 24, 43, 44, 45, 46, 64, 66, 83, 85, 86, 87, 104, 105, 108]"

Norman,L100,middle,17,12,5,1,0.8547,117,"[9, 17, 18, 19, 38, 39, 40, 57, 60, 77, 78, 79, 80, 81, 98, 99, 102]"

Norman,L100,middle,17,4,13,3,0.8547,117,"[9, 19, 20, 22, 38, 39, 40, 41, 58, 59, 60, 64, 82, 83, 101, 103, 104]"

Norman,L100,middle,15,9,6,1,0.8696,115,"[9, 18, 19, 36, 37, 39, 57, 58, 59, 75, 78, 79, 80, 97, 101]"

Norman,L100,middle,14,8,6,1,0.8772,114,"[9, 19, 36, 37, 39, 57, 60, 62, 81, 97, 98, 99, 100, 101]"

Norman,L100,middle,14,11,3,2,0.8772,114,"[9, 17, 19, 22, 40, 41, 42, 59, 60, 61, 62, 81, 83, 105]"

Norman,L100,middle,20,12,8,1,0.8333,120,"[18, 19, 22, 34, 36, 37, 38, 41, 42, 44, 45, 63, 64, 65, 66, 84, 85, 86, 105, 108]"

Norman,L100,middle,14,11,3,1,0.8772,114,"[9, 18, 19, 36, 37, 40, 57, 59, 76, 77, 78, 79, 97, 99]"

Norman,L100,middle,17,5,12,7,0.8547,117,"[18, 21, 33, 34, 35, 36, 37, 38, 39, 42, 62, 80, 83, 99, 101, 102, 104]"

Norman,L100,middle,13,5,8,6,0.885,113,"[18, 19, 31, 33, 35, 37, 39, 56, 58, 59, 77, 83, 102]"

Norman,L100,middle,16,3,13,5,0.8621,116,"[21, 35, 36, 37, 38, 40, 57, 58, 60, 79, 95, 97, 98, 99, 100, 102]"

Norman,L100,middle,17,11,6,4,0.8547,117,"[18, 20, 34, 35, 37, 38, 41, 58, 59, 61, 78, 79, 80, 81, 98, 100, 102]"

Norman,L100,middle,11,7,4,12,0.9009,111,"[9, 17, 18, 19, 21, 39, 41, 65, 83, 98, 102]"

Norman,L100,middle,14,7,7,5,0.8772,114,"[9, 20, 36, 41, 58, 59, 75, 76, 77, 78, 81, 98, 100, 102]"

Norman,L100,middle,21,7,14,4,0.8264,121,"[9, 18, 20, 37, 38, 39, 56, 57, 58, 59, 60, 77, 78, 80, 82, 83, 84, 85, 88, 106, 109]"

Norman,L100,middle,20,7,13,0,0.8333,120,"[9, 17, 20, 21, 38, 39, 40, 41, 58, 60, 61, 78, 80, 81, 83, 84, 101, 104, 105, 106]"

Norman,L100,middle,15,11,4,5,0.8696,115,"[10, 22, 39, 40, 56, 57, 58, 59, 60, 79, 80, 81, 100, 102, 106]"

Norman,L100,middle,18,12,6,1,0.8475,118,"[9, 17, 18, 19, 20, 38, 39, 41, 58, 59, 61, 62, 65, 85, 102, 104, 105, 107]"

Norman,L100,middle,14,4,10,2,0.8772,114,"[10, 20, 36, 37, 38, 39, 58, 60, 78, 79, 80, 82, 101, 102]"

Norman,L100,middle,16,5,11,3,0.8621,116,"[19, 31, 32, 34, 35, 38, 39, 57, 58, 59, 61, 80, 82, 85, 101, 103]"

Norman,L100,middle,15,9,6,1,0.8696,115,"[19, 22, 36, 39, 41, 58, 59, 60, 61, 78, 80, 81, 82, 100, 102]"

Norman,L100,middle,15,12,3,4,0.8696,115,"[18, 21, 34, 35, 37, 38, 42, 59, 60, 77, 78, 79, 80, 99, 100]"

Norman,L100,middle,21,8,13,3,0.8264,121,"[18, 20, 21, 23, 37, 38, 40, 42, 59, 60, 61, 63, 65, 82, 83, 85, 86, 87, 89, 106, 109]"

Norman,L100,middle,13,6,7,5,0.885,113,"[11, 22, 39, 40, 42, 58, 62, 78, 79, 80, 81, 99, 102]"

Norman,L100,middle,13,8,5,3,0.885,113,"[9, 17, 18, 20, 39, 41, 58, 59, 62, 79, 81, 99, 102]"

Norman,L100,middle,13,10,3,6,0.885,113,"[11, 20, 36, 43, 60, 62, 79, 80, 81, 82, 98, 103, 104]"

Norman,L100,middle,13,8,5,5,0.885,113,"[9, 18, 22, 38, 40, 42, 59, 60, 61, 79, 81, 98, 102]"

Norman,L100,middle,24,9,15,0,0.8065,124,"[18, 19, 21, 33, 34, 36, 37, 38, 39, 41, 60, 61, 79, 81, 82, 83, 84, 85, 103, 105, 107, 108, 110, 111]"

Norman,L100,middle,14,8,6,1,0.8772,114,"[18, 22, 39, 41, 57, 58, 60, 62, 79, 81, 82, 98, 100, 102]"

Norman,L100,middle,18,4,14,3,0.8475,118,"[19, 21, 33, 34, 35, 38, 39, 41, 42, 59, 61, 62, 82, 84, 100, 102, 103, 106]"

Norman,L100,middle,11,3,8,1,0.9009,111,"[11, 20, 36, 37, 39, 59, 79, 96, 97, 99, 100]"

Norman,L100,middle,19,11,8,1,0.8403,119,"[18, 19, 31, 32, 33, 36, 38, 39, 40, 58, 59, 61, 62, 81, 83, 100, 102, 103, 104]"

Norman,L100,middle,19,15,4,2,0.8403,119,"[9, 17, 18, 19, 20, 21, 39, 40, 41, 43, 61, 62, 80, 81, 82, 83, 100, 101, 104]"

Norman,L100,middle,17,9,8,1,0.8547,117,"[18, 19, 21, 33, 36, 38, 39, 40, 41, 60, 61, 79, 80, 82, 99, 101, 103]"

Norman,L100,middle,16,6,10,3,0.8621,116,"[18, 19, 33, 34, 37, 38, 41, 58, 59, 60, 61, 64, 82, 85, 102, 103]"

Norman,L100,middle,18,14,4,0,0.8475,118,"[19, 22, 23, 40, 41, 42, 43, 60, 61, 62, 64, 82, 84, 100, 102, 103, 104, 105]"

Norman,L100,middle,11,5,6,3,0.9009,111,"[9, 17, 21, 39, 58, 60, 76, 78, 79, 98, 99]"

Norman,L100,middle,20,3,17,3,0.8333,120,"[18, 20, 32, 33, 34, 35, 36, 37, 38, 39, 40, 41, 59, 60, 61, 62, 64, 66, 86, 105]"

Norman,L100,middle,17,14,3,1,0.8547,117,"[9, 18, 19, 39, 40, 57, 58, 59, 60, 61, 78, 79, 80, 82, 101, 102, 103]"

Norman,L100,middle,18,4,14,3,0.8475,118,"[10, 19, 20, 21, 23, 40, 41, 42, 43, 60, 61, 63, 65, 83, 84, 86, 104, 106]"

Norman,L100,middle,18,3,15,1,0.8475,118,"[18, 19, 32, 33, 34, 35, 36, 38, 40, 58, 59, 77, 78, 79, 80, 97, 99, 100]"

Norman,L100,middle,15,9,6,1,0.8696,115,"[9, 17, 18, 20, 38, 39, 57, 59, 75, 77, 79, 80, 81, 100, 101]"

Norman,L100,middle,16,12,4,0,0.8621,116,"[9, 17, 18, 20, 39, 40, 57, 59, 60, 77, 78, 79, 81, 98, 99, 101]"

Norman,L100,middle,17,7,10,8,0.8547,117,"[18, 19, 22, 34, 37, 38, 39, 42, 59, 61, 62, 64, 83, 99, 101, 102, 106]"

Norman,L100,middle,11,6,5,10,0.9009,111,"[20, 32, 34, 35, 36, 44, 61, 78, 81, 96, 102]"

Norman,L100,middle,16,11,5,2,0.8621,116,"[10, 20, 36, 39, 40, 57, 58, 59, 60, 76, 78, 79, 80, 97, 99, 101]"

Norman,L100,middle,19,8,11,0,0.8403,119,"[18, 19, 20, 21, 34, 35, 36, 38, 39, 40, 41, 60, 61, 62, 82, 100, 101, 102, 103]"

Norman,L100,middle,12,5,7,7,0.8929,112,"[11, 20, 36, 37, 39, 41, 58, 63, 79, 81, 98, 102]"

Norman,L100,middle,15,2,13,2,0.8696,115,"[19, 31, 33, 34, 35, 37, 40, 58, 59, 60, 78, 82, 99, 100, 101]"

Norman,L100,middle,17,7,10,1,0.8547,117,"[18, 19, 31, 32, 34, 35, 36, 38, 41, 59, 60, 61, 79, 81, 98, 100, 101]"

Norman,L100,middle,19,8,11,1,0.8403,119,"[18, 19, 31, 33, 34, 35, 36, 37, 38, 39, 57, 59, 60, 78, 79, 80, 81, 99, 102]"

Norman,L100,middle,18,4,14,2,0.8475,118,"[18, 19, 31, 34, 35, 36, 37, 38, 39, 56, 58, 60, 77, 80, 97, 98, 99, 100]"

Norman,L100,middle,17,2,15,1,0.8547,117,"[10, 19, 36, 38, 39, 40, 57, 58, 59, 60, 61, 78, 82, 83, 102, 104, 106]"

Norman,L100,middle,15,7,8,2,0.8696,115,"[9, 17, 18, 19, 38, 39, 40, 57, 59, 61, 79, 81, 98, 100, 102]"

Norman,L100,middle,17,6,11,3,0.8547,117,"[10, 19, 20, 22, 39, 40, 41, 42, 43, 46, 63, 64, 83, 84, 102, 103, 104]"

Norman,L100,middle,18,9,9,2,0.8475,118,"[18, 21, 33, 35, 36, 37, 38, 40, 42, 59, 61, 62, 63, 81, 82, 83, 103, 104]"

Norman,L100,middle,20,5,15,2,0.8333,120,"[18, 19, 20, 21, 23, 35, 37, 38, 39, 40, 41, 42, 61, 62, 63, 83, 102, 103, 105, 107]"

Norman,L100,middle,14,8,6,3,0.8772,114,"[18, 19, 20, 34, 36, 41, 57, 60, 62, 82, 98, 99, 100, 102]"

Norman,L100,middle,18,6,12,1,0.8475,118,"[19, 31, 32, 33, 34, 36, 37, 38, 39, 56, 59, 60, 79, 80, 98, 99, 100, 102]"

Norman,L100,middle,14,9,5,1,0.8772,114,"[9, 17, 19, 36, 37, 40, 58, 59, 75, 79, 80, 97, 100, 101]"

Norman,L100,middle,13,8,5,5,0.885,113,"[9, 19, 22, 42, 59, 60, 63, 81, 96, 97, 98, 99, 101]"

Norman,L100,middle,20,10,10,1,0.8333,120,"[18, 19, 20, 33, 34, 35, 37, 40, 57, 59, 60, 61, 64, 81, 82, 83, 101, 102, 103, 104]"

Norman,L100,middle,12,8,4,8,0.8929,112,"[26, 40, 58, 59, 77, 78, 79, 80, 81, 82, 101, 102]"

Norman,L100,middle,23,7,16,1,0.813,123,"[18, 19, 31, 32, 33, 34, 35, 37, 38, 39, 41, 59, 60, 79, 80, 97, 99, 100, 101, 102, 103, 104, 105]"

Norman,L100,middle,16,5,11,0,0.8621,116,"[9, 17, 19, 38, 39, 40, 57, 58, 60, 76, 78, 81, 82, 99, 101, 102]"

Norman,L100,middle,16,12,4,2,0.8621,116,"[18, 20, 32, 35, 36, 38, 39, 56, 60, 61, 78, 79, 80, 82, 99, 101]"

Norman,L100,middle,17,9,8,4,0.8547,117,"[20, 31, 33, 35, 36, 37, 39, 42, 59, 60, 61, 62, 80, 81, 83, 100, 102]"

Norman,L100,middle,15,10,5,0,0.8696,115,"[9, 17, 18, 19, 37, 40, 58, 59, 62, 79, 80, 83, 84, 102, 104]"

Norman,L100,middle,19,7,12,1,0.8403,119,"[10, 19, 36, 38, 39, 40, 57, 58, 59, 60, 61, 62, 80, 81, 83, 100, 101, 102, 103]"

Norman,L100,middle,18,13,5,1,0.8475,118,"[12, 19, 37, 38, 40, 57, 58, 59, 60, 80, 97, 99, 100, 101, 102, 103, 104, 106]"

Norman,L100,middle,13,5,8,4,0.885,113,"[20, 31, 35, 37, 39, 40, 57, 58, 61, 78, 80, 99, 102]"

Norman,L100,middle,16,10,6,3,0.8621,116,"[18, 19, 32, 33, 34, 36, 38, 40, 57, 58, 59, 76, 77, 78, 82, 100]"

Norman,L100,middle,13,6,7,6,0.885,113,"[9, 17, 18, 21, 39, 40, 57, 59, 63, 79, 82, 100, 102]"

Norman,L100,middle,13,10,3,10,0.885,113,"[9, 17, 18, 21, 40, 58, 61, 78, 81, 97, 98, 100, 104]"

Norman,L100,middle,17,10,7,1,0.8547,117,"[18, 19, 31, 32, 33, 34, 37, 38, 39, 56, 58, 59, 60, 81, 98, 100, 102]"

Norman,L100,middle,19,8,11,2,0.8403,119,"[18, 20, 32, 33, 36, 37, 38, 40, 57, 59, 60, 78, 79, 80, 97, 98, 101, 102, 103]"

Norman,L100,middle,17,6,11,3,0.8547,117,"[18, 19, 31, 32, 33, 35, 36, 41, 58, 59, 60, 78, 79, 81, 83, 100, 103]"

Norman,L100,middle,17,11,6,4,0.8547,117,"[18, 22, 35, 37, 38, 39, 58, 59, 76, 77, 79, 80, 97, 98, 99, 101, 103]"

Norman,L100,middle,17,11,6,3,0.8547,117,"[9, 21, 37, 38, 42, 58, 59, 60, 61, 62, 63, 65, 83, 84, 86, 104, 105]"

Norman,L100,middle,16,11,5,2,0.8621,116,"[18, 19, 31, 32, 33, 36, 37, 40, 57, 58, 59, 76, 77, 79, 98, 100]"

Norman,L100,middle,18,13,5,2,0.8475,118,"[19, 32, 35, 36, 37, 38, 39, 56, 57, 58, 60, 79, 95, 97, 98, 100, 101, 103]"

Norman,L100,middle,14,9,5,7,0.8772,114,"[9, 17, 19, 36, 37, 39, 46, 63, 79, 80, 81, 98, 100, 101]"

Norman,L100,middle,14,8,6,2,0.8772,114,"[9, 17, 20, 37, 38, 40, 61, 78, 80, 82, 98, 99, 100, 101]"

Norman,L100,middle,16,10,6,1,0.8621,116,"[19, 31, 34, 35, 36, 37, 38, 40, 59, 77, 78, 80, 97, 99, 100, 101]"

Norman,L100,middle,12,5,7,2,0.8929,112,"[10, 19, 36, 37, 40, 57, 58, 59, 78, 80, 97, 99]"

Norman,L100,middle,17,10,7,4,0.8547,117,"[9, 17, 18, 19, 37, 40, 57, 58, 59, 60, 64, 81, 85, 101, 102, 103, 104]"

Norman,L100,middle,18,7,11,2,0.8475,118,"[18, 19, 32, 33, 34, 36, 37, 38, 41, 59, 61, 79, 80, 96, 98, 99, 100, 102]"

Norman,L100,middle,16,8,8,4,0.8621,116,"[18, 19, 22, 34, 36, 39, 41, 58, 59, 61, 78, 79, 80, 96, 99, 100]"

Norman,L100,middle,14,11,3,6,0.8772,114,"[9, 17, 18, 19, 21, 40, 58, 59, 60, 64, 80, 83, 100, 102]"

Norman,L100,middle,16,11,5,0,0.8621,116,"[19, 20, 34, 35, 36, 37, 38, 39, 40, 59, 60, 79, 80, 81, 98, 101]"

Norman,L100,middle,15,7,8,5,0.8696,115,"[11, 21, 39, 55, 56, 58, 60, 61, 78, 79, 80, 82, 100, 101, 104]"

Norman,L100,middle,19,9,10,0,0.8403,119,"[18, 19, 20, 21, 34, 35, 38, 39, 40, 41, 42, 43, 61, 63, 81, 83, 102, 104, 106]"

Norman,L100,middle,16,10,6,1,0.8621,116,"[9, 17, 19, 38, 39, 56, 57, 59, 75, 77, 78, 79, 80, 97, 99, 101]"

Norman,L100,middle,17,4,13,4,0.8547,117,"[18, 20, 32, 33, 37, 38, 40, 57, 58, 59, 60, 61, 79, 82, 86, 102, 106]"

Norman,L100,middle,17,13,4,2,0.8547,117,"[9, 17, 18, 19, 23, 40, 41, 42, 60, 61, 62, 80, 81, 82, 83, 100, 104]"

Norman,L100,middle,18,7,11,2,0.8475,118,"[9, 18, 19, 22, 38, 39, 40, 42, 59, 60, 61, 62, 79, 81, 82, 84, 101, 104]"

Norman,L100,middle,16,4,12,1,0.8621,116,"[18, 19, 31, 32, 34, 35, 36, 37, 38, 39, 40, 58, 60, 78, 81, 101]"

Norman,L100,middle,16,7,9,3,0.8621,116,"[9, 18, 19, 20, 22, 26, 44, 61, 62, 63, 64, 81, 82, 84, 103, 104]"

Norman,L100,middle,19,5,14,2,0.8403,119,"[18, 19, 32, 33, 34, 35, 36, 37, 39, 40, 58, 59, 60, 78, 80, 81, 83, 100, 103]"

Norman,L100,middle,18,14,4,3,0.8475,118,"[9, 18, 19, 36, 37, 38, 39, 58, 59, 60, 78, 79, 80, 97, 98, 99, 100, 104]"

Norman,L100,middle,15,12,3,1,0.8696,115,"[9, 17, 18, 19, 38, 39, 56, 60, 77, 78, 79, 96, 97, 98, 99]"

Norman,L100,middle,15,5,10,6,0.8696,115,"[18, 19, 20, 38, 39, 41, 57, 62, 79, 81, 82, 98, 100, 101, 105]"

Norman,L100,middle,22,6,16,4,0.8197,122,"[18, 19, 31, 33, 34, 35, 36, 37, 38, 39, 57, 58, 59, 60, 78, 79, 80, 81, 83, 85, 103, 107]"

Norman,L100,middle,20,9,11,2,0.8333,120,"[18, 19, 20, 22, 36, 37, 38, 39, 40, 41, 42, 43, 61, 63, 64, 65, 66, 87, 104, 106]"

Norman,L100,middle,15,13,2,2,0.8696,115,"[9, 19, 38, 40, 57, 58, 60, 76, 77, 78, 79, 95, 97, 98, 99]"

Norman,L100,middle,14,6,8,2,0.8772,114,"[9, 18, 19, 36, 37, 38, 40, 58, 59, 76, 77, 78, 79, 100]"

Norman,L100,middle,14,7,7,2,0.8772,114,"[11, 20, 37, 39, 41, 57, 62, 78, 79, 80, 82, 83, 100, 104]"

Norman,L100,middle,18,10,8,2,0.8475,118,"[9, 18, 21, 22, 38, 39, 40, 43, 44, 46, 63, 64, 65, 83, 84, 85, 104, 106]"

Norman,L100,middle,17,6,11,2,0.8547,117,"[19, 31, 32, 33, 35, 36, 37, 38, 39, 41, 42, 45, 63, 65, 83, 84, 104]"

Norman,L100,middle,25,9,16,0,0.8,125,"[9, 17, 18, 19, 38, 39, 56, 57, 58, 59, 60, 77, 78, 79, 81, 83, 84, 102, 103, 104, 106, 107, 108, 109, 110]"

Norman,L100,middle,16,13,3,2,0.8621,116,"[9, 17, 19, 36, 37, 39, 57, 59, 61, 78, 79, 80, 97, 98, 99, 101]"

Norman,L100,middle,17,4,13,2,0.8547,117,"[18, 20, 33, 34, 35, 36, 38, 39, 40, 59, 60, 78, 79, 80, 97, 99, 102]"

Norman,L100,middle,17,14,3,2,0.8547,117,"[9, 18, 19, 36, 37, 39, 41, 59, 60, 76, 78, 80, 96, 97, 98, 99, 101]"

Norman,L100,middle,18,9,9,2,0.8475,118,"[18, 19, 31, 32, 35, 36, 37, 40, 57, 60, 78, 79, 80, 82, 99, 101, 102, 103]"

Norman,L100,middle,9,5,4,7,0.9174,109,"[10, 21, 41, 60, 77, 78, 81, 97, 100]"

Norman,L100,middle,17,12,5,0,0.8547,117,"[9, 17, 18, 19, 37, 38, 39, 56, 59, 60, 77, 78, 79, 81, 99, 100, 101]"

Norman,L100,middle,16,12,4,2,0.8621,116,"[9, 18, 19, 36, 38, 41, 58, 59, 60, 61, 79, 81, 97, 98, 100, 101]"

Norman,L100,middle,14,10,4,1,0.8772,114,"[9, 17, 18, 19, 37, 38, 39, 57, 59, 61, 63, 81, 84, 103]"

Norman,L100,middle,17,6,11,1,0.8547,117,"[9, 18, 20, 38, 39, 56, 57, 58, 59, 75, 77, 78, 79, 97, 98, 99, 101]"

Norman,L100,middle,16,5,11,2,0.8621,116,"[18, 19, 34, 35, 37, 38, 40, 57, 58, 59, 61, 81, 98, 99, 100, 103]"

Norman,L100,middle,16,4,12,0,0.8621,116,"[18, 19, 20, 21, 22, 35, 36, 37, 38, 42, 60, 62, 81, 82, 99, 102]"

Norman,L100,middle,14,5,9,5,0.8772,114,"[9, 18, 19, 22, 39, 40, 44, 62, 78, 80, 81, 98, 100, 101]"

Norman,L100,middle,20,6,14,1,0.8333,120,"[11, 19, 37, 38, 39, 56, 57, 58, 59, 60, 61, 62, 79, 81, 82, 83, 85, 102, 106, 109]"

Norman,L100,middle,17,5,12,4,0.8547,117,"[18, 19, 20, 21, 23, 35, 37, 40, 41, 43, 60, 64, 82, 84, 87, 89, 112]"

Norman,L100,middle,14,6,8,10,0.8772,114,"[9, 21, 37, 38, 39, 41, 59, 60, 61, 63, 80, 81, 87, 104]"

Norman,L100,middle,9,3,6,8,0.9174,109,"[10, 20, 36, 37, 40, 63, 79, 82, 101]"

Norman,L100,middle,16,6,10,3,0.8621,116,"[9, 18, 20, 21, 38, 39, 41, 42, 44, 61, 64, 81, 82, 84, 102, 103]"

Norman,L100,middle,16,5,11,2,0.8621,116,"[20, 31, 33, 34, 35, 36, 37, 39, 41, 59, 61, 79, 81, 99, 100, 101]"

Norman,L100,middle,16,9,7,1,0.8621,116,"[19, 31, 32, 33, 35, 36, 38, 40, 59, 77, 78, 79, 97, 98, 99, 100]"

Norman,L100,middle,13,10,3,5,0.885,113,"[9, 17, 20, 24, 41, 45, 63, 80, 81, 82, 84, 101, 104]"

Norman,L100,middle,16,7,9,4,0.8621,116,"[18, 19, 31, 32, 33, 34, 38, 41, 58, 59, 60, 78, 79, 82, 99, 101]"

Norman,L100,middle,20,8,12,0,0.8333,120,"[18, 20, 34, 35, 36, 38, 41, 42, 59, 61, 62, 64, 66, 67, 68, 69, 87, 89, 108, 109]"

Norman,L100,middle,15,10,5,3,0.8696,115,"[11, 22, 39, 40, 57, 58, 59, 60, 61, 62, 80, 81, 83, 100, 102]"

Norman,L100,middle,18,11,7,1,0.8475,118,"[19, 31, 34, 35, 37, 38, 39, 40, 41, 42, 62, 63, 80, 84, 101, 102, 103, 104]"

Norman,L100,middle,19,6,13,3,0.8403,119,"[18, 19, 21, 36, 38, 39, 40, 41, 58, 60, 62, 79, 80, 81, 83, 101, 103, 104, 105]"

Norman,L100,middle,17,11,6,1,0.8547,117,"[20, 31, 33, 36, 37, 40, 57, 59, 60, 77, 79, 80, 81, 82, 99, 101, 102]"

Norman,L100,middle,17,5,12,2,0.8547,117,"[19, 31, 32, 33, 34, 35, 36, 41, 58, 60, 61, 79, 80, 81, 82, 83, 103]"

Norman,L100,middle,15,6,9,6,0.8696,115,"[18, 21, 33, 35, 36, 37, 38, 41, 58, 59, 61, 82, 98, 100, 102]"

Norman,L100,middle,16,8,8,1,0.8621,116,"[11, 19, 20, 37, 39, 41, 58, 59, 60, 62, 79, 80, 81, 99, 100, 102]"

Norman,L100,middle,15,9,6,2,0.8696,115,"[9, 17, 19, 36, 38, 39, 57, 58, 59, 61, 78, 79, 83, 101, 102]"

Norman,L100,middle,18,6,12,2,0.8475,118,"[19, 31, 32, 34, 35, 36, 37, 38, 39, 40, 58, 59, 60, 61, 79, 80, 83, 103]"

Norman,L100,middle,14,7,7,2,0.8772,114,"[9, 17, 18, 20, 38, 40, 42, 60, 62, 63, 80, 83, 102, 104]"

Norman,L100,middle,21,0,21,1,0.8264,121,"[18, 20, 32, 33, 35, 36, 37, 38, 39, 40, 60, 78, 79, 80, 97, 98, 99, 100, 101, 102, 103]"

Norman,L100,middle,17,6,11,3,0.8547,117,"[18, 19, 20, 34, 35, 36, 37, 38, 39, 44, 61, 80, 81, 98, 99, 100, 101]"

Norman,L100,middle,13,5,8,2,0.885,113,"[18, 19, 20, 33, 34, 37, 38, 41, 60, 77, 81, 97, 100]"

Norman,L100,middle,16,9,7,2,0.8621,116,"[9, 17, 18, 19, 37, 38, 40, 57, 58, 60, 61, 78, 80, 82, 100, 104]"

Norman,L100,middle,16,7,9,2,0.8621,116,"[18, 20, 34, 36, 42, 43, 60, 63, 80, 82, 83, 84, 86, 103, 104, 105]"

Norman,L100,middle,18,13,5,7,0.8475,118,"[23, 36, 38, 39, 40, 42, 59, 60, 61, 79, 80, 81, 84, 101, 102, 103, 104, 105]"

Norman,L100,middle,20,10,10,0,0.8333,120,"[9, 19, 20, 38, 40, 57, 58, 61, 79, 81, 82, 100, 101, 102, 103, 105, 107, 108, 109, 110]"

Norman,L100,middle,17,7,10,3,0.8547,117,"[18, 19, 20, 23, 37, 38, 39, 40, 41, 60, 61, 62, 81, 83, 100, 101, 102]"

Norman,L100,middle,17,8,9,3,0.8547,117,"[18, 19, 31, 33, 34, 35, 36, 37, 41, 60, 78, 79, 80, 96, 98, 99, 100]"

Norman,L100,middle,16,9,7,2,0.8621,116,"[9, 17, 19, 36, 37, 39, 56, 58, 61, 79, 80, 96, 97, 99, 100, 103]"

Norman,L100,middle,16,5,11,3,0.8621,116,"[18, 19, 31, 32, 34, 35, 36, 37, 38, 39, 58, 60, 82, 99, 101, 103]"

Norman,L100,middle,16,8,8,1,0.8621,116,"[18, 19, 31, 33, 36, 37, 41, 58, 59, 60, 78, 79, 80, 96, 99, 100]"

Norman,L100,middle,17,3,14,0,0.8547,117,"[18, 19, 31, 33, 35, 38, 39, 57, 58, 59, 77, 78, 79, 95, 97, 98, 99]"

Norman,L100,middle,15,5,10,1,0.8696,115,"[21, 34, 36, 37, 38, 40, 41, 43, 44, 64, 83, 85, 102, 103, 104]"

Norman,L100,middle,18,11,7,3,0.8475,118,"[18, 21, 33, 35, 36, 37, 38, 39, 56, 57, 59, 76, 79, 95, 97, 98, 99, 101]"

Norman,L100,middle,19,11,8,1,0.8403,119,"[18, 19, 31, 32, 33, 34, 36, 39, 56, 58, 59, 77, 80, 81, 98, 101, 102, 103, 105]"

Norman,L100,middle,22,21,1,0,0.8197,122,"[9, 17, 18, 19, 37, 38, 39, 56, 58, 61, 78, 79, 80, 82, 83, 84, 85, 86, 103, 104, 105, 106]"

Norman,L100,middle,18,7,11,2,0.8475,118,"[18, 19, 20, 33, 34, 36, 37, 40, 57, 58, 59, 60, 62, 80, 82, 84, 102, 103]"

Norman,L100,middle,19,5,14,2,0.8403,119,"[18, 19, 21, 33, 34, 36, 37, 38, 39, 40, 59, 60, 78, 79, 81, 98, 100, 101, 102]"

Norman,L100,middle,18,5,13,1,0.8475,118,"[18, 19, 33, 34, 35, 37, 40, 58, 59, 60, 78, 79, 80, 97, 100, 101, 102, 104]"

Norman,L100,middle,15,7,8,3,0.8696,115,"[10, 19, 20, 21, 38, 39, 40, 43, 60, 61, 62, 80, 81, 83, 103]"

Norman,L100,middle,18,10,8,0,0.8475,118,"[10, 20, 21, 38, 39, 40, 41, 58, 60, 61, 78, 79, 80, 81, 98, 99, 100, 101]"

Norman,L100,middle,17,4,13,5,0.8547,117,"[18, 20, 33, 34, 35, 36, 37, 38, 39, 40, 58, 59, 62, 80, 83, 100, 102]"

Norman,L100,middle,18,12,6,1,0.8475,118,"[18, 19, 31, 32, 35, 37, 38, 40, 57, 58, 59, 61, 62, 81, 82, 100, 101, 103]"

Norman,L100,middle,16,10,6,2,0.8621,116,"[18, 20, 32, 33, 36, 37, 38, 39, 40, 58, 59, 60, 77, 78, 80, 101]"

Norman,L100,middle,15,12,3,7,0.8696,115,"[20, 31, 34, 35, 36, 37, 43, 60, 76, 77, 79, 80, 98, 99, 102]"

Norman,L100,middle,16,8,8,1,0.8621,116,"[9, 20, 36, 37, 38, 40, 57, 58, 59, 61, 62, 83, 100, 101, 102, 103]"

Norman,L100,middle,16,12,4,4,0.8621,116,"[20, 31, 33, 35, 36, 37, 38, 40, 57, 59, 62, 79, 80, 96, 98, 100]"

Norman,L100,middle,18,14,4,2,0.8475,118,"[9, 17, 18, 19, 20, 38, 40, 58, 60, 76, 78, 79, 81, 82, 85, 103, 104, 105]"

Norman,L100,middle,16,3,13,0,0.8621,116,"[11, 19, 36, 39, 59, 75, 76, 77, 78, 79, 80, 81, 82, 99, 102, 104]"

Norman,L100,middle,18,1,17,1,0.8475,118,"[18, 20, 32, 33, 34, 35, 36, 37, 39, 56, 59, 77, 78, 79, 80, 97, 99, 100]"

Norman,L100,middle,16,6,10,4,0.8621,116,"[9, 17, 18, 22, 39, 40, 57, 58, 59, 60, 61, 78, 80, 82, 99, 102]"

Norman,L100,middle,17,6,11,3,0.8547,117,"[9, 17, 18, 20, 38, 39, 44, 61, 78, 79, 80, 81, 97, 98, 100, 101, 102]"

Norman,L100,middle,17,6,11,2,0.8547,117,"[18, 20, 32, 34, 35, 36, 37, 38, 39, 57, 58, 59, 61, 79, 82, 100, 103]"

Norman,L100,middle,15,5,10,1,0.8696,115,"[18, 19, 31, 33, 34, 35, 37, 39, 41, 61, 78, 81, 98, 99, 101]"

Norman,L100,middle,17,10,7,1,0.8547,117,"[18, 19, 34, 36, 38, 39, 57, 58, 60, 77, 78, 79, 95, 97, 98, 100, 101]"

Norman,L100,middle,17,6,11,1,0.8547,117,"[18, 19, 20, 34, 37, 38, 40, 57, 59, 60, 61, 79, 80, 82, 99, 102, 103]"

Norman,L100,middle,16,7,9,7,0.8621,116,"[10, 19, 36, 38, 39, 41, 58, 59, 60, 61, 63, 64, 82, 83, 88, 106]"

Norman,L100,middle,17,4,13,4,0.8547,117,"[10, 20, 23, 42, 59, 60, 61, 77, 78, 79, 80, 81, 83, 100, 102, 103, 105]"

Norman,L100,middle,15,6,9,0,0.8696,115,"[10, 19, 36, 37, 38, 39, 40, 60, 77, 78, 80, 97, 100, 101, 102]"

Norman,L100,middle,17,6,11,1,0.8547,117,"[9, 18, 20, 38, 39, 56, 57, 60, 61, 63, 80, 81, 82, 83, 101, 103, 104]"

Norman,L100,middle,17,13,4,2,0.8547,117,"[9, 17, 18, 19, 20, 21, 39, 40, 41, 58, 59, 60, 62, 79, 82, 101, 102]"

Norman,L100,middle,15,9,6,3,0.8696,115,"[18, 20, 23, 39, 41, 42, 60, 61, 62, 80, 82, 99, 100, 101, 103]"

Norman,L100,middle,13,9,4,10,0.885,113,"[9, 17, 20, 37, 38, 45, 62, 81, 96, 97, 99, 100, 101]"

Norman,L100,middle,15,5,10,5,0.8696,115,"[18, 19, 31, 33, 34, 35, 36, 37, 38, 42, 60, 78, 80, 97, 99]"

Norman,L100,middle,13,6,7,6,0.885,113,"[13, 20, 24, 41, 42, 44, 63, 64, 66, 84, 86, 103, 109]"

Norman,L100,middle,18,4,14,2,0.8475,118,"[9, 17, 20, 37, 38, 39, 40, 41, 58, 59, 60, 61, 62, 80, 81, 83, 101, 103]"

Norman,L100,middle,16,5,11,2,0.8621,116,"[19, 31, 32, 33, 34, 35, 36, 39, 57, 58, 59, 61, 79, 81, 100, 101]"

Norman,L100,middle,17,6,11,4,0.8547,117,"[18, 20, 32, 34, 35, 36, 38, 39, 41, 59, 61, 79, 80, 82, 100, 101, 103]"

Norman,L100,middle,15,9,6,1,0.8696,115,"[9, 17, 18, 19, 37, 39, 41, 58, 60, 61, 78, 79, 82, 100, 101]"

Norman,L100,middle,15,5,10,1,0.8696,115,"[10, 19, 36, 37, 38, 40, 57, 59, 60, 61, 78, 81, 83, 100, 102]"

Norman,L100,middle,18,14,4,2,0.8475,118,"[9, 18, 19, 21, 38, 41, 58, 59, 60, 62, 79, 80, 81, 82, 99, 102, 103, 105]"

Norman,L100,middle,13,8,5,3,0.885,113,"[10, 19, 37, 40, 56, 58, 60, 76, 77, 79, 83, 99, 100]"

Norman,L100,middle,18,6,12,2,0.8475,118,"[10, 19, 20, 21, 38, 39, 40, 42, 59, 60, 61, 79, 80, 81, 82, 83, 100, 104]"

Norman,L100,middle,16,3,13,1,0.8621,116,"[9, 19, 36, 37, 39, 56, 57, 58, 62, 79, 80, 81, 97, 98, 100, 101]"

Norman,L100,middle,15,6,9,2,0.8696,115,"[9, 18, 19, 37, 38, 39, 40, 41, 58, 60, 61, 63, 85, 101, 104]"

Norman,L100,middle,21,12,9,0,0.8264,121,"[19, 31, 32, 33, 34, 35, 36, 39, 57, 58, 59, 60, 77, 80, 97, 99, 100, 101, 102, 103, 104]"

Norman,L100,middle,13,5,8,4,0.885,113,"[18, 19, 31, 34, 36, 37, 40, 57, 61, 79, 96, 97, 100]"

Norman,L100,middle,16,8,8,3,0.8621,116,"[9, 17, 18, 19, 20, 38, 41, 58, 59, 64, 82, 83, 102, 103, 104, 106]"

Norman,L100,middle,15,4,11,0,0.8696,115,"[9, 18, 19, 37, 38, 39, 57, 58, 59, 77, 80, 97, 99, 100, 101]"

Norman,L100,middle,12,5,7,11,0.8929,112,"[11, 20, 36, 37, 40, 41, 58, 59, 62, 79, 85, 107]"

Norman,L100,middle,16,13,3,4,0.8621,116,"[9, 17, 18, 19, 20, 38, 39, 40, 58, 59, 62, 66, 84, 101, 102, 103]"

Norman,L100,middle,20,6,14,5,0.8333,120,"[18, 19, 21, 22, 23, 24, 25, 38, 40, 41, 43, 44, 46, 64, 68, 86, 88, 90, 108, 109]"

Norman,L100,middle,17,7,10,5,0.8547,117,"[18, 21, 33, 34, 35, 36, 37, 39, 41, 59, 60, 61, 79, 81, 83, 100, 104]"

Norman,L100,middle,15,6,9,2,0.8696,115,"[9, 19, 20, 42, 60, 61, 76, 78, 79, 80, 81, 98, 100, 101, 102]"

Norman,L100,middle,17,12,5,0,0.8547,117,"[9, 17, 18, 20, 38, 40, 58, 59, 60, 61, 62, 64, 82, 83, 84, 103, 104]"

Norman,L100,middle,14,5,9,1,0.8772,114,"[18, 19, 34, 36, 37, 39, 56, 57, 58, 59, 78, 79, 95, 100]"

Norman,L100,middle,17,6,11,0,0.8547,117,"[18, 19, 20, 21, 36, 37, 39, 40, 42, 59, 61, 64, 82, 84, 100, 102, 104]"

Norman,L100,middle,19,11,8,2,0.8403,119,"[9, 17, 18, 19, 20, 38, 39, 40, 58, 59, 60, 77, 78, 79, 80, 81, 84, 101, 102]"

Norman,L100,middle,17,11,6,1,0.8547,117,"[9, 18, 19, 20, 39, 40, 41, 42, 60, 61, 62, 80, 81, 83, 101, 103, 104]"

Norman,L100,middle,14,5,9,2,0.8772,114,"[19, 31, 34, 37, 38, 42, 59, 60, 62, 63, 81, 85, 101, 103]"

Norman,L100,middle,13,9,4,3,0.885,113,"[12, 19, 37, 38, 40, 57, 58, 60, 77, 78, 80, 99, 100]"

Norman,L100,middle,19,8,11,4,0.8403,119,"[9, 17, 18, 20, 38, 39, 41, 42, 59, 60, 63, 81, 82, 83, 84, 87, 104, 105, 109]"

Norman,L100,middle,14,6,8,1,0.8772,114,"[9, 18, 19, 37, 38, 39, 56, 57, 59, 61, 79, 80, 99, 100]"

Norman,L100,middle,14,7,7,6,0.8772,114,"[18, 21, 33, 34, 35, 37, 38, 40, 41, 59, 61, 65, 85, 102]"

Norman,L100,middle,15,10,5,3,0.8696,115,"[10, 19, 37, 39, 40, 41, 58, 59, 61, 78, 79, 80, 81, 100, 104]"

Norman,L100,middle,18,9,9,4,0.8475,118,"[18, 21, 33, 35, 38, 40, 59, 61, 77, 78, 79, 80, 81, 82, 84, 102, 103, 104]"

Norman,L100,middle,15,10,5,2,0.8696,115,"[9, 17, 19, 20, 21, 22, 41, 42, 62, 79, 82, 83, 100, 101, 105]"

Norman,L100,middle,14,13,1,7,0.8772,114,"[9, 18, 23, 40, 56, 57, 58, 59, 75, 77, 82, 99, 100, 101]"

Norman,L100,middle,15,3,12,3,0.8696,115,"[19, 31, 32, 35, 38, 40, 57, 59, 62, 80, 81, 97, 99, 100, 102]"

Norman,L100,middle,15,12,3,1,0.8696,115,"[9, 18, 19, 36, 37, 38, 40, 59, 75, 78, 79, 96, 97, 99, 102]"

Norman,L100,middle,12,7,5,2,0.8929,112,"[9, 17, 19, 37, 39, 56, 57, 60, 77, 78, 81, 100]"

Norman,L100,middle,16,12,4,7,0.8621,116,"[9, 17, 18, 19, 21, 40, 41, 42, 59, 61, 62, 67, 85, 101, 102, 104]"

Norman,L100,middle,19,13,6,4,0.8403,119,"[18, 19, 31, 32, 33, 34, 35, 36, 37, 38, 39, 41, 59, 60, 63, 82, 100, 102, 103]"

Norman,L100,middle,19,7,12,2,0.8403,119,"[18, 20, 32, 33, 36, 37, 39, 56, 58, 59, 60, 61, 79, 82, 83, 100, 102, 103, 105]"

Norman,L100,middle,18,3,15,0,0.8475,118,"[18, 19, 20, 21, 34, 35, 38, 40, 41, 60, 61, 81, 82, 99, 101, 102, 103, 104]"

Norman,L100,middle,16,10,6,1,0.8621,116,"[19, 31, 33, 35, 36, 39, 58, 61, 77, 78, 79, 80, 97, 98, 99, 101]"

Norman,L100,middle,20,7,13,2,0.8333,120,"[20, 31, 33, 34, 35, 36, 37, 38, 39, 57, 58, 60, 77, 79, 81, 82, 83, 84, 102, 104]"

Norman,L100,middle,12,3,9,9,0.8929,112,"[22, 35, 37, 41, 57, 58, 60, 77, 79, 95, 97, 103]"

Norman,L100,middle,17,12,5,0,0.8547,117,"[9, 18, 19, 20, 39, 40, 58, 60, 77, 80, 97, 99, 100, 102, 103, 104, 107]"

Norman,L100,middle,16,9,7,2,0.8621,116,"[10, 19, 37, 38, 39, 40, 41, 59, 60, 61, 78, 79, 80, 82, 99, 104]"

Norman,L100,middle,17,8,9,0,0.8547,117,"[19, 31, 33, 34, 35, 36, 37, 39, 56, 57, 58, 61, 79, 81, 99, 100, 101]"

Norman,L100,middle,18,8,10,5,0.8475,118,"[9, 18, 19, 21, 38, 39, 40, 41, 43, 46, 63, 64, 83, 84, 85, 103, 104, 108]"

Norman,L100,middle,16,3,13,3,0.8621,116,"[19, 20, 32, 33, 34, 36, 38, 41, 58, 60, 61, 64, 83, 99, 101, 104]"

Norman,L100,middle,12,8,4,0,0.8929,112,"[9, 17, 19, 37, 39, 56, 59, 76, 77, 79, 98, 99]"

Norman,L100,middle,17,5,12,3,0.8547,117,"[20, 23, 36, 38, 39, 40, 41, 58, 59, 61, 78, 79, 81, 83, 100, 101, 102]"

Norman,L0,long,8,2,6,1,0.9259,108,"[30, 56, 57, 58, 59, 85, 86, 89]"

Norman,L0,long,13,1,12,0,0.885,113,"[27, 28, 29, 53, 55, 56, 57, 58, 59, 85, 88, 89, 91]"

Norman,L0,long,11,5,6,5,0.9009,111,"[15, 27, 28, 29, 30, 57, 58, 59, 60, 65, 92]"

Norman,L0,long,10,4,6,0,0.9091,110,"[15, 29, 56, 57, 58, 59, 85, 88, 89, 90]"

Norman,L0,long,13,7,6,1,0.885,113,"[28, 30, 56, 57, 58, 59, 60, 62, 88, 89, 90, 91, 92]"

Norman,L0,long,12,5,7,2,0.8929,112,"[27, 28, 29, 30, 54, 57, 58, 59, 60, 87, 88, 92]"

Norman,L0,long,11,3,8,2,0.9009,111,"[30, 55, 56, 57, 58, 59, 61, 87, 88, 89, 93]"

Norman,L0,long,12,3,9,1,0.8929,112,"[15, 27, 28, 30, 33, 60, 61, 62, 63, 90, 91, 93]"

Norman,L0,long,12,4,8,0,0.8929,112,"[15, 27, 28, 29, 56, 57, 58, 59, 86, 87, 88, 89]"

Norman,L0,long,9,5,4,3,0.9174,109,"[30, 55, 57, 58, 61, 86, 87, 88, 89]"

Norman,L0,long,12,6,6,0,0.8929,112,"[27, 28, 29, 31, 55, 58, 59, 60, 61, 88, 89, 91]"

Norman,L0,long,13,6,7,2,0.885,113,"[27, 28, 30, 54, 56, 57, 58, 61, 62, 64, 90, 92, 95]"

Norman,L0,long,15,5,10,1,0.8696,115,"[15, 27, 28, 31, 57, 58, 59, 60, 86, 87, 88, 89, 90, 91, 92]"

Norman,L0,long,15,10,5,0,0.8696,115,"[27, 28, 30, 31, 55, 57, 59, 61, 62, 89, 90, 91, 92, 93, 94]"

Norman,L0,long,12,4,8,0,0.8929,112,"[15, 27, 28, 29, 57, 58, 59, 60, 86, 87, 89, 90]"

Norman,L0,long,13,5,8,1,0.885,113,"[15, 27, 28, 31, 57, 58, 59, 60, 62, 64, 93, 94, 95]"

Norman,L0,long,12,4,8,1,0.8929,112,"[27, 28, 29, 30, 31, 55, 59, 60, 61, 88, 90, 93]"

Norman,L0,long,6,4,2,0,0.9434,106,"[29, 60, 83, 86, 89, 90]"

Norman,L0,long,15,1,14,1,0.8696,115,"[15, 27, 28, 29, 30, 31, 32, 33, 35, 63, 64, 65, 66, 93, 96]"

Norman,L0,long,11,2,9,2,0.9009,111,"[15, 27, 28, 29, 30, 57, 59, 61, 63, 91, 93]"

Norman,L0,long,9,2,7,4,0.9174,109,"[15, 27, 28, 30, 33, 60, 63, 90, 91]"

Norman,L0,long,11,2,9,4,0.9009,111,"[27, 28, 29, 33, 58, 60, 61, 87, 89, 91, 93]"

Norman,L0,long,12,7,5,0,0.8929,112,"[16, 28, 29, 55, 56, 57, 58, 59, 86, 88, 89, 91]"

Norman,L0,long,12,6,6,2,0.8929,112,"[27, 28, 29, 53, 55, 57, 58, 59, 60, 86, 89, 92]"

Norman,L0,long,10,4,6,2,0.9091,110,"[28, 31, 56, 57, 58, 59, 61, 87, 88, 90]"

Norman,L0,long,13,9,4,1,0.885,113,"[30, 55, 58, 60, 61, 85, 87, 88, 89, 90, 91, 94, 95]"

Norman,L0,long,14,11,3,0,0.8772,114,"[15, 29, 30, 31, 32, 58, 59, 60, 63, 64, 91, 92, 93, 94]"

Norman,L0,long,10,4,6,1,0.9091,110,"[27, 28, 29, 53, 56, 58, 60, 86, 88, 90]"

Norman,L0,long,12,6,6,5,0.8929,112,"[15, 27, 28, 29, 31, 57, 58, 59, 60, 61, 89, 95]"

Norman,L0,long,12,3,9,2,0.8929,112,"[16, 27, 28, 29, 30, 31, 58, 61, 64, 91, 92, 94]"

Norman,L0,long,14,7,7,1,0.8772,114,"[27, 28, 32, 57, 58, 59, 61, 88, 89, 90, 94, 95, 96, 97]"

Norman,L0,long,11,5,6,1,0.9009,111,"[16, 27, 28, 29, 30, 58, 59, 60, 86, 87, 91]"

Norman,L0,long,14,5,9,0,0.8772,114,"[15, 27, 28, 29, 56, 57, 59, 60, 61, 87, 88, 89, 91, 92]"

Norman,L0,long,10,5,5,0,0.9091,110,"[15, 30, 31, 32, 62, 63, 89, 90, 93, 94]"

Norman,L0,long,9,3,6,3,0.9174,109,"[15, 28, 31, 57, 58, 59, 62, 88, 90]"

Norman,L0,long,10,3,7,1,0.9091,110,"[15, 27, 28, 30, 31, 33, 60, 62, 64, 93]"

Norman,L0,long,9,5,4,3,0.9174,109,"[17, 30, 57, 58, 61, 87, 88, 91, 92]"

Norman,L0,long,14,2,12,5,0.8772,114,"[15, 27, 28, 29, 30, 32, 34, 61, 62, 66, 92, 94, 95, 100]"

Norman,L0,long,9,2,7,0,0.9174,109,"[15, 27, 29, 55, 58, 59, 85, 86, 89]"

Norman,L0,long,9,3,6,2,0.9174,109,"[27, 30, 56, 57, 58, 59, 86, 87, 91]"

Norman,L0,long,8,4,4,0,0.9259,108,"[28, 29, 55, 58, 59, 60, 87, 90]"

Norman,L0,long,10,8,2,1,0.9091,110,"[17, 30, 31, 58, 60, 61, 87, 88, 91, 94]"

Norman,L0,long,10,4,6,1,0.9091,110,"[16, 27, 28, 31, 33, 60, 62, 89, 91, 92]"

Norman,L0,long,10,5,5,2,0.9091,110,"[15, 27, 30, 33, 61, 62, 88, 90, 92, 93]"

Norman,L0,long,15,11,4,0,0.8696,115,"[15, 29, 30, 56, 57, 58, 59, 60, 61, 87, 89, 90, 92, 93, 94]"

Norman,L0,long,11,4,7,1,0.9009,111,"[28, 30, 56, 57, 58, 59, 85, 86, 87, 89, 90]"

Norman,L0,long,9,7,2,0,0.9174,109,"[15, 29, 55, 56, 59, 86, 87, 88, 89]"

Norman,L0,long,11,8,3,0,0.9009,111,"[16, 27, 28, 29, 56, 57, 59, 87, 88, 89, 91]"

Norman,L0,long,11,4,7,2,0.9009,111,"[27, 28, 30, 31, 32, 56, 60, 61, 63, 90, 93]"

Norman,L0,long,9,6,3,1,0.9174,109,"[15, 28, 30, 56, 59, 86, 87, 88, 89]"

Norman,L0,long,11,1,10,0,0.9009,111,"[15, 27, 28, 29, 57, 59, 85, 86, 87, 88, 89]"

Norman,L0,long,12,5,7,5,0.8929,112,"[27, 28, 29, 30, 54, 56, 58, 60, 62, 65, 91, 96]"

Norman,L0,long,10,8,2,3,0.9091,110,"[16, 28, 30, 56, 57, 60, 86, 87, 88, 90]"

Norman,L0,long,11,7,4,2,0.9009,111,"[27, 30, 31, 57, 59, 61, 62, 64, 89, 92, 95]"

Norman,L0,long,12,5,7,1,0.8929,112,"[15, 27, 28, 29, 30, 57, 58, 59, 60, 87, 89, 91]"

Norman,L0,long,11,5,6,1,0.9009,111,"[15, 27, 28, 30, 56, 57, 59, 86, 87, 89, 90]"

Norman,L0,long,9,3,6,1,0.9174,109,"[29, 55, 57, 60, 84, 87, 88, 90, 91]"

Norman,L0,long,9,4,5,1,0.9174,109,"[15, 27, 28, 29, 56, 57, 58, 59, 90]"

Norman,L0,long,11,8,3,2,0.9009,111,"[17, 30, 55, 56, 57, 58, 60, 86, 87, 89, 90]"

Norman,L0,long,8,1,7,1,0.9259,108,"[15, 28, 29, 57, 60, 88, 89, 90]"

Norman,L0,long,7,5,2,3,0.9346,107,"[15, 28, 30, 59, 85, 86, 91]"

Norman,L0,long,11,8,3,0,0.9009,111,"[15, 27, 29, 55, 56, 57, 59, 87, 88, 89, 90]"

Norman,L0,long,11,8,3,2,0.9009,111,"[31, 56, 57, 59, 60, 85, 87, 88, 89, 90, 91]"

Norman,L0,long,11,7,4,1,0.9009,111,"[15, 27, 28, 30, 56, 57, 59, 87, 88, 89, 90]"

Norman,L0,long,9,1,8,4,0.9174,109,"[27, 28, 29, 53, 55, 56, 61, 88, 91]"

Norman,L0,long,13,10,3,0,0.885,113,"[27, 29, 53, 55, 56, 57, 58, 59, 84, 86, 89, 91, 92]"

Norman,L0,long,11,5,6,0,0.9009,111,"[27, 28, 29, 53, 55, 56, 58, 59, 60, 86, 90]"

Norman,L0,long,10,4,6,5,0.9091,110,"[16, 27, 28, 29, 30, 33, 60, 63, 89, 92]"

Norman,L0,long,9,9,0,1,0.9174,109,"[17, 30, 59, 84, 85, 86, 87, 88, 89]"

Norman,L0,long,14,6,8,0,0.8772,114,"[15, 27, 29, 55, 56, 57, 59, 60, 62, 63, 89, 90, 91, 93]"

Norman,L0,long,10,4,6,2,0.9091,110,"[27, 28, 31, 57, 59, 61, 86, 88, 90, 92]"

Norman,L0,long,8,3,5,2,0.9259,108,"[15, 28, 30, 56, 58, 59, 86, 90]"

Norman,L0,long,9,3,6,0,0.9174,109,"[29, 55, 56, 58, 59, 60, 87, 88, 90]"

Norman,L0,long,9,4,5,1,0.9174,109,"[16, 28, 31, 58, 60, 86, 88, 89, 90]"

Norman,L0,long,10,6,4,0,0.9091,110,"[28, 29, 55, 56, 60, 61, 88, 89, 90, 92]"

Norman,L0,long,12,6,6,1,0.8929,112,"[15, 28, 29, 55, 56, 57, 58, 59, 87, 88, 89, 91]"

Norman,L0,long,9,6,3,0,0.9174,109,"[27, 29, 53, 55, 57, 58, 59, 84, 90]"

Norman,L0,long,11,5,6,3,0.9009,111,"[15, 27, 28, 30, 57, 58, 59, 60, 86, 91, 95]"

Norman,L0,long,10,5,5,5,0.9091,110,"[30, 56, 57, 58, 62, 65, 91, 92, 93, 97]"

Norman,L0,long,13,4,9,1,0.885,113,"[15, 27, 28, 29, 56, 58, 59, 60, 86, 87, 88, 89, 91]"

Norman,L0,long,10,4,6,2,0.9091,110,"[15, 27, 28, 30, 58, 60, 86, 87, 88, 89]"

Norman,L0,long,6,3,3,4,0.9434,106,"[19, 32, 61, 87, 88, 90]"

Norman,L0,long,9,2,7,1,0.9174,109,"[27, 28, 29, 30, 54, 58, 60, 86, 92]"

Norman,L0,long,12,8,4,1,0.8929,112,"[27, 29, 53, 56, 57, 58, 60, 86, 88, 89, 90, 91]"

Norman,L0,long,8,2,6,2,0.9259,108,"[15, 27, 31, 59, 86, 87, 88, 90]"

Norman,L0,long,9,4,5,0,0.9174,109,"[29, 55, 56, 57, 58, 59, 86, 87, 89]"

Norman,L0,long,13,8,5,2,0.885,113,"[27, 29, 31, 57, 58, 60, 86, 87, 88, 89, 90, 92, 94]"

Norman,L0,long,7,6,1,0,0.9346,107,"[29, 57, 58, 59, 84, 85, 89]"

Norman,L0,long,8,1,7,3,0.9259,108,"[15, 27, 28, 29, 58, 60, 88, 91]"

Norman,L0,long,14,9,5,3,0.8772,114,"[27, 28, 29, 31, 55, 57, 58, 59, 60, 61, 64, 92, 93, 94]"

Norman,L0,long,10,2,8,2,0.9091,110,"[27, 28, 29, 53, 55, 56, 58, 61, 87, 89]"

Norman,L0,long,12,5,7,3,0.8929,112,"[15, 29, 30, 31, 57, 59, 60, 64, 90, 91, 92, 94]"

Norman,L0,long,10,9,1,1,0.9091,110,"[28, 30, 57, 59, 84, 85, 86, 87, 88, 89]"

Norman,L0,long,11,4,7,1,0.9009,111,"[16, 27, 29, 55, 56, 57, 60, 86, 87, 88, 89]"

Norman,L0,long,9,5,4,4,0.9174,109,"[28, 29, 53, 57, 58, 59, 86, 88, 93]"

Norman,L0,long,13,7,6,2,0.885,113,"[29, 30, 32, 57, 58, 61, 62, 63, 88, 92, 93, 94, 96]"

Norman,L0,long,9,6,3,6,0.9174,109,"[27, 28, 29, 55, 56, 58, 63, 88, 92]"

Norman,L0,long,9,7,2,2,0.9174,109,"[16, 28, 29, 55, 56, 61, 87, 88, 89]"

Norman,L0,long,11,1,10,1,0.9009,111,"[15, 27, 28, 30, 57, 59, 85, 86, 87, 88, 89]"

Norman,L0,long,11,4,7,1,0.9009,111,"[16, 27, 28, 30, 56, 58, 59, 85, 86, 87, 89]"

Norman,L0,long,9,7,2,2,0.9174,109,"[28, 29, 53, 56, 60, 85, 86, 88, 90]"

Norman,L0,long,10,0,10,3,0.9091,110,"[27, 32, 57, 58, 59, 63, 88, 90, 91, 92]"

Norman,L0,long,11,8,3,0,0.9009,111,"[28, 29, 53, 55, 56, 57, 58, 59, 85, 87, 89]"

Norman,L0,long,10,5,5,0,0.9091,110,"[29, 30, 56, 57, 59, 60, 86, 87, 89, 91]"

Norman,L0,long,12,2,10,0,0.8929,112,"[27, 28, 29, 54, 55, 56, 57, 58, 59, 85, 87, 89]"

Norman,L0,long,15,6,9,0,0.8696,115,"[27, 29, 30, 32, 33, 60, 61, 62, 63, 64, 65, 91, 93, 95, 96]"

Norman,L0,long,8,4,4,1,0.9259,108,"[15, 28, 30, 56, 57, 59, 61, 91]"

Norman,L0,long,13,8,5,0,0.885,113,"[15, 28, 29, 56, 57, 58, 59, 61, 87, 89, 90, 91, 92]"

Norman,L0,long,11,7,4,1,0.9009,111,"[27, 28, 30, 54, 57, 58, 60, 87, 88, 89, 90]"

Norman,L0,long,11,5,6,0,0.9009,111,"[27, 28, 29, 53, 55, 57, 58, 59, 60, 87, 90]"

Norman,L0,long,9,2,7,2,0.9174,109,"[15, 27, 28, 29, 58, 59, 62, 88, 90]"

Norman,L0,long,13,6,7,2,0.885,113,"[15, 27, 28, 30, 57, 58, 59, 61, 87, 90, 91, 92, 94]"

Norman,L0,long,9,8,1,2,0.9174,109,"[15, 29, 55, 56, 57, 61, 87, 88, 89]"

Norman,L0,long,7,4,3,2,0.9346,107,"[29, 56, 59, 83, 87, 88, 91]"

Norman,L0,long,9,3,6,3,0.9174,109,"[16, 32, 59, 84, 86, 87, 88, 89, 90]"

Norman,L0,long,11,5,6,4,0.9009,111,"[27, 28, 29, 30, 54, 57, 58, 59, 63, 89, 91]"

Norman,L0,long,12,7,5,5,0.8929,112,"[15, 27, 28, 29, 33, 61, 87, 88, 89, 90, 91, 93]"

Norman,L0,long,13,8,5,0,0.885,113,"[15, 29, 30, 56, 58, 59, 61, 62, 88, 89, 90, 91, 92]"

Norman,L0,long,14,7,7,0,0.8772,114,"[16, 28, 29, 55, 56, 57, 58, 59, 60, 87, 89, 90, 91, 92]"

Norman,L0,long,14,7,7,4,0.8772,114,"[15, 27, 28, 30, 31, 57, 58, 59, 60, 62, 89, 91, 92, 96]"

Norman,L0,long,13,7,6,0,0.885,113,"[15, 28, 30, 31, 57, 58, 59, 60, 61, 87, 89, 90, 91]"

Norman,L0,long,10,5,5,0,0.9091,110,"[15, 27, 30, 58, 60, 61, 87, 88, 90, 91]"

Norman,L0,long,9,0,9,3,0.9174,109,"[27, 28, 32, 57, 58, 59, 85, 89, 91]"

Norman,L0,long,9,2,7,1,0.9174,109,"[15, 27, 28, 30, 56, 59, 60, 88, 90]"

Norman,L0,long,12,5,7,1,0.8929,112,"[15, 27, 28, 30, 32, 58, 61, 62, 88, 89, 90, 93]"

Norman,L0,long,10,4,6,0,0.9091,110,"[15, 27, 28, 29, 57, 58, 59, 85, 86, 89]"

Norman,L0,long,10,6,4,3,0.9091,110,"[15, 27, 28, 32, 59, 61, 87, 88, 89, 90]"

Norman,L0,long,8,1,7,1,0.9259,108,"[27, 28, 30, 57, 58, 60, 89, 90]"

Norman,L0,long,14,4,10,3,0.8772,114,"[15, 27, 28, 29, 30, 33, 61, 62, 63, 64, 91, 92, 93, 95]"

Norman,L0,long,10,3,7,1,0.9091,110,"[27, 29, 31, 57, 60, 87, 88, 89, 90, 91]"

Norman,L0,long,8,4,4,1,0.9259,108,"[18, 31, 58, 59, 60, 86, 89, 90]"

Norman,L0,long,11,5,6,1,0.9009,111,"[15, 28, 29, 55, 56, 58, 59, 85, 86, 87, 90]"

Norman,L0,long,11,4,7,0,0.9009,111,"[15, 27, 29, 56, 57, 58, 59, 85, 87, 88, 89]"

Norman,L0,long,9,7,2,3,0.9174,109,"[27, 29, 53, 55, 56, 57, 62, 87, 89]"

Norman,L0,long,10,7,3,3,0.9091,110,"[17, 30, 55, 56, 57, 58, 60, 64, 90, 91]"

Norman,L0,long,12,6,6,2,0.8929,112,"[15, 28, 29, 30, 57, 60, 86, 87, 88, 89, 90, 93]"

Norman,L0,long,9,5,4,1,0.9174,109,"[28, 30, 57, 58, 59, 85, 86, 87, 90]"

Norman,L0,long,10,4,6,3,0.9091,110,"[17, 32, 58, 60, 61, 87, 88, 89, 90, 91]"

Norman,L0,long,9,3,6,3,0.9174,109,"[15, 28, 32, 58, 61, 62, 88, 89, 92]"

Norman,L0,long,13,0,13,0,0.885,113,"[27, 28, 29, 54, 55, 56, 57, 58, 59, 60, 88, 89, 91]"

Norman,L0,long,8,4,4,1,0.9259,108,"[15, 31, 58, 59, 60, 87, 88, 92]"

Norman,L0,long,9,4,5,1,0.9174,109,"[27, 28, 29, 53, 56, 60, 87, 88, 89]"

Norman,L0,long,12,3,9,1,0.8929,112,"[28, 29, 53, 57, 58, 59, 85, 86, 87, 88, 89, 91]"

Norman,L0,long,13,5,8,1,0.885,113,"[15, 27, 28, 29, 30, 31, 58, 59, 60, 62, 88, 89, 92]"

Norman,L0,long,11,2,9,2,0.9009,111,"[27, 28, 30, 57, 58, 59, 85, 86, 87, 88, 90]"

Norman,L0,long,12,8,4,1,0.8929,112,"[27, 29, 53, 55, 56, 57, 58, 59, 84, 86, 88, 90]"

Norman,L0,long,12,7,5,1,0.8929,112,"[29, 31, 56, 58, 59, 60, 62, 87, 89, 90, 91, 92]"

Norman,L0,long,10,4,6,0,0.9091,110,"[15, 27, 28, 29, 56, 58, 59, 87, 90, 92]"

Norman,L0,long,9,2,7,3,0.9174,109,"[28, 30, 56, 61, 87, 88, 89, 90, 91]"

Norman,L0,long,12,6,6,2,0.8929,112,"[15, 27, 29, 55, 56, 57, 58, 59, 86, 87, 88, 91]"

Norman,L0,long,9,4,5,1,0.9174,109,"[28, 30, 57, 58, 59, 60, 86, 88, 90]"

Norman,L0,long,11,4,7,1,0.9009,111,"[29, 55, 56, 57, 58, 59, 85, 86, 88, 89, 91]"

Norman,L0,long,10,5,5,0,0.9091,110,"[15, 27, 28, 29, 56, 58, 59, 85, 88, 89]"

Norman,L0,long,10,5,5,3,0.9091,110,"[28, 29, 32, 57, 59, 63, 88, 91, 92, 94]"

Norman,L0,long,10,4,6,0,0.9091,110,"[27, 28, 29, 53, 57, 58, 59, 85, 87, 89]"

Norman,L0,long,12,9,3,0,0.8929,112,"[27, 29, 53, 56, 57, 58, 59, 84, 87, 89, 90, 91]"

Norman,L0,long,14,13,1,0,0.8772,114,"[28, 29, 30, 54, 56, 57, 58, 59, 61, 89, 91, 92, 93, 94]"

Norman,L0,long,13,9,4,1,0.885,113,"[27, 28, 29, 31, 55, 57, 58, 59, 60, 61, 63, 92, 96]"

Norman,L0,long,11,6,5,3,0.9009,111,"[16, 28, 33, 59, 61, 87, 89, 90, 93, 94, 95]"

Norman,L0,long,9,1,8,4,0.9174,109,"[18, 31, 57, 58, 61, 87, 88, 89, 90]"

Norman,L0,long,11,7,4,2,0.9009,111,"[27, 28, 29, 31, 60, 86, 87, 88, 89, 90, 92]"

Norman,L0,long,9,6,3,0,0.9174,109,"[15, 29, 30, 56, 57, 58, 61, 87, 91]"

Norman,L0,long,10,2,8,0,0.9091,110,"[16, 27, 29, 55, 58, 59, 61, 62, 90, 92]"

Norman,L0,long,12,8,4,1,0.8929,112,"[27, 29, 53, 56, 57, 58, 59, 61, 87, 89, 90, 91]"

Norman,L0,long,11,6,5,1,0.9009,111,"[16, 27, 28, 30, 56, 58, 59, 60, 87, 88, 90]"

Norman,L0,long,11,5,6,1,0.9009,111,"[29, 55, 56, 57, 58, 59, 61, 87, 88, 89, 90]"

Norman,L0,long,9,5,4,4,0.9174,109,"[15, 27, 28, 31, 57, 58, 61, 88, 89]"

Norman,L0,long,12,8,4,0,0.8929,112,"[17, 30, 55, 56, 57, 58, 59, 60, 86, 87, 88, 90]"

Norman,L0,long,12,0,12,2,0.8929,112,"[27, 28, 29, 57, 58, 59, 85, 86, 87, 88, 89, 93]"

Norman,L0,long,11,2,9,1,0.9009,111,"[29, 55, 56, 57, 58, 59, 85, 86, 87, 88, 90]"

Norman,L0,long,8,7,1,1,0.9259,108,"[29, 56, 58, 59, 60, 86, 87, 91]"

Norman,L0,long,11,2,9,1,0.9009,111,"[27, 28, 29, 30, 54, 56, 57, 58, 60, 63, 94]"

Norman,L0,long,9,0,9,0,0.9174,109,"[15, 27, 28, 29, 59, 60, 89, 90, 91]"

Norman,L0,long,10,5,5,3,0.9091,110,"[27, 28, 30, 54, 57, 58, 60, 86, 88, 90]"

Norman,L0,long,8,5,3,1,0.9259,108,"[15, 29, 55, 59, 85, 86, 88, 90]"

Norman,L0,long,10,6,4,2,0.9091,110,"[15, 27, 29, 55, 56, 57, 61, 87, 88, 89]"

Norman,L0,long,10,6,4,3,0.9091,110,"[30, 56, 57, 58, 60, 85, 86, 87, 88, 90]"

Norman,L0,long,13,7,6,1,0.885,113,"[27, 28, 29, 31, 60, 61, 86, 88, 89, 90, 92, 93, 94]"

Norman,L0,long,11,4,7,1,0.9009,111,"[27, 28, 29, 53, 55, 57, 58, 60, 85, 88, 89]"

Norman,L0,long,10,4,6,0,0.9091,110,"[15, 27, 28, 29, 57, 59, 85, 87, 89, 90]"

Norman,L0,long,11,5,6,1,0.9009,111,"[15, 28, 29, 55, 56, 57, 58, 60, 87, 88, 89]"

Norman,L0,long,13,4,9,2,0.885,113,"[27, 28, 29, 53, 55, 56, 58, 60, 85, 88, 89, 91, 94]"

Norman,L0,long,13,4,9,0,0.885,113,"[15, 27, 28, 29, 30, 57, 58, 59, 60, 87, 89, 90, 91]"

Norman,L0,long,11,5,6,6,0.9009,111,"[15, 27, 28, 29, 56, 57, 58, 60, 61, 67, 93]"

Norman,L0,long,13,7,6,2,0.885,113,"[15, 28, 29, 30, 32, 58, 60, 62, 88, 89, 91, 92, 93]"

Norman,L0,long,9,5,4,1,0.9174,109,"[15, 27, 29, 58, 60, 86, 87, 88, 89]"

Norman,L0,long,11,8,3,0,0.9009,111,"[15, 29, 55, 56, 57, 58, 59, 85, 88, 90, 92]"

Norman,L0,long,11,6,5,1,0.9009,111,"[27, 28, 30, 54, 56, 57, 58, 59, 84, 88, 89]"

Norman,L0,long,8,1,7,3,0.9259,108,"[15, 27, 32, 59, 87, 88, 89, 90]"

Norman,L0,long,10,4,6,5,0.9091,110,"[27, 28, 29, 53, 57, 63, 90, 92, 93, 95]"

Norman,L0,long,10,4,6,0,0.9091,110,"[15, 28, 29, 57, 58, 59, 86, 88, 89, 90]"

Norman,L0,long,14,6,8,0,0.8772,114,"[15, 27, 30, 56, 57, 58, 59, 60, 86, 87, 89, 90, 91, 92]"

Norman,L0,long,10,7,3,0,0.9091,110,"[27, 29, 30, 54, 56, 57, 58, 60, 87, 90]"

Norman,L0,long,13,7,6,0,0.885,113,"[27, 28, 30, 54, 56, 57, 58, 59, 60, 86, 88, 89, 90]"

Norman,L0,long,12,6,6,1,0.8929,112,"[15, 27, 28, 29, 57, 58, 61, 87, 88, 90, 91, 93]"

Norman,L0,long,10,6,4,2,0.9091,110,"[27, 29, 31, 58, 61, 62, 87, 90, 91, 93]"

Norman,L0,long,10,6,4,1,0.9091,110,"[16, 27, 28, 29, 56, 58, 60, 87, 88, 89]"

Norman,L0,long,12,4,8,1,0.8929,112,"[15, 28, 29, 55, 56, 58, 59, 85, 86, 87, 88, 90]"

Norman,L0,long,10,7,3,2,0.9091,110,"[19, 32, 58, 59, 60, 61, 87, 89, 92, 93]"

Norman,L0,long,8,4,4,2,0.9259,108,"[30, 55, 59, 60, 61, 64, 89, 92]"

Norman,L0,long,11,6,5,0,0.9009,111,"[28, 29, 56, 58, 59, 60, 61, 88, 89, 90, 91]"

Norman,L0,long,9,3,6,2,0.9174,109,"[15, 27, 28, 29, 30, 58, 62, 88, 90]"

Norman,L0,long,12,4,8,1,0.8929,112,"[27, 28, 29, 31, 55, 57, 58, 60, 87, 88, 89, 90]"

Norman,L0,long,13,6,7,1,0.885,113,"[27, 28, 29, 30, 31, 32, 57, 59, 60, 61, 62, 88, 93]"

Norman,L0,long,13,7,6,1,0.885,113,"[27, 28, 30, 54, 56, 58, 59, 60, 85, 88, 89, 92, 94]"

Norman,L0,long,13,1,12,3,0.885,113,"[29, 32, 57, 58, 59, 60, 64, 90, 91, 92, 93, 94, 95]"

Norman,L0,long,8,3,5,3,0.9259,108,"[27, 30, 31, 57, 59, 64, 89, 92]"

Norman,L0,long,9,1,8,0,0.9174,109,"[27, 28, 30, 57, 59, 60, 61, 90, 91]"

Norman,L0,long,12,8,4,1,0.8929,112,"[27, 28, 30, 54, 56, 57, 58, 59, 60, 62, 89, 92]"

Norman,L0,long,10,3,7,1,0.9091,110,"[17, 31, 59, 60, 86, 87, 88, 89, 90, 91]"

Norman,L0,long,10,3,7,1,0.9091,110,"[15, 27, 28, 29, 57, 58, 60, 86, 89, 91]"

Norman,L0,long,10,7,3,0,0.9091,110,"[16, 27, 30, 56, 59, 60, 86, 88, 89, 90]"

Norman,L0,long,10,9,1,1,0.9091,110,"[15, 30, 55, 59, 60, 86, 87, 88, 89, 90]"

Norman,L0,long,7,1,6,4,0.9346,107,"[27, 32, 57, 58, 60, 88, 89]"

Norman,L0,long,15,7,8,0,0.8696,115,"[27, 28, 29, 54, 56, 59, 60, 61, 87, 89, 90, 91, 92, 93, 94]"

Norman,L0,long,10,5,5,0,0.9091,110,"[27, 28, 29, 53, 57, 58, 59, 84, 87, 89]"

Norman,L0,long,11,1,10,0,0.9009,111,"[15, 27, 29, 56, 59, 60, 61, 90, 91, 92, 93]"

Norman,L0,long,12,8,4,2,0.8929,112,"[17, 33, 35, 61, 62, 64, 65, 91, 92, 93, 94, 96]"

Norman,L0,long,12,2,10,0,0.8929,112,"[27, 28, 29, 53, 55, 56, 57, 58, 59, 85, 87, 89]"

Norman,L0,long,12,11,1,4,0.8929,112,"[28, 29, 53, 55, 56, 57, 58, 63, 89, 90, 91, 92]"

Norman,L0,long,9,4,5,3,0.9174,109,"[17, 30, 57, 58, 59, 86, 88, 89, 92]"

Norman,L0,long,12,3,9,1,0.8929,112,"[15, 28, 29, 31, 57, 58, 61, 62, 63, 91, 92, 93]"

Norman,L0,long,8,5,3,1,0.9259,108,"[29, 57, 59, 84, 87, 88, 89, 91]"

Norman,L0,long,13,3,10,0,0.885,113,"[15, 27, 28, 29, 56, 58, 59, 85, 86, 87, 88, 89, 90]"

Norman,L0,long,14,4,10,0,0.8772,114,"[15, 27, 28, 29, 30, 57, 58, 59, 60, 87, 88, 89, 90, 92]"

Norman,L0,long,12,2,10,2,0.8929,112,"[15, 27, 28, 29, 30, 32, 59, 61, 62, 88, 90, 94]"

Norman,L0,long,10,5,5,0,0.9091,110,"[27, 28, 29, 54, 55, 57, 59, 84, 88, 89]"

Norman,L0,long,10,9,1,7,0.9091,110,"[28, 29, 30, 54, 57, 58, 59, 64, 89, 93]"

Norman,L0,long,14,5,9,1,0.8772,114,"[15, 28, 29, 31, 57, 58, 59, 60, 86, 87, 89, 90, 91, 92]"

Norman,L0,long,15,6,9,1,0.8696,115,"[15, 27, 28, 29, 30, 57, 59, 60, 61, 63, 89, 90, 92, 94, 96]"

Norman,L0,long,8,5,3,5,0.9259,108,"[18, 33, 58, 59, 61, 87, 88, 92]"

Norman,L0,long,12,8,4,0,0.8929,112,"[16, 27, 29, 55, 57, 58, 59, 60, 86, 87, 90, 91]"

Norman,L0,long,11,9,2,0,0.9009,111,"[27, 29, 53, 56, 57, 58, 59, 60, 85, 89, 90]"

Norman,L0,long,10,5,5,0,0.9091,110,"[27, 28, 29, 55, 59, 60, 86, 87, 88, 90]"

Norman,L0,long,11,8,3,4,0.9009,111,"[27, 29, 53, 55, 56, 57, 58, 62, 88, 89, 91]"

Norman,L0,long,11,6,5,1,0.9009,111,"[27, 28, 29, 30, 57, 58, 59, 61, 88, 89, 90]"

Norman,L0,long,12,3,9,3,0.8929,112,"[15, 27, 28, 29, 30, 32, 61, 62, 89, 90, 92, 95]"

Norman,L0,long,12,6,6,0,0.8929,112,"[27, 28, 29, 30, 32, 33, 34, 63, 64, 89, 92, 94]"

Norman,L0,long,9,3,6,3,0.9174,109,"[27, 31, 56, 58, 59, 61, 87, 88, 90]"

Norman,L0,long,10,5,5,0,0.9091,110,"[27, 28, 29, 53, 56, 58, 59, 84, 87, 89]"

Norman,L0,long,10,2,8,3,0.9091,110,"[27, 29, 32, 57, 58, 60, 86, 89, 90, 92]"

Norman,L0,long,7,3,4,4,0.9346,107,"[17, 31, 58, 60, 87, 88, 92]"

Norman,L0,long,12,3,9,4,0.8929,112,"[15, 27, 28, 29, 32, 58, 63, 89, 90, 91, 92, 93]"

Norman,L0,long,10,6,4,2,0.9091,110,"[16, 27, 30, 56, 57, 59, 85, 86, 88, 90]"

Norman,L0,long,12,1,11,0,0.8929,112,"[27, 29, 56, 57, 58, 59, 85, 86, 87, 88, 89, 90]"

Norman,L0,long,10,3,7,1,0.9091,110,"[27, 30, 56, 57, 59, 61, 87, 89, 90, 91]"

Norman,L0,long,14,10,4,0,0.8772,114,"[27, 28, 30, 31, 32, 56, 59, 60, 61, 63, 90, 91, 92, 93]"

Norman,L0,long,9,3,6,1,0.9174,109,"[16, 27, 29, 31, 58, 59, 61, 87, 91]"

Norman,L0,long,9,2,7,5,0.9174,109,"[15, 27, 28, 29, 33, 62, 88, 89, 90]"

Norman,L0,long,10,5,5,2,0.9091,110,"[15, 28, 31, 58, 59, 61, 87, 88, 90, 93]"

Norman,L0,long,15,9,6,2,0.8696,115,"[15, 27, 28, 29, 31, 57, 59, 60, 88, 89, 90, 91, 93, 94, 96]"

Norman,L0,long,9,6,3,3,0.9174,109,"[17, 31, 57, 58, 60, 86, 87, 88, 89]"

Norman,L0,long,10,4,6,2,0.9091,110,"[17, 30, 31, 58, 59, 61, 64, 90, 91, 92]"

Norman,L0,long,11,6,5,0,0.9009,111,"[15, 27, 30, 58, 59, 60, 86, 87, 88, 89, 90]"

Norman,L0,long,12,9,3,0,0.8929,112,"[15, 27, 29, 55, 56, 57, 58, 59, 60, 61, 62, 92]"

Norman,L0,long,12,6,6,0,0.8929,112,"[27, 28, 29, 31, 58, 59, 61, 88, 89, 90, 91, 92]"

Norman,L0,long,9,3,6,2,0.9174,109,"[29, 30, 56, 57, 58, 60, 88, 92, 95]"

Norman,L0,long,11,3,8,1,0.9009,111,"[27, 28, 30, 58, 59, 60, 61, 62, 88, 90, 92]"

Norman,L0,long,12,0,12,0,0.8929,112,"[27, 28, 29, 53, 55, 56, 57, 58, 59, 87, 88, 89]"

Norman,L0,long,11,7,4,2,0.9009,111,"[28, 30, 56, 57, 58, 60, 86, 87, 88, 89, 90]"

Norman,L0,long,13,8,5,0,0.885,113,"[15, 27, 30, 56, 57, 58, 59, 60, 61, 88, 89, 90, 92]"

Norman,L0,long,8,5,3,0,0.9259,108,"[29, 56, 59, 83, 85, 86, 88, 89]"

Norman,L0,long,15,11,4,1,0.8696,115,"[27, 29, 30, 31, 55, 57, 58, 59, 60, 62, 89, 90, 92, 93, 94]"

Norman,L0,long,11,3,8,2,0.9009,111,"[27, 28, 29, 53, 55, 56, 57, 59, 62, 89, 90]"

Norman,L0,long,9,5,4,0,0.9174,109,"[29, 56, 57, 58, 59, 85, 87, 88, 89]"

Norman,L0,long,10,5,5,0,0.9091,110,"[28, 29, 56, 57, 61, 85, 87, 89, 90, 91]"

Norman,L0,long,12,4,8,5,0.8929,112,"[27, 28, 29, 30, 31, 34, 60, 61, 64, 89, 91, 93]"

Norman,L0,long,13,12,1,1,0.885,113,"[29, 31, 58, 59, 60, 85, 86, 88, 89, 90, 91, 92, 93]"

Norman,L0,long,10,7,3,1,0.9091,110,"[15, 29, 55, 56, 57, 58, 60, 86, 88, 89]"

Norman,L0,long,10,4,6,3,0.9091,110,"[15, 27, 31, 57, 59, 60, 86, 87, 88, 91]"

Norman,L0,long,8,2,6,1,0.9259,108,"[15, 28, 29, 56, 58, 61, 89, 90]"

Norman,L0,long,8,3,5,3,0.9259,108,"[29, 56, 57, 58, 62, 86, 89, 92]"

Norman,L0,long,10,8,2,0,0.9091,110,"[17, 30, 55, 56, 57, 60, 86, 90, 92, 93]"

Norman,L0,long,7,4,3,2,0.9346,107,"[28, 30, 56, 60, 84, 88, 89]"

Norman,L0,long,12,6,6,0,0.8929,112,"[15, 28, 29, 55, 56, 57, 58, 59, 60, 87, 88, 90]"

Norman,L0,long,11,5,6,0,0.9009,111,"[15, 27, 28, 30, 59, 60, 86, 88, 89, 90, 91]"

Norman,L0,long,11,4,7,1,0.9009,111,"[27, 28, 30, 54, 56, 58, 59, 85, 87, 88, 89]"

Norman,L0,long,8,3,5,1,0.9259,108,"[28, 30, 56, 57, 58, 59, 87, 90]"

Norman,L0,long,10,3,7,0,0.9091,110,"[28, 30, 56, 57, 58, 61, 88, 90, 91, 92]"

Norman,L0,long,9,3,6,1,0.9174,109,"[28, 30, 56, 58, 59, 86, 88, 89, 90]"

Norman,L0,long,10,2,8,2,0.9091,110,"[27, 30, 56, 57, 58, 59, 60, 63, 90, 91]"

Norman,L0,long,12,4,8,0,0.8929,112,"[27, 29, 53, 57, 58, 59, 85, 86, 87, 89, 90, 91]"

Norman,L0,long,9,6,3,2,0.9174,109,"[27, 29, 30, 31, 32, 59, 64, 92, 93]"

Norman,L0,long,11,8,3,0,0.9009,111,"[29, 30, 31, 32, 59, 61, 62, 87, 89, 91, 92]"

Norman,L0,long,6,3,3,7,0.9434,106,"[35, 62, 86, 88, 90, 91]"

Norman,L0,long,13,3,10,1,0.885,113,"[27, 28, 29, 30, 54, 56, 58, 59, 61, 88, 89, 90, 91]"

Norman,L0,long,11,7,4,2,0.9009,111,"[15, 27, 30, 56, 57, 58, 59, 85, 87, 89, 91]"

Norman,L0,long,10,7,3,1,0.9091,110,"[15, 29, 55, 57, 59, 85, 86, 87, 88, 90]"

Norman,L0,long,11,3,8,0,0.9009,111,"[15, 27, 28, 29, 57, 59, 85, 87, 88, 91, 92]"

Norman,L0,long,13,5,8,0,0.885,113,"[27, 28, 29, 53, 55, 56, 57, 59, 84, 86, 87, 88, 90]"

Norman,L0,long,12,5,7,1,0.8929,112,"[27, 28, 29, 30, 55, 57, 58, 60, 61, 88, 89, 92]"

Norman,L0,long,7,4,3,5,0.9346,107,"[27, 34, 60, 86, 88, 89, 90]"

Norman,L0,long,8,4,4,2,0.9259,108,"[15, 28, 30, 59, 85, 86, 88, 90]"

Norman,L0,long,11,4,7,1,0.9009,111,"[27, 30, 56, 57, 58, 59, 60, 86, 88, 89, 90]"

Norman,L0,long,11,5,6,4,0.9009,111,"[27, 28, 29, 30, 55, 57, 58, 59, 63, 89, 91]"

Norman,L0,long,11,6,5,1,0.9009,111,"[28, 29, 30, 54, 57, 58, 61, 87, 90, 91, 92]"

Norman,L0,long,11,5,6,1,0.9009,111,"[27, 28, 29, 32, 59, 60, 61, 87, 88, 89, 91]"

Norman,L0,long,10,4,6,1,0.9091,110,"[16, 27, 28, 29, 30, 57, 58, 59, 62, 91]"

Norman,L0,long,15,2,13,2,0.8696,115,"[27, 28, 29, 53, 55, 56, 57, 58, 59, 60, 61, 63, 66, 93, 96]"

Norman,L0,long,9,1,8,4,0.9174,109,"[18, 31, 57, 60, 86, 87, 88, 89, 91]"

Norman,L0,long,13,5,8,0,0.885,113,"[16, 27, 28, 29, 31, 32, 60, 62, 63, 90, 91, 92, 93]"

Norman,L0,long,13,5,8,0,0.885,113,"[27, 28, 29, 53, 55, 57, 58, 59, 60, 86, 88, 89, 91]"

Norman,L0,long,6,2,4,3,0.9434,106,"[15, 31, 57, 62, 88, 90]"

Norman,L0,long,9,5,4,3,0.9174,109,"[15, 27, 28, 29, 57, 58, 59, 88, 92]"

Norman,L0,long,9,4,5,2,0.9174,109,"[27, 28, 29, 54, 56, 57, 61, 87, 89]"

Norman,L0,long,12,1,11,0,0.8929,112,"[27, 28, 29, 30, 55, 56, 57, 58, 59, 60, 86, 90]"

Norman,L0,long,12,4,8,4,0.8929,112,"[27, 28, 32, 57, 58, 59, 85, 87, 88, 89, 90, 93]"

Norman,L0,long,12,2,10,1,0.8929,112,"[27, 28, 29, 54, 55, 56, 57, 58, 60, 86, 88, 89]"

Norman,L0,long,8,5,3,6,0.9259,108,"[16, 31, 58, 59, 61, 88, 90, 94]"

Norman,L0,long,11,3,8,2,0.9009,111,"[27, 28, 29, 53, 56, 58, 59, 61, 63, 91, 93]"

Norman,L0,long,7,1,6,5,0.9346,107,"[27, 28, 33, 60, 86, 87, 89]"

Norman,L0,long,11,5,6,3,0.9009,111,"[27, 28, 32, 58, 59, 60, 86, 87, 89, 90, 91]"

Norman,L0,long,9,3,6,3,0.9174,109,"[18, 31, 57, 58, 59, 85, 86, 87, 90]"

Norman,L0,long,12,6,6,0,0.8929,112,"[15, 28, 29, 55, 58, 59, 61, 87, 88, 89, 90, 91]"

Norman,L0,long,11,7,4,3,0.9009,111,"[27, 28, 30, 54, 56, 57, 58, 60, 85, 88, 90]"

Norman,L0,long,8,4,4,3,0.9259,108,"[27, 28, 29, 56, 57, 62, 87, 89]"

Norman,L0,long,9,5,4,4,0.9174,109,"[28, 30, 57, 60, 84, 87, 88, 89, 92]"

Norman,L0,long,7,3,4,1,0.9346,107,"[17, 30, 57, 59, 86, 87, 89]"

Norman,L0,long,10,7,3,2,0.9091,110,"[17, 30, 55, 56, 57, 59, 85, 86, 88, 90]"

Norman,L0,long,10,6,4,1,0.9091,110,"[15, 27, 28, 30, 56, 57, 58, 59, 88, 89]"

Norman,L0,long,11,7,4,0,0.9009,111,"[27, 29, 53, 55, 56, 57, 58, 59, 84, 87, 89]"

Norman,L0,long,10,5,5,4,0.9091,110,"[15, 30, 55, 56, 57, 58, 60, 86, 87, 91]"

Norman,L0,long,13,5,8,4,0.885,113,"[15, 27, 28, 29, 30, 34, 61, 63, 65, 91, 93, 95, 97]"

Norman,L0,long,8,2,6,3,0.9259,108,"[28, 30, 56, 57, 59, 63, 88, 90]"

Norman,L0,long,11,5,6,3,0.9009,111,"[16, 27, 29, 30, 57, 59, 61, 87, 88, 89, 92]"

Norman,L0,long,13,1,12,1,0.885,113,"[15, 27, 28, 29, 30, 59, 60, 62, 63, 64, 93, 94, 96]"

Norman,L0,long,8,5,3,4,0.9259,108,"[28, 31, 56, 60, 84, 86, 87, 90]"

Norman,L0,long,9,3,6,3,0.9174,109,"[28, 32, 57, 58, 59, 60, 62, 90, 92]"

Norman,L0,long,9,2,7,3,0.9174,109,"[16, 27, 28, 29, 58, 59, 63, 89, 90]"

Norman,L0,long,10,6,4,3,0.9091,110,"[27, 28, 30, 54, 56, 58, 61, 87, 88, 89]"

Norman,L0,long,9,5,4,0,0.9174,109,"[16, 27, 28, 29, 59, 86, 87, 88, 89]"

Norman,L0,long,13,5,8,1,0.885,113,"[15, 29, 31, 57, 58, 59, 61, 62, 63, 90, 91, 92, 94]"

Norman,L0,long,10,7,3,5,0.9091,110,"[27, 32, 57, 59, 60, 61, 86, 88, 89, 94]"

Norman,L0,long,11,5,6,3,0.9009,111,"[15, 27, 28, 29, 30, 57, 59, 60, 88, 89, 93]"

Norman,L0,long,13,4,9,1,0.885,113,"[15, 27, 28, 29, 57, 59, 60, 61, 62, 64, 91, 92, 93]"

Norman,L0,long,9,5,4,1,0.9174,109,"[27, 30, 56, 57, 59, 86, 87, 88, 89]"

Norman,L0,long,12,7,5,1,0.8929,112,"[16, 28, 29, 31, 32, 59, 60, 63, 89, 90, 91, 94]"

Norman,L0,long,14,6,8,3,0.8772,114,"[29, 30, 31, 57, 58, 59, 60, 61, 62, 63, 64, 91, 92, 97]"

Norman,L0,long,12,9,3,0,0.8929,112,"[27, 29, 53, 55, 56, 57, 58, 59, 85, 86, 87, 89]"

Norman,L0,long,10,5,5,1,0.9091,110,"[15, 27, 29, 55, 56, 59, 85, 87, 88, 90]"

Norman,L0,long,11,4,7,3,0.9009,111,"[27, 28, 29, 31, 34, 62, 87, 90, 91, 92, 94]"

Norman,L0,long,8,2,6,4,0.9259,108,"[27, 28, 29, 33, 58, 60, 90, 92]"

Norman,L0,long,9,5,4,2,0.9174,109,"[28, 30, 56, 58, 59, 85, 86, 88, 90]"

Norman,L0,long,12,5,7,2,0.8929,112,"[15, 27, 28, 30, 57, 58, 60, 61, 63, 90, 91, 92]"

Norman,L0,long,11,3,8,3,0.9009,111,"[27, 28, 30, 57, 58, 61, 86, 89, 90, 91, 92]"

Norman,L0,long,12,4,8,0,0.8929,112,"[27, 28, 29, 30, 55, 58, 59, 60, 85, 88, 89, 90]"

Norman,L0,long,8,5,3,6,0.9259,108,"[15, 29, 55, 56, 57, 58, 64, 90]"

Norman,L0,long,7,4,3,3,0.9346,107,"[18, 31, 58, 59, 85, 88, 90]"

Norman,L0,long,11,7,4,1,0.9009,111,"[15, 27, 30, 56, 57, 58, 59, 60, 86, 88, 90]"

Norman,L0,long,16,7,9,1,0.8621,116,"[16, 27, 28, 30, 56, 58, 59, 60, 61, 62, 88, 89, 90, 91, 93, 94]"

Norman,L0,long,11,9,2,0,0.9009,111,"[27, 29, 53, 55, 56, 57, 59, 84, 88, 89, 90]"

Norman,L0,long,11,6,5,2,0.9009,111,"[27, 28, 30, 57, 58, 60, 62, 87, 89, 90, 94]"

Norman,L0,long,13,8,5,0,0.885,113,"[28, 29, 30, 31, 55, 57, 58, 59, 61, 88, 89, 90, 91]"

Norman,L0,long,11,9,2,1,0.9009,111,"[16, 27, 30, 56, 57, 58, 60, 87, 88, 89, 90]"

Norman,L0,long,14,5,9,1,0.8772,114,"[15, 27, 28, 30, 31, 32, 33, 34, 61, 62, 63, 64, 92, 95]"

Norman,L0,long,10,6,4,2,0.9091,110,"[27, 29, 53, 56, 57, 60, 86, 87, 88, 91]"

Norman,L0,long,13,8,5,1,0.885,113,"[27, 29, 53, 56, 57, 58, 60, 61, 63, 89, 91, 92, 93]"

Norman,L0,long,12,6,6,0,0.8929,112,"[17, 30, 32, 33, 34, 35, 63, 65, 91, 93, 94, 95]"

Norman,L0,long,10,7,3,1,0.9091,110,"[16, 28, 30, 56, 58, 59, 87, 88, 89, 90]"

Norman,L0,long,6,0,6,4,0.9434,106,"[27, 32, 57, 58, 63, 92]"

Norman,L0,long,13,5,8,1,0.885,113,"[27, 28, 29, 30, 32, 34, 60, 61, 62, 63, 90, 92, 93]"

Norman,L0,long,11,9,2,0,0.9009,111,"[28, 29, 53, 55, 56, 57, 58, 59, 84, 90, 92]"

Norman,L0,long,11,2,9,2,0.9009,111,"[30, 55, 56, 57, 58, 59, 85, 86, 87, 89, 91]"

Norman,L0,long,9,2,7,3,0.9174,109,"[15, 27, 30, 57, 58, 59, 88, 89, 92]"

Norman,L0,long,12,10,2,0,0.8929,112,"[28, 29, 30, 54, 57, 58, 59, 60, 61, 62, 89, 92]"

Norman,L0,long,11,5,6,8,0.9009,111,"[15, 27, 28, 29, 31, 57, 58, 59, 62, 89, 95]"

Norman,L0,long,10,7,3,0,0.9091,110,"[28, 29, 30, 54, 56, 58, 60, 86, 89, 90]"

Norman,L0,long,10,7,3,1,0.9091,110,"[29, 30, 56, 57, 59, 61, 86, 88, 89, 90]"

Norman,L0,long,11,4,7,1,0.9009,111,"[15, 27, 28, 30, 57, 58, 59, 61, 87, 88, 90]"

Norman,L0,long,14,6,8,2,0.8772,114,"[15, 28, 29, 55, 56, 57, 58, 59, 87, 88, 89, 90, 91, 94]"

Norman,L0,long,12,5,7,2,0.8929,112,"[15, 27, 28, 30, 59, 60, 86, 87, 88, 89, 90, 93]"

Norman,L0,long,8,2,6,5,0.9259,108,"[27, 28, 29, 53, 57, 64, 89, 91]"

Norman,L0,long,8,3,5,2,0.9259,108,"[27, 30, 57, 58, 59, 86, 87, 90]"

Norman,L0,long,10,4,6,1,0.9091,110,"[27, 28, 30, 54, 56, 59, 60, 87, 89, 91]"

Norman,L0,long,10,7,3,1,0.9091,110,"[27, 29, 53, 55, 56, 60, 86, 87, 88, 89]"

Norman,L0,long,7,4,3,0,0.9346,107,"[29, 55, 58, 60, 86, 90, 92]"

Norman,L0,long,8,1,7,4,0.9259,108,"[27, 32, 57, 60, 86, 88, 89, 93]"

Norman,L0,long,11,4,7,1,0.9009,111,"[15, 27, 28, 30, 57, 58, 59, 85, 86, 88, 90]"

Norman,L0,long,14,6,8,1,0.8772,114,"[27, 28, 30, 54, 56, 57, 58, 59, 84, 88, 89, 90, 91, 92]"

Norman,L0,long,12,4,8,0,0.8929,112,"[15, 28, 29, 30, 57, 58, 59, 60, 86, 87, 89, 90]"

Norman,L0,long,10,2,8,4,0.9091,110,"[27, 28, 29, 53, 55, 56, 57, 60, 85, 92]"

Norman,L0,long,8,3,5,3,0.9259,108,"[27, 34, 60, 63, 89, 91, 92, 93]"

Norman,L0,long,10,2,8,2,0.9091,110,"[27, 31, 56, 57, 58, 59, 85, 86, 88, 89]"

Norman,L0,long,12,6,6,0,0.8929,112,"[16, 28, 29, 30, 57, 59, 60, 61, 88, 89, 90, 91]"

Norman,L0,long,10,7,3,1,0.9091,110,"[16, 27, 29, 55, 56, 58, 60, 87, 88, 89]"

Norman,L0,long,13,5,8,2,0.885,113,"[16, 27, 28, 30, 32, 58, 59, 60, 62, 88, 89, 90, 91]"

Norman,L0,long,8,0,8,3,0.9259,108,"[15, 28, 32, 58, 59, 87, 88, 89]"

Norman,L0,long,13,5,8,0,0.885,113,"[15, 27, 28, 29, 56, 57, 58, 59, 60, 87, 88, 89, 90]"

Norman,L0,long,9,4,5,1,0.9174,109,"[15, 27, 30, 57, 58, 59, 86, 88, 89]"

Norman,L0,long,12,6,6,3,0.8929,112,"[16, 27, 28, 29, 31, 57, 58, 59, 60, 88, 89, 92]"

Norman,L0,long,8,4,4,1,0.9259,108,"[15, 28, 30, 57, 60, 87, 90, 92]"

Norman,L0,long,10,6,4,1,0.9091,110,"[15, 29, 55, 57, 58, 60, 86, 87, 88, 89]"

Norman,L0,long,10,4,6,1,0.9091,110,"[27, 28, 30, 57, 58, 59, 85, 87, 89, 90]"

Norman,L0,long,11,6,5,1,0.9009,111,"[15, 28, 29, 55, 56, 57, 58, 60, 61, 88, 92]"

Norman,L0,long,14,12,2,2,0.8772,114,"[28, 29, 30, 54, 56, 57, 58, 59, 60, 61, 64, 91, 92, 93]"

Norman,L0,long,9,3,6,3,0.9174,109,"[15, 28, 30, 32, 59, 60, 61, 65, 92]"

Norman,L0,long,10,3,7,2,0.9091,110,"[27, 28, 31, 57, 58, 59, 85, 86, 88, 89]"

Norman,L0,long,11,5,6,0,0.9009,111,"[27, 29, 53, 55, 56, 58, 59, 85, 87, 88, 89]"

Norman,L0,long,10,5,5,4,0.9091,110,"[15, 28, 29, 55, 56, 57, 58, 62, 88, 92]"

Norman,L0,long,10,4,6,1,0.9091,110,"[15, 27, 28, 29, 56, 57, 59, 60, 62, 92]"

Norman,L0,long,12,4,8,3,0.8929,112,"[15, 27, 29, 55, 57, 58, 59, 85, 86, 87, 88, 93]"

Norman,L0,long,11,5,6,1,0.9009,111,"[28, 30, 56, 57, 58, 59, 60, 86, 88, 89, 90]"

Norman,L0,long,9,7,2,3,0.9174,109,"[17, 31, 58, 59, 85, 86, 87, 88, 90]"

Norman,L0,long,10,4,6,1,0.9091,110,"[27, 28, 29, 53, 55, 60, 86, 87, 88, 89]"

Norman,L0,long,9,4,5,4,0.9174,109,"[28, 32, 57, 58, 59, 86, 87, 88, 90]"

Norman,L0,long,11,3,8,3,0.9009,111,"[27, 28, 29, 32, 58, 59, 60, 86, 88, 90, 92]"

Norman,L0,long,13,4,9,1,0.885,113,"[15, 27, 28, 29, 56, 57, 58, 60, 86, 87, 88, 89, 90]"

Norman,L0,long,12,4,8,0,0.8929,112,"[15, 27, 28, 29, 56, 57, 58, 59, 86, 87, 88, 89]"

Norman,L0,long,8,3,5,4,0.9259,108,"[27, 28, 31, 57, 61, 85, 88, 89]"

Norman,L0,long,12,1,11,0,0.8929,112,"[27, 28, 29, 54, 55, 56, 57, 58, 59, 85, 88, 89]"

Norman,L0,long,12,5,7,2,0.8929,112,"[15, 27, 28, 29, 56, 57, 58, 59, 86, 87, 88, 91]"

Norman,L0,long,7,2,5,6,0.9346,107,"[16, 28, 33, 59, 87, 88, 92]"

Norman,L0,long,10,5,5,1,0.9091,110,"[15, 29, 55, 56, 57, 59, 63, 90, 91, 92]"

Norman,L0,long,13,4,9,1,0.885,113,"[15, 27, 28, 29, 56, 57, 59, 86, 87, 88, 89, 90, 92]"

Norman,L0,long,10,5,5,1,0.9091,110,"[16, 27, 28, 29, 30, 57, 59, 61, 89, 90]"

Norman,L0,long,9,6,3,3,0.9174,109,"[27, 30, 57, 58, 61, 86, 87, 88, 89]"

Norman,L0,long,9,6,3,0,0.9174,109,"[17, 30, 55, 56, 59, 60, 86, 89, 92]"

Norman,L0,long,13,4,9,0,0.885,113,"[15, 27, 28, 29, 56, 57, 59, 87, 90, 91, 92, 93, 94]"

Norman,L0,long,10,3,7,1,0.9091,110,"[15, 29, 55, 57, 59, 62, 88, 89, 90, 91]"

Norman,L0,long,10,3,7,4,0.9091,110,"[15, 27, 28, 29, 30, 32, 59, 60, 64, 91]"

Norman,L0,long,9,8,1,1,0.9174,109,"[27, 29, 55, 56, 60, 85, 87, 88, 89]"

Norman,L0,long,11,2,9,3,0.9009,111,"[27, 28, 29, 30, 32, 56, 60, 61, 87, 90, 93]"

Norman,L0,long,12,4,8,0,0.8929,112,"[15, 27, 28, 29, 56, 57, 58, 59, 87, 88, 89, 90]"

Norman,L0,long,8,1,7,3,0.9259,108,"[27, 31, 57, 58, 60, 87, 88, 90]"

Norman,L0,long,14,6,8,2,0.8772,114,"[15, 27, 30, 32, 33, 60, 61, 62, 63, 66, 93, 94, 96, 97]"

Norman,L0,long,11,5,6,1,0.9009,111,"[27, 28, 30, 54, 56, 58, 59, 61, 88, 92, 93]"

Norman,L0,long,11,8,3,2,0.9009,111,"[27, 30, 56, 58, 60, 85, 86, 87, 88, 89, 91]"

Norman,L0,long,12,5,7,1,0.8929,112,"[15, 27, 29, 55, 56, 57, 58, 60, 86, 87, 88, 89]"

Norman,L0,long,11,7,4,1,0.9009,111,"[16, 27, 28, 31, 59, 60, 86, 88, 89, 90, 91]"

Norman,L0,long,7,3,4,1,0.9346,107,"[15, 27, 30, 60, 86, 88, 90]"

Norman,L0,long,9,3,6,1,0.9174,109,"[15, 28, 29, 30, 56, 59, 60, 88, 92]"

Norman,L0,long,10,6,4,1,0.9091,110,"[15, 28, 29, 55, 56, 59, 86, 87, 88, 90]"

Norman,L0,long,12,5,7,1,0.8929,112,"[15, 27, 28, 30, 56, 57, 58, 59, 60, 87, 89, 90]"

Norman,L0,long,11,8,3,2,0.9009,111,"[15, 29, 55, 56, 58, 60, 86, 87, 88, 89, 91]"

Norman,L0,long,13,2,11,0,0.885,113,"[27, 28, 29, 30, 55, 56, 57, 59, 60, 87, 88, 89, 90]"

Norman,L0,long,12,4,8,2,0.8929,112,"[15, 27, 29, 56, 57, 59, 60, 62, 89, 90, 92, 94]"

Norman,L0,long,12,8,4,1,0.8929,112,"[27, 28, 30, 54, 56, 57, 58, 59, 85, 86, 87, 89]"

Norman,L0,long,9,4,5,3,0.9174,109,"[27, 29, 30, 33, 59, 60, 61, 87, 92]"

Norman,L0,long,8,2,6,0,0.9259,108,"[15, 29, 55, 57, 58, 59, 88, 89]"

Norman,L0,long,13,4,9,0,0.885,113,"[17, 30, 55, 56, 58, 59, 60, 61, 87, 88, 89, 90, 91]"

Norman,L0,long,13,1,12,1,0.885,113,"[27, 28, 29, 53, 55, 56, 57, 58, 59, 60, 86, 89, 91]"

Norman,L0,long,11,5,6,1,0.9009,111,"[27, 28, 30, 54, 56, 59, 61, 87, 88, 90, 92]"

Norman,L0,long,11,3,8,0,0.9009,111,"[15, 27, 28, 29, 56, 58, 59, 86, 87, 88, 89]"

Norman,L0,long,9,4,5,0,0.9174,109,"[17, 30, 55, 57, 58, 60, 87, 89, 90]"

Norman,L0,long,9,2,7,6,0.9174,109,"[27, 33, 60, 84, 86, 87, 88, 89, 91]"

Norman,L0,long,9,4,5,0,0.9174,109,"[15, 27, 30, 56, 58, 60, 87, 88, 90]"

Norman,L0,long,13,2,11,1,0.885,113,"[27, 28, 29, 30, 55, 56, 57, 58, 59, 60, 86, 88, 91]"

Norman,L0,long,10,9,1,0,0.9091,110,"[28, 30, 58, 59, 60, 61, 86, 88, 89, 91]"

Norman,L0,long,14,8,6,1,0.8772,114,"[17, 30, 31, 58, 59, 60, 61, 87, 88, 89, 91, 92, 94, 96]"

Norman,L0,long,10,3,7,1,0.9091,110,"[27, 28, 29, 53, 55, 56, 57, 60, 88, 89]"

Norman,L0,long,6,4,2,3,0.9434,106,"[29, 56, 58, 62, 88, 89]"

Norman,L0,long,10,8,2,0,0.9091,110,"[27, 29, 55, 56, 57, 58, 59, 84, 88, 91]"

Norman,L0,long,11,7,4,1,0.9009,111,"[15, 28, 29, 55, 56, 57, 58, 59, 60, 87, 91]"

Norman,L0,long,11,6,5,4,0.9009,111,"[15, 27, 28, 31, 57, 58, 59, 61, 87, 89, 91]"

Norman,L0,long,10,4,6,0,0.9091,110,"[15, 28, 30, 56, 58, 59, 61, 87, 88, 91]"

Norman,L0,long,12,8,4,1,0.8929,112,"[27, 29, 53, 56, 57, 59, 85, 87, 88, 89, 90, 92]"

Norman,L0,long,8,3,5,2,0.9259,108,"[15, 27, 30, 56, 60, 87, 88, 90]"

Norman,L0,long,11,5,6,1,0.9009,111,"[15, 27, 29, 30, 56, 59, 61, 87, 89, 90, 91]"

Norman,L0,long,12,8,4,1,0.8929,112,"[27, 28, 30, 54, 56, 57, 61, 87, 88, 89, 90, 92]"

Norman,L0,long,10,2,8,1,0.9091,110,"[27, 28, 32, 57, 58, 60, 61, 88, 89, 91]"

Norman,L0,long,10,7,3,0,0.9091,110,"[16, 29, 55, 57, 58, 59, 86, 87, 88, 90]"

Norman,L0,long,10,2,8,3,0.9091,110,"[27, 31, 56, 57, 58, 59, 60, 87, 88, 91]"

Norman,L0,long,8,4,4,7,0.9259,108,"[27, 28, 34, 61, 85, 88, 90, 91]"

Norman,L0,long,9,6,3,1,0.9174,109,"[15, 29, 55, 56, 57, 59, 62, 88, 91]"

Norman,L0,long,11,5,6,1,0.9009,111,"[28, 30, 57, 60, 61, 85, 89, 90, 91, 92, 93]"

Norman,L0,long,14,5,9,0,0.8772,114,"[15, 28, 29, 30, 56, 57, 58, 60, 61, 88, 89, 90, 91, 92]"

Norman,L0,long,13,6,7,1,0.885,113,"[15, 27, 29, 55, 57, 58, 60, 61, 87, 88, 90, 91, 93]"

Norman,L0,long,8,2,6,1,0.9259,108,"[27, 29, 56, 57, 61, 87, 88, 90]"

Norman,L0,long,11,7,4,0,0.9009,111,"[15, 27, 29, 55, 57, 58, 59, 61, 88, 90, 91]"

Norman,L0,long,12,5,7,1,0.8929,112,"[15, 27, 28, 29, 30, 57, 58, 59, 60, 88, 89, 91]"

Norman,L0,long,10,3,7,3,0.9091,110,"[27, 30, 56, 57, 58, 59, 61, 88, 89, 92]"

Norman,L0,long,10,4,6,2,0.9091,110,"[15, 31, 58, 59, 60, 86, 88, 89, 90, 91]"

Norman,L0,long,6,5,1,1,0.9434,106,"[29, 55, 59, 83, 88, 90]"

Norman,L0,long,15,4,11,0,0.8696,115,"[27, 28, 29, 30, 54, 56, 57, 58, 59, 60, 61, 88, 89, 90, 91]"

Norman,L0,long,10,1,9,2,0.9091,110,"[27, 28, 30, 33, 58, 60, 61, 62, 91, 92]"

Norman,L0,long,10,8,2,3,0.9091,110,"[28, 29, 30, 32, 59, 61, 86, 88, 90, 93]"

Norman,L0,long,7,5,2,3,0.9346,107,"[15, 28, 31, 60, 88, 89, 90]"

Norman,L0,long,12,5,7,0,0.8929,112,"[16, 27, 28, 29, 56, 58, 59, 60, 87, 88, 89, 90]"

Norman,L0,long,9,4,5,3,0.9174,109,"[27, 28, 29, 34, 59, 61, 86, 91, 92]"

Norman,L0,long,10,5,5,1,0.9091,110,"[27, 30, 31, 57, 59, 60, 62, 87, 89, 92]"

Norman,L0,long,9,5,4,0,0.9174,109,"[15, 27, 29, 55, 56, 57, 59, 86, 89]"

Norman,L0,long,10,4,6,3,0.9091,110,"[15, 27, 29, 33, 60, 86, 87, 88, 91, 92]"

Norman,L0,long,10,5,5,0,0.9091,110,"[15, 27, 28, 29, 56, 57, 58, 59, 87, 89]"

Norman,L0,long,9,6,3,2,0.9174,109,"[29, 56, 57, 58, 61, 85, 87, 88, 89]"

Norman,L0,long,7,4,3,2,0.9346,107,"[29, 56, 57, 60, 84, 88, 90]"

Norman,L0,long,11,6,5,0,0.9009,111,"[15, 27, 28, 29, 56, 57, 59, 60, 87, 89, 90]"

Norman,L0,long,14,11,3,0,0.8772,114,"[28, 29, 53, 55, 56, 58, 59, 60, 85, 88, 89, 91, 92, 94]"

Norman,L0,long,11,8,3,1,0.9009,111,"[28, 29, 53, 56, 57, 58, 59, 84, 87, 88, 90]"

Norman,L0,long,8,1,7,1,0.9259,108,"[15, 28, 30, 61, 86, 88, 89, 90]"

Norman,L0,long,10,7,3,0,0.9091,110,"[16, 29, 30, 31, 57, 60, 62, 88, 91, 92]"

Norman,L0,long,10,4,6,1,0.9091,110,"[16, 27, 28, 29, 60, 86, 87, 89, 90, 91]"

Norman,L0,long,13,6,7,0,0.885,113,"[15, 27, 28, 29, 30, 31, 32, 59, 60, 62, 90, 91, 92]"

Norman,L0,long,10,6,4,1,0.9091,110,"[15, 28, 30, 57, 59, 85, 86, 87, 88, 89]"

Norman,L0,long,9,5,4,0,0.9174,109,"[15, 27, 28, 29, 56, 58, 59, 87, 89]"

Norman,L0,long,11,5,6,3,0.9009,111,"[17, 31, 32, 33, 34, 61, 62, 65, 92, 93, 96]"

Norman,L0,long,9,6,3,1,0.9174,109,"[29, 55, 56, 57, 60, 85, 87, 88, 89]"

Norman,L0,long,12,6,6,2,0.8929,112,"[15, 27, 28, 29, 30, 33, 61, 87, 88, 89, 90, 91]"

Norman,L0,long,12,9,3,0,0.8929,112,"[27, 29, 53, 55, 56, 59, 86, 87, 88, 89, 90, 91]"

Norman,L0,long,13,5,8,1,0.885,113,"[27, 28, 29, 31, 55, 57, 58, 60, 85, 88, 89, 90, 91]"

Norman,L0,long,10,2,8,0,0.9091,110,"[15, 29, 56, 57, 58, 59, 85, 86, 87, 89]"

Norman,L50,long,9,4,5,1,0.9174,109,"[28, 29, 56, 57, 60, 86, 88, 89, 91]"

Norman,L50,long,15,11,4,6,0.8696,115,"[15, 28, 29, 31, 57, 58, 59, 62, 88, 89, 90, 91, 93, 94, 98]"

Norman,L50,long,12,7,5,4,0.8929,112,"[14, 26, 27, 28, 29, 30, 31, 58, 59, 60, 65, 91]"

Norman,L50,long,10,7,3,5,0.9091,110,"[15, 26, 27, 28, 32, 59, 86, 87, 88, 91]"

Norman,L50,long,11,6,5,0,0.9009,111,"[15, 30, 55, 57, 58, 60, 61, 88, 89, 90, 91]"

Norman,L50,long,9,8,1,1,0.9174,109,"[16, 30, 55, 56, 57, 58, 59, 86, 89]"

Norman,L50,long,10,6,4,2,0.9091,110,"[14, 25, 27, 28, 31, 58, 59, 85, 87, 89]"

Norman,L50,long,9,6,3,2,0.9174,109,"[28, 30, 55, 57, 60, 86, 88, 89, 92]"

Norman,L50,long,12,4,8,1,0.8929,112,"[27, 28, 29, 30, 55, 56, 58, 59, 62, 88, 90, 91]"

Norman,L50,long,11,3,8,2,0.9009,111,"[27, 30, 55, 57, 58, 59, 84, 85, 86, 88, 90]"

Norman,L50,long,13,7,6,2,0.885,113,"[14, 25, 27, 28, 30, 57, 58, 59, 61, 87, 89, 90, 91]"

Norman,L50,long,14,8,6,0,0.8772,114,"[27, 29, 30, 54, 56, 58, 59, 60, 61, 87, 88, 90, 91, 93]"

Norman,L50,long,12,10,2,1,0.8929,112,"[28, 29, 30, 55, 57, 58, 59, 60, 86, 89, 91, 93]"

Norman,L50,long,13,9,4,1,0.885,113,"[14, 25, 26, 28, 29, 31, 58, 61, 62, 90, 91, 92, 93]"

Norman,L50,long,11,7,4,1,0.9009,111,"[15, 27, 29, 55, 57, 58, 59, 60, 62, 89, 91]"

Norman,L50,long,14,3,11,0,0.8772,114,"[27, 28, 29, 30, 54, 58, 59, 60, 86, 87, 88, 89, 90, 91]"

Norman,L50,long,12,6,6,1,0.8929,112,"[14, 25, 26, 27, 29, 56, 57, 58, 60, 86, 88, 89]"

Norman,L50,long,9,4,5,4,0.9174,109,"[27, 28, 33, 57, 61, 86, 87, 88, 90]"

Norman,L50,long,10,4,6,0,0.9091,110,"[14, 27, 29, 55, 58, 59, 85, 87, 88, 89]"

Norman,L50,long,11,5,6,1,0.9009,111,"[14, 25, 27, 28, 30, 57, 59, 85, 87, 88, 89]"

Norman,L50,long,15,6,9,2,0.8696,115,"[14, 25, 26, 27, 28, 29, 31, 58, 59, 60, 61, 89, 90, 91, 93]"

Norman,L50,long,12,9,3,0,0.8929,112,"[14, 25, 29, 57, 60, 61, 86, 87, 88, 89, 90, 91]"

Norman,L50,long,11,5,6,2,0.9009,111,"[14, 26, 27, 28, 30, 59, 85, 87, 88, 91, 93]"

Norman,L50,long,12,4,8,0,0.8929,112,"[28, 29, 52, 54, 55, 56, 57, 58, 59, 85, 87, 90]"

Norman,L50,long,13,9,4,1,0.885,113,"[14, 25, 26, 28, 29, 30, 57, 60, 61, 63, 89, 91, 92]"

Norman,L50,long,13,11,2,4,0.885,113,"[27, 29, 31, 56, 57, 58, 59, 60, 62, 90, 91, 92, 97]"

Norman,L50,long,12,9,3,0,0.8929,112,"[14, 25, 26, 28, 29, 30, 58, 61, 87, 89, 91, 92]"

Norman,L50,long,16,11,5,0,0.8621,116,"[14, 25, 26, 27, 28, 29, 31, 58, 59, 60, 61, 88, 89, 90, 91, 92]"

Norman,L50,long,11,7,4,2,0.9009,111,"[14, 25, 26, 27, 29, 56, 58, 59, 86, 87, 91]"

Norman,L50,long,13,9,4,0,0.885,113,"[14, 25, 26, 27, 29, 57, 58, 59, 60, 86, 88, 89, 90]"

Norman,L50,long,12,4,8,0,0.8929,112,"[14, 25, 26, 28, 29, 56, 57, 58, 59, 87, 88, 89]"

Norman,L50,long,16,8,8,1,0.8621,116,"[27, 28, 30, 31, 32, 57, 59, 60, 61, 62, 88, 89, 90, 91, 92, 94]"

Norman,L50,long,10,3,7,0,0.9091,110,"[14, 27, 28, 29, 55, 59, 85, 87, 88, 90]"

Norman,L50,long,13,7,6,1,0.885,113,"[14, 25, 26, 28, 29, 56, 57, 58, 59, 86, 87, 88, 90]"

Norman,L50,long,10,5,5,3,0.9091,110,"[27, 28, 30, 54, 57, 60, 86, 87, 88, 91]"

Norman,L50,long,12,6,6,2,0.8929,112,"[28, 30, 33, 58, 59, 60, 61, 86, 88, 89, 90, 91]"

Norman,L50,long,11,8,3,0,0.9009,111,"[16, 28, 29, 55, 56, 57, 58, 60, 86, 89, 90]"

Norman,L50,long,9,5,4,1,0.9174,109,"[16, 27, 29, 55, 56, 58, 59, 86, 90]"

Norman,L50,long,16,14,2,1,0.8621,116,"[15, 26, 27, 28, 29, 30, 32, 59, 60, 61, 62, 88, 89, 90, 91, 92]"

Norman,L50,long,10,3,7,3,0.9091,110,"[27, 29, 52, 54, 55, 56, 57, 58, 61, 90]"

Norman,L50,long,12,8,4,4,0.8929,112,"[14, 25, 26, 32, 59, 60, 87, 88, 89, 90, 91, 94]"

Norman,L50,long,9,5,4,1,0.9174,109,"[15, 27, 30, 55, 57, 59, 85, 88, 89]"

Norman,L50,long,12,3,9,0,0.8929,112,"[27, 28, 29, 54, 55, 56, 57, 58, 59, 61, 87, 91]"

Norman,L50,long,14,4,10,1,0.8772,114,"[27, 28, 29, 53, 56, 57, 58, 60, 86, 87, 88, 89, 90, 91]"

Norman,L50,long,9,2,7,0,0.9174,109,"[16, 27, 29, 58, 59, 84, 86, 89, 90]"

Norman,L50,long,11,6,5,1,0.9009,111,"[27, 29, 30, 32, 33, 35, 60, 63, 67, 93, 97]"

Norman,L50,long,12,7,5,6,0.8929,112,"[29, 30, 33, 58, 59, 60, 62, 65, 92, 93, 95, 99]"

Norman,L50,long,11,10,1,0,0.9009,111,"[29, 52, 54, 55, 57, 58, 59, 84, 88, 89, 91]"

Norman,L50,long,13,10,3,0,0.885,113,"[28, 29, 31, 57, 58, 59, 62, 87, 89, 90, 91, 92, 93]"

Norman,L50,long,15,11,4,0,0.8696,115,"[14, 25, 26, 27, 28, 29, 56, 57, 59, 85, 87, 88, 89, 90, 91]"

Norman,L50,long,17,10,7,1,0.8547,117,"[28, 29, 30, 31, 32, 34, 35, 36, 37, 63, 65, 66, 67, 68, 95, 97, 99]"

Norman,L50,long,13,10,3,3,0.885,113,"[14, 25, 26, 28, 30, 57, 58, 59, 85, 86, 87, 88, 91]"

Norman,L50,long,8,3,5,3,0.9259,108,"[14, 27, 29, 56, 58, 60, 86, 91]"

Norman,L50,long,13,6,7,1,0.885,113,"[27, 29, 52, 54, 55, 56, 57, 59, 85, 86, 87, 88, 91]"

Norman,L50,long,11,7,4,0,0.9009,111,"[16, 27, 29, 55, 56, 57, 58, 60, 86, 88, 90]"

Norman,L50,long,14,8,6,0,0.8772,114,"[14, 25, 27, 28, 29, 30, 57, 59, 60, 86, 88, 90, 91, 92]"

Norman,L50,long,15,12,3,0,0.8696,115,"[14, 25, 26, 27, 28, 29, 55, 56, 57, 59, 60, 87, 88, 89, 91]"

Norman,L50,long,13,1,12,0,0.885,113,"[27, 28, 29, 53, 54, 55, 56, 58, 61, 87, 89, 90, 91]"

Norman,L50,long,10,6,4,2,0.9091,110,"[15, 27, 29, 55, 56, 57, 58, 61, 88, 89]"

Norman,L50,long,11,2,9,0,0.9009,111,"[27, 28, 29, 53, 54, 57, 59, 85, 87, 88, 89]"

Norman,L50,long,11,7,4,0,0.9009,111,"[14, 25, 26, 29, 56, 57, 58, 59, 85, 88, 89]"

Norman,L50,long,10,10,0,1,0.9091,110,"[16, 29, 55, 56, 57, 61, 86, 87, 89, 90]"

Norman,L50,long,14,11,3,1,0.8772,114,"[27, 28, 30, 32, 57, 58, 59, 60, 61, 88, 90, 91, 92, 93]"

Norman,L50,long,10,4,6,3,0.9091,110,"[27, 28, 30, 31, 32, 58, 60, 65, 91, 92]"

Norman,L50,long,12,7,5,0,0.8929,112,"[27, 29, 53, 55, 56, 57, 58, 59, 85, 87, 88, 89]"

Norman,L50,long,12,3,9,1,0.8929,112,"[14, 25, 28, 29, 30, 31, 60, 61, 87, 89, 91, 93]"

Norman,L50,long,11,5,6,4,0.9009,111,"[15, 26, 27, 28, 33, 60, 86, 89, 90, 91, 92]"

Norman,L50,long,11,9,2,1,0.9009,111,"[14, 25, 26, 27, 28, 29, 30, 60, 86, 89, 91]"

Norman,L50,long,14,10,4,0,0.8772,114,"[15, 28, 29, 30, 56, 57, 58, 59, 60, 86, 87, 88, 89, 90]"

Norman,L50,long,14,11,3,3,0.8772,114,"[14, 25, 26, 30, 56, 57, 58, 59, 85, 86, 90, 91, 92, 95]"

Norman,L50,long,13,1,12,0,0.885,113,"[27, 28, 29, 30, 31, 56, 57, 58, 61, 87, 88, 90, 91]"

Norman,L50,long,13,8,5,1,0.885,113,"[14, 25, 26, 27, 28, 30, 31, 58, 59, 62, 88, 90, 92]"

Norman,L50,long,9,7,2,2,0.9174,109,"[15, 31, 58, 59, 84, 85, 86, 88, 89]"

Norman,L50,long,11,6,5,0,0.9009,111,"[14, 25, 27, 28, 29, 58, 59, 85, 87, 88, 89]"

Norman,L50,long,10,3,7,0,0.9091,110,"[14, 25, 28, 29, 56, 57, 60, 61, 87, 91]"

Norman,L50,long,15,2,13,2,0.8696,115,"[27, 28, 30, 54, 58, 59, 60, 86, 87, 88, 89, 90, 91, 92, 94]"

Norman,L50,long,9,6,3,1,0.9174,109,"[15, 26, 27, 30, 56, 59, 86, 87, 89]"

Norman,L50,long,12,11,1,2,0.8929,112,"[28, 29, 31, 56, 57, 58, 59, 60, 61, 63, 91, 92]"

Norman,L50,long,13,7,6,1,0.885,113,"[14, 25, 26, 27, 29, 31, 58, 59, 60, 87, 89, 90, 91]"

Norman,L50,long,11,5,6,2,0.9009,111,"[27, 28, 31, 56, 57, 58, 59, 85, 86, 88, 89]"

Norman,L50,long,12,8,4,3,0.8929,112,"[14, 25, 26, 27, 28, 29, 33, 60, 87, 88, 90, 91]"

Norman,L50,long,10,3,7,1,0.9091,110,"[27, 29, 53, 57, 59, 61, 87, 89, 90, 92]"

Norman,L50,long,11,7,4,1,0.9009,111,"[15, 29, 54, 56, 57, 58, 59, 85, 87, 88, 90]"

Norman,L50,long,13,10,3,3,0.885,113,"[14, 26, 27, 28, 31, 57, 58, 59, 85, 86, 87, 88, 90]"

Norman,L50,long,14,14,0,0,0.8772,114,"[28, 29, 54, 55, 56, 57, 58, 59, 85, 86, 87, 88, 89, 90]"

Norman,L50,long,13,2,11,1,0.885,113,"[27, 28, 29, 30, 55, 56, 57, 58, 59, 60, 86, 88, 91]"

Norman,L50,long,11,6,5,1,0.9009,111,"[14, 25, 26, 27, 28, 29, 56, 57, 58, 60, 91]"

Norman,L50,long,10,7,3,3,0.9091,110,"[14, 26, 27, 30, 58, 61, 86, 87, 88, 89]"

Norman,L50,long,13,6,7,2,0.885,113,"[27, 28, 30, 54, 56, 57, 58, 59, 60, 63, 89, 90, 91]"

Norman,L50,long,8,3,5,6,0.9259,108,"[27, 28, 32, 58, 61, 85, 87, 90]"

Norman,L50,long,11,7,4,3,0.9009,111,"[28, 29, 30, 55, 56, 60, 85, 86, 88, 89, 93]"

Norman,L50,long,12,8,4,2,0.8929,112,"[14, 25, 26, 28, 30, 57, 58, 59, 85, 86, 88, 90]"

Norman,L50,long,10,4,6,0,0.9091,110,"[27, 29, 53, 55, 56, 57, 60, 89, 90, 92]"

Norman,L50,long,12,11,1,0,0.8929,112,"[14, 26, 27, 28, 29, 57, 58, 59, 85, 89, 90, 91]"

Norman,L50,long,14,10,4,0,0.8772,114,"[14, 25, 26, 27, 28, 29, 31, 32, 34, 61, 64, 90, 93, 94]"

Norman,L50,long,14,8,6,2,0.8772,114,"[15, 26, 27, 28, 29, 56, 57, 58, 59, 85, 86, 87, 88, 91]"

Norman,L50,long,11,5,6,3,0.9009,111,"[14, 26, 27, 30, 34, 60, 61, 63, 67, 93, 94]"

Norman,L50,long,10,5,5,2,0.9091,110,"[15, 26, 28, 29, 31, 57, 61, 87, 88, 90]"

Norman,L50,long,10,7,3,2,0.9091,110,"[27, 28, 30, 55, 56, 57, 59, 84, 87, 90]"

Norman,L50,long,12,7,5,1,0.8929,112,"[14, 25, 26, 27, 28, 29, 55, 58, 61, 87, 89, 90]"

Norman,L50,long,9,4,5,0,0.9174,109,"[14, 25, 26, 29, 55, 59, 85, 87, 89]"

Norman,L50,long,10,5,5,1,0.9091,110,"[14, 26, 27, 28, 30, 57, 60, 61, 88, 91]"

Norman,L50,long,10,6,4,1,0.9091,110,"[14, 25, 27, 28, 30, 59, 85, 87, 88, 89]"

Norman,L50,long,11,5,6,0,0.9009,111,"[27, 28, 29, 30, 54, 57, 59, 61, 89, 90, 91]"

Norman,L50,long,10,4,6,1,0.9091,110,"[28, 29, 52, 54, 55, 56, 57, 60, 87, 89]"

Norman,L50,long,13,10,3,0,0.885,113,"[14, 25, 26, 27, 28, 29, 55, 56, 58, 59, 87, 88, 89]"

Norman,L50,long,13,6,7,3,0.885,113,"[27, 28, 31, 56, 57, 58, 60, 61, 62, 88, 89, 91, 93]"

Norman,L50,long,10,5,5,3,0.9091,110,"[27, 28, 30, 54, 56, 57, 59, 61, 87, 94]"

Norman,L50,long,11,6,5,2,0.9009,111,"[15, 26, 27, 29, 31, 58, 60, 63, 89, 90, 92]"

Norman,L50,long,13,8,5,1,0.885,113,"[15, 27, 29, 30, 56, 57, 58, 62, 88, 89, 90, 91, 92]"

Norman,L50,long,11,5,6,2,0.9009,111,"[27, 28, 29, 30, 33, 59, 62, 88, 89, 90, 92]"

Norman,L50,long,8,5,3,0,0.9259,108,"[27, 29, 53, 56, 57, 58, 59, 90]"

Norman,L50,long,16,13,3,1,0.8621,116,"[14, 26, 27, 28, 29, 30, 31, 32, 60, 63, 89, 91, 92, 93, 94, 95]"

Norman,L50,long,14,12,2,1,0.8772,114,"[15, 26, 27, 28, 29, 30, 31, 59, 60, 61, 62, 89, 92, 94]"

Norman,L50,long,11,5,6,1,0.9009,111,"[28, 30, 32, 57, 58, 59, 61, 86, 89, 90, 91]"

Norman,L50,long,13,5,8,0,0.885,113,"[14, 27, 28, 30, 56, 57, 58, 60, 61, 88, 89, 90, 91]"

Norman,L50,long,11,9,2,3,0.9009,111,"[14, 25, 26, 27, 28, 33, 59, 60, 86, 89, 90]"

Norman,L50,long,16,10,6,2,0.8621,116,"[14, 25, 26, 27, 28, 29, 30, 31, 33, 60, 61, 62, 63, 90, 91, 94]"

Norman,L50,long,11,7,4,1,0.9009,111,"[15, 26, 29, 30, 56, 57, 59, 61, 88, 89, 90]"

Norman,L50,long,10,7,3,5,0.9091,110,"[27, 30, 55, 56, 57, 60, 86, 87, 88, 92]"

Norman,L50,long,9,5,4,0,0.9174,109,"[16, 30, 32, 61, 62, 87, 90, 91, 92]"

Norman,L50,long,11,3,8,0,0.9009,111,"[27, 28, 29, 53, 55, 57, 58, 59, 86, 87, 89]"

Norman,L50,long,14,8,6,5,0.8772,114,"[14, 26, 27, 28, 31, 57, 58, 59, 61, 87, 89, 90, 91, 94]"

Norman,L50,long,18,6,12,2,0.8475,118,"[15, 26, 27, 28, 32, 58, 60, 61, 62, 63, 64, 65, 67, 93, 96, 97, 98, 99]"

Norman,L50,long,6,2,4,3,0.9434,106,"[30, 61, 85, 86, 87, 89]"

Norman,L50,long,10,3,7,0,0.9091,110,"[27, 29, 30, 54, 58, 59, 60, 85, 87, 90]"

Norman,L50,long,13,12,1,2,0.885,113,"[14, 25, 26, 27, 28, 29, 55, 56, 60, 86, 87, 88, 92]"

Norman,L50,long,13,5,8,0,0.885,113,"[14, 25, 27, 29, 55, 56, 58, 59, 60, 87, 88, 89, 91]"

Norman,L50,long,9,7,2,5,0.9174,109,"[14, 25, 27, 28, 32, 58, 62, 88, 90]"

Norman,L50,long,12,0,12,2,0.8929,112,"[27, 31, 57, 58, 59, 60, 85, 86, 87, 88, 89, 90]"

Norman,L50,long,10,8,2,4,0.9091,110,"[14, 25, 27, 32, 57, 59, 62, 88, 89, 90]"

Norman,L50,long,9,4,5,2,0.9174,109,"[27, 30, 31, 57, 58, 60, 63, 88, 91]"

Norman,L50,long,13,9,4,1,0.885,113,"[27, 28, 31, 58, 59, 61, 86, 87, 88, 89, 90, 91, 92]"

Norman,L50,long,11,8,3,2,0.9009,111,"[27, 28, 30, 54, 56, 57, 58, 60, 88, 89, 90]"

Norman,L50,long,15,12,3,1,0.8696,115,"[14, 25, 26, 27, 28, 30, 57, 59, 60, 86, 87, 88, 89, 90, 93]"

Norman,L50,long,12,6,6,0,0.8929,112,"[14, 25, 28, 31, 33, 36, 64, 67, 92, 93, 96, 97]"

Norman,L50,long,12,10,2,4,0.8929,112,"[14, 26, 27, 29, 33, 61, 86, 87, 88, 89, 90, 92]"

Norman,L50,long,11,6,5,3,0.9009,111,"[27, 28, 30, 54, 56, 57, 59, 61, 87, 89, 91]"

Norman,L50,long,11,4,7,2,0.9009,111,"[27, 30, 55, 56, 57, 60, 85, 86, 87, 88, 89]"

Norman,L50,long,12,5,7,0,0.8929,112,"[15, 28, 29, 55, 57, 58, 59, 60, 87, 88, 89, 90]"

Norman,L50,long,12,6,6,1,0.8929,112,"[27, 29, 53, 55, 56, 57, 58, 60, 86, 87, 88, 89]"

Norman,L50,long,15,10,5,0,0.8696,115,"[14, 25, 26, 27, 28, 29, 30, 32, 59, 60, 62, 63, 91, 92, 94]"

Norman,L50,long,12,3,9,0,0.8929,112,"[27, 28, 29, 53, 54, 55, 56, 59, 85, 86, 88, 89]"

Norman,L50,long,10,5,5,1,0.9091,110,"[27, 28, 29, 55, 56, 58, 60, 86, 89, 90]"

Norman,L50,long,11,7,4,3,0.9009,111,"[14, 25, 26, 27, 29, 56, 58, 60, 86, 88, 91]"

Norman,L50,long,13,7,6,4,0.885,113,"[14, 25, 26, 28, 29, 30, 57, 58, 59, 61, 62, 66, 94]"

Norman,L50,long,11,6,5,1,0.9009,111,"[14, 26, 27, 28, 30, 57, 58, 59, 86, 87, 89]"

Norman,L50,long,13,5,8,0,0.885,113,"[27, 28, 29, 53, 56, 57, 58, 59, 60, 87, 88, 90, 91]"

Norman,L50,long,11,9,2,2,0.9009,111,"[29, 53, 54, 55, 56, 58, 59, 84, 87, 88, 91]"

Norman,L50,long,13,2,11,1,0.885,113,"[27, 28, 29, 30, 54, 56, 57, 58, 61, 88, 89, 90, 92]"

Norman,L50,long,7,3,4,6,0.9346,107,"[19, 33, 58, 61, 86, 89, 92]"

Norman,L50,long,12,6,6,0,0.8929,112,"[16, 27, 29, 30, 31, 57, 60, 61, 88, 89, 90, 91]"

Norman,L50,long,12,7,5,1,0.8929,112,"[15, 26, 27, 29, 31, 57, 61, 62, 88, 89, 90, 92]"

Norman,L50,long,12,7,5,1,0.8929,112,"[14, 25, 26, 27, 28, 30, 57, 58, 59, 86, 87, 90]"

Norman,L50,long,10,8,2,3,0.9091,110,"[14, 25, 26, 27, 30, 61, 86, 87, 88, 89]"

Norman,L50,long,12,5,7,5,0.8929,112,"[28, 29, 32, 58, 59, 60, 61, 86, 88, 89, 90, 94]"

Norman,L50,long,13,10,3,1,0.885,113,"[14, 26, 27, 28, 29, 56, 58, 59, 60, 86, 87, 88, 91]"

Norman,L50,long,12,7,5,1,0.8929,112,"[16, 27, 30, 31, 32, 34, 62, 63, 90, 91, 92, 93]"

Norman,L50,long,13,8,5,0,0.885,113,"[15, 29, 54, 55, 56, 58, 59, 86, 87, 88, 89, 91, 92]"

Norman,L50,long,10,6,4,5,0.9091,110,"[27, 29, 54, 55, 56, 57, 60, 86, 89, 95]"

Norman,L50,long,10,8,2,0,0.9091,110,"[28, 29, 52, 56, 57, 58, 62, 90, 92, 93]"

Norman,L50,long,12,7,5,2,0.8929,112,"[14, 26, 27, 29, 55, 56, 58, 62, 88, 89, 90, 91]"

Norman,L50,long,16,7,9,1,0.8621,116,"[15, 26, 28, 31, 57, 59, 60, 61, 62, 63, 64, 66, 92, 97, 98, 99]"

Norman,L50,long,10,5,5,4,0.9091,110,"[15, 26, 28, 30, 56, 57, 58, 61, 87, 90]"

Norman,L50,long,13,11,2,0,0.885,113,"[27, 29, 30, 54, 57, 58, 59, 60, 61, 62, 90, 91, 92]"

Norman,L50,long,13,9,4,2,0.885,113,"[27, 28, 30, 54, 56, 57, 58, 59, 85, 86, 87, 88, 90]"

Norman,L50,long,12,2,10,3,0.8929,112,"[27, 28, 29, 53, 54, 56, 57, 58, 59, 62, 89, 91]"

Norman,L50,long,14,4,10,0,0.8772,114,"[27, 28, 29, 53, 54, 56, 57, 58, 59, 60, 86, 88, 89, 90]"

Norman,L50,long,12,5,7,0,0.8929,112,"[27, 28, 30, 54, 56, 58, 59, 60, 86, 87, 89, 90]"

Norman,L50,long,13,7,6,1,0.885,113,"[14, 25, 27, 28, 29, 32, 59, 60, 61, 87, 89, 90, 91]"

Norman,L50,long,12,7,5,2,0.8929,112,"[27, 28, 29, 31, 57, 58, 60, 62, 88, 89, 90, 91]"

Norman,L50,long,7,3,4,3,0.9346,107,"[32, 35, 60, 63, 90, 92, 94]"

Norman,L50,long,12,6,6,0,0.8929,112,"[28, 29, 52, 54, 55, 56, 58, 59, 60, 86, 89, 90]"

Norman,L50,long,10,1,9,1,0.9091,110,"[29, 31, 56, 57, 58, 60, 61, 62, 91, 92]"

Norman,L50,long,13,7,6,1,0.885,113,"[14, 25, 26, 27, 31, 32, 33, 60, 61, 62, 65, 91, 94]"

Norman,L50,long,12,2,10,3,0.8929,112,"[27, 28, 29, 53, 54, 55, 56, 58, 59, 85, 88, 92]"

Norman,L50,long,16,3,13,1,0.8621,116,"[27, 28, 29, 53, 54, 55, 56, 57, 58, 59, 85, 86, 88, 89, 90, 93]"

Norman,L50,long,11,1,10,1,0.9009,111,"[27, 28, 29, 54, 55, 58, 60, 85, 87, 88, 89]"

Norman,L50,long,12,0,12,2,0.8929,112,"[27, 28, 29, 54, 55, 56, 57, 61, 87, 88, 89, 90]"

Norman,L50,long,12,5,7,2,0.8929,112,"[27, 28, 29, 30, 32, 56, 60, 62, 88, 89, 90, 91]"

Norman,L50,long,11,5,6,1,0.9009,111,"[28, 30, 57, 58, 59, 60, 61, 87, 88, 90, 93]"

Norman,L50,long,14,14,0,0,0.8772,114,"[28, 29, 30, 55, 56, 57, 59, 60, 61, 89, 90, 91, 92, 93]"

Norman,L50,long,11,7,4,3,0.9009,111,"[14, 25, 26, 27, 28, 31, 58, 60, 86, 88, 91]"

Norman,L50,long,13,9,4,0,0.885,113,"[27, 28, 29, 53, 56, 57, 58, 59, 85, 86, 87, 88, 89]"

Norman,L50,long,11,5,6,0,0.9009,111,"[14, 26, 28, 29, 55, 56, 58, 59, 85, 86, 89]"

Norman,L50,long,10,4,6,1,0.9091,110,"[14, 25, 26, 29, 55, 56, 57, 60, 87, 89]"

Norman,L50,long,13,7,6,1,0.885,113,"[14, 26, 27, 29, 56, 58, 60, 61, 87, 89, 90, 91, 94]"

Norman,L50,long,12,6,6,2,0.8929,112,"[28, 29, 30, 54, 57, 58, 59, 62, 90, 91, 92, 93]"

Norman,L50,long,13,7,6,1,0.885,113,"[15, 26, 27, 28, 30, 58, 59, 86, 87, 88, 89, 91, 93]"

Norman,L50,long,8,3,5,8,0.9259,108,"[14, 26, 27, 33, 59, 63, 88, 91]"

Norman,L50,long,10,8,2,1,0.9091,110,"[15, 26, 27, 28, 30, 57, 58, 59, 85, 90]"

Norman,L50,long,9,5,4,3,0.9174,109,"[14, 25, 27, 29, 32, 58, 59, 61, 90]"

Norman,L50,long,10,9,1,3,0.9091,110,"[29, 33, 57, 60, 84, 86, 87, 88, 89, 90]"

Norman,L50,long,10,4,6,2,0.9091,110,"[14, 27, 28, 29, 30, 57, 59, 62, 89, 90]"

Norman,L50,long,12,3,9,0,0.8929,112,"[27, 28, 29, 53, 54, 56, 58, 59, 85, 87, 88, 89]"

Norman,L50,long,12,7,5,0,0.8929,112,"[14, 28, 29, 56, 59, 84, 86, 87, 88, 89, 90, 91]"

Norman,L50,long,11,5,6,1,0.9009,111,"[28, 30, 56, 57, 58, 59, 60, 62, 88, 89, 91]"

Norman,L50,long,9,6,3,0,0.9174,109,"[16, 29, 30, 55, 58, 60, 87, 88, 91]"

Norman,L50,long,12,7,5,1,0.8929,112,"[27, 28, 31, 56, 59, 60, 61, 63, 64, 90, 91, 96]"

Norman,L50,long,15,10,5,2,0.8696,115,"[14, 25, 26, 27, 29, 30, 57, 58, 59, 61, 87, 88, 89, 90, 93]"

Norman,L50,long,10,5,5,0,0.9091,110,"[14, 28, 29, 55, 57, 58, 59, 86, 87, 89]"

Norman,L50,long,10,3,7,1,0.9091,110,"[27, 28, 30, 54, 56, 59, 84, 85, 87, 89]"

Norman,L50,long,12,5,7,0,0.8929,112,"[27, 29, 52, 54, 55, 57, 58, 59, 85, 87, 88, 89]"

Norman,L50,long,11,6,5,2,0.9009,111,"[30, 57, 58, 59, 60, 62, 87, 89, 90, 91, 92]"

Norman,L50,long,10,6,4,2,0.9091,110,"[27, 30, 55, 56, 57, 58, 60, 85, 87, 89]"

Norman,L50,long,11,6,5,2,0.9009,111,"[27, 28, 31, 56, 57, 58, 59, 84, 86, 88, 89]"

Norman,L50,long,11,9,2,3,0.9009,111,"[28, 29, 30, 54, 56, 57, 59, 62, 88, 89, 91]"

Norman,L50,long,8,1,7,5,0.9259,108,"[28, 31, 56, 57, 58, 59, 64, 90]"

Norman,L50,long,10,7,3,1,0.9091,110,"[14, 25, 27, 28, 29, 57, 59, 87, 90, 92]"

Norman,L50,long,13,7,6,1,0.885,113,"[14, 25, 26, 27, 28, 29, 30, 58, 59, 60, 88, 89, 92]"

Norman,L50,long,14,4,10,1,0.8772,114,"[27, 29, 30, 31, 33, 59, 60, 61, 62, 88, 89, 90, 91, 92]"

Norman,L50,long,11,8,3,0,0.9009,111,"[14, 26, 29, 55, 56, 57, 59, 60, 86, 89, 90]"

Norman,L50,long,10,6,4,2,0.9091,110,"[14, 25, 26, 27, 28, 31, 59, 85, 87, 89]"

Norman,L50,long,14,10,4,4,0.8772,114,"[14, 25, 28, 31, 57, 58, 59, 62, 89, 90, 91, 92, 94, 97]"

Norman,L50,long,11,8,3,1,0.9009,111,"[14, 26, 27, 28, 30, 57, 58, 59, 85, 86, 89]"

Norman,L50,long,10,4,6,2,0.9091,110,"[15, 26, 28, 30, 56, 57, 60, 86, 88, 92]"

Norman,L50,long,9,2,7,3,0.9174,109,"[27, 28, 32, 57, 59, 86, 87, 89, 90]"

Norman,L50,long,11,6,5,1,0.9009,111,"[27, 28, 30, 54, 56, 57, 58, 59, 85, 87, 89]"

Norman,L50,long,14,5,9,3,0.8772,114,"[29, 53, 55, 57, 62, 86, 88, 89, 90, 91, 92, 93, 96, 99]"

Norman,L50,long,15,7,8,1,0.8696,115,"[27, 31, 56, 57, 59, 60, 61, 62, 88, 89, 90, 91, 92, 93, 94]"

Norman,L50,long,14,8,6,0,0.8772,114,"[14, 26, 27, 28, 29, 31, 33, 60, 61, 63, 89, 91, 92, 95]"

Norman,L50,long,14,11,3,0,0.8772,114,"[27, 29, 30, 55, 56, 57, 58, 59, 60, 61, 62, 88, 91, 92]"

Norman,L50,long,11,8,3,2,0.9009,111,"[14, 25, 26, 30, 31, 33, 59, 63, 89, 90, 94]"

Norman,L50,long,8,6,2,6,0.9259,108,"[28, 29, 52, 55, 57, 58, 62, 93]"

Norman,L50,long,11,8,3,0,0.9009,111,"[14, 25, 26, 27, 29, 59, 85, 87, 88, 90, 91]"

Norman,L50,long,14,4,10,2,0.8772,114,"[27, 28, 29, 53, 54, 56, 58, 59, 61, 88, 89, 90, 91, 93]"

Norman,L50,long,13,8,5,2,0.885,113,"[27, 29, 30, 54, 56, 57, 58, 59, 60, 87, 88, 89, 92]"

Norman,L50,long,13,8,5,0,0.885,113,"[14, 25, 27, 28, 29, 56, 57, 58, 59, 85, 86, 87, 89]"

Norman,L50,long,10,5,5,2,0.9091,110,"[14, 27, 29, 55, 57, 58, 60, 86, 88, 90]"

Norman,L50,long,15,4,11,0,0.8696,115,"[27, 28, 29, 30, 31, 55, 57, 59, 60, 61, 62, 89, 90, 91, 92]"

Norman,L50,long,10,4,6,3,0.9091,110,"[28, 31, 56, 57, 58, 60, 85, 87, 88, 89]"

Norman,L50,long,14,8,6,0,0.8772,114,"[27, 28, 29, 54, 55, 56, 58, 59, 85, 86, 87, 88, 89, 90]"

Norman,L50,long,10,3,7,3,0.9091,110,"[14, 28, 32, 58, 60, 61, 87, 89, 90, 91]"

Norman,L50,long,11,7,4,5,0.9009,111,"[15, 26, 27, 28, 32, 58, 59, 85, 87, 88, 91]"

Norman,L50,long,13,4,9,1,0.885,113,"[14, 26, 28, 29, 55, 56, 57, 58, 59, 61, 87, 88, 90]"

Norman,L50,long,11,8,3,1,0.9009,111,"[28, 29, 52, 54, 56, 58, 59, 61, 88, 89, 90]"

Norman,L50,long,12,10,2,1,0.8929,112,"[14, 25, 27, 28, 29, 58, 62, 87, 89, 90, 91, 93]"

Norman,L50,long,12,7,5,0,0.8929,112,"[15, 26, 28, 29, 55, 57, 58, 59, 85, 86, 87, 89]"

Norman,L50,long,11,9,2,0,0.9009,111,"[14, 26, 27, 28, 30, 57, 59, 60, 88, 89, 90]"

Norman,L50,long,14,5,9,3,0.8772,114,"[14, 25, 27, 28, 29, 56, 57, 58, 59, 64, 91, 93, 94, 95]"

Norman,L50,long,9,3,6,4,0.9174,109,"[28, 31, 56, 57, 58, 59, 62, 87, 90]"

Norman,L50,long,10,5,5,1,0.9091,110,"[14, 25, 28, 31, 60, 61, 63, 89, 91, 92]"

Norman,L50,long,12,3,9,1,0.8929,112,"[27, 28, 29, 53, 54, 55, 57, 59, 61, 87, 89, 91]"

Norman,L50,long,7,4,3,8,0.9346,107,"[14, 25, 29, 34, 60, 65, 91]"

Norman,L50,long,9,4,5,0,0.9174,109,"[16, 27, 29, 56, 58, 59, 85, 87, 89]"

Norman,L50,long,11,8,3,0,0.9009,111,"[14, 25, 26, 27, 29, 57, 58, 59, 85, 88, 89]"

Norman,L50,long,11,7,4,3,0.9009,111,"[14, 25, 26, 27, 28, 30, 57, 58, 61, 87, 91]"

Norman,L50,long,11,7,4,0,0.9009,111,"[14, 28, 29, 56, 57, 58, 59, 60, 86, 89, 90]"

Norman,L50,long,11,7,4,1,0.9009,111,"[16, 27, 29, 56, 57, 58, 59, 61, 87, 89, 90]"

Norman,L50,long,12,2,10,0,0.8929,112,"[27, 28, 29, 53, 55, 56, 59, 84, 86, 87, 88, 89]"

Norman,L50,long,13,7,6,2,0.885,113,"[14, 28, 29, 30, 56, 57, 58, 59, 61, 87, 91, 92, 94]"

Norman,L50,long,11,4,7,1,0.9009,111,"[27, 28, 30, 54, 56, 57, 59, 85, 86, 88, 89]"

Norman,L50,long,9,5,4,0,0.9174,109,"[29, 30, 57, 58, 60, 86, 87, 89, 90]"

Norman,L50,long,9,6,3,2,0.9174,109,"[17, 29, 54, 55, 56, 57, 60, 86, 90]"

Norman,L50,long,13,5,8,1,0.885,113,"[28, 29, 52, 54, 55, 56, 57, 58, 59, 85, 87, 88, 90]"

Norman,L50,long,15,6,9,2,0.8696,115,"[14, 25, 26, 28, 29, 56, 57, 58, 59, 62, 88, 90, 91, 92, 94]"

Norman,L50,long,9,6,3,4,0.9174,109,"[16, 27, 32, 58, 60, 86, 87, 88, 89]"

Norman,L50,long,15,9,6,1,0.8696,115,"[28, 29, 30, 31, 32, 56, 58, 59, 60, 62, 88, 89, 90, 91, 93]"

Norman,L50,long,12,7,5,7,0.8929,112,"[27, 28, 29, 35, 61, 85, 87, 88, 89, 90, 92, 94]"

Norman,L50,long,11,4,7,3,0.9009,111,"[27, 30, 55, 56, 58, 60, 85, 86, 87, 88, 90]"

Norman,L50,long,10,3,7,1,0.9091,110,"[28, 30, 56, 57, 58, 59, 84, 85, 86, 89]"

Norman,L50,long,11,6,5,2,0.9009,111,"[15, 28, 29, 55, 56, 57, 58, 59, 62, 88, 90]"

Norman,L50,long,11,7,4,0,0.9009,111,"[27, 29, 31, 32, 61, 62, 63, 88, 91, 92, 93]"

Norman,L50,long,9,6,3,2,0.9174,109,"[30, 56, 57, 60, 85, 86, 87, 88, 89]"

Norman,L50,long,9,3,6,0,0.9174,109,"[29, 52, 55, 56, 58, 59, 84, 86, 90]"

Norman,L50,long,11,8,3,3,0.9009,111,"[14, 29, 55, 56, 57, 58, 60, 86, 89, 90, 94]"

Norman,L50,long,10,7,3,5,0.9091,110,"[14, 25, 27, 30, 57, 58, 61, 87, 88, 94]"

Norman,L50,long,12,2,10,1,0.8929,112,"[27, 28, 31, 56, 58, 59, 60, 85, 87, 88, 89, 90]"

Norman,L50,long,12,6,6,1,0.8929,112,"[27, 30, 56, 59, 61, 86, 87, 88, 90, 91, 92, 94]"

Norman,L50,long,11,5,6,0,0.9009,111,"[15, 26, 29, 55, 56, 57, 59, 85, 87, 88, 89]"

Norman,L50,long,15,8,7,0,0.8696,115,"[27, 28, 29, 31, 56, 57, 58, 59, 60, 61, 87, 89, 90, 91, 92]"

Norman,L50,long,9,5,4,0,0.9174,109,"[27, 30, 59, 60, 85, 87, 88, 89, 92]"

Norman,L50,long,15,2,13,1,0.8696,115,"[27, 29, 52, 54, 55, 56, 57, 58, 59, 60, 61, 63, 90, 91, 92]"

Norman,L50,long,11,9,2,0,0.9009,111,"[28, 29, 30, 31, 55, 57, 58, 59, 61, 87, 91]"

Norman,L50,long,10,8,2,2,0.9091,110,"[16, 27, 30, 55, 56, 58, 59, 85, 88, 90]"

Norman,L50,long,11,8,3,0,0.9009,111,"[27, 28, 31, 32, 33, 60, 62, 64, 92, 93, 94]"

Norman,L50,long,14,8,6,5,0.8772,114,"[14, 25, 26, 27, 28, 29, 32, 59, 60, 87, 88, 89, 90, 94]"

Norman,L50,long,9,5,4,5,0.9174,109,"[27, 29, 52, 56, 57, 58, 61, 86, 92]"

Norman,L50,long,10,3,7,2,0.9091,110,"[15, 27, 28, 29, 55, 57, 61, 87, 89, 91]"

Norman,L50,long,11,4,7,5,0.9009,111,"[14, 25, 28, 29, 30, 31, 59, 62, 69, 94, 97]"

Norman,L50,long,11,4,7,1,0.9009,111,"[29, 55, 56, 57, 59, 61, 86, 87, 90, 91, 93]"

Norman,L50,long,15,13,2,2,0.8696,115,"[14, 25, 26, 27, 28, 29, 55, 56, 57, 58, 59, 60, 63, 90, 91]"

Norman,L50,long,14,9,5,2,0.8772,114,"[14, 25, 26, 27, 28, 29, 32, 59, 60, 62, 88, 90, 91, 94]"

Norman,L50,long,11,5,6,1,0.9009,111,"[14, 25, 27, 28, 30, 58, 59, 86, 87, 88, 89]"

Norman,L50,long,10,2,8,3,0.9091,110,"[27, 31, 56, 57, 58, 60, 85, 86, 88, 89]"

Norman,L50,long,15,11,4,0,0.8696,115,"[14, 25, 26, 27, 28, 29, 55, 56, 58, 59, 60, 87, 88, 89, 90]"

Norman,L50,long,12,5,7,1,0.8929,112,"[28, 29, 31, 56, 57, 59, 60, 85, 87, 88, 89, 90]"

Norman,L50,long,15,8,7,0,0.8696,115,"[14, 25, 26, 28, 29, 56, 57, 58, 60, 61, 87, 88, 90, 91, 92]"

Norman,L50,long,13,11,2,4,0.885,113,"[14, 26, 27, 28, 29, 30, 33, 60, 61, 65, 91, 92, 93]"

Norman,L50,long,12,5,7,3,0.8929,112,"[14, 25, 28, 29, 58, 59, 85, 87, 88, 89, 90, 94]"

Norman,L50,long,10,8,2,1,0.9091,110,"[28, 30, 55, 56, 57, 58, 60, 88, 89, 91]"

Norman,L50,long,10,4,6,1,0.9091,110,"[27, 28, 29, 31, 57, 58, 60, 85, 87, 90]"

Norman,L50,long,10,4,6,0,0.9091,110,"[14, 25, 29, 56, 57, 60, 61, 88, 91, 92]"

Norman,L50,long,12,8,4,0,0.8929,112,"[28, 30, 55, 57, 59, 61, 62, 63, 89, 90, 92, 93]"

Norman,L50,long,12,8,4,2,0.8929,112,"[15, 26, 27, 30, 56, 57, 59, 60, 61, 87, 89, 92]"

Norman,L50,long,11,4,7,0,0.9009,111,"[27, 29, 52, 54, 55, 57, 59, 84, 86, 88, 89]"

Norman,L50,long,10,5,5,1,0.9091,110,"[14, 25, 26, 28, 29, 56, 57, 61, 87, 90]"

Norman,L50,long,17,10,7,0,0.8547,117,"[14, 25, 26, 27, 28, 29, 31, 58, 59, 60, 62, 63, 64, 65, 92, 94, 95]"

Norman,L50,long,12,6,6,0,0.8929,112,"[15, 26, 27, 28, 29, 56, 58, 60, 86, 88, 89, 90]"

Norman,L50,long,15,3,12,0,0.8696,115,"[27, 28, 29, 53, 54, 55, 56, 58, 60, 61, 87, 89, 90, 91, 93]"

Norman,L50,long,12,7,5,2,0.8929,112,"[14, 25, 26, 27, 28, 29, 32, 59, 60, 87, 88, 90]"

Norman,L50,long,12,6,6,1,0.8929,112,"[15, 26, 27, 28, 29, 56, 57, 58, 60, 86, 88, 89]"

Norman,L50,long,10,3,7,2,0.9091,110,"[14, 26, 28, 29, 55, 56, 58, 61, 87, 89]"

Norman,L50,long,9,6,3,3,0.9174,109,"[27, 29, 30, 56, 61, 62, 88, 91, 95]"

Norman,L50,long,11,6,5,1,0.9009,111,"[28, 29, 31, 57, 58, 59, 60, 62, 89, 90, 91]"

Norman,L50,long,13,11,2,4,0.885,113,"[14, 25, 26, 27, 28, 30, 59, 62, 88, 89, 90, 91, 93]"

Norman,L50,long,12,4,8,0,0.8929,112,"[27, 28, 29, 30, 55, 57, 58, 59, 60, 87, 89, 90]"

Norman,L50,long,11,6,5,2,0.9009,111,"[14, 25, 26, 27, 29, 56, 57, 60, 86, 88, 90]"

Norman,L50,long,12,6,6,0,0.8929,112,"[27, 28, 30, 54, 56, 57, 58, 59, 60, 87, 89, 90]"

Norman,L50,long,16,8,8,3,0.8621,116,"[28, 29, 52, 55, 57, 58, 59, 60, 62, 88, 89, 90, 91, 92, 93, 96]"

Norman,L50,long,10,6,4,1,0.9091,110,"[14, 26, 27, 29, 55, 58, 60, 87, 88, 89]"

Norman,L50,long,11,6,5,2,0.9009,111,"[27, 28, 31, 56, 57, 58, 59, 84, 86, 87, 89]"

Norman,L50,long,11,5,6,1,0.9009,111,"[14, 26, 27, 28, 30, 58, 59, 85, 87, 88, 89]"

Norman,L50,long,11,3,8,1,0.9009,111,"[27, 28, 29, 53, 55, 58, 59, 85, 86, 87, 91]"

Norman,L50,long,13,10,3,0,0.885,113,"[14, 25, 26, 27, 29, 56, 57, 59, 85, 86, 87, 88, 89]"

Norman,L50,long,7,6,1,3,0.9346,107,"[28, 29, 31, 56, 58, 62, 90]"

Norman,L50,long,11,6,5,0,0.9009,111,"[14, 25, 28, 29, 30, 57, 59, 60, 86, 89, 90]"

Norman,L50,long,14,10,4,0,0.8772,114,"[15, 26, 27, 28, 29, 30, 57, 59, 60, 86, 87, 88, 90, 91]"

Norman,L50,long,14,1,13,0,0.8772,114,"[27, 28, 29, 53, 54, 55, 56, 57, 58, 59, 60, 61, 90, 93]"

Norman,L50,long,15,11,4,0,0.8696,115,"[27, 29, 53, 55, 56, 57, 58, 59, 60, 61, 87, 89, 90, 93, 94]"

Norman,L50,long,12,5,7,0,0.8929,112,"[27, 29, 52, 54, 56, 57, 58, 60, 86, 88, 89, 90]"

Norman,L50,long,11,2,9,1,0.9009,111,"[27, 28, 29, 53, 54, 56, 58, 60, 86, 88, 89]"

Norman,L50,long,16,8,8,2,0.8621,116,"[14, 27, 28, 30, 31, 32, 58, 59, 60, 61, 62, 88, 89, 91, 92, 95]"

Norman,L50,long,12,8,4,0,0.8929,112,"[15, 26, 29, 55, 56, 57, 58, 59, 85, 86, 88, 89]"

Norman,L50,long,12,4,8,0,0.8929,112,"[15, 26, 28, 29, 57, 58, 59, 86, 87, 88, 89, 90]"

Norman,L50,long,15,7,8,3,0.8696,115,"[27, 28, 29, 30, 32, 56, 58, 59, 60, 61, 62, 63, 90, 92, 96]"

Norman,L50,long,10,1,9,0,0.9091,110,"[27, 28, 29, 30, 54, 56, 58, 61, 90, 92]"

Norman,L50,long,11,7,4,1,0.9009,111,"[14, 25, 26, 30, 32, 58, 59, 60, 61, 91, 92]"

Norman,L50,long,12,3,9,1,0.8929,112,"[27, 28, 30, 54, 56, 58, 60, 85, 87, 88, 89, 90]"

Norman,L50,long,12,5,7,2,0.8929,112,"[27, 28, 29, 54, 56, 57, 59, 84, 87, 88, 89, 92]"

Norman,L50,long,12,6,6,1,0.8929,112,"[14, 27, 28, 30, 57, 58, 59, 85, 87, 89, 90, 92]"

Norman,L50,long,8,7,1,2,0.9259,108,"[29, 30, 59, 60, 85, 86, 89, 92]"

Norman,L50,long,10,7,3,2,0.9091,110,"[14, 25, 27, 28, 30, 57, 59, 86, 88, 90]"

Norman,L50,long,11,6,5,0,0.9009,111,"[15, 26, 27, 28, 29, 57, 59, 86, 87, 88, 89]"

Norman,L50,long,11,9,2,0,0.9009,111,"[30, 56, 58, 59, 60, 85, 86, 87, 88, 89, 90]"

Norman,L50,long,9,3,6,4,0.9174,109,"[16, 27, 29, 33, 59, 62, 87, 90, 91]"

Norman,L50,long,12,7,5,3,0.8929,112,"[14, 25, 28, 29, 31, 57, 58, 59, 60, 63, 90, 91]"

Norman,L50,long,12,2,10,3,0.8929,112,"[27, 30, 55, 57, 58, 59, 60, 61, 87, 88, 89, 93]"

Norman,L50,long,14,7,7,1,0.8772,114,"[15, 26, 29, 30, 56, 57, 58, 60, 61, 88, 89, 90, 91, 93]"

Norman,L50,long,10,6,4,1,0.9091,110,"[27, 30, 55, 56, 57, 60, 85, 86, 89, 90]"

Norman,L50,long,21,11,10,1,0.8264,121,"[15, 27, 30, 55, 56, 57, 58, 59, 60, 86, 87, 88, 89, 91, 92, 93, 94, 95, 96, 97, 98]"

Norman,L50,long,12,6,6,1,0.8929,112,"[14, 26, 27, 29, 30, 57, 59, 60, 86, 88, 89, 91]"

Norman,L50,long,8,1,7,1,0.9259,108,"[27, 29, 56, 57, 58, 60, 88, 89]"

Norman,L50,long,12,6,6,2,0.8929,112,"[27, 28, 31, 56, 57, 58, 59, 84, 86, 87, 88, 89]"

Norman,L50,long,15,11,4,0,0.8696,115,"[27, 29, 30, 31, 32, 33, 57, 59, 61, 62, 63, 64, 91, 92, 94]"

Norman,L50,long,15,8,7,1,0.8696,115,"[27, 28, 29, 53, 55, 57, 58, 60, 61, 63, 89, 91, 92, 93, 94]"

Norman,L50,long,11,8,3,3,0.9009,111,"[27, 30, 55, 56, 57, 58, 59, 84, 86, 88, 91]"

Norman,L50,long,12,6,6,1,0.8929,112,"[15, 27, 28, 29, 30, 57, 58, 59, 61, 87, 91, 92]"

Norman,L50,long,15,10,5,0,0.8696,115,"[15, 26, 27, 28, 29, 56, 57, 58, 59, 85, 86, 87, 88, 90, 91]"

Norman,L50,long,13,10,3,0,0.885,113,"[14, 26, 27, 28, 29, 30, 58, 59, 61, 63, 89, 91, 93]"

Norman,L50,long,11,8,3,4,0.9009,111,"[28, 30, 55, 56, 57, 60, 85, 87, 88, 89, 93]"

Norman,L50,long,13,4,9,0,0.885,113,"[27, 28, 29, 55, 56, 57, 59, 85, 86, 87, 88, 89, 90]"

Norman,L50,long,9,5,4,3,0.9174,109,"[31, 55, 57, 58, 60, 85, 86, 87, 89]"

Norman,L50,long,12,8,4,0,0.8929,112,"[14, 25, 26, 28, 29, 56, 58, 59, 85, 86, 88, 89]"

Norman,L50,long,12,7,5,0,0.8929,112,"[15, 26, 27, 29, 30, 57, 58, 60, 86, 88, 90, 91]"

Norman,L50,long,11,4,7,0,0.9009,111,"[14, 28, 29, 55, 57, 58, 59, 86, 87, 88, 89]"

Norman,L50,long,14,8,6,0,0.8772,114,"[14, 25, 26, 27, 28, 29, 56, 57, 58, 59, 85, 88, 89, 90]"

Norman,L50,long,11,2,9,1,0.9009,111,"[14, 26, 28, 29, 55, 56, 57, 58, 59, 60, 91]"

Norman,L50,long,16,11,5,0,0.8621,116,"[15, 27, 28, 29, 55, 57, 58, 59, 60, 61, 62, 88, 89, 90, 91, 92]"

Norman,L50,long,11,6,5,2,0.9009,111,"[14, 26, 27, 28, 30, 57, 58, 60, 86, 88, 89]"

Norman,L50,long,13,2,11,0,0.885,113,"[27, 28, 29, 53, 55, 56, 57, 58, 59, 60, 86, 88, 90]"

Norman,L50,long,10,7,3,1,0.9091,110,"[16, 27, 30, 55, 56, 57, 59, 85, 87, 89]"

Norman,L50,long,12,6,6,2,0.8929,112,"[27, 29, 54, 55, 57, 58, 60, 85, 87, 88, 89, 91]"

Norman,L50,long,12,8,4,1,0.8929,112,"[14, 25, 28, 30, 56, 57, 59, 60, 61, 87, 90, 91]"

Norman,L50,long,9,4,5,2,0.9174,109,"[14, 26, 28, 30, 56, 57, 60, 86, 89]"

Norman,L50,long,11,9,2,1,0.9009,111,"[14, 26, 27, 28, 30, 57, 58, 59, 85, 89, 90]"

Norman,L50,long,12,9,3,1,0.8929,112,"[14, 25, 27, 30, 59, 61, 86, 87, 89, 90, 91, 92]"

Norman,L50,long,14,7,7,0,0.8772,114,"[16, 27, 30, 56, 57, 58, 59, 60, 86, 88, 89, 90, 91, 92]"

Norman,L50,long,10,5,5,0,0.9091,110,"[15, 28, 29, 55, 56, 57, 59, 86, 87, 89]"

Norman,L50,long,7,0,7,6,0.9346,107,"[27, 28, 32, 62, 87, 88, 89]"

Norman,L50,long,10,7,3,3,0.9091,110,"[31, 55, 58, 59, 61, 85, 87, 88, 89, 91]"

Norman,L50,long,13,10,3,2,0.885,113,"[27, 28, 30, 55, 56, 57, 58, 59, 60, 61, 87, 90, 92]"

Norman,L50,long,10,8,2,2,0.9091,110,"[14, 26, 27, 28, 29, 57, 58, 60, 88, 91]"

Norman,L50,long,11,5,6,1,0.9009,111,"[29, 52, 55, 56, 58, 59, 84, 85, 86, 89, 91]"

Norman,L50,long,10,4,6,0,0.9091,110,"[27, 28, 29, 55, 57, 59, 60, 86, 88, 90]"

Norman,L50,long,11,1,10,2,0.9009,111,"[30, 55, 56, 57, 58, 59, 84, 85, 86, 87, 90]"

Norman,L50,long,14,7,7,1,0.8772,114,"[27, 28, 29, 30, 32, 57, 58, 59, 60, 61, 87, 89, 90, 91]"

Norman,L50,long,9,4,5,1,0.9174,109,"[27, 31, 56, 60, 61, 86, 87, 90, 91]"

Norman,L50,long,8,4,4,2,0.9259,108,"[16, 27, 29, 55, 56, 60, 88, 92]"

Norman,L50,long,9,4,5,3,0.9174,109,"[16, 27, 29, 56, 58, 59, 62, 88, 91]"

Norman,L50,long,11,5,6,3,0.9009,111,"[29, 30, 35, 61, 62, 63, 64, 90, 91, 93, 94]"

Norman,L50,long,12,2,10,2,0.8929,112,"[27, 28, 29, 53, 54, 56, 57, 58, 60, 86, 88, 90]"

Norman,L50,long,13,6,7,3,0.885,113,"[15, 26, 28, 29, 55, 57, 58, 60, 61, 62, 64, 90, 95]"

Norman,L50,long,14,7,7,0,0.8772,114,"[14, 25, 26, 27, 28, 29, 30, 57, 58, 59, 61, 88, 90, 91]"

Norman,L50,long,11,6,5,1,0.9009,111,"[28, 30, 31, 56, 58, 59, 60, 62, 89, 90, 92]"

Norman,L50,long,11,4,7,1,0.9009,111,"[27, 28, 29, 54, 55, 58, 61, 86, 88, 89, 90]"

Norman,L50,long,13,8,5,1,0.885,113,"[15, 28, 30, 56, 57, 58, 60, 61, 62, 89, 90, 91, 93]"

Norman,L50,long,10,7,3,1,0.9091,110,"[14, 25, 27, 30, 56, 58, 59, 85, 88, 89]"

Norman,L50,long,10,2,8,2,0.9091,110,"[28, 31, 56, 57, 58, 59, 61, 86, 89, 91]"

Norman,L50,long,11,7,4,2,0.9009,111,"[14, 25, 26, 27, 28, 30, 57, 59, 62, 88, 90]"

Norman,L50,long,12,8,4,2,0.8929,112,"[15, 26, 28, 31, 57, 59, 60, 87, 88, 89, 90, 92]"

Norman,L50,long,10,4,6,3,0.9091,110,"[27, 28, 30, 54, 56, 58, 60, 86, 89, 91]"

Norman,L50,long,10,4,6,3,0.9091,110,"[27, 28, 29, 30, 33, 60, 62, 87, 89, 91]"

Norman,L50,long,11,8,3,0,0.9009,111,"[28, 29, 52, 54, 55, 57, 59, 60, 88, 89, 90]"

Norman,L50,long,11,6,5,0,0.9009,111,"[29, 54, 56, 57, 58, 59, 61, 87, 88, 89, 91]"

Norman,L50,long,9,3,6,1,0.9174,109,"[27, 29, 52, 57, 58, 60, 87, 88, 90]"

Norman,L50,long,14,10,4,0,0.8772,114,"[27, 29, 30, 55, 56, 60, 61, 62, 88, 89, 90, 91, 92, 93]"

Norman,L50,long,10,6,4,0,0.9091,110,"[27, 29, 30, 31, 55, 57, 59, 62, 88, 92]"

Norman,L50,long,14,7,7,0,0.8772,114,"[27, 28, 29, 54, 55, 56, 57, 60, 61, 89, 90, 91, 92, 93]"

Norman,L50,long,14,9,5,0,0.8772,114,"[14, 25, 26, 27, 28, 29, 55, 56, 58, 59, 60, 86, 89, 90]"

Norman,L50,long,13,5,8,0,0.885,113,"[28, 29, 52, 54, 55, 58, 59, 60, 86, 87, 88, 89, 90]"

Norman,L50,long,10,9,1,3,0.9091,110,"[28, 29, 33, 35, 61, 66, 91, 92, 93, 94]"

Norman,L50,long,9,3,6,2,0.9174,109,"[14, 25, 26, 29, 55, 56, 57, 61, 89]"

Norman,L50,long,11,4,7,0,0.9009,111,"[27, 28, 29, 54, 56, 57, 59, 84, 86, 88, 89]"

Norman,L50,long,10,5,5,1,0.9091,110,"[14, 26, 29, 30, 57, 60, 86, 87, 89, 91]"

Norman,L50,long,13,10,3,1,0.885,113,"[28, 30, 31, 56, 57, 58, 59, 60, 61, 87, 88, 89, 92]"

Norman,L50,long,10,5,5,2,0.9091,110,"[28, 29, 52, 54, 55, 57, 61, 86, 88, 90]"

Norman,L50,long,10,5,5,5,0.9091,110,"[14, 26, 27, 28, 29, 56, 57, 58, 63, 90]"

Norman,L50,long,10,6,4,3,0.9091,110,"[14, 25, 26, 28, 30, 57, 58, 61, 87, 89]"

Norman,L50,long,13,6,7,1,0.885,113,"[27, 29, 30, 33, 35, 60, 62, 63, 64, 90, 92, 93, 94]"

Norman,L50,long,11,5,6,0,0.9009,111,"[27, 29, 52, 55, 57, 58, 60, 61, 87, 88, 91]"

Norman,L50,long,14,11,3,1,0.8772,114,"[14, 25, 26, 27, 28, 29, 32, 59, 60, 61, 87, 88, 89, 92]"

Norman,L50,long,12,1,11,0,0.8929,112,"[14, 27, 28, 29, 55, 56, 57, 58, 59, 85, 88, 89]"

Norman,L50,long,12,2,10,0,0.8929,112,"[30, 55, 57, 60, 84, 87, 88, 89, 90, 91, 92, 93]"

Norman,L50,long,13,6,7,1,0.885,113,"[14, 25, 26, 27, 30, 57, 58, 60, 86, 88, 89, 90, 91]"

Norman,L50,long,13,5,8,2,0.885,113,"[14, 27, 31, 57, 58, 59, 60, 62, 88, 92, 94, 95, 96]"

Norman,L50,long,10,5,5,3,0.9091,110,"[27, 29, 31, 56, 58, 60, 62, 87, 90, 92]"

Norman,L50,long,11,3,8,0,0.9009,111,"[27, 28, 29, 53, 55, 56, 57, 59, 85, 86, 89]"

Norman,L50,long,10,7,3,2,0.9091,110,"[14, 25, 26, 30, 60, 85, 86, 87, 89, 91]"

Norman,L50,long,12,5,7,0,0.8929,112,"[27, 28, 29, 54, 55, 57, 59, 60, 86, 87, 90, 91]"

Norman,L50,long,11,8,3,0,0.9009,111,"[14, 27, 29, 56, 57, 58, 59, 60, 88, 89, 90]"

Norman,L50,long,10,7,3,5,0.9091,110,"[27, 28, 31, 56, 57, 61, 87, 88, 89, 91]"

Norman,L50,long,10,5,5,2,0.9091,110,"[14, 25, 26, 27, 29, 56, 57, 61, 87, 89]"

Norman,L50,long,13,7,6,0,0.885,113,"[15, 26, 27, 28, 29, 56, 57, 58, 60, 86, 87, 89, 90]"

Norman,L50,long,13,7,6,1,0.885,113,"[14, 26, 27, 28, 30, 57, 58, 59, 85, 87, 88, 89, 91]"

Norman,L50,long,14,5,9,0,0.8772,114,"[14, 27, 29, 55, 57, 58, 59, 85, 87, 88, 89, 90, 91, 93]"

Norman,L50,long,11,1,10,2,0.9009,111,"[15, 27, 28, 29, 55, 56, 57, 58, 59, 87, 91]"

Norman,L50,long,13,8,5,2,0.885,113,"[16, 29, 30, 55, 59, 60, 61, 62, 88, 89, 91, 92, 95]"

Norman,L50,long,9,6,3,3,0.9174,109,"[27, 29, 52, 55, 57, 62, 87, 88, 91]"

Norman,L50,long,11,6,5,2,0.9009,111,"[14, 25, 27, 28, 30, 57, 58, 60, 87, 88, 89]"

Norman,L50,long,11,9,2,2,0.9009,111,"[28, 30, 55, 56, 58, 59, 86, 87, 88, 89, 91]"

Norman,L50,long,11,4,7,2,0.9009,111,"[27, 29, 52, 54, 56, 57, 58, 61, 87, 88, 89]"

Norman,L50,long,11,5,6,0,0.9009,111,"[14, 26, 27, 29, 55, 57, 59, 85, 87, 88, 90]"

Norman,L50,long,13,9,4,1,0.885,113,"[15, 28, 30, 55, 56, 57, 60, 62, 64, 90, 91, 92, 93]"

Norman,L50,long,11,4,7,1,0.9009,111,"[27, 28, 32, 58, 60, 61, 63, 88, 90, 91, 92]"

Norman,L50,long,11,2,9,2,0.9009,111,"[27, 28, 32, 57, 61, 64, 89, 90, 91, 92, 94]"

Norman,L50,long,10,5,5,3,0.9091,110,"[27, 28, 30, 54, 56, 58, 62, 87, 90, 92]"

Norman,L50,long,12,5,7,0,0.8929,112,"[16, 27, 29, 30, 31, 57, 60, 61, 87, 89, 90, 92]"

Norman,L50,long,10,4,6,2,0.9091,110,"[27, 28, 31, 56, 58, 60, 85, 86, 89, 90]"

Norman,L50,long,11,9,2,1,0.9009,111,"[14, 25, 26, 27, 28, 29, 57, 59, 88, 89, 91]"

Norman,L50,long,12,9,3,5,0.8929,112,"[14, 25, 26, 27, 30, 57, 59, 60, 61, 66, 93, 95]"

Norman,L50,long,17,8,9,0,0.8547,117,"[14, 25, 27, 28, 29, 56, 57, 58, 59, 86, 87, 88, 91, 92, 93, 94, 96]"

Norman,L50,long,16,6,10,0,0.8621,116,"[27, 28, 29, 53, 55, 56, 58, 59, 60, 61, 88, 89, 91, 92, 94, 95]"

Norman,L50,long,10,6,4,1,0.9091,110,"[17, 28, 30, 57, 59, 84, 86, 88, 89, 90]"

Norman,L50,long,9,4,5,3,0.9174,109,"[28, 30, 57, 59, 62, 86, 88, 90, 91]"

Norman,L50,long,16,14,2,0,0.8621,116,"[14, 26, 27, 28, 29, 30, 31, 59, 60, 61, 87, 88, 89, 90, 91, 93]"

Norman,L50,long,14,8,6,0,0.8772,114,"[14, 25, 26, 28, 29, 56, 58, 61, 62, 63, 89, 91, 92, 93]"

Norman,L50,long,10,3,7,3,0.9091,110,"[18, 32, 57, 60, 85, 88, 89, 90, 91, 93]"

Norman,L50,long,7,3,4,2,0.9346,107,"[14, 25, 27, 28, 31, 59, 89]"

Norman,L50,long,15,13,2,4,0.8696,115,"[15, 26, 27, 28, 29, 32, 58, 59, 60, 61, 87, 88, 89, 90, 94]"

Norman,L50,long,10,8,2,1,0.9091,110,"[14, 25, 26, 27, 29, 57, 58, 60, 86, 89]"

Norman,L50,long,10,2,8,1,0.9091,110,"[15, 26, 28, 29, 30, 31, 59, 62, 90, 92]"

Norman,L50,long,10,7,3,2,0.9091,110,"[15, 28, 29, 55, 56, 57, 58, 60, 88, 90]"

Norman,L50,long,9,5,4,0,0.9174,109,"[14, 25, 27, 30, 56, 57, 60, 87, 90]"

Norman,L50,long,13,6,7,2,0.885,113,"[14, 26, 27, 29, 55, 56, 57, 58, 59, 85, 87, 88, 92]"

Norman,L50,long,9,8,1,3,0.9174,109,"[28, 29, 52, 56, 57, 58, 62, 87, 89]"

Norman,L50,long,15,12,3,0,0.8696,115,"[14, 26, 27, 28, 29, 56, 57, 59, 60, 61, 87, 88, 89, 90, 91]"

Norman,L50,long,11,7,4,2,0.9009,111,"[14, 25, 26, 27, 30, 57, 58, 61, 87, 89, 91]"

Norman,L50,long,11,2,9,3,0.9009,111,"[28, 31, 56, 57, 59, 60, 61, 64, 90, 92, 93]"

Norman,L50,long,12,6,6,1,0.8929,112,"[27, 29, 52, 55, 58, 60, 61, 86, 88, 89, 90, 92]"

Norman,L50,long,12,3,9,1,0.8929,112,"[28, 29, 52, 57, 58, 59, 60, 85, 87, 88, 89, 91]"

Norman,L50,long,7,4,3,9,0.9346,107,"[27, 29, 30, 35, 66, 90, 92]"

Norman,L50,long,12,4,8,1,0.8929,112,"[27, 28, 29, 55, 56, 57, 59, 61, 87, 88, 89, 90]"

Norman,L50,long,11,4,7,0,0.9009,111,"[27, 28, 29, 30, 54, 57, 58, 60, 63, 89, 93]"

Norman,L50,long,14,3,11,3,0.8772,114,"[27, 28, 29, 31, 56, 59, 60, 61, 62, 63, 89, 90, 92, 95]"

Norman,L50,long,12,8,4,1,0.8929,112,"[27, 28, 31, 56, 57, 58, 60, 85, 88, 89, 91, 92]"

Norman,L50,long,9,3,6,6,0.9174,109,"[27, 28, 30, 36, 63, 88, 89, 90, 92]"

Norman,L50,long,14,8,6,1,0.8772,114,"[14, 25, 26, 27, 28, 29, 30, 31, 58, 59, 62, 89, 91, 92]"

Norman,L50,long,9,5,4,1,0.9174,109,"[27, 29, 52, 56, 59, 61, 86, 88, 90]"

Norman,L50,long,9,4,5,3,0.9174,109,"[28, 29, 52, 54, 56, 58, 61, 89, 91]"

Norman,L50,long,12,6,6,2,0.8929,112,"[15, 26, 27, 28, 31, 58, 59, 60, 87, 88, 89, 90]"

Norman,L50,long,13,5,8,2,0.885,113,"[27, 28, 31, 32, 58, 59, 60, 61, 62, 89, 90, 91, 94]"

Norman,L50,long,13,3,10,1,0.885,113,"[27, 29, 30, 54, 58, 59, 60, 85, 87, 88, 89, 90, 92]"

Norman,L50,long,10,6,4,1,0.9091,110,"[27, 29, 52, 55, 57, 58, 59, 84, 87, 91]"

Norman,L50,long,13,8,5,0,0.885,113,"[14, 25, 28, 29, 55, 56, 58, 59, 85, 86, 87, 88, 89]"

Norman,L50,long,11,10,1,0,0.9009,111,"[27, 30, 58, 60, 85, 86, 87, 88, 89, 90, 91]"

Norman,L50,long,13,5,8,1,0.885,113,"[27, 28, 30, 54, 56, 57, 59, 84, 86, 88, 89, 90, 91]"

Norman,L50,long,10,3,7,0,0.9091,110,"[27, 28, 29, 53, 54, 55, 59, 84, 87, 89]"

Norman,L50,long,12,10,2,1,0.8929,112,"[16, 28, 29, 31, 57, 58, 59, 60, 88, 89, 90, 91]"

Norman,L50,long,11,1,10,1,0.9009,111,"[27, 28, 29, 54, 55, 56, 57, 60, 86, 87, 89]"

Norman,L50,long,12,6,6,0,0.8929,112,"[14, 26, 27, 28, 29, 56, 58, 59, 86, 87, 88, 89]"

Norman,L50,long,13,2,11,1,0.885,113,"[27, 28, 29, 53, 54, 56, 57, 59, 61, 87, 88, 89, 90]"

Norman,L50,long,11,5,6,0,0.9009,111,"[30, 56, 58, 59, 60, 62, 87, 89, 91, 92, 93]"

Norman,L50,long,11,8,3,0,0.9009,111,"[14, 26, 27, 30, 57, 58, 59, 60, 87, 89, 90]"

Norman,L50,long,12,4,8,4,0.8929,112,"[27, 28, 29, 53, 57, 58, 59, 84, 86, 87, 88, 94]"

Norman,L50,long,12,8,4,0,0.8929,112,"[16, 28, 29, 55, 56, 57, 58, 59, 60, 86, 89, 90]"

Norman,L50,long,13,6,7,0,0.885,113,"[14, 26, 27, 28, 29, 56, 57, 58, 60, 86, 88, 90, 91]"

Norman,L50,long,17,14,3,0,0.8547,117,"[14, 25, 27, 28, 29, 30, 31, 32, 60, 61, 62, 88, 89, 92, 93, 95, 96]"

Norman,L50,long,8,6,2,3,0.9259,108,"[14, 26, 27, 31, 57, 58, 60, 91]"

Norman,L50,long,17,7,10,0,0.8547,117,"[14, 26, 27, 28, 29, 30, 57, 58, 60, 86, 88, 89, 90, 91, 92, 93, 94]"

Norman,L50,long,8,4,4,2,0.9259,108,"[18, 31, 59, 60, 87, 88, 90, 91]"

Norman,L50,long,13,9,4,0,0.885,113,"[28, 29, 54, 56, 57, 59, 60, 62, 63, 89, 90, 91, 93]"

Norman,L50,long,12,5,7,3,0.8929,112,"[27, 30, 55, 56, 57, 59, 60, 85, 87, 88, 89, 92]"

Norman,L50,long,11,2,9,4,0.9009,111,"[14, 25, 28, 29, 55, 56, 57, 58, 60, 88, 92]"

Norman,L50,long,11,2,9,1,0.9009,111,"[27, 28, 29, 53, 54, 55, 56, 58, 59, 85, 90]"

Norman,L50,long,13,11,2,1,0.885,113,"[14, 25, 26, 27, 28, 29, 55, 56, 57, 58, 59, 87, 90]"

Norman,L50,long,13,0,13,0,0.885,113,"[27, 28, 29, 53, 55, 56, 60, 61, 87, 88, 89, 90, 91]"

Norman,L50,long,9,5,4,3,0.9174,109,"[28, 33, 57, 59, 60, 86, 88, 89, 90]"

Norman,L50,long,14,10,4,4,0.8772,114,"[28, 29, 30, 31, 32, 57, 58, 60, 61, 62, 89, 90, 91, 96]"

Norman,L50,long,14,6,8,2,0.8772,114,"[27, 28, 30, 54, 56, 57, 58, 59, 85, 87, 88, 89, 90, 92]"

Norman,L100,long,11,7,4,0,0.9009,111,"[15, 27, 29, 55, 56, 57, 60, 87, 88, 89, 90]"

Norman,L100,long,8,2,6,4,0.9259,108,"[27, 30, 56, 58, 61, 87, 88, 90]"

Norman,L100,long,11,7,4,1,0.9009,111,"[27, 28, 30, 54, 56, 57, 58, 59, 60, 88, 90]"

Norman,L100,long,13,4,9,0,0.885,113,"[27, 28, 29, 54, 55, 56, 57, 58, 59, 86, 87, 88, 89]"

Norman,L100,long,12,7,5,0,0.8929,112,"[27, 28, 29, 30, 54, 57, 58, 59, 60, 61, 90, 91]"

Norman,L100,long,10,5,5,1,0.9091,110,"[27, 29, 54, 55, 56, 59, 84, 86, 87, 90]"

Norman,L100,long,15,12,3,3,0.8696,115,"[28, 29, 30, 55, 56, 57, 58, 59, 60, 61, 62, 89, 90, 91, 95]"

Norman,L100,long,10,7,3,0,0.9091,110,"[16, 27, 28, 29, 56, 58, 59, 87, 88, 89]"

Norman,L100,long,12,4,8,0,0.8929,112,"[27, 29, 53, 54, 55, 57, 58, 59, 86, 87, 88, 89]"

Norman,L100,long,14,5,9,3,0.8772,114,"[27, 28, 29, 30, 31, 32, 34, 60, 64, 65, 92, 93, 94, 98]"

Norman,L100,long,13,8,5,2,0.885,113,"[14, 26, 27, 28, 29, 32, 59, 60, 61, 62, 89, 93, 94]"

Norman,L100,long,9,3,6,3,0.9174,109,"[15, 27, 28, 30, 57, 58, 60, 88, 90]"

Norman,L100,long,8,1,7,1,0.9259,108,"[14, 27, 28, 29, 55, 58, 60, 89]"

Norman,L100,long,11,5,6,4,0.9009,111,"[27, 28, 29, 32, 57, 58, 59, 60, 86, 88, 92]"

Norman,L100,long,10,4,6,0,0.9091,110,"[14, 26, 28, 29, 55, 58, 59, 86, 89, 91]"

Norman,L100,long,8,4,4,5,0.9259,108,"[14, 27, 28, 30, 57, 61, 87, 91]"

Norman,L100,long,12,2,10,1,0.8929,112,"[15, 27, 28, 30, 31, 32, 33, 61, 63, 89, 93, 95]"

Norman,L100,long,13,7,6,2,0.885,113,"[14, 27, 28, 29, 55, 57, 58, 59, 60, 63, 90, 92, 93]"

Norman,L100,long,10,9,1,1,0.9091,110,"[28, 30, 55, 56, 57, 58, 59, 86, 88, 89]"

Norman,L100,long,11,5,6,1,0.9009,111,"[14, 27, 28, 29, 30, 56, 58, 59, 61, 89, 90]"

Norman,L100,long,12,3,9,0,0.8929,112,"[28, 29, 53, 56, 58, 59, 85, 86, 87, 88, 89, 90]"

Norman,L100,long,11,7,4,2,0.9009,111,"[27, 28, 30, 55, 56, 58, 60, 85, 88, 89, 90]"

Norman,L100,long,9,3,6,1,0.9174,109,"[28, 31, 56, 57, 58, 59, 62, 88, 91]"

Norman,L100,long,8,2,6,3,0.9259,108,"[27, 28, 30, 54, 58, 62, 88, 90]"

Norman,L100,long,10,6,4,1,0.9091,110,"[27, 28, 29, 31, 56, 57, 59, 60, 86, 90]"

Norman,L100,long,13,11,2,1,0.885,113,"[15, 27, 30, 56, 57, 58, 59, 87, 88, 89, 90, 91, 92]"

Norman,L100,long,11,2,9,1,0.9009,111,"[27, 29, 53, 57, 58, 59, 84, 86, 87, 88, 90]"

Norman,L100,long,9,6,3,3,0.9174,109,"[14, 26, 27, 28, 29, 55, 58, 62, 89]"

Norman,L100,long,9,6,3,4,0.9174,109,"[27, 29, 30, 54, 57, 58, 59, 64, 90]"

Norman,L100,long,9,6,3,0,0.9174,109,"[14, 29, 55, 56, 58, 59, 87, 88, 89]"

Norman,L100,long,12,5,7,1,0.8929,112,"[27, 28, 29, 30, 54, 57, 58, 59, 60, 87, 88, 91]"

Norman,L100,long,13,8,5,1,0.885,113,"[27, 28, 30, 54, 56, 58, 59, 61, 62, 89, 90, 91, 93]"

Norman,L100,long,11,5,6,1,0.9009,111,"[15, 27, 28, 29, 55, 57, 58, 59, 85, 88, 90]"

Norman,L100,long,11,1,10,1,0.9009,111,"[27, 28, 29, 53, 55, 56, 57, 58, 60, 88, 89]"

Norman,L100,long,7,5,2,2,0.9346,107,"[16, 27, 30, 57, 61, 86, 90]"

Norman,L100,long,9,4,5,1,0.9174,109,"[14, 27, 28, 30, 57, 61, 88, 91, 92]"

Norman,L100,long,10,8,2,1,0.9091,110,"[14, 26, 27, 29, 57, 61, 62, 64, 92, 93]"

Norman,L100,long,9,5,4,1,0.9174,109,"[14, 26, 29, 55, 56, 59, 87, 88, 90]"

Norman,L100,long,10,7,3,3,0.9091,110,"[14, 26, 27, 28, 30, 57, 61, 87, 88, 89]"

Norman,L100,long,10,7,3,1,0.9091,110,"[14, 27, 30, 56, 59, 85, 86, 87, 88, 89]"

Norman,L100,long,10,5,5,1,0.9091,110,"[15, 30, 56, 57, 58, 60, 86, 87, 88, 90]"

Norman,L100,long,14,8,6,2,0.8772,114,"[16, 27, 28, 29, 31, 58, 59, 60, 62, 89, 90, 91, 92, 95]"

Norman,L100,long,12,6,6,1,0.8929,112,"[28, 29, 53, 54, 56, 57, 59, 85, 86, 87, 88, 92]"

Norman,L100,long,12,1,11,0,0.8929,112,"[27, 28, 29, 53, 55, 56, 59, 85, 86, 87, 89, 90]"

Norman,L100,long,7,3,4,7,0.9346,107,"[15, 27, 31, 57, 61, 86, 93]"

Norman,L100,long,13,9,4,0,0.885,113,"[14, 26, 27, 29, 56, 57, 58, 59, 86, 88, 90, 92, 93]"

Norman,L100,long,13,6,7,1,0.885,113,"[14, 27, 28, 29, 30, 31, 58, 59, 60, 62, 64, 92, 93]"

Norman,L100,long,12,9,3,1,0.8929,112,"[15, 28, 30, 56, 57, 58, 59, 60, 61, 88, 90, 92]"

Norman,L100,long,10,2,8,4,0.9091,110,"[27, 28, 33, 58, 59, 84, 85, 86, 88, 89]"

Norman,L100,long,16,3,13,1,0.8621,116,"[27, 28, 29, 30, 54, 56, 57, 59, 60, 87, 88, 89, 90, 91, 92, 95]"

Norman,L100,long,10,5,5,0,0.9091,110,"[15, 27, 28, 29, 55, 58, 59, 87, 88, 89]"

Norman,L100,long,12,8,4,1,0.8929,112,"[28, 29, 30, 31, 55, 58, 59, 60, 62, 64, 91, 93]"

Norman,L100,long,12,6,6,0,0.8929,112,"[28, 29, 53, 56, 57, 58, 59, 85, 86, 87, 89, 90]"

Norman,L100,long,12,6,6,1,0.8929,112,"[15, 27, 28, 30, 57, 59, 61, 87, 88, 89, 90, 91]"

Norman,L100,long,17,7,10,1,0.8547,117,"[27, 28, 29, 30, 31, 56, 57, 58, 60, 62, 63, 64, 65, 66, 93, 96, 98]"

Norman,L100,long,9,8,1,6,0.9174,109,"[14, 26, 27, 28, 32, 62, 87, 88, 89]"

Norman,L100,long,12,5,7,2,0.8929,112,"[15, 27, 28, 29, 55, 58, 59, 60, 87, 89, 90, 93]"

Norman,L100,long,13,6,7,4,0.885,113,"[27, 28, 29, 30, 56, 57, 59, 62, 88, 90, 92, 93, 97]"

Norman,L100,long,10,5,5,7,0.9091,110,"[14, 26, 28, 29, 55, 57, 58, 59, 66, 93]"

Norman,L100,long,9,5,4,4,0.9174,109,"[15, 29, 30, 32, 58, 60, 64, 91, 93]"

Norman,L100,long,9,3,6,5,0.9174,109,"[27, 28, 29, 54, 57, 58, 59, 65, 90]"

Norman,L100,long,18,10,8,1,0.8475,118,"[14, 26, 27, 28, 30, 56, 58, 59, 63, 64, 65, 67, 93, 94, 95, 96, 98, 99]"

Norman,L100,long,10,5,5,5,0.9091,110,"[15, 27, 31, 58, 59, 60, 86, 88, 89, 93]"

Norman,L100,long,10,7,3,2,0.9091,110,"[28, 30, 55, 56, 57, 60, 62, 88, 90, 92]"

Norman,L100,long,11,9,2,2,0.9009,111,"[15, 28, 31, 59, 60, 85, 86, 87, 88, 89, 90]"

Norman,L100,long,14,9,5,1,0.8772,114,"[27, 28, 31, 56, 57, 58, 60, 61, 87, 89, 90, 91, 92, 94]"

Norman,L100,long,12,8,4,2,0.8929,112,"[27, 28, 30, 32, 57, 58, 59, 60, 61, 63, 89, 92]"

Norman,L100,long,10,6,4,1,0.9091,110,"[14, 26, 28, 30, 57, 58, 59, 86, 88, 89]"

Norman,L100,long,13,4,9,2,0.885,113,"[28, 29, 53, 54, 55, 56, 57, 58, 60, 87, 89, 90, 92]"

Norman,L100,long,9,2,7,2,0.9174,109,"[29, 31, 57, 58, 59, 61, 88, 89, 90]"

Norman,L100,long,15,0,15,0,0.8696,115,"[27, 28, 29, 30, 31, 55, 57, 58, 59, 60, 61, 62, 63, 91, 93]"

Norman,L100,long,12,5,7,1,0.8929,112,"[15, 27, 29, 30, 32, 59, 60, 61, 89, 90, 91, 92]"

Norman,L100,long,14,3,11,1,0.8772,114,"[27, 28, 29, 53, 54, 55, 56, 57, 58, 59, 87, 88, 89, 91]"

Norman,L100,long,11,7,4,0,0.9009,111,"[15, 28, 30, 31, 58, 60, 62, 63, 89, 93, 94]"

Norman,L100,long,11,5,6,3,0.9009,111,"[27, 29, 30, 31, 33, 59, 61, 64, 90, 91, 92]"

Norman,L100,long,13,6,7,2,0.885,113,"[14, 26, 27, 28, 30, 31, 33, 34, 63, 64, 66, 92, 96]"

Norman,L100,long,10,7,3,6,0.9091,110,"[14, 26, 27, 28, 34, 60, 87, 88, 89, 90]"

Norman,L100,long,11,6,5,2,0.9009,111,"[27, 29, 30, 54, 56, 60, 85, 87, 88, 89, 92]"

Norman,L100,long,12,2,10,1,0.8929,112,"[15, 27, 28, 29, 31, 32, 34, 61, 63, 90, 92, 94]"

Norman,L100,long,11,2,9,2,0.9009,111,"[27, 28, 29, 53, 55, 56, 57, 58, 61, 87, 90]"

Norman,L100,long,11,0,11,0,0.9009,111,"[27, 28, 29, 57, 58, 59, 84, 86, 87, 88, 89]"

Norman,L100,long,9,2,7,2,0.9174,109,"[27, 28, 29, 53, 58, 59, 86, 89, 92]"

Norman,L100,long,11,4,7,0,0.9009,111,"[29, 54, 55, 56, 58, 59, 84, 86, 87, 88, 89]"

Norman,L100,long,10,4,6,1,0.9091,110,"[14, 27, 28, 30, 57, 58, 59, 60, 87, 91]"

Norman,L100,long,9,6,3,2,0.9174,109,"[14, 26, 27, 28, 31, 58, 59, 87, 90]"

Norman,L100,long,14,3,11,1,0.8772,114,"[27, 28, 29, 53, 55, 56, 57, 59, 60, 61, 88, 89, 90, 92]"

Norman,L100,long,11,6,5,7,0.9009,111,"[14, 26, 28, 30, 32, 35, 61, 63, 69, 94, 95]"

Norman,L100,long,11,7,4,2,0.9009,111,"[27, 28, 30, 56, 57, 58, 59, 60, 62, 88, 91]"

Norman,L100,long,10,5,5,1,0.9091,110,"[14, 26, 28, 29, 55, 57, 58, 60, 87, 89]"

Norman,L100,long,14,3,11,2,0.8772,114,"[27, 28, 29, 30, 55, 57, 59, 61, 62, 65, 92, 93, 94, 95]"

Norman,L100,long,13,7,6,0,0.885,113,"[14, 26, 28, 29, 55, 57, 58, 59, 85, 86, 87, 89, 90]"

Norman,L100,long,11,5,6,0,0.9009,111,"[15, 27, 28, 29, 55, 57, 59, 86, 88, 89, 90]"

Norman,L100,long,8,3,5,0,0.9259,108,"[14, 26, 27, 29, 55, 59, 86, 89]"

Norman,L100,long,12,1,11,0,0.8929,112,"[27, 28, 29, 53, 54, 55, 57, 58, 59, 86, 88, 89]"

Norman,L100,long,9,6,3,4,0.9174,109,"[27, 28, 31, 58, 60, 86, 87, 88, 93]"

Norman,L100,long,14,12,2,0,0.8772,114,"[14, 26, 27, 28, 29, 30, 56, 59, 60, 86, 87, 88, 89, 90]"

Norman,L100,long,14,7,7,1,0.8772,114,"[14, 27, 30, 31, 58, 59, 61, 62, 63, 89, 90, 91, 92, 94]"

Norman,L100,long,11,8,3,1,0.9009,111,"[14, 26, 27, 28, 29, 31, 58, 59, 60, 89, 93]"

Norman,L100,long,9,5,4,2,0.9174,109,"[29, 30, 55, 57, 58, 59, 62, 88, 91]"

Norman,L100,long,10,7,3,3,0.9091,110,"[14, 26, 27, 29, 30, 57, 58, 63, 89, 90]"

Norman,L100,long,11,5,6,0,0.9009,111,"[27, 29, 30, 56, 58, 59, 60, 61, 87, 90, 91]"

Norman,L100,long,10,8,2,1,0.9091,110,"[28, 30, 55, 57, 59, 61, 87, 88, 89, 90]"

Norman,L100,long,11,5,6,1,0.9009,111,"[14, 27, 28, 29, 55, 57, 58, 59, 61, 88, 90]"

Norman,L100,long,13,7,6,0,0.885,113,"[27, 29, 53, 54, 55, 57, 59, 60, 61, 88, 90, 91, 94]"

Norman,L100,long,11,8,3,3,0.9009,111,"[28, 29, 30, 54, 56, 58, 59, 60, 63, 90, 93]"

Norman,L100,long,15,9,6,0,0.8696,115,"[14, 26, 27, 28, 29, 30, 56, 58, 59, 60, 86, 87, 88, 89, 92]"

Norman,L100,long,8,2,6,7,0.9259,108,"[27, 35, 60, 62, 86, 88, 90, 92]"

Norman,L100,long,10,3,7,0,0.9091,110,"[27, 28, 29, 56, 58, 59, 84, 88, 89, 91]"

Norman,L100,long,11,8,3,0,0.9009,111,"[14, 26, 27, 29, 56, 58, 59, 86, 88, 90, 91]"

Norman,L100,long,6,3,3,8,0.9434,106,"[15, 35, 61, 87, 88, 90]"

Norman,L100,long,8,5,3,3,0.9259,108,"[15, 27, 31, 59, 84, 85, 87, 90]"

Norman,L100,long,11,3,8,2,0.9009,111,"[15, 27, 28, 29, 30, 32, 61, 87, 89, 90, 92]"

Norman,L100,long,12,9,3,3,0.8929,112,"[14, 26, 27, 28, 29, 56, 58, 59, 60, 63, 90, 92]"

Norman,L100,long,10,7,3,2,0.9091,110,"[27, 29, 53, 55, 56, 57, 58, 60, 87, 90]"

Norman,L100,long,12,1,11,2,0.8929,112,"[27, 28, 29, 53, 54, 55, 57, 61, 87, 88, 89, 92]"

Norman,L100,long,11,4,7,2,0.9009,111,"[27, 28, 29, 55, 56, 57, 58, 61, 87, 88, 89]"

Norman,L100,long,12,9,3,2,0.8929,112,"[27, 28, 31, 56, 57, 58, 59, 85, 88, 89, 90, 91]"

Norman,L100,long,9,6,3,7,0.9174,109,"[14, 26, 27, 28, 32, 63, 91, 92, 95]"

Norman,L100,long,9,4,5,0,0.9174,109,"[15, 27, 28, 29, 55, 57, 58, 59, 89]"

Norman,L100,long,11,3,8,1,0.9009,111,"[27, 28, 29, 55, 56, 57, 60, 86, 87, 88, 89]"

Norman,L100,long,10,2,8,2,0.9091,110,"[27, 28, 30, 57, 58, 62, 88, 90, 91, 92]"

Norman,L100,long,9,6,3,0,0.9174,109,"[14, 29, 57, 59, 60, 85, 86, 87, 90]"

Norman,L100,long,9,4,5,3,0.9174,109,"[27, 28, 29, 31, 55, 57, 62, 88, 90]"

Norman,L100,long,12,4,8,1,0.8929,112,"[27, 29, 31, 57, 58, 59, 60, 61, 87, 88, 90, 91]"

Norman,L100,long,11,3,8,6,0.9009,111,"[15, 28, 29, 33, 60, 85, 87, 90, 91, 92, 96]"

Norman,L100,long,10,5,5,2,0.9091,110,"[27, 28, 30, 56, 57, 58, 60, 85, 87, 89]"

Norman,L100,long,9,5,4,7,0.9174,109,"[15, 28, 29, 55, 57, 61, 86, 87, 94]"

Norman,L100,long,11,6,5,2,0.9009,111,"[14, 26, 28, 29, 31, 58, 60, 87, 88, 89, 91]"

Norman,L100,long,13,7,6,3,0.885,113,"[14, 26, 28, 29, 55, 57, 59, 86, 88, 89, 90, 91, 95]"

Norman,L100,long,10,2,8,1,0.9091,110,"[27, 28, 29, 54, 57, 59, 84, 86, 87, 90]"

Norman,L100,long,11,6,5,0,0.9009,111,"[14, 26, 27, 28, 30, 56, 60, 61, 88, 89, 91]"

Norman,L100,long,10,3,7,0,0.9091,110,"[27, 31, 58, 60, 61, 87, 88, 89, 90, 91]"

Norman,L100,long,12,7,5,2,0.8929,112,"[27, 28, 29, 55, 56, 57, 58, 59, 62, 88, 90, 92]"

Norman,L100,long,11,7,4,0,0.9009,111,"[28, 29, 30, 54, 57, 59, 60, 86, 89, 90, 91]"

Norman,L100,long,12,8,4,2,0.8929,112,"[27, 29, 31, 32, 34, 61, 62, 63, 64, 67, 93, 96]"

Norman,L100,long,14,1,13,1,0.8772,114,"[27, 28, 29, 53, 55, 56, 57, 58, 60, 87, 88, 90, 91, 92]"

Norman,L100,long,10,3,7,1,0.9091,110,"[14, 27, 30, 57, 58, 60, 61, 87, 88, 92]"

Norman,L100,long,10,6,4,3,0.9091,110,"[15, 28, 30, 33, 60, 61, 62, 88, 91, 94]"

Norman,L100,long,12,4,8,0,0.8929,112,"[27, 28, 29, 53, 56, 57, 58, 60, 86, 87, 89, 90]"

Norman,L100,long,13,7,6,0,0.885,113,"[14, 26, 29, 55, 56, 58, 60, 62, 63, 89, 90, 91, 94]"

Norman,L100,long,12,2,10,0,0.8929,112,"[27, 28, 29, 53, 55, 57, 59, 85, 86, 87, 88, 89]"

Norman,L100,long,10,7,3,1,0.9091,110,"[14, 26, 27, 28, 30, 57, 59, 86, 88, 89]"

Norman,L100,long,9,5,4,1,0.9174,109,"[27, 28, 30, 55, 57, 58, 59, 85, 90]"

Norman,L100,long,11,3,8,1,0.9009,111,"[27, 28, 29, 53, 55, 56, 58, 62, 87, 90, 91]"

Norman,L100,long,9,4,5,1,0.9174,109,"[14, 28, 30, 56, 58, 60, 87, 88, 90]"

Norman,L100,long,9,5,4,1,0.9174,109,"[27, 28, 29, 54, 60, 86, 87, 88, 89]"

Norman,L100,long,9,5,4,2,0.9174,109,"[27, 28, 30, 55, 56, 59, 62, 88, 90]"

Norman,L100,long,13,11,2,5,0.885,113,"[27, 29, 31, 32, 57, 58, 59, 60, 62, 89, 90, 91, 97]"

Norman,L100,long,10,4,6,3,0.9091,110,"[14, 26, 27, 30, 58, 59, 60, 87, 89, 92]"

Norman,L100,long,14,6,8,1,0.8772,114,"[27, 28, 29, 31, 55, 57, 58, 59, 60, 61, 88, 89, 90, 91]"

Norman,L100,long,12,6,6,0,0.8929,112,"[27, 29, 30, 54, 56, 58, 60, 62, 63, 90, 91, 94]"

Norman,L100,long,14,11,3,0,0.8772,114,"[15, 28, 29, 55, 56, 57, 58, 59, 60, 86, 87, 88, 89, 90]"

Norman,L100,long,6,2,4,4,0.9434,106,"[27, 28, 32, 58, 60, 90]"

Norman,L100,long,11,7,4,5,0.9009,111,"[16, 27, 28, 30, 57, 58, 59, 61, 88, 90, 95]"

Norman,L100,long,8,1,7,2,0.9259,108,"[30, 55, 56, 58, 60, 87, 89, 90]"

Norman,L100,long,7,1,6,2,0.9346,107,"[18, 31, 56, 58, 59, 86, 89]"

Norman,L100,long,11,1,10,0,0.9009,111,"[27, 28, 29, 53, 54, 55, 57, 58, 59, 86, 89]"

Norman,L100,long,9,2,7,2,0.9174,109,"[31, 56, 59, 84, 86, 87, 88, 89, 90]"

Norman,L100,long,13,5,8,2,0.885,113,"[14, 27, 29, 31, 33, 59, 61, 62, 64, 90, 91, 93, 95]"

Norman,L100,long,11,3,8,2,0.9009,111,"[27, 28, 30, 54, 56, 57, 60, 85, 87, 88, 89]"

Norman,L100,long,10,4,6,1,0.9091,110,"[14, 27, 28, 29, 55, 58, 60, 87, 88, 89]"

Norman,L100,long,10,3,7,3,0.9091,110,"[27, 30, 56, 57, 58, 59, 62, 88, 90, 92]"

Norman,L100,long,14,4,10,1,0.8772,114,"[27, 28, 29, 53, 54, 56, 57, 58, 59, 86, 87, 88, 89, 91]"

Norman,L100,long,10,6,4,1,0.9091,110,"[27, 29, 53, 54, 56, 57, 59, 60, 88, 91]"

Norman,L100,long,8,3,5,1,0.9259,108,"[30, 56, 58, 59, 84, 87, 88, 89]"

Norman,L100,long,10,6,4,1,0.9091,110,"[16, 27, 29, 55, 56, 58, 59, 60, 62, 91]"

Norman,L100,long,13,7,6,0,0.885,113,"[14, 26, 27, 28, 29, 30, 56, 58, 59, 60, 62, 89, 92]"

Norman,L100,long,12,6,6,0,0.8929,112,"[15, 28, 29, 55, 57, 58, 59, 86, 88, 90, 92, 93]"

Norman,L100,long,10,3,7,0,0.9091,110,"[28, 29, 53, 54, 58, 59, 85, 88, 90, 91]"

Norman,L100,long,10,4,6,4,0.9091,110,"[16, 27, 29, 31, 33, 60, 61, 64, 91, 95]"

Norman,L100,long,11,4,7,2,0.9009,111,"[27, 29, 53, 55, 58, 60, 61, 86, 89, 90, 93]"

Norman,L100,long,11,6,5,4,0.9009,111,"[27, 29, 31, 56, 58, 59, 60, 61, 88, 89, 94]"

Norman,L100,long,11,10,1,5,0.9009,111,"[14, 26, 30, 56, 57, 58, 59, 60, 88, 89, 94]"

Norman,L100,long,8,6,2,4,0.9259,108,"[29, 54, 55, 58, 60, 86, 88, 92]"

Norman,L100,long,11,5,6,6,0.9009,111,"[14, 26, 28, 29, 55, 57, 58, 65, 91, 93, 94]"

Norman,L100,long,10,5,5,2,0.9091,110,"[16, 27, 28, 29, 56, 57, 59, 86, 88, 91]"

Norman,L100,long,11,7,4,1,0.9009,111,"[14, 26, 27, 28, 30, 56, 58, 59, 85, 86, 89]"

Norman,L100,long,14,2,12,0,0.8772,114,"[27, 28, 29, 54, 55, 57, 59, 85, 86, 87, 88, 89, 90, 91]"

Norman,L100,long,12,3,9,1,0.8929,112,"[27, 28, 29, 30, 31, 55, 57, 58, 60, 61, 89, 92]"

Norman,L100,long,11,8,3,1,0.9009,111,"[14, 26, 27, 30, 57, 58, 59, 86, 88, 89, 90]"

Norman,L100,long,10,1,9,2,0.9091,110,"[27, 30, 56, 61, 63, 88, 89, 90, 91, 92]"

Norman,L100,long,9,2,7,3,0.9174,109,"[27, 28, 30, 54, 57, 59, 61, 86, 91]"

Norman,L100,long,12,9,3,2,0.8929,112,"[28, 29, 30, 54, 56, 57, 59, 60, 62, 88, 90, 92]"

Norman,L100,long,10,5,5,1,0.9091,110,"[14, 26, 28, 29, 55, 57, 58, 60, 87, 89]"

Norman,L100,long,11,3,8,2,0.9009,111,"[27, 28, 30, 33, 59, 60, 61, 86, 89, 90, 92]"

Norman,L100,long,12,7,5,1,0.8929,112,"[14, 26, 28, 29, 30, 56, 59, 63, 89, 90, 91, 92]"

Norman,L100,long,11,6,5,4,0.9009,111,"[15, 28, 29, 30, 57, 58, 59, 60, 61, 88, 95]"

Norman,L100,long,12,6,6,2,0.8929,112,"[16, 27, 28, 31, 58, 59, 60, 61, 88, 89, 90, 91]"

Norman,L100,long,12,2,10,0,0.8929,112,"[27, 29, 53, 54, 55, 56, 57, 59, 86, 87, 88, 89]"

Norman,L100,long,13,7,6,2,0.885,113,"[14, 28, 29, 55, 56, 57, 58, 59, 85, 88, 89, 90, 93]"

Norman,L100,long,10,4,6,3,0.9091,110,"[27, 29, 30, 31, 55, 57, 61, 65, 90, 92]"

Norman,L100,long,16,9,7,1,0.8621,116,"[14, 27, 29, 56, 58, 59, 60, 61, 88, 89, 90, 91, 92, 93, 94, 96]"

Norman,L100,long,11,1,10,0,0.9009,111,"[27, 28, 29, 56, 58, 59, 85, 86, 87, 88, 89]"

Norman,L100,long,10,7,3,1,0.9091,110,"[14, 26, 27, 30, 57, 58, 59, 86, 88, 89]"

Norman,L100,long,11,7,4,0,0.9009,111,"[28, 29, 54, 55, 56, 57, 59, 85, 86, 88, 89]"

Norman,L100,long,10,4,6,3,0.9091,110,"[27, 28, 31, 56, 58, 60, 85, 87, 88, 91]"

Norman,L100,long,10,6,4,3,0.9091,110,"[14, 28, 29, 55, 56, 57, 58, 60, 88, 92]"

Norman,L100,long,8,1,7,4,0.9259,108,"[27, 31, 56, 58, 59, 62, 88, 90]"

Norman,L100,long,12,4,8,0,0.8929,112,"[27, 29, 30, 54, 56, 59, 60, 61, 62, 88, 91, 93]"

Norman,L100,long,10,3,7,0,0.9091,110,"[29, 31, 56, 59, 61, 87, 88, 90, 91, 92]"

Norman,L100,long,10,5,5,3,0.9091,110,"[15, 27, 28, 29, 55, 57, 59, 63, 89, 90]"

Norman,L100,long,8,2,6,2,0.9259,108,"[27, 30, 57, 58, 61, 88, 89, 90]"

Norman,L100,long,10,7,3,2,0.9091,110,"[14, 26, 27, 28, 31, 58, 59, 86, 88, 89]"

Norman,L100,long,11,7,4,1,0.9009,111,"[27, 29, 30, 55, 56, 58, 60, 85, 87, 89, 91]"

Norman,L100,long,10,7,3,2,0.9091,110,"[14, 26, 27, 28, 29, 56, 61, 87, 88, 89]"

Norman,L100,long,9,3,6,1,0.9174,109,"[15, 27, 28, 29, 57, 59, 86, 87, 90]"

Norman,L100,long,11,6,5,1,0.9009,111,"[14, 26, 28, 29, 55, 57, 58, 60, 87, 89, 90]"

Norman,L100,long,10,6,4,2,0.9091,110,"[28, 29, 54, 55, 58, 59, 85, 87, 88, 91]"

Norman,L100,long,8,1,7,1,0.9259,108,"[14, 27, 28, 29, 55, 57, 60, 89]"

Norman,L100,long,9,4,5,2,0.9174,109,"[27, 28, 30, 57, 58, 60, 86, 87, 89]"

Norman,L100,long,9,3,6,1,0.9174,109,"[30, 56, 58, 59, 84, 87, 88, 89, 90]"

Norman,L100,long,10,2,8,3,0.9091,110,"[28, 32, 57, 58, 59, 60, 61, 86, 89, 92]"

Norman,L100,long,14,10,4,1,0.8772,114,"[14, 26, 27, 28, 30, 56, 58, 59, 85, 86, 87, 88, 89, 91]"

Norman,L100,long,11,6,5,1,0.9009,111,"[29, 54, 55, 56, 57, 58, 60, 85, 87, 88, 89]"

Norman,L100,long,9,3,6,2,0.9174,109,"[16, 27, 28, 32, 58, 60, 87, 89, 90]"

Norman,L100,long,12,9,3,1,0.8929,112,"[27, 28, 30, 54, 56, 57, 58, 59, 60, 89, 90, 92]"

Norman,L100,long,8,1,7,0,0.9259,108,"[16, 27, 28, 29, 55, 59, 88, 89]"

Norman,L100,long,12,3,9,2,0.8929,112,"[27, 28, 29, 53, 54, 55, 56, 59, 60, 88, 89, 92]"

Norman,L100,long,12,6,6,0,0.8929,112,"[14, 26, 27, 29, 55, 59, 60, 61, 88, 89, 90, 91]"

Norman,L100,long,13,5,8,3,0.885,113,"[14, 26, 27, 28, 29, 56, 57, 58, 59, 87, 88, 89, 93]"

Norman,L100,long,9,2,7,1,0.9174,109,"[14, 27, 28, 31, 58, 59, 62, 89, 91]"

Norman,L100,long,13,0,13,0,0.885,113,"[27, 28, 29, 30, 55, 56, 57, 58, 59, 60, 88, 89, 90]"

Norman,L100,long,13,8,5,1,0.885,113,"[14, 26, 27, 28, 29, 55, 59, 60, 61, 62, 64, 93, 94]"

Norman,L100,long,12,7,5,0,0.8929,112,"[14, 27, 28, 31, 59, 61, 62, 88, 89, 91, 94, 95]"

Norman,L100,long,10,4,6,4,0.9091,110,"[14, 27, 28, 31, 58, 61, 87, 88, 90, 92]"

Norman,L100,long,10,2,8,8,0.9091,110,"[27, 28, 33, 58, 60, 62, 88, 89, 90, 96]"

Norman,L100,long,10,4,6,1,0.9091,110,"[15, 27, 28, 29, 55, 57, 58, 60, 87, 89]"

Norman,L100,long,10,2,8,1,0.9091,110,"[27, 28, 29, 54, 55, 56, 57, 59, 88, 91]"

Norman,L100,long,12,9,3,0,0.8929,112,"[14, 27, 29, 55, 56, 57, 58, 59, 60, 86, 90, 91]"

Norman,L100,long,11,7,4,0,0.9009,111,"[14, 26, 29, 30, 57, 58, 59, 60, 87, 89, 90]"

Norman,L100,long,11,3,8,5,0.9009,111,"[15, 27, 28, 29, 30, 56, 58, 59, 61, 88, 96]"

Norman,L100,long,14,11,3,2,0.8772,114,"[27, 29, 30, 31, 32, 58, 59, 60, 61, 62, 63, 66, 93, 95]"

Norman,L100,long,11,7,4,0,0.9009,111,"[28, 29, 31, 56, 57, 58, 62, 89, 90, 91, 92]"

Norman,L100,long,6,4,2,0,0.9434,106,"[29, 54, 56, 59, 86, 89]"

Norman,L100,long,13,2,11,0,0.885,113,"[27, 28, 29, 30, 54, 56, 57, 59, 60, 87, 88, 89, 90]"

Norman,L100,long,10,5,5,0,0.9091,110,"[14, 27, 28, 30, 57, 58, 59, 60, 87, 90]"

Norman,L100,long,14,1,13,0,0.8772,114,"[27, 28, 29, 30, 31, 55, 57, 58, 59, 60, 61, 88, 90, 91]"

Norman,L100,long,11,6,5,0,0.9009,111,"[27, 28, 30, 31, 55, 57, 59, 60, 62, 89, 92]"

Norman,L100,long,10,4,6,1,0.9091,110,"[14, 27, 28, 29, 55, 58, 59, 87, 88, 91]"

Norman,L100,long,13,7,6,0,0.885,113,"[14, 27, 29, 30, 57, 59, 60, 87, 88, 89, 90, 91, 92]"

Norman,L100,long,10,3,7,2,0.9091,110,"[16, 28, 29, 55, 58, 60, 88, 89, 90, 93]"

Norman,L100,long,10,4,6,0,0.9091,110,"[27, 28, 29, 56, 57, 59, 61, 87, 89, 91]"

Norman,L100,long,13,1,12,0,0.885,113,"[27, 28, 29, 53, 55, 56, 57, 58, 59, 60, 87, 89, 91]"

Norman,L100,long,9,3,6,4,0.9174,109,"[15, 27, 29, 31, 58, 59, 63, 90, 92]"

Norman,L100,long,9,6,3,8,0.9174,109,"[14, 28, 29, 55, 56, 57, 58, 64, 92]"

Norman,L100,long,12,8,4,1,0.8929,112,"[14, 26, 27, 28, 29, 55, 60, 62, 88, 90, 91, 92]"

Norman,L100,long,10,6,4,1,0.9091,110,"[28, 29, 53, 54, 55, 57, 58, 60, 63, 94]"

Norman,L100,long,14,9,5,1,0.8772,114,"[28, 29, 53, 54, 55, 57, 59, 60, 61, 62, 63, 65, 91, 94]"

Norman,L100,long,8,3,5,4,0.9259,108,"[17, 31, 56, 58, 60, 63, 89, 91]"

Norman,L100,long,12,1,11,1,0.8929,112,"[27, 28, 29, 53, 54, 55, 56, 57, 58, 60, 87, 89]"

Norman,L100,long,9,5,4,0,0.9174,109,"[14, 26, 27, 29, 58, 59, 87, 88, 89]"

Norman,L100,long,12,4,8,1,0.8929,112,"[27, 28, 29, 31, 55, 59, 60, 61, 88, 89, 91, 93]"

Norman,L100,long,12,4,8,2,0.8929,112,"[27, 28, 29, 53, 56, 58, 59, 61, 87, 88, 89, 91]"

Norman,L100,long,11,2,9,1,0.9009,111,"[27, 28, 29, 31, 33, 59, 61, 62, 87, 92, 93]"

Norman,L100,long,11,8,3,1,0.9009,111,"[14, 26, 27, 28, 29, 55, 59, 60, 88, 90, 92]"

Norman,L100,long,12,8,4,2,0.8929,112,"[14, 26, 27, 28, 29, 31, 33, 60, 61, 63, 90, 92]"

Norman,L100,long,11,4,7,2,0.9009,111,"[27, 31, 56, 57, 59, 84, 85, 87, 88, 89, 91]"

Norman,L100,long,7,5,2,5,0.9346,107,"[27, 33, 58, 59, 61, 65, 92]"

Norman,L100,long,7,5,2,5,0.9346,107,"[27, 29, 30, 36, 61, 88, 91]"

Norman,L100,long,10,4,6,2,0.9091,110,"[14, 27, 28, 30, 58, 59, 86, 87, 88, 90]"

Norman,L100,long,12,5,7,0,0.8929,112,"[14, 26, 30, 57, 58, 59, 60, 61, 62, 89, 91, 92]"

Norman,L100,long,9,5,4,1,0.9174,109,"[14, 26, 28, 30, 57, 58, 59, 86, 89]"

Norman,L100,long,13,8,5,0,0.885,113,"[14, 26, 28, 29, 55, 57, 58, 59, 85, 86, 87, 88, 90]"

Norman,L100,long,9,5,4,1,0.9174,109,"[14, 26, 27, 29, 55, 57, 60, 88, 89]"

Norman,L100,long,12,3,9,0,0.8929,112,"[14, 28, 29, 31, 32, 59, 60, 61, 62, 63, 90, 94]"

Norman,L100,long,8,3,5,1,0.9259,108,"[29, 55, 56, 57, 60, 86, 89, 90]"

Norman,L100,long,10,7,3,1,0.9091,110,"[15, 28, 30, 56, 57, 58, 59, 86, 88, 90]"

Norman,L100,long,7,2,5,4,0.9346,107,"[27, 28, 33, 59, 84, 88, 89]"

Norman,L100,long,12,9,3,1,0.8929,112,"[14, 26, 27, 28, 29, 30, 56, 61, 88, 89, 90, 91]"

Norman,L100,long,12,5,7,0,0.8929,112,"[14, 26, 27, 28, 29, 30, 56, 58, 59, 60, 89, 90]"

Norman,L100,long,8,6,2,5,0.9259,108,"[28, 29, 34, 62, 86, 89, 90, 92]"

Norman,L100,long,13,10,3,3,0.885,113,"[14, 26, 29, 31, 60, 61, 86, 87, 88, 89, 90, 91, 94]"

Norman,L100,long,9,3,6,0,0.9174,109,"[27, 29, 54, 56, 58, 59, 60, 86, 90]"

Norman,L100,long,11,7,4,0,0.9009,111,"[27, 29, 30, 54, 57, 58, 60, 85, 89, 90, 91]"

Norman,L100,long,13,2,11,0,0.885,113,"[27, 28, 29, 30, 54, 56, 57, 59, 60, 87, 88, 89, 90]"

Norman,L100,long,9,3,6,5,0.9174,109,"[27, 30, 56, 58, 59, 61, 88, 89, 93]"

Norman,L100,long,12,5,7,3,0.8929,112,"[27, 29, 53, 54, 56, 57, 59, 61, 87, 88, 90, 93]"

Norman,L100,long,9,6,3,2,0.9174,109,"[14, 26, 27, 28, 31, 58, 59, 86, 89]"

Norman,L100,long,10,5,5,3,0.9091,110,"[14, 26, 28, 29, 57, 58, 59, 86, 88, 92]"

Norman,L100,long,9,5,4,4,0.9174,109,"[16, 28, 32, 60, 85, 86, 87, 89, 90]"

Norman,L100,long,10,5,5,1,0.9091,110,"[14, 27, 28, 30, 57, 58, 59, 86, 88, 89]"

Norman,L100,long,11,2,9,2,0.9009,111,"[27, 30, 56, 57, 58, 60, 61, 88, 90, 91, 93]"

Norman,L100,long,13,10,3,2,0.885,113,"[28, 30, 55, 56, 57, 58, 59, 60, 61, 87, 89, 90, 92]"

Norman,L100,long,8,3,5,5,0.9259,108,"[15, 28, 32, 58, 63, 89, 90, 91]"

Norman,L100,long,11,8,3,1,0.9009,111,"[28, 29, 30, 31, 55, 57, 58, 60, 62, 88, 91]"

Norman,L100,long,9,3,6,0,0.9174,109,"[29, 55, 56, 57, 59, 86, 87, 89, 90]"

Norman,L100,long,10,3,7,4,0.9091,110,"[27, 31, 57, 58, 59, 60, 86, 88, 89, 92]"

Norman,L100,long,12,10,2,0,0.8929,112,"[28, 29, 30, 54, 57, 58, 59, 60, 61, 87, 90, 91]"

Norman,L100,long,8,6,2,7,0.9259,108,"[14, 26, 31, 63, 89, 90, 91, 94]"

Norman,L100,long,14,7,7,1,0.8772,114,"[15, 28, 29, 31, 59, 60, 61, 63, 89, 90, 91, 92, 93, 95]"

Norman,L100,long,12,2,10,0,0.8929,112,"[27, 28, 29, 53, 55, 56, 58, 59, 86, 87, 88, 89]"

Norman,L100,long,15,8,7,2,0.8696,115,"[14, 26, 27, 28, 29, 30, 56, 58, 59, 60, 61, 88, 89, 90, 93]"

Norman,L100,long,9,5,4,2,0.9174,109,"[27, 28, 30, 56, 57, 59, 62, 88, 90]"

Norman,L100,long,11,5,6,0,0.9009,111,"[14, 27, 28, 29, 55, 57, 58, 60, 87, 89, 90]"

Norman,L100,long,15,1,14,0,0.8696,115,"[16, 27, 28, 30, 31, 32, 33, 34, 35, 64, 65, 66, 94, 96, 97]"

Norman,L100,long,11,5,6,0,0.9009,111,"[27, 29, 53, 54, 55, 57, 59, 60, 87, 88, 90]"

Norman,L100,long,9,4,5,3,0.9174,109,"[27, 28, 31, 56, 57, 58, 60, 85, 90]"

Norman,L100,long,13,6,7,0,0.885,113,"[15, 28, 29, 30, 57, 58, 60, 61, 62, 89, 90, 91, 92]"

Norman,L100,long,10,3,7,1,0.9091,110,"[27, 28, 29, 53, 54, 55, 60, 87, 88, 89]"

Norman,L100,long,11,9,2,1,0.9009,111,"[14, 26, 27, 28, 29, 30, 32, 60, 61, 90, 91]"

Norman,L100,long,7,2,5,4,0.9346,107,"[14, 26, 29, 30, 59, 64, 90]"

Norman,L100,long,14,12,2,1,0.8772,114,"[14, 26, 27, 28, 29, 31, 58, 59, 60, 86, 87, 88, 89, 90]"

Norman,L100,long,12,2,10,0,0.8929,112,"[27, 29, 53, 54, 55, 56, 57, 58, 60, 87, 88, 90]"

Norman,L100,long,9,2,7,2,0.9174,109,"[14, 28, 29, 31, 59, 60, 86, 89, 91]"

Norman,L100,long,12,9,3,2,0.8929,112,"[14, 26, 27, 28, 29, 32, 59, 60, 87, 89, 90, 92]"

Norman,L100,long,11,7,4,0,0.9009,111,"[15, 28, 29, 30, 57, 58, 59, 60, 88, 89, 91]"

Norman,L100,long,11,6,5,0,0.9009,111,"[14, 26, 27, 28, 29, 56, 57, 59, 86, 88, 90]"

Norman,L100,long,13,0,13,6,0.885,113,"[27, 28, 29, 53, 54, 55, 56, 57, 58, 59, 64, 90, 94]"

Norman,L100,long,11,8,3,0,0.9009,111,"[28, 29, 30, 55, 56, 58, 59, 61, 62, 89, 92]"

Norman,L100,long,10,8,2,2,0.9091,110,"[28, 29, 30, 55, 56, 57, 58, 62, 87, 90]"

Norman,L100,long,12,5,7,1,0.8929,112,"[15, 27, 29, 30, 31, 58, 59, 60, 62, 89, 90, 93]"

Norman,L100,long,14,9,5,0,0.8772,114,"[14, 26, 27, 28, 29, 30, 56, 58, 59, 60, 86, 87, 88, 90]"

Norman,L100,long,10,8,2,1,0.9091,110,"[29, 54, 55, 56, 57, 58, 59, 85, 87, 90]"

Norman,L100,long,10,3,7,1,0.9091,110,"[15, 27, 28, 29, 55, 58, 60, 87, 88, 91]"

Norman,L100,long,12,8,4,0,0.8929,112,"[14, 26, 27, 28, 29, 55, 57, 59, 85, 86, 87, 89]"

Norman,L100,long,8,5,3,2,0.9259,108,"[14, 26, 27, 30, 57, 59, 62, 92]"

Norman,L100,long,13,7,6,1,0.885,113,"[14, 26, 27, 28, 29, 55, 57, 58, 59, 85, 87, 88, 90]"

Norman,L100,long,9,2,7,0,0.9174,109,"[27, 28, 29, 58, 59, 84, 85, 87, 89]"

Norman,L100,long,8,1,7,6,0.9259,108,"[31, 56, 57, 58, 62, 88, 89, 91]"

Norman,L100,long,9,4,5,2,0.9174,109,"[27, 29, 54, 56, 58, 60, 85, 87, 90]"

Norman,L100,long,10,8,2,1,0.9091,110,"[14, 26, 27, 28, 29, 57, 58, 61, 89, 90]"

Norman,L100,long,14,4,10,1,0.8772,114,"[14, 27, 28, 29, 30, 31, 59, 61, 63, 64, 90, 91, 93, 95]"

Norman,L100,long,10,6,4,1,0.9091,110,"[29, 54, 55, 57, 59, 62, 64, 90, 92, 93]"

Norman,L100,long,10,4,6,1,0.9091,110,"[14, 26, 28, 30, 59, 60, 87, 88, 89, 91]"

Norman,L100,long,13,8,5,1,0.885,113,"[14, 26, 27, 28, 29, 55, 57, 58, 60, 86, 87, 88, 90]"

Norman,L100,long,12,11,1,2,0.8929,112,"[27, 29, 30, 31, 32, 33, 34, 36, 64, 65, 94, 96]"

Norman,L100,long,9,5,4,4,0.9174,109,"[28, 29, 32, 57, 59, 61, 87, 88, 91]"

Norman,L100,long,16,8,8,3,0.8621,116,"[14, 26, 27, 30, 57, 58, 60, 61, 62, 63, 65, 92, 93, 94, 95, 97]"

Norman,L100,long,13,5,8,1,0.885,113,"[27, 28, 29, 53, 55, 57, 58, 60, 86, 87, 89, 91, 92]"

Norman,L100,long,13,7,6,1,0.885,113,"[27, 28, 30, 54, 56, 57, 58, 59, 60, 61, 88, 89, 91]"

Norman,L100,long,12,8,4,1,0.8929,112,"[14, 26, 27, 28, 30, 56, 58, 59, 85, 86, 87, 89]"

Norman,L100,long,12,1,11,0,0.8929,112,"[27, 28, 29, 54, 55, 56, 57, 60, 86, 87, 88, 90]"

Norman,L100,long,12,8,4,3,0.8929,112,"[14, 26, 27, 28, 30, 31, 35, 62, 88, 89, 91, 92]"

Norman,L100,long,9,6,3,4,0.9174,109,"[17, 28, 31, 57, 60, 86, 87, 88, 90]"

Norman,L100,long,12,5,7,2,0.8929,112,"[18, 31, 56, 58, 59, 60, 61, 87, 88, 89, 90, 91]"

Norman,L100,long,8,5,3,5,0.9259,108,"[14, 26, 27, 32, 59, 62, 89, 91]"

Norman,L100,long,9,6,3,2,0.9174,109,"[14, 26, 29, 55, 57, 58, 59, 87, 91]"

Norman,L100,long,11,1,10,3,0.9009,111,"[27, 28, 29, 54, 55, 56, 57, 58, 59, 86, 92]"

Norman,L100,long,11,5,6,1,0.9009,111,"[14, 26, 30, 31, 33, 59, 61, 62, 89, 91, 92]"

Norman,L100,long,10,6,4,2,0.9091,110,"[16, 27, 28, 30, 57, 58, 60, 87, 88, 89]"

Norman,L100,long,12,6,6,1,0.8929,112,"[14, 26, 27, 28, 29, 55, 57, 58, 59, 61, 87, 90]"

Norman,L100,long,10,4,6,1,0.9091,110,"[28, 32, 59, 61, 62, 63, 89, 90, 92, 93]"

Norman,L100,long,10,5,5,1,0.9091,110,"[27, 28, 30, 54, 56, 59, 60, 87, 88, 90]"

Norman,L100,long,10,3,7,3,0.9091,110,"[27, 28, 29, 32, 59, 60, 85, 87, 88, 91]"

Norman,L100,long,9,3,6,1,0.9174,109,"[15, 27, 28, 30, 57, 58, 60, 88, 90]"

Norman,L100,long,10,3,7,2,0.9091,110,"[28, 30, 56, 57, 59, 84, 85, 86, 87, 90]"

Norman,L100,long,9,6,3,0,0.9174,109,"[14, 26, 29, 55, 57, 58, 59, 86, 89]"

Norman,L100,long,10,4,6,3,0.9091,110,"[27, 29, 30, 31, 55, 59, 60, 64, 90, 91]"

Norman,L100,long,15,9,6,0,0.8696,115,"[15, 27, 28, 29, 56, 57, 58, 59, 60, 86, 87, 88, 89, 91, 92]"

Norman,L100,long,10,7,3,3,0.9091,110,"[14, 26, 27, 29, 56, 57, 59, 61, 88, 94]"

Norman,L100,long,10,6,4,3,0.9091,110,"[14, 26, 27, 28, 29, 55, 57, 60, 88, 91]"

Norman,L100,long,12,9,3,0,0.8929,112,"[28, 29, 30, 56, 58, 59, 60, 87, 88, 89, 91, 92]"

Norman,L100,long,10,4,6,2,0.9091,110,"[14, 27, 28, 29, 55, 58, 60, 87, 88, 90]"

Norman,L100,long,12,6,6,0,0.8929,112,"[27, 29, 30, 55, 57, 58, 60, 85, 87, 88, 89, 91]"

Norman,L100,long,9,3,6,2,0.9174,109,"[30, 55, 57, 58, 60, 86, 87, 89, 90]"

Norman,L100,long,8,5,3,1,0.9259,108,"[27, 30, 58, 59, 85, 86, 88, 89]"

Norman,L100,long,10,3,7,4,0.9091,110,"[14, 27, 28, 29, 32, 59, 61, 88, 89, 92]"

Norman,L100,long,14,11,3,1,0.8772,114,"[14, 26, 27, 28, 30, 56, 58, 59, 61, 62, 63, 91, 92, 94]"

Norman,L100,long,11,9,2,0,0.9009,111,"[28, 29, 53, 55, 56, 57, 58, 59, 86, 89, 90]"

Norman,L100,long,11,6,5,1,0.9009,111,"[27, 28, 30, 54, 56, 57, 58, 59, 87, 88, 90]"

Norman,L100,long,9,4,5,0,0.9174,109,"[14, 27, 28, 29, 56, 58, 59, 86, 89]"

Norman,L100,long,9,6,3,1,0.9174,109,"[14, 26, 29, 55, 56, 58, 59, 87, 91]"

Norman,L100,long,10,8,2,0,0.9091,110,"[14, 26, 27, 28, 29, 55, 59, 60, 88, 90]"

Norman,L100,long,9,5,4,1,0.9174,109,"[27, 28, 30, 54, 56, 60, 63, 91, 92]"

Norman,L100,long,9,3,6,1,0.9174,109,"[14, 31, 56, 58, 59, 60, 86, 88, 92]"

Norman,L100,long,9,7,2,0,0.9174,109,"[14, 26, 27, 28, 29, 56, 59, 88, 89]"

Norman,L100,long,8,7,1,4,0.9259,108,"[28, 29, 55, 56, 57, 58, 62, 90]"

Norman,L100,long,12,5,7,1,0.8929,112,"[28, 29, 53, 54, 55, 57, 58, 59, 86, 87, 88, 90]"

Norman,L100,long,9,2,7,1,0.9174,109,"[27, 30, 55, 57, 58, 60, 85, 89, 90]"

Norman,L100,long,12,8,4,2,0.8929,112,"[14, 26, 27, 30, 57, 58, 59, 86, 88, 89, 90, 93]"

Norman,L100,long,11,7,4,3,0.9009,111,"[14, 26, 28, 30, 57, 58, 60, 87, 88, 89, 91]"

Norman,L100,long,11,6,5,0,0.9009,111,"[14, 28, 30, 58, 59, 60, 86, 87, 88, 89, 90]"

Norman,L100,long,13,5,8,1,0.885,113,"[27, 28, 29, 30, 54, 56, 57, 59, 60, 61, 62, 89, 93]"

Norman,L100,long,9,4,5,0,0.9174,109,"[16, 27, 28, 29, 55, 61, 62, 89, 92]"

Norman,L100,long,10,5,5,4,0.9091,110,"[14, 26, 27, 30, 58, 60, 86, 87, 88, 91]"

Norman,L100,long,7,2,5,2,0.9346,107,"[14, 30, 56, 57, 58, 59, 90]"

Norman,L100,long,9,4,5,4,0.9174,109,"[27, 29, 53, 54, 55, 57, 62, 88, 90]"

Norman,L100,long,11,6,5,0,0.9009,111,"[14, 26, 27, 29, 55, 59, 60, 87, 88, 89, 90]"

Norman,L100,long,8,3,5,1,0.9259,108,"[14, 27, 30, 57, 59, 86, 87, 89]"

Norman,L100,long,11,5,6,4,0.9009,111,"[27, 28, 29, 55, 56, 57, 58, 59, 86, 88, 93]"

Norman,L100,long,11,7,4,1,0.9009,111,"[14, 26, 27, 28, 30, 56, 58, 60, 87, 89, 90]"

Norman,L100,long,10,10,0,0,0.9091,110,"[28, 29, 54, 56, 57, 58, 59, 87, 88, 89]"

Norman,L100,long,13,6,7,4,0.885,113,"[14, 26, 28, 29, 30, 32, 59, 60, 62, 89, 90, 91, 94]"

Norman,L100,long,9,3,6,5,0.9174,109,"[27, 28, 30, 54, 59, 61, 65, 90, 93]"

Norman,L100,long,9,4,5,3,0.9174,109,"[27, 31, 57, 59, 85, 86, 87, 89, 91]"

Norman,L100,long,10,3,7,1,0.9091,110,"[30, 55, 56, 58, 59, 84, 85, 87, 88, 89]"

Norman,L100,long,10,4,6,2,0.9091,110,"[15, 27, 28, 32, 58, 61, 87, 88, 90, 91]"

Norman,L100,long,9,4,5,5,0.9174,109,"[27, 29, 53, 54, 56, 59, 63, 89, 92]"

Norman,L100,long,10,6,4,3,0.9091,110,"[27, 28, 30, 55, 56, 57, 59, 86, 88, 91]"

Norman,L100,long,9,4,5,1,0.9174,109,"[14, 26, 28, 30, 57, 59, 87, 88, 91]"

Norman,L100,long,9,2,7,3,0.9174,109,"[14, 27, 28, 29, 33, 60, 87, 90, 91]"

Norman,L100,long,11,8,3,3,0.9009,111,"[17, 28, 31, 57, 59, 61, 86, 87, 88, 89, 90]"

Norman,L100,long,13,4,9,0,0.885,113,"[27, 28, 29, 30, 54, 56, 57, 58, 59, 61, 90, 91, 92]"

Norman,L100,long,12,7,5,2,0.8929,112,"[27, 28, 31, 56, 57, 60, 61, 62, 88, 90, 91, 92]"

Norman,L100,long,7,2,5,2,0.9346,107,"[14, 30, 56, 57, 60, 87, 89]"

Norman,L100,long,10,6,4,1,0.9091,110,"[27, 29, 54, 55, 58, 59, 85, 87, 88, 90]"

Norman,L100,long,13,5,8,0,0.885,113,"[15, 27, 28, 29, 55, 57, 58, 59, 85, 86, 88, 89, 90]"

Norman,L100,long,11,3,8,3,0.9009,111,"[27, 28, 29, 33, 58, 59, 60, 86, 88, 89, 90]"

Norman,L100,long,9,9,0,0,0.9174,109,"[29, 57, 58, 59, 85, 86, 87, 88, 89]"

Norman,L100,long,10,4,6,0,0.9091,110,"[28, 29, 30, 32, 58, 59, 60, 62, 90, 92]"

Norman,L100,long,11,5,6,0,0.9009,111,"[15, 27, 28, 29, 55, 57, 58, 59, 60, 88, 90]"

Norman,L100,long,8,5,3,2,0.9259,108,"[17, 32, 57, 60, 85, 86, 89, 91]"

Norman,L100,long,10,6,4,1,0.9091,110,"[14, 26, 27, 28, 29, 56, 57, 60, 87, 90]"

Norman,L100,long,11,4,7,2,0.9009,111,"[27, 28, 29, 53, 54, 57, 58, 59, 86, 87, 91]"

Norman,L100,long,16,11,5,0,0.8621,116,"[14, 27, 28, 29, 30, 57, 58, 59, 60, 61, 87, 88, 89, 90, 91, 92]"

Norman,L100,long,14,6,8,0,0.8772,114,"[28, 31, 32, 33, 34, 61, 62, 63, 64, 65, 92, 93, 94, 95]"

Norman,L100,long,11,7,4,2,0.9009,111,"[14, 26, 27, 29, 56, 57, 58, 59, 61, 88, 92]"

Norman,L100,long,8,3,5,0,0.9259,108,"[14, 28, 29, 56, 57, 59, 87, 89]"

Norman,L100,long,9,3,6,3,0.9174,109,"[15, 27, 28, 32, 59, 85, 87, 89, 90]"

Norman,L100,long,10,7,3,1,0.9091,110,"[14, 28, 29, 55, 56, 57, 59, 87, 88, 90]"

Norman,L100,long,12,7,5,1,0.8929,112,"[27, 29, 31, 56, 57, 58, 62, 63, 90, 91, 92, 93]"

Norman,L100,long,15,13,2,0,0.8696,115,"[14, 26, 29, 55, 56, 57, 58, 59, 60, 61, 62, 63, 64, 93, 94]"

Norman,L100,long,9,7,2,3,0.9174,109,"[28, 33, 58, 59, 60, 86, 87, 89, 90]"

Norman,L100,long,4,3,1,0,0.9615,104,"[29, 58, 59, 89]"

Norman,L100,long,10,4,6,1,0.9091,110,"[30, 55, 56, 57, 58, 59, 86, 87, 88, 89]"

Norman,L100,long,14,5,9,0,0.8772,114,"[27, 28, 29, 53, 55, 56, 57, 58, 59, 86, 87, 88, 89, 90]"

Norman,L100,long,10,6,4,0,0.9091,110,"[14, 28, 29, 55, 56, 58, 59, 86, 88, 89]"

Norman,L100,long,14,12,2,1,0.8772,114,"[14, 26, 27, 28, 29, 31, 58, 60, 61, 62, 90, 91, 92, 94]"

Norman,L100,long,12,1,11,2,0.8929,112,"[28, 31, 60, 61, 86, 87, 88, 89, 90, 91, 92, 93]"

Norman,L100,long,12,4,8,1,0.8929,112,"[27, 28, 29, 31, 55, 57, 58, 60, 87, 88, 89, 90]"

Norman,L100,long,10,6,4,4,0.9091,110,"[27, 29, 30, 54, 57, 59, 60, 87, 88, 94]"

Norman,L100,long,11,6,5,2,0.9009,111,"[14, 26, 27, 29, 31, 58, 60, 87, 89, 90, 92]"

Norman,L100,long,11,2,9,0,0.9009,111,"[27, 28, 29, 53, 54, 56, 58, 59, 87, 88, 89]"

Norman,L100,long,9,4,5,3,0.9174,109,"[27, 30, 55, 56, 57, 59, 84, 86, 91]"

Norman,L100,long,11,7,4,1,0.9009,111,"[14, 27, 29, 55, 56, 58, 60, 87, 88, 89, 91]"

Norman,L100,long,13,10,3,0,0.885,113,"[28, 29, 30, 31, 55, 57, 61, 62, 88, 90, 91, 92, 93]"

Norman,L100,long,10,3,7,1,0.9091,110,"[14, 26, 28, 29, 31, 58, 60, 61, 90, 93]"

Norman,L100,long,12,4,8,1,0.8929,112,"[27, 28, 29, 30, 54, 56, 58, 60, 61, 63, 89, 92]"

Norman,L100,long,10,6,4,0,0.9091,110,"[15, 28, 29, 30, 57, 58, 59, 60, 89, 90]"

Norman,L100,long,13,7,6,0,0.885,113,"[27, 30, 55, 56, 57, 58, 59, 60, 86, 87, 88, 89, 90]"

Norman,L100,long,9,2,7,0,0.9174,109,"[27, 28, 29, 53, 54, 56, 57, 59, 89]"

Norman,L100,long,11,5,6,0,0.9009,111,"[15, 27, 29, 55, 58, 59, 60, 87, 88, 89, 90]"

Norman,L100,long,13,9,4,1,0.885,113,"[14, 26, 27, 28, 29, 31, 32, 60, 61, 63, 90, 91, 92]"

Norman,L100,long,11,6,5,4,0.9009,111,"[14, 27, 28, 31, 58, 60, 87, 88, 89, 90, 94]"

Norman,L100,long,9,3,6,1,0.9174,109,"[27, 28, 29, 58, 59, 85, 87, 88, 90]"

Norman,L100,long,12,9,3,1,0.8929,112,"[14, 27, 31, 57, 60, 62, 87, 88, 89, 90, 91, 92]"

Norman,L100,long,10,4,6,4,0.9091,110,"[14, 27, 34, 61, 62, 63, 89, 91, 92, 94]"

Norman,L100,long,8,3,5,2,0.9259,108,"[14, 26, 27, 28, 30, 56, 60, 90]"

Norman,L100,long,12,7,5,3,0.8929,112,"[14, 26, 27, 31, 58, 59, 60, 63, 89, 90, 91, 94]"

Norman,L100,long,8,6,2,2,0.9259,108,"[14, 29, 58, 59, 60, 63, 90, 91]"

Norman,L100,long,10,7,3,1,0.9091,110,"[28, 30, 55, 56, 57, 58, 59, 61, 87, 91]"

Norman,L100,long,9,6,3,1,0.9174,109,"[15, 28, 29, 55, 56, 57, 58, 60, 89]"

Norman,L100,long,12,5,7,4,0.8929,112,"[27, 29, 53, 54, 55, 57, 58, 59, 61, 87, 89, 93]"

Norman,L100,long,9,4,5,4,0.9174,109,"[27, 28, 30, 54, 56, 58, 63, 89, 90]"

Norman,L100,long,14,5,9,0,0.8772,114,"[27, 28, 29, 54, 55, 56, 57, 58, 59, 86, 87, 88, 89, 90]"

Norman,L100,long,11,6,5,2,0.9009,111,"[14, 26, 28, 29, 55, 57, 58, 59, 85, 89, 92]"

Norman,L100,long,13,10,3,1,0.885,113,"[14, 26, 29, 55, 57, 60, 86, 87, 89, 90, 91, 92, 93]"

Norman,L100,long,7,1,6,3,0.9346,107,"[30, 55, 57, 58, 61, 88, 89]"

Norman,L100,long,11,6,5,1,0.9009,111,"[27, 30, 55, 56, 57, 58, 59, 85, 86, 88, 89]"

Norman,L100,long,11,8,3,2,0.9009,111,"[17, 28, 32, 58, 60, 85, 86, 88, 89, 90, 91]"

Norman,L100,long,8,4,4,4,0.9259,108,"[28, 30, 56, 59, 63, 88, 90, 93]"

Norman,L100,long,11,2,9,1,0.9009,111,"[27, 29, 53, 54, 55, 56, 57, 58, 60, 87, 89]"

Norman,L100,long,11,6,5,1,0.9009,111,"[27, 30, 31, 32, 57, 59, 60, 63, 89, 91, 92]"

Norman,L100,long,9,3,6,3,0.9174,109,"[27, 29, 32, 57, 59, 61, 87, 89, 90]"

Norman,L100,long,10,1,9,2,0.9091,110,"[15, 27, 28, 29, 30, 31, 35, 62, 66, 95]"

Norman,L100,long,10,5,5,2,0.9091,110,"[27, 29, 32, 57, 59, 60, 86, 87, 89, 90]"

Norman,L100,long,11,6,5,1,0.9009,111,"[14, 27, 28, 30, 57, 58, 59, 60, 87, 89, 90]"

Norman,L100,long,11,6,5,3,0.9009,111,"[14, 26, 27, 29, 31, 58, 59, 60, 87, 90, 93]"

Norman,L100,long,9,2,7,3,0.9174,109,"[27, 28, 29, 32, 57, 59, 60, 62, 91]"

Norman,L100,long,10,4,6,1,0.9091,110,"[27, 28, 29, 54, 55, 57, 58, 60, 86, 89]"

Norman,L100,long,11,5,6,1,0.9009,111,"[27, 29, 53, 54, 55, 57, 58, 61, 87, 89, 90]"

Norman,L100,long,8,3,5,13,0.9259,108,"[27, 29, 53, 54, 56, 58, 68, 93]"

Norman,L100,long,11,6,5,4,0.9009,111,"[14, 30, 35, 61, 62, 63, 65, 91, 92, 93, 94]"

Norman,L100,long,9,6,3,0,0.9174,109,"[15, 29, 58, 59, 61, 88, 90, 92, 94]"

Norman,L100,long,11,9,2,3,0.9009,111,"[16, 27, 31, 57, 60, 61, 86, 87, 89, 90, 95]"

Norman,L100,long,15,7,8,0,0.8696,115,"[16, 27, 28, 29, 30, 31, 32, 60, 62, 64, 90, 91, 92, 93, 94]"

Norman,L100,long,11,6,5,2,0.9009,111,"[14, 27, 28, 30, 57, 58, 59, 60, 87, 89, 91]"

Norman,L100,long,12,2,10,1,0.8929,112,"[27, 28, 31, 56, 59, 60, 61, 86, 90, 91, 92, 93]"

Norman,L100,long,10,3,7,3,0.9091,110,"[27, 31, 56, 57, 58, 59, 84, 87, 88, 90]"

Norman,L100,long,10,4,6,4,0.9091,110,"[27, 28, 30, 54, 56, 58, 60, 86, 88, 91]"

Norman,L100,long,12,3,9,0,0.8929,112,"[27, 28, 29, 30, 54, 56, 58, 59, 60, 87, 89, 90]"

Norman,L100,long,13,0,13,1,0.885,113,"[27, 28, 29, 54, 55, 56, 57, 58, 59, 60, 88, 89, 91]"

Norman,L100,long,13,2,11,0,0.885,113,"[27, 28, 29, 53, 54, 56, 58, 59, 86, 87, 89, 90, 91]"

Norman,L100,long,8,4,4,2,0.9259,108,"[28, 30, 55, 58, 59, 61, 89, 90]"

Norman,L100,long,11,3,8,4,0.9009,111,"[27, 28, 29, 30, 32, 58, 60, 62, 87, 90, 93]"

Norman,L100,long,10,4,6,1,0.9091,110,"[27, 28, 29, 54, 55, 57, 58, 59, 86, 90]"

Norman,L100,long,10,2,8,2,0.9091,110,"[27, 28, 29, 53, 55, 58, 59, 61, 87, 91]"

Norman,L100,long,11,5,6,1,0.9009,111,"[14, 27, 28, 29, 30, 56, 58, 59, 61, 90, 91]"

Norman,L100,long,9,6,3,1,0.9174,109,"[14, 26, 29, 31, 60, 85, 86, 88, 90]"

Norman,L100,long,11,7,4,2,0.9009,111,"[27, 28, 31, 56, 57, 59, 61, 87, 89, 90, 91]"

Norman,L100,long,15,11,4,1,0.8696,115,"[14, 26, 27, 28, 29, 30, 56, 58, 59, 61, 87, 88, 89, 90, 91]"

Norman,L100,long,9,6,3,4,0.9174,109,"[14, 28, 33, 59, 84, 86, 87, 88, 89]"

Norman,L100,long,12,10,2,0,0.8929,112,"[14, 26, 30, 57, 60, 61, 62, 88, 89, 90, 91, 92]"

Norman,L100,long,9,6,3,2,0.9174,109,"[15, 28, 30, 58, 60, 85, 86, 87, 89]"

Norman,L100,long,12,5,7,4,0.8929,112,"[27, 28, 29, 31, 55, 57, 58, 60, 63, 90, 92, 94]"

Norman,L100,long,11,5,6,1,0.9009,111,"[27, 29, 31, 57, 58, 59, 60, 61, 88, 90, 91]"

Norman,L100,long,10,3,7,1,0.9091,110,"[27, 31, 56, 58, 59, 61, 87, 88, 90, 92]"

Norman,L100,long,9,5,4,0,0.9174,109,"[14, 26, 27, 29, 55, 57, 59, 87, 90]"

Norman,L100,long,16,9,7,0,0.8621,116,"[14, 27, 28, 29, 55, 57, 58, 59, 60, 61, 87, 88, 89, 90, 92, 94]"

Norman,L100,long,11,6,5,1,0.9009,111,"[28, 30, 55, 57, 58, 59, 61, 86, 89, 90, 91]"

Norman,L100,long,10,5,5,7,0.9091,110,"[27, 28, 29, 30, 37, 63, 90, 91, 93, 94]"

Norman,L100,long,10,1,9,1,0.9091,110,"[14, 27, 28, 30, 32, 59, 60, 61, 62, 92]"

Norman,L100,long,10,2,8,1,0.9091,110,"[27, 28, 29, 53, 55, 56, 57, 59, 87, 90]"

Norman,L100,long,14,5,9,1,0.8772,114,"[28, 29, 53, 54, 55, 56, 57, 58, 59, 86, 87, 89, 90, 93]"

Norman,L100,long,12,7,5,1,0.8929,112,"[14, 26, 28, 30, 31, 58, 59, 60, 62, 89, 90, 91]"

Norman,L100,long,9,6,3,1,0.9174,109,"[27, 29, 54, 55, 56, 57, 60, 85, 89]"

Norman,L100,long,11,5,6,1,0.9009,111,"[15, 27, 28, 30, 57, 59, 60, 87, 88, 89, 90]"

Norman,L100,long,10,2,8,1,0.9091,110,"[15, 28, 29, 57, 58, 59, 60, 87, 89, 91]"

Norman,L100,long,14,9,5,5,0.8772,114,"[14, 26, 27, 29, 55, 57, 58, 59, 60, 61, 62, 63, 90, 99]"

Norman,L100,long,8,2,6,1,0.9259,108,"[15, 30, 57, 58, 59, 85, 88, 89]"

